state_name,district_name,disability_type,age_lower,age_upper,Male_count,female_count,total
Maharashtra,Yavatmal,Acid Attack Victim,35,60,1,0,1
Maharashtra,Yavatmal,Acid Attack Victim,60,80,0,1,1
Haryana,Yamunanagar,Acid Attack Victim,15,35,1,0,1
Haryana,Yamunanagar,Acid Attack Victim,35,60,4,0,4
Karnataka,Yadgir,Acid Attack Victim,15,35,5,8,13
Karnataka,Yadgir,Acid Attack Victim,35,60,5,4,9
Jharkhand,West Singhbhum,Acid Attack Victim,6,15,1,0,1
Jharkhand,West Singhbhum,Acid Attack Victim,35,60,1,0,1
Meghalaya,West Jaintia Hills,Acid Attack Victim,15,35,0,1,1
Maharashtra,Wardha,Acid Attack Victim,35,60,1,0,1
Andhra Pradesh,Vizianagaram,Acid Attack Victim,35,60,3,0,3
Andhra Pradesh,Visakhapatanam,Acid Attack Victim,15,35,1,0,1
Andhra Pradesh,Visakhapatanam,Acid Attack Victim,35,60,2,0,2
Tamil Nadu,Virudhunagar,Acid Attack Victim,6,15,1,1,2
Tamil Nadu,Virudhunagar,Acid Attack Victim,15,35,4,7,11
Tamil Nadu,Virudhunagar,Acid Attack Victim,35,60,13,15,28
Tamil Nadu,Virudhunagar,Acid Attack Victim,60,80,1,5,6
Tamil Nadu,Villupuram,Acid Attack Victim,35,60,2,1,3
Tamil Nadu,Villupuram,Acid Attack Victim,60,80,1,1,2
Karnataka,Vijayapura,Acid Attack Victim,6,15,1,0,1
Karnataka,Vijayapura,Acid Attack Victim,15,35,7,7,14
Karnataka,Vijayapura,Acid Attack Victim,35,60,11,2,13
Karnataka,Vijayapura,Acid Attack Victim,60,80,2,0,2
Madhya Pradesh,Vidisha,Acid Attack Victim,15,35,4,2,6
Madhya Pradesh,Vidisha,Acid Attack Victim,35,60,5,2,7
Madhya Pradesh,Vidisha,Acid Attack Victim,60,80,3,0,3
Tamil Nadu,Vellore,Acid Attack Victim,15,35,8,8,16
Tamil Nadu,Vellore,Acid Attack Victim,35,60,14,4,18
Tamil Nadu,Vellore,Acid Attack Victim,60,80,1,4,5
Tamil Nadu,Vellore,Acid Attack Victim,80,100,1,0,1
Uttar Pradesh,Varanasi,Acid Attack Victim,35,60,1,0,1
Gujarat,Valsad,Acid Attack Victim,60,80,0,1,1
Bihar,Vaishali,Acid Attack Victim,6,15,0,1,1
Bihar,Vaishali,Acid Attack Victim,15,35,5,0,5
Bihar,Vaishali,Acid Attack Victim,35,60,1,0,1
Gujarat,Vadodara,Acid Attack Victim,35,60,0,1,1
Karnataka,Uttara Kannada,Acid Attack Victim,35,60,1,2,3
Uttarakhand,Uttar Kashi,Acid Attack Victim,15,35,2,1,3
Uttarakhand,Uttar Kashi,Acid Attack Victim,35,60,1,0,1
Uttar Pradesh,Unnao,Acid Attack Victim,15,35,2,0,2
Uttar Pradesh,Unnao,Acid Attack Victim,35,60,2,2,4
Himachal Pradesh,Una,Acid Attack Victim,35,60,0,1,1
Madhya Pradesh,Umaria,Acid Attack Victim,6,15,0,1,1
Madhya Pradesh,Umaria,Acid Attack Victim,15,35,10,5,15
Madhya Pradesh,Umaria,Acid Attack Victim,35,60,7,5,12
Madhya Pradesh,Umaria,Acid Attack Victim,60,80,1,0,1
Madhya Pradesh,Ujjain,Acid Attack Victim,6,15,0,1,1
Madhya Pradesh,Ujjain,Acid Attack Victim,15,35,0,1,1
Madhya Pradesh,Ujjain,Acid Attack Victim,35,60,1,1,2
Karnataka,Udupi,Acid Attack Victim,35,60,0,1,1
Uttarakhand,Udam Singh Nagar,Acid Attack Victim,35,60,0,2,2
Uttarakhand,Udam Singh Nagar,Acid Attack Victim,60,80,1,0,1
Assam,Udalguri,Acid Attack Victim,35,60,2,1,3
Rajasthan,Udaipur,Acid Attack Victim,15,35,1,1,2
Rajasthan,Udaipur,Acid Attack Victim,35,60,2,0,2
Tamil Nadu,Tuticorin,Acid Attack Victim,35,60,1,1,2
Tamil Nadu,Tuticorin,Acid Attack Victim,60,80,1,0,1
Karnataka,Tumakuru,Acid Attack Victim,0,6,1,0,1
Karnataka,Tumakuru,Acid Attack Victim,6,15,0,2,2
Karnataka,Tumakuru,Acid Attack Victim,15,35,2,0,2
Karnataka,Tumakuru,Acid Attack Victim,35,60,10,9,19
Karnataka,Tumakuru,Acid Attack Victim,60,80,2,1,3
Rajasthan,Tonk,Acid Attack Victim,15,35,1,0,1
Rajasthan,Tonk,Acid Attack Victim,35,60,3,1,4
Tamil Nadu,Tiruvannamalai,Acid Attack Victim,0,6,3,0,3
Tamil Nadu,Tiruvannamalai,Acid Attack Victim,6,15,0,1,1
Tamil Nadu,Tiruvannamalai,Acid Attack Victim,15,35,1,1,2
Tamil Nadu,Tiruvannamalai,Acid Attack Victim,35,60,5,2,7
Tamil Nadu,Tiruvannamalai,Acid Attack Victim,60,80,1,0,1
Tamil Nadu,Tiruppur,Acid Attack Victim,35,60,1,0,1
Tamil Nadu,Tirupathur,Acid Attack Victim,15,35,3,4,7
Tamil Nadu,Tirupathur,Acid Attack Victim,35,60,6,2,8
Tamil Nadu,Tirupathur,Acid Attack Victim,60,80,3,0,3
Tamil Nadu,Tirupathur,Acid Attack Victim,80,100,0,1,1
Tamil Nadu,Tiruchirappalli,Acid Attack Victim,6,15,1,0,1
Tamil Nadu,Tiruchirappalli,Acid Attack Victim,15,35,1,2,3
Tamil Nadu,Tiruchirappalli,Acid Attack Victim,35,60,1,0,1
Assam,Tinsukia,Acid Attack Victim,35,60,1,0,1
Madhya Pradesh,Tikamgarh,Acid Attack Victim,15,35,1,1,2
Madhya Pradesh,Tikamgarh,Acid Attack Victim,35,60,2,0,2
Kerala,Thrissur,Acid Attack Victim,35,60,2,0,2
Kerala,Thrissur,Acid Attack Victim,60,80,3,0,3
Tamil Nadu,Thiruvarur,Acid Attack Victim,15,35,1,0,1
Tamil Nadu,Thiruvarur,Acid Attack Victim,35,60,0,1,1
Kerala,Thiruvananthapuram,Acid Attack Victim,15,35,2,0,2
Kerala,Thiruvananthapuram,Acid Attack Victim,35,60,1,3,4
Tamil Nadu,Thiruvallur,Acid Attack Victim,60,80,1,0,1
Maharashtra,Thane,Acid Attack Victim,15,35,2,0,2
Maharashtra,Thane,Acid Attack Victim,35,60,5,0,5
Maharashtra,Thane,Acid Attack Victim,60,80,4,2,6
Uttarakhand,Tehri Garhwal,Acid Attack Victim,35,60,2,0,2
Punjab,Tarn Taran,Acid Attack Victim,0,6,0,1,1
Punjab,Tarn Taran,Acid Attack Victim,15,35,2,2,4
Punjab,Tarn Taran,Acid Attack Victim,35,60,12,4,16
Chhattisgarh,Surguja,Acid Attack Victim,15,35,0,1,1
Gujarat,Surat,Acid Attack Victim,35,60,1,0,1
Chhattisgarh,Surajpur,Acid Attack Victim,35,60,1,0,1
Bihar,Supaul,Acid Attack Victim,6,15,1,0,1
Bihar,Supaul,Acid Attack Victim,35,60,1,1,2
Odisha,Sundargarh,Acid Attack Victim,6,15,1,4,5
Odisha,Sundargarh,Acid Attack Victim,15,35,1,4,5
Odisha,Sundargarh,Acid Attack Victim,35,60,9,7,16
Odisha,Sundargarh,Acid Attack Victim,60,80,1,0,1
Uttar Pradesh,Sultanpur,Acid Attack Victim,15,35,7,1,8
Uttar Pradesh,Sultanpur,Acid Attack Victim,35,60,14,3,17
Uttar Pradesh,Sultanpur,Acid Attack Victim,60,80,6,0,6
Andhra Pradesh,Srikakulam,Acid Attack Victim,15,35,2,0,2
Andhra Pradesh,Srikakulam,Acid Attack Victim,35,60,1,0,1
Punjab,Sri Muktsar Sahib,Acid Attack Victim,6,15,0,1,1
Punjab,Sri Muktsar Sahib,Acid Attack Victim,35,60,4,0,4
Punjab,Sri Muktsar Sahib,Acid Attack Victim,60,80,1,0,1
Andhra Pradesh,Spsr Nellore,Acid Attack Victim,15,35,2,0,2
Andaman And Nicobar Islands,South Andamans,Acid Attack Victim,15,35,1,0,1
Andaman And Nicobar Islands,South Andamans,Acid Attack Victim,35,60,1,1,2
Andaman And Nicobar Islands,South Andamans,Acid Attack Victim,60,80,2,0,2
Haryana,Sonipat,Acid Attack Victim,15,35,1,0,1
Haryana,Sonipat,Acid Attack Victim,35,60,1,1,2
Odisha,Sonepur,Acid Attack Victim,35,60,1,0,1
Odisha,Sonepur,Acid Attack Victim,60,80,1,0,1
Uttar Pradesh,Sonbhadra,Acid Attack Victim,15,35,7,2,9
Uttar Pradesh,Sonbhadra,Acid Attack Victim,35,60,5,0,5
Maharashtra,Solapur,Acid Attack Victim,15,35,1,0,1
Himachal Pradesh,Solan,Acid Attack Victim,35,60,1,0,1
Bihar,Siwan,Acid Attack Victim,6,15,0,1,1
Bihar,Siwan,Acid Attack Victim,15,35,3,2,5
Bihar,Siwan,Acid Attack Victim,35,60,1,1,2
Bihar,Siwan,Acid Attack Victim,60,80,2,0,2
Tamil Nadu,Sivaganga,Acid Attack Victim,0,6,1,0,1
Tamil Nadu,Sivaganga,Acid Attack Victim,60,80,1,0,1
Uttar Pradesh,Sitapur,Acid Attack Victim,15,35,2,1,3
Uttar Pradesh,Sitapur,Acid Attack Victim,35,60,6,0,6
Bihar,Sitamarhi,Acid Attack Victim,15,35,2,1,3
Bihar,Sitamarhi,Acid Attack Victim,35,60,0,2,2
Haryana,Sirsa,Acid Attack Victim,35,60,0,1,1
Rajasthan,Sirohi,Acid Attack Victim,6,15,1,0,1
Rajasthan,Sirohi,Acid Attack Victim,15,35,1,0,1
Rajasthan,Sirohi,Acid Attack Victim,35,60,1,0,1
Himachal Pradesh,Sirmaur,Acid Attack Victim,35,60,2,0,2
Madhya Pradesh,Singrauli,Acid Attack Victim,15,35,0,1,1
Madhya Pradesh,Singrauli,Acid Attack Victim,35,60,1,0,1
Madhya Pradesh,Sidhi,Acid Attack Victim,6,15,1,0,1
Madhya Pradesh,Sidhi,Acid Attack Victim,15,35,8,1,9
Madhya Pradesh,Sidhi,Acid Attack Victim,35,60,9,1,10
Madhya Pradesh,Sidhi,Acid Attack Victim,60,80,1,0,1
Uttar Pradesh,Siddharth Nagar,Acid Attack Victim,6,15,2,0,2
Uttar Pradesh,Siddharth Nagar,Acid Attack Victim,15,35,5,4,9
Uttar Pradesh,Siddharth Nagar,Acid Attack Victim,35,60,15,4,19
Uttar Pradesh,Siddharth Nagar,Acid Attack Victim,60,80,3,2,5
Uttar Pradesh,Siddharth Nagar,Acid Attack Victim,80,100,1,0,1
Uttar Pradesh,Shravasti,Acid Attack Victim,6,15,1,0,1
Uttar Pradesh,Shravasti,Acid Attack Victim,15,35,1,2,3
Uttar Pradesh,Shravasti,Acid Attack Victim,35,60,4,1,5
Uttar Pradesh,Shravasti,Acid Attack Victim,60,80,2,0,2
Jammu And Kashmir,Shopian,Acid Attack Victim,15,35,1,0,1
Madhya Pradesh,Shivpuri,Acid Attack Victim,6,15,0,1,1
Madhya Pradesh,Shivpuri,Acid Attack Victim,15,35,2,1,3
Madhya Pradesh,Shivpuri,Acid Attack Victim,35,60,3,1,4
Karnataka,Shivamogga,Acid Attack Victim,35,60,3,4,7
Himachal Pradesh,Shimla,Acid Attack Victim,35,60,0,1,1
Bihar,Sheohar,Acid Attack Victim,6,15,0,5,5
Bihar,Sheohar,Acid Attack Victim,15,35,1,0,1
Bihar,Sheohar,Acid Attack Victim,35,60,1,0,1
Uttar Pradesh,Shamli,Acid Attack Victim,15,35,2,0,2
Uttar Pradesh,Shamli,Acid Attack Victim,35,60,3,1,4
Uttar Pradesh,Shahjahanpur,Acid Attack Victim,0,6,2,0,2
Uttar Pradesh,Shahjahanpur,Acid Attack Victim,6,15,6,5,11
Uttar Pradesh,Shahjahanpur,Acid Attack Victim,15,35,30,10,40
Uttar Pradesh,Shahjahanpur,Acid Attack Victim,35,60,31,13,44
Uttar Pradesh,Shahjahanpur,Acid Attack Victim,60,80,14,4,18
Punjab,Shahid Bhagat Singh Nagar,Acid Attack Victim,15,35,1,1,2
Madhya Pradesh,Shahdol,Acid Attack Victim,0,6,1,0,1
Madhya Pradesh,Shahdol,Acid Attack Victim,6,15,2,0,2
Madhya Pradesh,Shahdol,Acid Attack Victim,15,35,3,0,3
Madhya Pradesh,Shahdol,Acid Attack Victim,35,60,4,0,4
Madhya Pradesh,Shahdol,Acid Attack Victim,60,80,0,1,1
Delhi,Shahdara,Acid Attack Victim,35,60,1,0,1
Madhya Pradesh,Seoni,Acid Attack Victim,6,15,1,0,1
Madhya Pradesh,Seoni,Acid Attack Victim,15,35,2,2,4
Madhya Pradesh,Seoni,Acid Attack Victim,35,60,0,1,1
Manipur,Senapati,Acid Attack Victim,15,35,0,1,1
Maharashtra,Satara,Acid Attack Victim,6,15,0,1,1
Maharashtra,Satara,Acid Attack Victim,15,35,1,3,4
Maharashtra,Satara,Acid Attack Victim,35,60,3,0,3
Bihar,Saran,Acid Attack Victim,15,35,4,1,5
Bihar,Saran,Acid Attack Victim,35,60,2,1,3
Jharkhand,Saraikela Kharsawan,Acid Attack Victim,35,60,1,0,1
Uttar Pradesh,Sant Kabeer Nagar,Acid Attack Victim,35,60,1,0,1
Punjab,Sangrur,Acid Attack Victim,15,35,2,2,4
Punjab,Sangrur,Acid Attack Victim,35,60,1,1,2
Punjab,Sangrur,Acid Attack Victim,80,100,1,0,1
Maharashtra,Sangli,Acid Attack Victim,15,35,1,0,1
Maharashtra,Sangli,Acid Attack Victim,35,60,1,0,1
Odisha,Sambalpur,Acid Attack Victim,15,35,0,1,1
Odisha,Sambalpur,Acid Attack Victim,35,60,0,2,2
Bihar,Samastipur,Acid Attack Victim,6,15,1,0,1
Bihar,Samastipur,Acid Attack Victim,15,35,7,3,10
Bihar,Samastipur,Acid Attack Victim,35,60,9,4,13
Bihar,Samastipur,Acid Attack Victim,60,80,2,1,3
Tamil Nadu,Salem,Acid Attack Victim,6,15,1,0,1
Tamil Nadu,Salem,Acid Attack Victim,15,35,1,3,4
Tamil Nadu,Salem,Acid Attack Victim,35,60,0,1,1
Jharkhand,Sahebganj,Acid Attack Victim,35,60,0,1,1
Bihar,Saharsa,Acid Attack Victim,6,15,0,2,2
Bihar,Saharsa,Acid Attack Victim,15,35,1,0,1
Bihar,Saharsa,Acid Attack Victim,35,60,1,0,1
Uttar Pradesh,Saharanpur,Acid Attack Victim,15,35,5,6,11
Uttar Pradesh,Saharanpur,Acid Attack Victim,35,60,10,4,14
Uttar Pradesh,Saharanpur,Acid Attack Victim,60,80,1,0,1
Uttar Pradesh,Saharanpur,Acid Attack Victim,80,100,2,0,2
Madhya Pradesh,Sagar,Acid Attack Victim,15,35,1,1,2
Madhya Pradesh,Sagar,Acid Attack Victim,35,60,4,1,5
Madhya Pradesh,Sagar,Acid Attack Victim,60,80,0,2,2
Punjab,S.A.S Nagar,Acid Attack Victim,6,15,2,1,3
Punjab,S.A.S Nagar,Acid Attack Victim,35,60,3,0,3
Punjab,S.A.S Nagar,Acid Attack Victim,60,80,1,0,1
Punjab,Rupnagar,Acid Attack Victim,6,15,0,1,1
Punjab,Rupnagar,Acid Attack Victim,15,35,1,0,1
Punjab,Rupnagar,Acid Attack Victim,35,60,3,2,5
Punjab,Rupnagar,Acid Attack Victim,60,80,1,0,1
Punjab,Rupnagar,Acid Attack Victim,80,100,1,0,1
Uttarakhand,Rudra Prayag,Acid Attack Victim,35,60,1,0,1
Bihar,Rohtas,Acid Attack Victim,6,15,2,0,2
Bihar,Rohtas,Acid Attack Victim,15,35,6,3,9
Bihar,Rohtas,Acid Attack Victim,35,60,3,0,3
Haryana,Rohtak,Acid Attack Victim,15,35,0,3,3
Haryana,Rewari,Acid Attack Victim,15,35,1,0,1
Haryana,Rewari,Acid Attack Victim,35,60,0,2,2
Haryana,Rewari,Acid Attack Victim,60,80,1,0,1
Madhya Pradesh,Rewa,Acid Attack Victim,15,35,0,1,1
Madhya Pradesh,Rewa,Acid Attack Victim,35,60,1,0,1
Odisha,Rayagada,Acid Attack Victim,15,35,4,2,6
Odisha,Rayagada,Acid Attack Victim,35,60,2,0,2
Maharashtra,Ratnagiri,Acid Attack Victim,60,80,2,0,2
Tamil Nadu,Ranipet,Acid Attack Victim,15,35,1,3,4
Tamil Nadu,Ranipet,Acid Attack Victim,35,60,2,1,3
Tamil Nadu,Ranipet,Acid Attack Victim,60,80,2,1,3
Jharkhand,Ranchi,Acid Attack Victim,15,35,1,0,1
Jharkhand,Ranchi,Acid Attack Victim,35,60,2,0,2
Uttar Pradesh,Rampur,Acid Attack Victim,15,35,4,1,5
Uttar Pradesh,Rampur,Acid Attack Victim,35,60,7,2,9
Uttar Pradesh,Rampur,Acid Attack Victim,60,80,1,0,1
Jharkhand,Ramgarh,Acid Attack Victim,0,6,0,1,1
Jharkhand,Ramgarh,Acid Attack Victim,6,15,8,1,9
Jharkhand,Ramgarh,Acid Attack Victim,15,35,31,19,50
Jharkhand,Ramgarh,Acid Attack Victim,35,60,34,21,55
Jharkhand,Ramgarh,Acid Attack Victim,60,80,7,5,12
Jammu And Kashmir,Ramban,Acid Attack Victim,35,60,1,0,1
Tamil Nadu,Ramanathapuram,Acid Attack Victim,35,60,1,0,1
Tamil Nadu,Ramanathapuram,Acid Attack Victim,60,80,1,1,2
Karnataka,Ramanagara,Acid Attack Victim,15,35,1,1,2
Karnataka,Ramanagara,Acid Attack Victim,35,60,3,4,7
Karnataka,Ramanagara,Acid Attack Victim,60,80,1,1,2
Rajasthan,Rajsamand,Acid Attack Victim,15,35,0,2,2
Rajasthan,Rajsamand,Acid Attack Victim,35,60,4,0,4
Jammu And Kashmir,Rajouri,Acid Attack Victim,15,35,0,2,2
Jammu And Kashmir,Rajouri,Acid Attack Victim,35,60,0,1,1
Chhattisgarh,Rajnandgaon,Acid Attack Victim,15,35,2,1,3
Chhattisgarh,Rajnandgaon,Acid Attack Victim,35,60,2,0,2
Madhya Pradesh,Rajgarh,Acid Attack Victim,15,35,3,0,3
Madhya Pradesh,Rajgarh,Acid Attack Victim,35,60,6,1,7
Madhya Pradesh,Rajgarh,Acid Attack Victim,60,80,1,2,3
Madhya Pradesh,Raisen,Acid Attack Victim,15,35,2,3,5
Madhya Pradesh,Raisen,Acid Attack Victim,35,60,5,1,6
Madhya Pradesh,Raisen,Acid Attack Victim,60,80,1,0,1
Chhattisgarh,Raipur,Acid Attack Victim,15,35,0,1,1
Chhattisgarh,Raipur,Acid Attack Victim,35,60,2,0,2
Chhattisgarh,Raigarh,Acid Attack Victim,6,15,0,1,1
Maharashtra,Raigad,Acid Attack Victim,35,60,1,0,1
Karnataka,Raichur,Acid Attack Victim,35,60,1,0,1
Uttar Pradesh,Rae Bareli,Acid Attack Victim,15,35,1,0,1
Uttar Pradesh,Rae Bareli,Acid Attack Victim,35,60,0,2,2
Bihar,Purnia,Acid Attack Victim,35,60,2,0,2
Bihar,Purnia,Acid Attack Victim,60,80,1,0,1
Odisha,Puri,Acid Attack Victim,6,15,0,1,1
Odisha,Puri,Acid Attack Victim,15,35,4,2,6
Odisha,Puri,Acid Attack Victim,35,60,5,1,6
Bihar,Purbi Champaran,Acid Attack Victim,6,15,0,1,1
Bihar,Purbi Champaran,Acid Attack Victim,15,35,4,3,7
Bihar,Purbi Champaran,Acid Attack Victim,35,60,6,0,6
Bihar,Purbi Champaran,Acid Attack Victim,60,80,2,0,2
Maharashtra,Pune,Acid Attack Victim,15,35,1,1,2
Maharashtra,Pune,Acid Attack Victim,35,60,4,0,4
Jammu And Kashmir,Pulwama,Acid Attack Victim,6,15,3,2,5
Jammu And Kashmir,Pulwama,Acid Attack Victim,15,35,1,11,12
Jammu And Kashmir,Pulwama,Acid Attack Victim,35,60,5,14,19
Jammu And Kashmir,Pulwama,Acid Attack Victim,60,80,2,0,2
Tamil Nadu,Pudukkottai,Acid Attack Victim,15,35,0,1,1
Tamil Nadu,Pudukkottai,Acid Attack Victim,35,60,0,2,2
Uttar Pradesh,Prayagraj,Acid Attack Victim,15,35,2,1,3
Uttar Pradesh,Prayagraj,Acid Attack Victim,35,60,3,2,5
Uttar Pradesh,Prayagraj,Acid Attack Victim,60,80,3,0,3
Rajasthan,Pratapgarh,Acid Attack Victim,15,35,0,3,3
Rajasthan,Pratapgarh,Acid Attack Victim,35,60,3,1,4
Uttar Pradesh,Pratapgarh,Acid Attack Victim,15,35,12,2,14
Uttar Pradesh,Pratapgarh,Acid Attack Victim,35,60,10,5,15
Uttar Pradesh,Pratapgarh,Acid Attack Victim,60,80,3,0,3
Andhra Pradesh,Prakasam,Acid Attack Victim,15,35,2,0,2
Andhra Pradesh,Prakasam,Acid Attack Victim,60,80,1,0,1
Jammu And Kashmir,Poonch,Acid Attack Victim,0,6,1,1,2
Jammu And Kashmir,Poonch,Acid Attack Victim,6,15,7,4,11
Jammu And Kashmir,Poonch,Acid Attack Victim,15,35,25,15,40
Jammu And Kashmir,Poonch,Acid Attack Victim,35,60,34,19,53
Jammu And Kashmir,Poonch,Acid Attack Victim,60,80,5,2,7
Jammu And Kashmir,Poonch,Acid Attack Victim,80,100,2,0,2
Puducherry,Pondicherry,Acid Attack Victim,15,35,0,3,3
Puducherry,Pondicherry,Acid Attack Victim,35,60,0,2,2
Uttar Pradesh,Pilibhit,Acid Attack Victim,6,15,0,1,1
Uttar Pradesh,Pilibhit,Acid Attack Victim,15,35,12,1,13
Uttar Pradesh,Pilibhit,Acid Attack Victim,35,60,8,6,14
Uttar Pradesh,Pilibhit,Acid Attack Victim,60,80,3,0,3
Uttar Pradesh,Pilibhit,Acid Attack Victim,80,100,1,0,1
Uttarakhand,Pauri Garhwal,Acid Attack Victim,15,35,1,0,1
Bihar,Patna,Acid Attack Victim,0,6,1,0,1
Bihar,Patna,Acid Attack Victim,6,15,1,0,1
Bihar,Patna,Acid Attack Victim,15,35,8,6,14
Bihar,Patna,Acid Attack Victim,35,60,4,3,7
Punjab,Patiala,Acid Attack Victim,15,35,1,6,7
Punjab,Patiala,Acid Attack Victim,35,60,8,3,11
Punjab,Patiala,Acid Attack Victim,80,100,1,1,2
Punjab,Pathankot,Acid Attack Victim,15,35,0,1,1
Punjab,Pathankot,Acid Attack Victim,35,60,3,0,3
Punjab,Pathankot,Acid Attack Victim,60,80,2,0,2
Kerala,Pathanamthitta,Acid Attack Victim,35,60,0,1,1
Kerala,Pathanamthitta,Acid Attack Victim,60,80,1,1,2
Bihar,Pashchim Champaran,Acid Attack Victim,15,35,0,3,3
Bihar,Pashchim Champaran,Acid Attack Victim,35,60,3,1,4
Bihar,Pashchim Champaran,Acid Attack Victim,60,80,2,0,2
Maharashtra,Parbhani,Acid Attack Victim,15,35,4,1,5
Maharashtra,Parbhani,Acid Attack Victim,35,60,7,2,9
Maharashtra,Parbhani,Acid Attack Victim,60,80,3,1,4
Madhya Pradesh,Panna,Acid Attack Victim,15,35,3,0,3
Madhya Pradesh,Panna,Acid Attack Victim,35,60,5,1,6
Haryana,Panipat,Acid Attack Victim,15,35,0,1,1
Haryana,Panipat,Acid Attack Victim,35,60,1,0,1
Haryana,Panchkula,Acid Attack Victim,35,60,0,1,1
Haryana,Palwal,Acid Attack Victim,15,35,1,0,1
Rajasthan,Pali,Acid Attack Victim,15,35,1,0,1
Maharashtra,Palghar,Acid Attack Victim,35,60,1,0,1
Jharkhand,Palamu,Acid Attack Victim,35,60,2,0,2
Kerala,Palakkad,Acid Attack Victim,35,60,2,0,2
Jharkhand,Pakur,Acid Attack Victim,15,35,2,0,2
Maharashtra,Osmanabad,Acid Attack Victim,6,15,0,3,3
Maharashtra,Osmanabad,Acid Attack Victim,15,35,11,7,18
Maharashtra,Osmanabad,Acid Attack Victim,35,60,15,15,30
Maharashtra,Osmanabad,Acid Attack Victim,60,80,5,3,8
Haryana,Nuh,Acid Attack Victim,15,35,1,0,1
Haryana,Nuh,Acid Attack Victim,35,60,1,0,1
Odisha,Nuapada,Acid Attack Victim,35,60,3,0,3
Delhi,North West,Acid Attack Victim,35,60,3,0,3
Goa,North Goa,Acid Attack Victim,15,35,1,0,1
Andaman And Nicobar Islands,North And Middle Andaman,Acid Attack Victim,35,60,1,0,1
Delhi,North,Acid Attack Victim,6,15,1,0,1
Madhya Pradesh,Niwari,Acid Attack Victim,15,35,1,1,2
Madhya Pradesh,Niwari,Acid Attack Victim,60,80,0,1,1
Andaman And Nicobar Islands,Nicobars,Acid Attack Victim,35,60,0,1,1
Madhya Pradesh,Neemuch,Acid Attack Victim,6,15,0,1,1
Madhya Pradesh,Neemuch,Acid Attack Victim,15,35,1,0,1
Odisha,Nayagarh,Acid Attack Victim,6,15,1,1,2
Odisha,Nayagarh,Acid Attack Victim,15,35,5,0,5
Odisha,Nayagarh,Acid Attack Victim,35,60,3,3,6
Bihar,Nawada,Acid Attack Victim,6,15,1,0,1
Bihar,Nawada,Acid Attack Victim,15,35,1,1,2
Bihar,Nawada,Acid Attack Victim,35,60,0,1,1
Madhya Pradesh,Narsinghpur,Acid Attack Victim,6,15,1,1,2
Madhya Pradesh,Narsinghpur,Acid Attack Victim,15,35,14,7,21
Madhya Pradesh,Narsinghpur,Acid Attack Victim,35,60,41,8,49
Madhya Pradesh,Narsinghpur,Acid Attack Victim,60,80,21,2,23
Madhya Pradesh,Narsinghpur,Acid Attack Victim,80,100,1,0,1
Madhya Pradesh,Narmadapuram,Acid Attack Victim,15,35,4,1,5
Madhya Pradesh,Narmadapuram,Acid Attack Victim,35,60,1,1,2
Maharashtra,Nandurbar,Acid Attack Victim,60,80,1,0,1
Maharashtra,Nanded,Acid Attack Victim,15,35,1,0,1
Maharashtra,Nanded,Acid Attack Victim,35,60,3,0,3
Tamil Nadu,Namakkal,Acid Attack Victim,60,80,1,0,1
Assam,Nalbari,Acid Attack Victim,15,35,1,2,3
Assam,Nalbari,Acid Attack Victim,35,60,2,2,4
Bihar,Nalanda,Acid Attack Victim,6,15,3,2,5
Bihar,Nalanda,Acid Attack Victim,15,35,0,2,2
Bihar,Nalanda,Acid Attack Victim,35,60,1,1,2
Bihar,Nalanda,Acid Attack Victim,60,80,1,0,1
Uttarakhand,Nainital,Acid Attack Victim,35,60,2,0,2
Maharashtra,Nagpur,Acid Attack Victim,15,35,1,0,1
Rajasthan,Nagaur,Acid Attack Victim,15,35,0,1,1
Rajasthan,Nagaur,Acid Attack Victim,60,80,1,0,1
Tamil Nadu,Nagapattinam,Acid Attack Victim,15,35,1,1,2
Tamil Nadu,Nagapattinam,Acid Attack Victim,35,60,2,0,2
Assam,Nagaon,Acid Attack Victim,0,6,1,0,1
Assam,Nagaon,Acid Attack Victim,15,35,2,0,2
Assam,Nagaon,Acid Attack Victim,35,60,1,2,3
Odisha,Nabarangpur,Acid Attack Victim,15,35,0,2,2
Karnataka,Mysuru,Acid Attack Victim,15,35,2,1,3
Karnataka,Mysuru,Acid Attack Victim,35,60,1,3,4
Karnataka,Mysuru,Acid Attack Victim,60,80,3,0,3
Bihar,Muzaffarpur,Acid Attack Victim,6,15,0,1,1
Bihar,Muzaffarpur,Acid Attack Victim,15,35,2,1,3
Bihar,Muzaffarpur,Acid Attack Victim,35,60,0,2,2
Uttar Pradesh,Muzaffarnagar,Acid Attack Victim,15,35,5,1,6
Uttar Pradesh,Muzaffarnagar,Acid Attack Victim,35,60,5,2,7
Uttar Pradesh,Muzaffarnagar,Acid Attack Victim,60,80,6,0,6
Bihar,Munger,Acid Attack Victim,35,60,0,1,1
Chhattisgarh,Mungeli,Acid Attack Victim,35,60,2,0,2
Chhattisgarh,Mungeli,Acid Attack Victim,80,100,0,1,1
Maharashtra,Mumbai,Acid Attack Victim,35,60,0,1,1
Madhya Pradesh,Morena,Acid Attack Victim,35,60,1,0,1
Madhya Pradesh,Morena,Acid Attack Victim,60,80,0,1,1
Uttar Pradesh,Moradabad,Acid Attack Victim,15,35,0,1,1
Uttar Pradesh,Moradabad,Acid Attack Victim,35,60,1,0,1
Punjab,Moga,Acid Attack Victim,15,35,1,2,3
Punjab,Moga,Acid Attack Victim,35,60,3,1,4
Punjab,Moga,Acid Attack Victim,60,80,0,1,1
Uttar Pradesh,Mirzapur,Acid Attack Victim,15,35,4,1,5
Uttar Pradesh,Mirzapur,Acid Attack Victim,35,60,7,3,10
Uttar Pradesh,Mirzapur,Acid Attack Victim,60,80,1,0,1
Uttar Pradesh,Meerut,Acid Attack Victim,15,35,6,2,8
Uttar Pradesh,Meerut,Acid Attack Victim,35,60,1,1,2
Uttar Pradesh,Meerut,Acid Attack Victim,60,80,1,0,1
Odisha,Mayurbhanj,Acid Attack Victim,60,80,2,0,2
Tamil Nadu,Mayiladuthurai,Acid Attack Victim,15,35,0,2,2
Uttar Pradesh,Mathura,Acid Attack Victim,6,15,1,0,1
Uttar Pradesh,Mathura,Acid Attack Victim,15,35,2,1,3
Uttar Pradesh,Mathura,Acid Attack Victim,35,60,1,1,2
Punjab,Mansa,Acid Attack Victim,6,15,0,1,1
Punjab,Mansa,Acid Attack Victim,15,35,2,0,2
Punjab,Mansa,Acid Attack Victim,35,60,2,1,3
Punjab,Mansa,Acid Attack Victim,60,80,1,0,1
Karnataka,Mandya,Acid Attack Victim,15,35,1,1,2
Karnataka,Mandya,Acid Attack Victim,35,60,7,1,8
Karnataka,Mandya,Acid Attack Victim,60,80,2,0,2
Madhya Pradesh,Mandla,Acid Attack Victim,6,15,0,1,1
Madhya Pradesh,Mandla,Acid Attack Victim,35,60,2,0,2
Himachal Pradesh,Mandi,Acid Attack Victim,6,15,2,0,2
Himachal Pradesh,Mandi,Acid Attack Victim,15,35,2,4,6
Himachal Pradesh,Mandi,Acid Attack Victim,35,60,4,5,9
Himachal Pradesh,Mandi,Acid Attack Victim,60,80,3,1,4
Odisha,Malkangiri,Acid Attack Victim,0,6,1,0,1
Odisha,Malkangiri,Acid Attack Victim,35,60,1,1,2
Punjab,Malerkotla,Acid Attack Victim,35,60,1,1,2
Kerala,Malappuram,Acid Attack Victim,15,35,1,0,1
Kerala,Malappuram,Acid Attack Victim,35,60,2,0,2
Kerala,Malappuram,Acid Attack Victim,60,80,2,0,2
Assam,Majuli,Acid Attack Victim,35,60,2,2,4
Uttar Pradesh,Mainpuri,Acid Attack Victim,6,15,1,1,2
Uttar Pradesh,Mainpuri,Acid Attack Victim,15,35,3,3,6
Uttar Pradesh,Mainpuri,Acid Attack Victim,35,60,15,1,16
Uttar Pradesh,Mainpuri,Acid Attack Victim,60,80,1,1,2
Uttar Pradesh,Mahoba,Acid Attack Victim,6,15,0,1,1
Uttar Pradesh,Mahoba,Acid Attack Victim,15,35,16,5,21
Uttar Pradesh,Mahoba,Acid Attack Victim,35,60,31,4,35
Uttar Pradesh,Mahoba,Acid Attack Victim,60,80,11,2,13
Gujarat,Mahisagar,Acid Attack Victim,60,80,1,0,1
Uttar Pradesh,Maharajganj,Acid Attack Victim,0,6,0,1,1
Uttar Pradesh,Maharajganj,Acid Attack Victim,15,35,4,4,8
Uttar Pradesh,Maharajganj,Acid Attack Victim,35,60,1,0,1
Tamil Nadu,Madurai,Acid Attack Victim,35,60,0,2,2
Tamil Nadu,Madurai,Acid Attack Victim,60,80,1,0,1
Bihar,Madhubani,Acid Attack Victim,35,60,6,2,8
Bihar,Madhubani,Acid Attack Victim,60,80,1,0,1
Bihar,Madhepura,Acid Attack Victim,15,35,1,1,2
Bihar,Madhepura,Acid Attack Victim,35,60,11,2,13
Bihar,Madhepura,Acid Attack Victim,60,80,1,1,2
Punjab,Ludhiana,Acid Attack Victim,6,15,2,1,3
Punjab,Ludhiana,Acid Attack Victim,15,35,4,8,12
Punjab,Ludhiana,Acid Attack Victim,35,60,8,8,16
Punjab,Ludhiana,Acid Attack Victim,60,80,5,2,7
Punjab,Ludhiana,Acid Attack Victim,80,100,1,0,1
Uttar Pradesh,Lucknow,Acid Attack Victim,6,15,1,0,1
Uttar Pradesh,Lucknow,Acid Attack Victim,15,35,7,5,12
Uttar Pradesh,Lucknow,Acid Attack Victim,35,60,16,8,24
Uttar Pradesh,Lucknow,Acid Attack Victim,60,80,4,0,4
Jharkhand,Lohardaga,Acid Attack Victim,6,15,0,1,1
Jharkhand,Lohardaga,Acid Attack Victim,15,35,4,0,4
Jharkhand,Lohardaga,Acid Attack Victim,35,60,1,0,1
Jharkhand,Lohardaga,Acid Attack Victim,60,80,1,2,3
Maharashtra,Latur,Acid Attack Victim,15,35,0,1,1
Maharashtra,Latur,Acid Attack Victim,35,60,1,0,1
Jharkhand,Latehar,Acid Attack Victim,15,35,0,1,1
Uttar Pradesh,Lalitpur,Acid Attack Victim,15,35,3,0,3
Uttar Pradesh,Lalitpur,Acid Attack Victim,35,60,1,0,1
Uttar Pradesh,Lalitpur,Acid Attack Victim,60,80,1,0,1
Bihar,Lakhisarai,Acid Attack Victim,6,15,1,0,1
Bihar,Lakhisarai,Acid Attack Victim,35,60,2,0,2
Assam,Lakhimpur,Acid Attack Victim,6,15,0,1,1
Assam,Lakhimpur,Acid Attack Victim,15,35,1,0,1
Assam,Lakhimpur,Acid Attack Victim,35,60,1,0,1
Uttar Pradesh,Kushi Nagar,Acid Attack Victim,6,15,2,0,2
Uttar Pradesh,Kushi Nagar,Acid Attack Victim,15,35,4,1,5
Uttar Pradesh,Kushi Nagar,Acid Attack Victim,35,60,6,1,7
Uttar Pradesh,Kushi Nagar,Acid Attack Victim,60,80,3,0,3
Haryana,Kurukshetra,Acid Attack Victim,15,35,0,1,1
Jammu And Kashmir,Kupwara,Acid Attack Victim,35,60,1,0,1
Tamil Nadu,Krishnagiri,Acid Attack Victim,6,15,0,1,1
Tamil Nadu,Krishnagiri,Acid Attack Victim,15,35,8,4,12
Tamil Nadu,Krishnagiri,Acid Attack Victim,35,60,12,7,19
Tamil Nadu,Krishnagiri,Acid Attack Victim,60,80,5,2,7
Andhra Pradesh,Krishna,Acid Attack Victim,15,35,1,0,1
Kerala,Kozhikode,Acid Attack Victim,15,35,2,0,2
Kerala,Kozhikode,Acid Attack Victim,35,60,5,1,6
Kerala,Kozhikode,Acid Attack Victim,60,80,1,0,1
Rajasthan,Kota,Acid Attack Victim,35,60,0,1,1
Chhattisgarh,Korea,Acid Attack Victim,35,60,0,1,1
Odisha,Koraput,Acid Attack Victim,15,35,0,2,2
Karnataka,Koppal,Acid Attack Victim,15,35,2,0,2
Karnataka,Koppal,Acid Attack Victim,35,60,4,0,4
Chhattisgarh,Kondagaon,Acid Attack Victim,6,15,2,0,2
Chhattisgarh,Kondagaon,Acid Attack Victim,15,35,2,2,4
Chhattisgarh,Kondagaon,Acid Attack Victim,35,60,1,0,1
Kerala,Kollam,Acid Attack Victim,15,35,1,0,1
Maharashtra,Kolhapur,Acid Attack Victim,15,35,0,2,2
Maharashtra,Kolhapur,Acid Attack Victim,35,60,3,0,3
Karnataka,Kolar,Acid Attack Victim,6,15,1,0,1
Karnataka,Kolar,Acid Attack Victim,15,35,3,2,5
Karnataka,Kolar,Acid Attack Victim,35,60,4,5,9
Karnataka,Kolar,Acid Attack Victim,60,80,2,0,2
Assam,Kokrajhar,Acid Attack Victim,35,60,0,1,1
Nagaland,Kohima,Acid Attack Victim,6,15,1,0,1
Nagaland,Kohima,Acid Attack Victim,80,100,1,0,1
Jharkhand,Koderma,Acid Attack Victim,15,35,0,1,1
Jharkhand,Koderma,Acid Attack Victim,35,60,1,0,1
Karnataka,Kodagu,Acid Attack Victim,15,35,0,2,2
Karnataka,Kodagu,Acid Attack Victim,35,60,1,3,4
Jammu And Kashmir,Kishtwar,Acid Attack Victim,6,15,1,0,1
Jammu And Kashmir,Kishtwar,Acid Attack Victim,15,35,0,1,1
Bihar,Kishanganj,Acid Attack Victim,15,35,5,3,8
Bihar,Kishanganj,Acid Attack Victim,35,60,1,0,1
Jharkhand,Khunti,Acid Attack Victim,6,15,1,0,1
Jharkhand,Khunti,Acid Attack Victim,15,35,4,0,4
Jharkhand,Khunti,Acid Attack Victim,35,60,4,2,6
Jharkhand,Khunti,Acid Attack Victim,60,80,1,0,1
Odisha,Khordha,Acid Attack Victim,15,35,1,0,1
Odisha,Khordha,Acid Attack Victim,35,60,0,1,1
Odisha,Khordha,Acid Attack Victim,60,80,1,0,1
Uttar Pradesh,Kheri,Acid Attack Victim,6,15,2,0,2
Uttar Pradesh,Kheri,Acid Attack Victim,15,35,15,5,20
Uttar Pradesh,Kheri,Acid Attack Victim,35,60,32,6,38
Uttar Pradesh,Kheri,Acid Attack Victim,60,80,5,2,7
Madhya Pradesh,Khargone,Acid Attack Victim,0,6,1,0,1
Madhya Pradesh,Khargone,Acid Attack Victim,6,15,1,0,1
Madhya Pradesh,Khargone,Acid Attack Victim,15,35,8,8,16
Madhya Pradesh,Khargone,Acid Attack Victim,35,60,3,2,5
Madhya Pradesh,Khargone,Acid Attack Victim,60,80,0,1,1
Bihar,Khagaria,Acid Attack Victim,35,60,4,0,4
Odisha,Kendujhar,Acid Attack Victim,35,60,1,0,1
Odisha,Kendrapara,Acid Attack Victim,60,80,2,0,2
Uttar Pradesh,Kaushambi,Acid Attack Victim,15,35,3,0,3
Uttar Pradesh,Kaushambi,Acid Attack Victim,35,60,2,0,2
Uttar Pradesh,Kaushambi,Acid Attack Victim,60,80,1,0,1
Madhya Pradesh,Katni,Acid Attack Victim,6,15,1,0,1
Madhya Pradesh,Katni,Acid Attack Victim,15,35,9,4,13
Madhya Pradesh,Katni,Acid Attack Victim,35,60,11,6,17
Madhya Pradesh,Katni,Acid Attack Victim,60,80,1,3,4
Madhya Pradesh,Katni,Acid Attack Victim,80,100,0,1,1
Bihar,Katihar,Acid Attack Victim,15,35,1,1,2
Bihar,Katihar,Acid Attack Victim,35,60,1,1,2
Jammu And Kashmir,Kathua,Acid Attack Victim,6,15,1,0,1
Jammu And Kashmir,Kathua,Acid Attack Victim,15,35,8,2,10
Jammu And Kashmir,Kathua,Acid Attack Victim,35,60,7,2,9
Jammu And Kashmir,Kathua,Acid Attack Victim,60,80,2,0,2
Uttar Pradesh,Kasganj,Acid Attack Victim,15,35,13,1,14
Uttar Pradesh,Kasganj,Acid Attack Victim,35,60,8,3,11
Uttar Pradesh,Kasganj,Acid Attack Victim,60,80,3,0,3
Tamil Nadu,Karur,Acid Attack Victim,35,60,2,1,3
Assam,Karimganj,Acid Attack Victim,15,35,0,2,2
Assam,Karimganj,Acid Attack Victim,35,60,1,1,2
Assam,Karimganj,Acid Attack Victim,60,80,0,1,1
Ladakh,Kargil,Acid Attack Victim,15,35,1,0,1
Punjab,Kapurthala,Acid Attack Victim,6,15,0,1,1
Punjab,Kapurthala,Acid Attack Victim,15,35,0,1,1
Punjab,Kapurthala,Acid Attack Victim,35,60,0,2,2
Uttar Pradesh,Kanpur Nagar,Acid Attack Victim,15,35,6,2,8
Uttar Pradesh,Kanpur Nagar,Acid Attack Victim,35,60,10,2,12
Uttar Pradesh,Kanpur Nagar,Acid Attack Victim,60,80,3,0,3
Uttar Pradesh,Kanpur Dehat,Acid Attack Victim,15,35,2,0,2
Uttar Pradesh,Kanpur Dehat,Acid Attack Victim,35,60,9,2,11
Uttar Pradesh,Kanpur Dehat,Acid Attack Victim,60,80,2,0,2
Tamil Nadu,Kanniyakumari,Acid Attack Victim,35,60,1,2,3
Uttar Pradesh,Kannauj,Acid Attack Victim,15,35,1,2,3
Chhattisgarh,Kanker,Acid Attack Victim,15,35,0,1,1
Himachal Pradesh,Kangra,Acid Attack Victim,35,60,2,1,3
Himachal Pradesh,Kangra,Acid Attack Victim,60,80,1,2,3
Manipur,Kangpokpi,Acid Attack Victim,35,60,0,1,1
Odisha,Kandhamal,Acid Attack Victim,35,60,1,0,1
Tamil Nadu,Kanchipuram,Acid Attack Victim,35,60,3,1,4
Tamil Nadu,Kanchipuram,Acid Attack Victim,60,80,2,0,2
Assam,Kamrup,Acid Attack Victim,15,35,1,0,1
Assam,Kamrup,Acid Attack Victim,35,60,1,1,2
Tamil Nadu,Kallakurichi,Acid Attack Victim,15,35,0,2,2
Tamil Nadu,Kallakurichi,Acid Attack Victim,35,60,1,2,3
Odisha,Kalahandi,Acid Attack Victim,15,35,2,0,2
Odisha,Kalahandi,Acid Attack Victim,35,60,1,0,1
Karnataka,Kalaburagi,Acid Attack Victim,15,35,5,4,9
Karnataka,Kalaburagi,Acid Attack Victim,35,60,6,2,8
Karnataka,Kalaburagi,Acid Attack Victim,60,80,1,0,1
Haryana,Kaithal,Acid Attack Victim,35,60,2,0,2
Bihar,Kaimur (Bhabua),Acid Attack Victim,6,15,0,2,2
Bihar,Kaimur (Bhabua),Acid Attack Victim,15,35,9,2,11
Bihar,Kaimur (Bhabua),Acid Attack Victim,35,60,4,8,12
Bihar,Kaimur (Bhabua),Acid Attack Victim,60,80,2,3,5
Gujarat,Junagadh,Acid Attack Victim,35,60,3,2,5
Gujarat,Junagadh,Acid Attack Victim,60,80,1,0,1
Assam,Jorhat,Acid Attack Victim,15,35,1,0,1
Rajasthan,Jodhpur,Acid Attack Victim,15,35,1,0,1
Rajasthan,Jodhpur,Acid Attack Victim,35,60,0,1,1
Rajasthan,Jhunjhunu,Acid Attack Victim,15,35,1,1,2
Rajasthan,Jhunjhunu,Acid Attack Victim,60,80,0,1,1
Odisha,Jharsuguda,Acid Attack Victim,15,35,1,2,3
Odisha,Jharsuguda,Acid Attack Victim,35,60,1,0,1
Uttar Pradesh,Jhansi,Acid Attack Victim,15,35,3,0,3
Uttar Pradesh,Jhansi,Acid Attack Victim,35,60,3,0,3
Uttar Pradesh,Jhansi,Acid Attack Victim,60,80,2,0,2
Rajasthan,Jhalawar,Acid Attack Victim,15,35,0,1,1
Rajasthan,Jhalawar,Acid Attack Victim,35,60,4,1,5
Haryana,Jhajjar,Acid Attack Victim,15,35,0,2,2
Haryana,Jhajjar,Acid Attack Victim,35,60,1,0,1
Madhya Pradesh,Jhabua,Acid Attack Victim,15,35,10,5,15
Madhya Pradesh,Jhabua,Acid Attack Victim,35,60,8,6,14
Madhya Pradesh,Jhabua,Acid Attack Victim,60,80,1,0,1
Bihar,Jehanabad,Acid Attack Victim,15,35,6,6,12
Bihar,Jehanabad,Acid Attack Victim,35,60,5,1,6
Bihar,Jehanabad,Acid Attack Victim,60,80,2,0,2
Uttar Pradesh,Jaunpur,Acid Attack Victim,6,15,1,0,1
Uttar Pradesh,Jaunpur,Acid Attack Victim,15,35,5,2,7
Uttar Pradesh,Jaunpur,Acid Attack Victim,35,60,9,2,11
Uttar Pradesh,Jaunpur,Acid Attack Victim,60,80,3,0,3
Uttar Pradesh,Jaunpur,Acid Attack Victim,80,100,1,0,1
Chhattisgarh,Jashpur,Acid Attack Victim,35,60,1,0,1
Bihar,Jamui,Acid Attack Victim,6,15,1,0,1
Bihar,Jamui,Acid Attack Victim,15,35,3,4,7
Bihar,Jamui,Acid Attack Victim,35,60,1,4,5
Bihar,Jamui,Acid Attack Victim,60,80,2,0,2
Jammu And Kashmir,Jammu,Acid Attack Victim,15,35,2,1,3
Jammu And Kashmir,Jammu,Acid Attack Victim,35,60,5,5,10
Jammu And Kashmir,Jammu,Acid Attack Victim,60,80,1,1,2
Rajasthan,Jalore,Acid Attack Victim,15,35,1,0,1
Rajasthan,Jalore,Acid Attack Victim,35,60,3,0,3
Rajasthan,Jalore,Acid Attack Victim,60,80,1,0,1
Maharashtra,Jalna,Acid Attack Victim,15,35,2,0,2
Maharashtra,Jalna,Acid Attack Victim,35,60,3,0,3
Maharashtra,Jalna,Acid Attack Victim,60,80,0,1,1
Maharashtra,Jalgaon,Acid Attack Victim,35,60,1,0,1
Uttar Pradesh,Jalaun,Acid Attack Victim,6,15,1,0,1
Uttar Pradesh,Jalaun,Acid Attack Victim,15,35,3,2,5
Uttar Pradesh,Jalaun,Acid Attack Victim,35,60,8,3,11
Uttar Pradesh,Jalaun,Acid Attack Victim,60,80,2,0,2
Punjab,Jalandhar,Acid Attack Victim,15,35,1,0,1
Punjab,Jalandhar,Acid Attack Victim,35,60,2,1,3
Odisha,Jajapur,Acid Attack Victim,15,35,1,1,2
Odisha,Jajapur,Acid Attack Victim,35,60,2,0,2
Odisha,Jajapur,Acid Attack Victim,60,80,1,0,1
Rajasthan,Jaipur,Acid Attack Victim,15,35,1,1,2
Rajasthan,Jaipur,Acid Attack Victim,35,60,3,1,4
Madhya Pradesh,Jabalpur,Acid Attack Victim,15,35,4,1,5
Madhya Pradesh,Jabalpur,Acid Attack Victim,35,60,6,1,7
Madhya Pradesh,Indore,Acid Attack Victim,15,35,3,1,4
Madhya Pradesh,Indore,Acid Attack Victim,35,60,2,0,2
Kerala,Idukki,Acid Attack Victim,15,35,1,0,1
Kerala,Idukki,Acid Attack Victim,35,60,1,0,1
Punjab,Hoshiarpur,Acid Attack Victim,15,35,2,0,2
Punjab,Hoshiarpur,Acid Attack Victim,35,60,3,2,5
Punjab,Hoshiarpur,Acid Attack Victim,60,80,3,0,3
Assam,Hojai,Acid Attack Victim,15,35,0,1,1
Assam,Hojai,Acid Attack Victim,35,60,1,1,2
Haryana,Hisar,Acid Attack Victim,15,35,1,0,1
Haryana,Hisar,Acid Attack Victim,35,60,0,1,1
Jharkhand,Hazaribagh,Acid Attack Victim,6,15,1,0,1
Jharkhand,Hazaribagh,Acid Attack Victim,15,35,3,2,5
Jharkhand,Hazaribagh,Acid Attack Victim,35,60,1,2,3
Jharkhand,Hazaribagh,Acid Attack Victim,60,80,2,0,2
Karnataka,Haveri,Acid Attack Victim,0,6,1,0,1
Karnataka,Haveri,Acid Attack Victim,15,35,3,5,8
Karnataka,Haveri,Acid Attack Victim,35,60,12,3,15
Karnataka,Haveri,Acid Attack Victim,60,80,3,0,3
Uttar Pradesh,Hathras,Acid Attack Victim,15,35,2,0,2
Uttar Pradesh,Hathras,Acid Attack Victim,60,80,1,1,2
Karnataka,Hassan,Acid Attack Victim,15,35,2,0,2
Karnataka,Hassan,Acid Attack Victim,35,60,3,10,13
Karnataka,Hassan,Acid Attack Victim,60,80,0,1,1
Uttarakhand,Haridwar,Acid Attack Victim,15,35,2,0,2
Uttarakhand,Haridwar,Acid Attack Victim,35,60,2,0,2
Uttar Pradesh,Hardoi,Acid Attack Victim,15,35,10,0,10
Uttar Pradesh,Hardoi,Acid Attack Victim,35,60,20,4,24
Uttar Pradesh,Hardoi,Acid Attack Victim,60,80,6,2,8
Uttar Pradesh,Hardoi,Acid Attack Victim,80,100,1,0,1
Uttar Pradesh,Hapur,Acid Attack Victim,6,15,1,0,1
Uttar Pradesh,Hapur,Acid Attack Victim,15,35,3,0,3
Uttar Pradesh,Hapur,Acid Attack Victim,35,60,4,0,4
Rajasthan,Hanumangarh,Acid Attack Victim,6,15,1,0,1
Rajasthan,Hanumangarh,Acid Attack Victim,15,35,2,0,2
Rajasthan,Hanumangarh,Acid Attack Victim,35,60,0,2,2
Uttar Pradesh,Hamirpur,Acid Attack Victim,15,35,1,1,2
Uttar Pradesh,Hamirpur,Acid Attack Victim,35,60,2,1,3
Uttar Pradesh,Hamirpur,Acid Attack Victim,60,80,1,0,1
Madhya Pradesh,Gwalior,Acid Attack Victim,15,35,2,1,3
Madhya Pradesh,Gwalior,Acid Attack Victim,60,80,1,0,1
Punjab,Gurdaspur,Acid Attack Victim,15,35,0,2,2
Punjab,Gurdaspur,Acid Attack Victim,35,60,2,2,4
Punjab,Gurdaspur,Acid Attack Victim,60,80,1,0,1
Andhra Pradesh,Guntur,Acid Attack Victim,15,35,1,0,1
Madhya Pradesh,Guna,Acid Attack Victim,15,35,0,1,1
Jharkhand,Gumla,Acid Attack Victim,6,15,1,0,1
Jharkhand,Gumla,Acid Attack Victim,15,35,11,4,15
Jharkhand,Gumla,Acid Attack Victim,35,60,10,1,11
Jharkhand,Gumla,Acid Attack Victim,60,80,6,1,7
Uttar Pradesh,Gorakhpur,Acid Attack Victim,6,15,1,0,1
Uttar Pradesh,Gorakhpur,Acid Attack Victim,15,35,3,1,4
Uttar Pradesh,Gorakhpur,Acid Attack Victim,35,60,11,3,14
Uttar Pradesh,Gorakhpur,Acid Attack Victim,60,80,0,1,1
Bihar,Gopalganj,Acid Attack Victim,35,60,1,0,1
Uttar Pradesh,Gonda,Acid Attack Victim,15,35,12,3,15
Uttar Pradesh,Gonda,Acid Attack Victim,35,60,15,4,19
Uttar Pradesh,Gonda,Acid Attack Victim,60,80,4,0,4
Assam,Golaghat,Acid Attack Victim,35,60,1,1,2
Jharkhand,Godda,Acid Attack Victim,6,15,0,1,1
Jharkhand,Godda,Acid Attack Victim,15,35,2,6,8
Jharkhand,Godda,Acid Attack Victim,35,60,6,2,8
Jharkhand,Godda,Acid Attack Victim,60,80,1,1,2
Jharkhand,Godda,Acid Attack Victim,80,100,0,1,1
Assam,Goalpara,Acid Attack Victim,6,15,1,0,1
Assam,Goalpara,Acid Attack Victim,15,35,2,1,3
Assam,Goalpara,Acid Attack Victim,35,60,5,1,6
Assam,Goalpara,Acid Attack Victim,60,80,2,1,3
Assam,Goalpara,Acid Attack Victim,80,100,1,0,1
Jharkhand,Giridih,Acid Attack Victim,6,15,1,2,3
Jharkhand,Giridih,Acid Attack Victim,15,35,1,3,4
Jharkhand,Giridih,Acid Attack Victim,35,60,0,1,1
Jharkhand,Giridih,Acid Attack Victim,60,80,1,0,1
Uttar Pradesh,Ghazipur,Acid Attack Victim,15,35,1,2,3
Uttar Pradesh,Ghazipur,Acid Attack Victim,35,60,4,0,4
Uttar Pradesh,Ghazipur,Acid Attack Victim,60,80,1,0,1
Uttar Pradesh,Ghaziabad,Acid Attack Victim,15,35,1,3,4
Uttar Pradesh,Ghaziabad,Acid Attack Victim,35,60,2,1,3
Bihar,Gaya,Acid Attack Victim,6,15,1,0,1
Uttar Pradesh,Gautam Buddha Nagar,Acid Attack Victim,15,35,0,1,1
Uttar Pradesh,Gautam Buddha Nagar,Acid Attack Victim,35,60,3,0,3
Chhattisgarh,Gariyaband,Acid Attack Victim,15,35,1,1,2
Jharkhand,Garhwa,Acid Attack Victim,6,15,5,0,5
Jharkhand,Garhwa,Acid Attack Victim,15,35,19,4,23
Jharkhand,Garhwa,Acid Attack Victim,35,60,14,9,23
Jharkhand,Garhwa,Acid Attack Victim,60,80,8,3,11
Jharkhand,Garhwa,Acid Attack Victim,80,100,1,0,1
Odisha,Ganjam,Acid Attack Victim,6,15,0,1,1
Odisha,Ganjam,Acid Attack Victim,15,35,0,1,1
Odisha,Ganjam,Acid Attack Victim,35,60,0,1,1
Rajasthan,Ganganagar,Acid Attack Victim,35,60,0,1,1
Maharashtra,Gadchiroli,Acid Attack Victim,6,15,0,1,1
Maharashtra,Gadchiroli,Acid Attack Victim,15,35,0,1,1
Karnataka,Gadag,Acid Attack Victim,15,35,2,1,3
Karnataka,Gadag,Acid Attack Victim,35,60,2,2,4
Karnataka,Gadag,Acid Attack Victim,60,80,3,0,3
Uttar Pradesh,Firozabad,Acid Attack Victim,15,35,2,3,5
Uttar Pradesh,Firozabad,Acid Attack Victim,35,60,7,2,9
Uttar Pradesh,Firozabad,Acid Attack Victim,60,80,2,0,2
Punjab,Ferozepur,Acid Attack Victim,15,35,1,1,2
Punjab,Ferozepur,Acid Attack Victim,35,60,1,0,1
Punjab,Fazilka,Acid Attack Victim,35,60,1,0,1
Uttar Pradesh,Fatehpur,Acid Attack Victim,6,15,1,0,1
Uttar Pradesh,Fatehpur,Acid Attack Victim,15,35,8,3,11
Uttar Pradesh,Fatehpur,Acid Attack Victim,35,60,8,6,14
Uttar Pradesh,Fatehpur,Acid Attack Victim,60,80,9,0,9
Uttar Pradesh,Fatehpur,Acid Attack Victim,80,100,1,0,1
Punjab,Fatehgarh Sahib,Acid Attack Victim,15,35,0,1,1
Punjab,Fatehgarh Sahib,Acid Attack Victim,35,60,1,3,4
Punjab,Fatehgarh Sahib,Acid Attack Victim,60,80,1,0,1
Haryana,Fatehabad,Acid Attack Victim,15,35,1,0,1
Haryana,Fatehabad,Acid Attack Victim,35,60,4,2,6
Uttar Pradesh,Farrukhabad,Acid Attack Victim,15,35,3,4,7
Uttar Pradesh,Farrukhabad,Acid Attack Victim,35,60,10,2,12
Uttar Pradesh,Farrukhabad,Acid Attack Victim,60,80,4,0,4
Uttar Pradesh,Etawah,Acid Attack Victim,15,35,11,3,14
Uttar Pradesh,Etawah,Acid Attack Victim,35,60,12,0,12
Uttar Pradesh,Etawah,Acid Attack Victim,60,80,5,0,5
Uttar Pradesh,Etah,Acid Attack Victim,15,35,1,0,1
Kerala,Ernakulam,Acid Attack Victim,15,35,1,0,1
Kerala,Ernakulam,Acid Attack Victim,35,60,2,0,2
Jharkhand,East Singhbum,Acid Attack Victim,15,35,0,3,3
Jharkhand,East Singhbum,Acid Attack Victim,35,60,4,2,6
Madhya Pradesh,East Nimar,Acid Attack Victim,15,35,1,0,1
Madhya Pradesh,East Nimar,Acid Attack Victim,35,60,0,3,3
Delhi,East,Acid Attack Victim,15,35,0,1,1
Delhi,East,Acid Attack Victim,35,60,1,0,1
Rajasthan,Dungarpur,Acid Attack Victim,15,35,1,0,1
Jharkhand,Dumka,Acid Attack Victim,15,35,5,1,6
Jharkhand,Dumka,Acid Attack Victim,35,60,1,3,4
Jammu And Kashmir,Doda,Acid Attack Victim,6,15,1,0,1
Jammu And Kashmir,Doda,Acid Attack Victim,35,60,3,1,4
Jammu And Kashmir,Doda,Acid Attack Victim,60,80,0,1,1
Tamil Nadu,Dindigul,Acid Attack Victim,35,60,1,0,1
Maharashtra,Dhule,Acid Attack Victim,15,35,4,0,4
Maharashtra,Dhule,Acid Attack Victim,35,60,7,0,7
Maharashtra,Dhule,Acid Attack Victim,60,80,2,0,2
Assam,Dhubri,Acid Attack Victim,6,15,1,0,1
Odisha,Dhenkanal,Acid Attack Victim,6,15,1,4,5
Odisha,Dhenkanal,Acid Attack Victim,15,35,8,3,11
Odisha,Dhenkanal,Acid Attack Victim,35,60,5,4,9
Odisha,Dhenkanal,Acid Attack Victim,60,80,2,0,2
Assam,Dhemaji,Acid Attack Victim,15,35,1,0,1
Assam,Dhemaji,Acid Attack Victim,35,60,0,1,1
Karnataka,Dharwad,Acid Attack Victim,15,35,1,0,1
Karnataka,Dharwad,Acid Attack Victim,35,60,1,2,3
Tamil Nadu,Dharmapuri,Acid Attack Victim,35,60,0,2,2
Madhya Pradesh,Dhar,Acid Attack Victim,6,15,0,1,1
Madhya Pradesh,Dhar,Acid Attack Victim,15,35,5,2,7
Madhya Pradesh,Dhar,Acid Attack Victim,35,60,6,6,12
Madhya Pradesh,Dhar,Acid Attack Victim,60,80,2,0,2
Jharkhand,Dhanbad,Acid Attack Victim,6,15,1,0,1
Jharkhand,Dhanbad,Acid Attack Victim,15,35,1,0,1
Jharkhand,Dhanbad,Acid Attack Victim,35,60,2,0,2
Madhya Pradesh,Dewas,Acid Attack Victim,6,15,1,1,2
Madhya Pradesh,Dewas,Acid Attack Victim,15,35,4,2,6
Madhya Pradesh,Dewas,Acid Attack Victim,35,60,5,1,6
Madhya Pradesh,Dewas,Acid Attack Victim,60,80,4,1,5
Gujarat,Devbhumi Dwarka,Acid Attack Victim,15,35,1,0,1
Uttar Pradesh,Deoria,Acid Attack Victim,15,35,10,10,20
Uttar Pradesh,Deoria,Acid Attack Victim,35,60,13,8,21
Uttar Pradesh,Deoria,Acid Attack Victim,60,80,3,5,8
Jharkhand,Deoghar,Acid Attack Victim,15,35,0,1,1
Uttarakhand,Dehradun,Acid Attack Victim,15,35,1,2,3
Uttarakhand,Dehradun,Acid Attack Victim,35,60,3,1,4
Karnataka,Davangere,Acid Attack Victim,15,35,2,0,2
Karnataka,Davangere,Acid Attack Victim,35,60,1,1,2
Rajasthan,Dausa,Acid Attack Victim,15,35,4,2,6
Rajasthan,Dausa,Acid Attack Victim,35,60,2,0,2
Madhya Pradesh,Datia,Acid Attack Victim,6,15,1,1,2
Madhya Pradesh,Datia,Acid Attack Victim,15,35,6,3,9
Madhya Pradesh,Datia,Acid Attack Victim,35,60,1,1,2
Assam,Darrang,Acid Attack Victim,15,35,0,1,1
Assam,Darrang,Acid Attack Victim,35,60,0,1,1
Bihar,Darbhanga,Acid Attack Victim,6,15,0,1,1
Bihar,Darbhanga,Acid Attack Victim,15,35,2,4,6
Bihar,Darbhanga,Acid Attack Victim,35,60,2,0,2
Bihar,Darbhanga,Acid Attack Victim,60,80,1,0,1
Madhya Pradesh,Damoh,Acid Attack Victim,15,35,6,5,11
Madhya Pradesh,Damoh,Acid Attack Victim,35,60,5,0,5
Madhya Pradesh,Damoh,Acid Attack Victim,60,80,1,0,1
Karnataka,Dakshina Kannada,Acid Attack Victim,15,35,2,0,2
Karnataka,Dakshina Kannada,Acid Attack Victim,60,80,0,1,1
Odisha,Cuttack,Acid Attack Victim,15,35,3,1,4
Odisha,Cuttack,Acid Attack Victim,35,60,4,1,5
Odisha,Cuttack,Acid Attack Victim,60,80,4,0,4
Tamil Nadu,Cuddalore,Acid Attack Victim,15,35,0,1,1
Tamil Nadu,Cuddalore,Acid Attack Victim,35,60,2,1,3
Tamil Nadu,Cuddalore,Acid Attack Victim,60,80,2,0,2
Tamil Nadu,Coimbatore,Acid Attack Victim,6,15,0,1,1
Tamil Nadu,Coimbatore,Acid Attack Victim,15,35,0,1,1
Tamil Nadu,Coimbatore,Acid Attack Victim,35,60,8,0,8
Tamil Nadu,Coimbatore,Acid Attack Victim,60,80,3,0,3
Rajasthan,Churu,Acid Attack Victim,6,15,0,1,1
Rajasthan,Chittorgarh,Acid Attack Victim,15,35,0,1,1
Rajasthan,Chittorgarh,Acid Attack Victim,35,60,2,1,3
Uttar Pradesh,Chitrakoot,Acid Attack Victim,6,15,1,1,2
Uttar Pradesh,Chitrakoot,Acid Attack Victim,15,35,14,5,19
Uttar Pradesh,Chitrakoot,Acid Attack Victim,35,60,6,6,12
Uttar Pradesh,Chitrakoot,Acid Attack Victim,60,80,2,2,4
Karnataka,Chitradurga,Acid Attack Victim,0,6,1,0,1
Karnataka,Chitradurga,Acid Attack Victim,6,15,0,1,1
Karnataka,Chitradurga,Acid Attack Victim,15,35,1,1,2
Karnataka,Chitradurga,Acid Attack Victim,35,60,5,5,10
Karnataka,Chitradurga,Acid Attack Victim,60,80,2,1,3
Karnataka,Chitradurga,Acid Attack Victim,80,100,1,0,1
Karnataka,Chikkamagaluru,Acid Attack Victim,15,35,0,5,5
Karnataka,Chikkamagaluru,Acid Attack Victim,35,60,4,6,10
Karnataka,Chikkamagaluru,Acid Attack Victim,60,80,1,0,1
Karnataka,Chikkaballapura,Acid Attack Victim,6,15,0,1,1
Karnataka,Chikkaballapura,Acid Attack Victim,15,35,0,1,1
Karnataka,Chikkaballapura,Acid Attack Victim,35,60,3,5,8
Karnataka,Chikkaballapura,Acid Attack Victim,60,80,1,1,2
Madhya Pradesh,Chhindwara,Acid Attack Victim,6,15,0,1,1
Madhya Pradesh,Chhindwara,Acid Attack Victim,15,35,2,3,5
Madhya Pradesh,Chhindwara,Acid Attack Victim,35,60,5,3,8
Madhya Pradesh,Chhindwara,Acid Attack Victim,60,80,3,0,3
Madhya Pradesh,Chhatarpur,Acid Attack Victim,15,35,3,2,5
Madhya Pradesh,Chhatarpur,Acid Attack Victim,35,60,5,0,5
Madhya Pradesh,Chhatarpur,Acid Attack Victim,60,80,1,1,2
Tamil Nadu,Chennai,Acid Attack Victim,6,15,0,1,1
Tamil Nadu,Chennai,Acid Attack Victim,15,35,0,1,1
Tamil Nadu,Chennai,Acid Attack Victim,35,60,3,4,7
Tamil Nadu,Chennai,Acid Attack Victim,60,80,1,0,1
Tamil Nadu,Chengalpattu,Acid Attack Victim,35,60,1,0,1
Jharkhand,Chatra,Acid Attack Victim,15,35,0,1,1
Assam,Charaideo,Acid Attack Victim,35,60,1,0,1
Maharashtra,Chandrapur,Acid Attack Victim,35,60,0,1,1
Chandigarh,Chandigarh,Acid Attack Victim,15,35,0,1,1
Chandigarh,Chandigarh,Acid Attack Victim,35,60,1,1,2
Uttar Pradesh,Chandauli,Acid Attack Victim,15,35,2,1,3
Uttar Pradesh,Chandauli,Acid Attack Victim,35,60,3,0,3
Mizoram,Champhai,Acid Attack Victim,35,60,1,0,1
Uttarakhand,Champawat,Acid Attack Victim,6,15,1,0,1
Uttarakhand,Champawat,Acid Attack Victim,15,35,0,1,1
Uttarakhand,Champawat,Acid Attack Victim,35,60,2,0,2
Uttarakhand,Chamoli,Acid Attack Victim,15,35,1,0,1
Uttarakhand,Chamoli,Acid Attack Victim,35,60,3,1,4
Himachal Pradesh,Chamba,Acid Attack Victim,15,35,1,0,1
Himachal Pradesh,Chamba,Acid Attack Victim,35,60,1,0,1
Karnataka,Chamarajanagara,Acid Attack Victim,15,35,1,2,3
Karnataka,Chamarajanagara,Acid Attack Victim,35,60,3,3,6
Delhi,Central,Acid Attack Victim,60,80,1,0,1
Assam,Cachar,Acid Attack Victim,15,35,0,1,1
Assam,Cachar,Acid Attack Victim,35,60,1,1,2
Bihar,Buxar,Acid Attack Victim,6,15,0,1,1
Bihar,Buxar,Acid Attack Victim,15,35,2,0,2
Bihar,Buxar,Acid Attack Victim,35,60,1,0,1
Madhya Pradesh,Burhanpur,Acid Attack Victim,35,60,0,1,1
Rajasthan,Bundi,Acid Attack Victim,6,15,1,0,1
Rajasthan,Bundi,Acid Attack Victim,15,35,1,1,2
Rajasthan,Bundi,Acid Attack Victim,35,60,1,0,1
Uttar Pradesh,Bulandshahr,Acid Attack Victim,15,35,7,2,9
Uttar Pradesh,Bulandshahr,Acid Attack Victim,35,60,14,5,19
Uttar Pradesh,Bulandshahr,Acid Attack Victim,60,80,3,0,3
Jammu And Kashmir,Budgam,Acid Attack Victim,15,35,1,0,1
Jammu And Kashmir,Budgam,Acid Attack Victim,35,60,0,1,1
Jammu And Kashmir,Budgam,Acid Attack Victim,60,80,1,0,1
Uttar Pradesh,Budaun,Acid Attack Victim,15,35,1,0,1
Uttar Pradesh,Budaun,Acid Attack Victim,35,60,2,0,2
Odisha,Boudh,Acid Attack Victim,15,35,2,0,2
Jharkhand,Bokaro,Acid Attack Victim,15,35,4,2,6
Jharkhand,Bokaro,Acid Attack Victim,35,60,2,0,2
Jharkhand,Bokaro,Acid Attack Victim,60,80,3,0,3
Assam,Biswanath,Acid Attack Victim,0,6,5,0,5
Assam,Biswanath,Acid Attack Victim,6,15,1,1,2
Assam,Biswanath,Acid Attack Victim,35,60,7,2,9
Assam,Biswanath,Acid Attack Victim,60,80,1,0,1
West Bengal,Birbhum,Acid Attack Victim,6,15,1,0,1
Chhattisgarh,Bilaspur,Acid Attack Victim,15,35,2,1,3
Chhattisgarh,Bilaspur,Acid Attack Victim,60,80,1,0,1
Himachal Pradesh,Bilaspur,Acid Attack Victim,35,60,1,0,1
Rajasthan,Bikaner,Acid Attack Victim,15,35,2,0,2
Rajasthan,Bikaner,Acid Attack Victim,35,60,1,1,2
Uttar Pradesh,Bijnor,Acid Attack Victim,15,35,7,1,8
Uttar Pradesh,Bijnor,Acid Attack Victim,35,60,5,1,6
Uttar Pradesh,Bijnor,Acid Attack Victim,60,80,3,0,3
Karnataka,Bidar,Acid Attack Victim,0,6,0,1,1
Karnataka,Bidar,Acid Attack Victim,6,15,0,1,1
Karnataka,Bidar,Acid Attack Victim,15,35,6,2,8
Karnataka,Bidar,Acid Attack Victim,35,60,12,3,15
Karnataka,Bidar,Acid Attack Victim,60,80,2,0,2
Madhya Pradesh,Bhopal,Acid Attack Victim,6,15,0,3,3
Madhya Pradesh,Bhopal,Acid Attack Victim,15,35,12,5,17
Madhya Pradesh,Bhopal,Acid Attack Victim,35,60,22,6,28
Madhya Pradesh,Bhopal,Acid Attack Victim,60,80,2,0,2
Bihar,Bhojpur,Acid Attack Victim,6,15,1,0,1
Bihar,Bhojpur,Acid Attack Victim,15,35,2,1,3
Bihar,Bhojpur,Acid Attack Victim,35,60,2,0,2
Haryana,Bhiwani,Acid Attack Victim,15,35,3,0,3
Haryana,Bhiwani,Acid Attack Victim,35,60,3,1,4
Madhya Pradesh,Bhind,Acid Attack Victim,15,35,2,0,2
Madhya Pradesh,Bhind,Acid Attack Victim,35,60,8,5,13
Madhya Pradesh,Bhind,Acid Attack Victim,60,80,0,1,1
Rajasthan,Bhilwara,Acid Attack Victim,6,15,0,1,1
Rajasthan,Bhilwara,Acid Attack Victim,15,35,2,1,3
Rajasthan,Bhilwara,Acid Attack Victim,35,60,1,0,1
Rajasthan,Bharatpur,Acid Attack Victim,35,60,0,1,1
Bihar,Bhagalpur,Acid Attack Victim,15,35,3,3,6
Bihar,Bhagalpur,Acid Attack Victim,35,60,2,0,2
Odisha,Bhadrak,Acid Attack Victim,15,35,5,1,6
Odisha,Bhadrak,Acid Attack Victim,35,60,5,3,8
Odisha,Bhadrak,Acid Attack Victim,60,80,0,1,1
Madhya Pradesh,Betul,Acid Attack Victim,6,15,1,0,1
Madhya Pradesh,Betul,Acid Attack Victim,15,35,4,0,4
Madhya Pradesh,Betul,Acid Attack Victim,35,60,4,3,7
Karnataka,Bengaluru Urban,Acid Attack Victim,0,6,1,0,1
Karnataka,Bengaluru Urban,Acid Attack Victim,6,15,2,0,2
Karnataka,Bengaluru Urban,Acid Attack Victim,15,35,4,7,11
Karnataka,Bengaluru Urban,Acid Attack Victim,35,60,5,7,12
Karnataka,Bengaluru Urban,Acid Attack Victim,60,80,1,1,2
Karnataka,Bengaluru Rural,Acid Attack Victim,15,35,1,3,4
Karnataka,Bengaluru Rural,Acid Attack Victim,35,60,6,4,10
Karnataka,Bengaluru Rural,Acid Attack Victim,60,80,4,0,4
Karnataka,Belagavi,Acid Attack Victim,6,15,1,0,1
Karnataka,Belagavi,Acid Attack Victim,15,35,6,5,11
Karnataka,Belagavi,Acid Attack Victim,35,60,12,12,24
Karnataka,Belagavi,Acid Attack Victim,60,80,2,1,3
Bihar,Begusarai,Acid Attack Victim,0,6,1,0,1
Bihar,Begusarai,Acid Attack Victim,6,15,3,3,6
Bihar,Begusarai,Acid Attack Victim,15,35,5,2,7
Bihar,Begusarai,Acid Attack Victim,35,60,4,1,5
Bihar,Begusarai,Acid Attack Victim,60,80,1,0,1
Maharashtra,Beed,Acid Attack Victim,15,35,1,0,1
Maharashtra,Beed,Acid Attack Victim,60,80,1,0,1
Punjab,Bathinda,Acid Attack Victim,15,35,2,0,2
Punjab,Bathinda,Acid Attack Victim,35,60,0,1,1
Uttar Pradesh,Basti,Acid Attack Victim,15,35,1,0,1
Uttar Pradesh,Basti,Acid Attack Victim,35,60,3,0,3
Uttar Pradesh,Basti,Acid Attack Victim,60,80,1,0,1
Chhattisgarh,Bastar,Acid Attack Victim,6,15,1,0,1
Madhya Pradesh,Barwani,Acid Attack Victim,15,35,2,4,6
Madhya Pradesh,Barwani,Acid Attack Victim,35,60,2,0,2
Madhya Pradesh,Barwani,Acid Attack Victim,60,80,0,1,1
Assam,Barpeta,Acid Attack Victim,6,15,0,1,1
Assam,Barpeta,Acid Attack Victim,15,35,2,2,4
Assam,Barpeta,Acid Attack Victim,35,60,1,3,4
Assam,Barpeta,Acid Attack Victim,60,80,1,0,1
Punjab,Barnala,Acid Attack Victim,35,60,3,1,4
Punjab,Barnala,Acid Attack Victim,60,80,0,1,1
Rajasthan,Barmer,Acid Attack Victim,15,35,1,1,2
Odisha,Bargarh,Acid Attack Victim,35,60,2,0,2
Uttar Pradesh,Bareilly,Acid Attack Victim,15,35,7,2,9
Uttar Pradesh,Bareilly,Acid Attack Victim,35,60,17,3,20
Uttar Pradesh,Bareilly,Acid Attack Victim,60,80,3,0,3
Rajasthan,Baran,Acid Attack Victim,15,35,0,1,1
Rajasthan,Baran,Acid Attack Victim,60,80,2,0,2
Jammu And Kashmir,Baramulla,Acid Attack Victim,0,6,1,0,1
Jammu And Kashmir,Baramulla,Acid Attack Victim,15,35,0,2,2
Jammu And Kashmir,Baramulla,Acid Attack Victim,35,60,2,3,5
Jammu And Kashmir,Baramulla,Acid Attack Victim,60,80,0,1,1
Uttar Pradesh,Barabanki,Acid Attack Victim,15,35,4,4,8
Uttar Pradesh,Barabanki,Acid Attack Victim,35,60,13,3,16
Uttar Pradesh,Barabanki,Acid Attack Victim,60,80,2,0,2
Uttar Pradesh,Barabanki,Acid Attack Victim,80,100,1,0,1
Rajasthan,Banswara,Acid Attack Victim,15,35,1,0,1
Rajasthan,Banswara,Acid Attack Victim,35,60,2,0,2
Rajasthan,Banswara,Acid Attack Victim,60,80,0,1,1
Bihar,Banka,Acid Attack Victim,6,15,1,0,1
Bihar,Banka,Acid Attack Victim,15,35,8,3,11
Bihar,Banka,Acid Attack Victim,35,60,3,1,4
Bihar,Banka,Acid Attack Victim,60,80,3,0,3
Bihar,Banka,Acid Attack Victim,80,100,0,1,1
Jammu And Kashmir,Bandipora,Acid Attack Victim,0,6,0,1,1
Jammu And Kashmir,Bandipora,Acid Attack Victim,15,35,0,1,1
Jammu And Kashmir,Bandipora,Acid Attack Victim,35,60,1,0,1
Uttar Pradesh,Banda,Acid Attack Victim,15,35,3,0,3
Uttar Pradesh,Banda,Acid Attack Victim,35,60,7,1,8
Chhattisgarh,Balrampur,Acid Attack Victim,6,15,0,1,1
Chhattisgarh,Balrampur,Acid Attack Victim,15,35,0,3,3
Chhattisgarh,Balrampur,Acid Attack Victim,35,60,0,1,1
Uttar Pradesh,Balrampur,Acid Attack Victim,15,35,3,2,5
Uttar Pradesh,Balrampur,Acid Attack Victim,35,60,0,1,1
Uttar Pradesh,Balrampur,Acid Attack Victim,60,80,1,0,1
Chhattisgarh,Baloda Bazar,Acid Attack Victim,35,60,1,1,2
Chhattisgarh,Baloda Bazar,Acid Attack Victim,60,80,0,1,1
Uttar Pradesh,Ballia,Acid Attack Victim,15,35,3,3,6
Uttar Pradesh,Ballia,Acid Attack Victim,35,60,7,2,9
Uttar Pradesh,Ballia,Acid Attack Victim,60,80,5,0,5
Karnataka,Ballari,Acid Attack Victim,6,15,0,1,1
Karnataka,Ballari,Acid Attack Victim,15,35,1,2,3
Karnataka,Ballari,Acid Attack Victim,35,60,2,3,5
Odisha,Baleshwar,Acid Attack Victim,6,15,1,2,3
Odisha,Baleshwar,Acid Attack Victim,15,35,6,4,10
Odisha,Baleshwar,Acid Attack Victim,35,60,8,7,15
Odisha,Baleshwar,Acid Attack Victim,60,80,4,2,6
Odisha,Balangir,Acid Attack Victim,6,15,1,0,1
Odisha,Balangir,Acid Attack Victim,15,35,2,1,3
Odisha,Balangir,Acid Attack Victim,35,60,6,2,8
Odisha,Balangir,Acid Attack Victim,60,80,2,1,3
Madhya Pradesh,Balaghat,Acid Attack Victim,6,15,1,1,2
Madhya Pradesh,Balaghat,Acid Attack Victim,60,80,1,0,1
Uttar Pradesh,Bahraich,Acid Attack Victim,15,35,0,1,1
Uttar Pradesh,Bahraich,Acid Attack Victim,35,60,2,0,2
Uttar Pradesh,Bahraich,Acid Attack Victim,60,80,1,0,1
Uttar Pradesh,Baghpat,Acid Attack Victim,15,35,1,0,1
Uttar Pradesh,Baghpat,Acid Attack Victim,35,60,3,2,5
Karnataka,Bagalkote,Acid Attack Victim,6,15,0,1,1
Karnataka,Bagalkote,Acid Attack Victim,15,35,6,4,10
Karnataka,Bagalkote,Acid Attack Victim,35,60,4,3,7
Karnataka,Bagalkote,Acid Attack Victim,60,80,1,0,1
Uttar Pradesh,Ayodhya,Acid Attack Victim,15,35,2,0,2
Uttar Pradesh,Ayodhya,Acid Attack Victim,35,60,1,0,1
Uttar Pradesh,Ayodhya,Acid Attack Victim,60,80,1,0,1
Bihar,Aurangabad,Acid Attack Victim,15,35,2,1,3
Bihar,Aurangabad,Acid Attack Victim,35,60,2,0,2
Bihar,Aurangabad,Acid Attack Victim,60,80,1,0,1
Maharashtra,Aurangabad,Acid Attack Victim,15,35,1,2,3
Uttar Pradesh,Auraiya,Acid Attack Victim,15,35,2,2,4
Uttar Pradesh,Auraiya,Acid Attack Victim,35,60,3,0,3
Uttar Pradesh,Auraiya,Acid Attack Victim,60,80,1,0,1
Bihar,Arwal,Acid Attack Victim,6,15,0,1,1
Bihar,Arwal,Acid Attack Victim,35,60,1,0,1
Tamil Nadu,Ariyalur,Acid Attack Victim,35,60,1,0,1
Tamil Nadu,Ariyalur,Acid Attack Victim,60,80,1,1,2
Bihar,Araria,Acid Attack Victim,6,15,1,1,2
Bihar,Araria,Acid Attack Victim,15,35,3,0,3
Bihar,Araria,Acid Attack Victim,35,60,2,0,2
Odisha,Anugul,Acid Attack Victim,6,15,1,0,1
Odisha,Anugul,Acid Attack Victim,15,35,1,0,1
Odisha,Anugul,Acid Attack Victim,35,60,0,1,1
Jammu And Kashmir,Anantnag,Acid Attack Victim,0,6,1,0,1
Jammu And Kashmir,Anantnag,Acid Attack Victim,15,35,0,1,1
Andhra Pradesh,Anantapur,Acid Attack Victim,15,35,1,0,1
Andhra Pradesh,Anantapur,Acid Attack Victim,35,60,1,0,1
Uttar Pradesh,Amroha,Acid Attack Victim,6,15,1,0,1
Uttar Pradesh,Amroha,Acid Attack Victim,15,35,13,4,17
Uttar Pradesh,Amroha,Acid Attack Victim,35,60,8,2,10
Uttar Pradesh,Amroha,Acid Attack Victim,60,80,0,1,1
Punjab,Amritsar,Acid Attack Victim,15,35,8,6,14
Punjab,Amritsar,Acid Attack Victim,35,60,10,7,17
Punjab,Amritsar,Acid Attack Victim,60,80,2,0,2
Gujarat,Amreli,Acid Attack Victim,15,35,1,2,3
Gujarat,Amreli,Acid Attack Victim,35,60,0,1,1
Maharashtra,Amravati,Acid Attack Victim,35,60,2,0,2
Uttar Pradesh,Ambedkar Nagar,Acid Attack Victim,6,15,1,0,1
Uttar Pradesh,Ambedkar Nagar,Acid Attack Victim,15,35,2,1,3
Uttar Pradesh,Ambedkar Nagar,Acid Attack Victim,35,60,5,2,7
Uttar Pradesh,Ambedkar Nagar,Acid Attack Victim,60,80,1,0,1
Haryana,Ambala,Acid Attack Victim,35,60,1,1,2
Rajasthan,Alwar,Acid Attack Victim,15,35,3,4,7
Rajasthan,Alwar,Acid Attack Victim,35,60,5,1,6
Rajasthan,Alwar,Acid Attack Victim,60,80,1,0,1
Uttarakhand,Almora,Acid Attack Victim,15,35,1,0,1
Uttarakhand,Almora,Acid Attack Victim,35,60,2,0,2
Uttarakhand,Almora,Acid Attack Victim,60,80,1,0,1
Madhya Pradesh,Alirajpur,Acid Attack Victim,15,35,0,1,1
Madhya Pradesh,Alirajpur,Acid Attack Victim,60,80,1,0,1
Uttar Pradesh,Aligarh,Acid Attack Victim,15,35,6,4,10
Uttar Pradesh,Aligarh,Acid Attack Victim,35,60,11,4,15
Uttar Pradesh,Aligarh,Acid Attack Victim,60,80,2,4,6
Kerala,Alappuzha,Acid Attack Victim,15,35,1,0,1
Kerala,Alappuzha,Acid Attack Victim,35,60,0,1,1
Maharashtra,Akola,Acid Attack Victim,15,35,0,1,1
Maharashtra,Akola,Acid Attack Victim,35,60,2,0,2
Rajasthan,Ajmer,Acid Attack Victim,15,35,0,1,1
Rajasthan,Ajmer,Acid Attack Victim,35,60,1,0,1
Maharashtra,Ahmednagar,Acid Attack Victim,15,35,1,0,1
Gujarat,Ahmadabad,Acid Attack Victim,35,60,1,0,1
Uttar Pradesh,Agra,Acid Attack Victim,6,15,0,1,1
Uttar Pradesh,Agra,Acid Attack Victim,15,35,1,4,5
Uttar Pradesh,Agra,Acid Attack Victim,35,60,4,4,8
Maharashtra,Yavatmal,Autism Spectrum Disorder,0,6,2,0,2
Maharashtra,Yavatmal,Autism Spectrum Disorder,35,60,0,1,1
Puducherry,Yanam,Autism Spectrum Disorder,35,60,1,0,1
Haryana,Yamunanagar,Autism Spectrum Disorder,0,6,0,1,1
Haryana,Yamunanagar,Autism Spectrum Disorder,6,15,2,1,3
Haryana,Yamunanagar,Autism Spectrum Disorder,15,35,2,0,2
Haryana,Yamunanagar,Autism Spectrum Disorder,35,60,2,1,3
Haryana,Yamunanagar,Autism Spectrum Disorder,60,80,0,1,1
Karnataka,Yadgir,Autism Spectrum Disorder,0,6,1,0,1
Karnataka,Yadgir,Autism Spectrum Disorder,6,15,1,0,1
Karnataka,Yadgir,Autism Spectrum Disorder,15,35,1,1,2
Tripura,West Tripura,Autism Spectrum Disorder,0,6,12,3,15
Tripura,West Tripura,Autism Spectrum Disorder,6,15,15,2,17
Tripura,West Tripura,Autism Spectrum Disorder,15,35,2,0,2
Jharkhand,West Singhbhum,Autism Spectrum Disorder,6,15,2,0,2
Jharkhand,West Singhbhum,Autism Spectrum Disorder,15,35,1,1,2
Jharkhand,West Singhbhum,Autism Spectrum Disorder,35,60,3,1,4
Meghalaya,West Jaintia Hills,Autism Spectrum Disorder,0,6,1,0,1
Meghalaya,West Jaintia Hills,Autism Spectrum Disorder,6,15,14,3,17
Meghalaya,West Jaintia Hills,Autism Spectrum Disorder,15,35,6,8,14
Andhra Pradesh,West Godavari,Autism Spectrum Disorder,6,15,0,2,2
Meghalaya,West Garo Hills,Autism Spectrum Disorder,6,15,3,1,4
Meghalaya,West Garo Hills,Autism Spectrum Disorder,15,35,0,1,1
Delhi,West,Autism Spectrum Disorder,0,6,10,0,10
Delhi,West,Autism Spectrum Disorder,6,15,33,14,47
Delhi,West,Autism Spectrum Disorder,15,35,16,1,17
Delhi,West,Autism Spectrum Disorder,35,60,1,0,1
Kerala,Wayanad,Autism Spectrum Disorder,0,6,0,1,1
Kerala,Wayanad,Autism Spectrum Disorder,6,15,5,1,6
Kerala,Wayanad,Autism Spectrum Disorder,15,35,1,2,3
Maharashtra,Washim,Autism Spectrum Disorder,0,6,1,0,1
Maharashtra,Washim,Autism Spectrum Disorder,15,35,2,0,2
Maharashtra,Washim,Autism Spectrum Disorder,80,100,0,1,1
Maharashtra,Wardha,Autism Spectrum Disorder,0,6,1,2,3
Maharashtra,Wardha,Autism Spectrum Disorder,6,15,15,3,18
Maharashtra,Wardha,Autism Spectrum Disorder,15,35,1,2,3
Andhra Pradesh,Visakhapatanam,Autism Spectrum Disorder,0,6,4,2,6
Andhra Pradesh,Visakhapatanam,Autism Spectrum Disorder,6,15,1,0,1
Andhra Pradesh,Visakhapatanam,Autism Spectrum Disorder,15,35,4,0,4
Tamil Nadu,Virudhunagar,Autism Spectrum Disorder,0,6,3,1,4
Tamil Nadu,Virudhunagar,Autism Spectrum Disorder,6,15,31,6,37
Tamil Nadu,Virudhunagar,Autism Spectrum Disorder,15,35,9,8,17
Tamil Nadu,Virudhunagar,Autism Spectrum Disorder,35,60,3,3,6
Tamil Nadu,Villupuram,Autism Spectrum Disorder,0,6,0,1,1
Tamil Nadu,Villupuram,Autism Spectrum Disorder,6,15,7,0,7
Tamil Nadu,Villupuram,Autism Spectrum Disorder,15,35,3,2,5
Tamil Nadu,Villupuram,Autism Spectrum Disorder,35,60,2,1,3
Tamil Nadu,Villupuram,Autism Spectrum Disorder,60,80,2,1,3
Karnataka,Vijayapura,Autism Spectrum Disorder,15,35,0,1,1
Karnataka,Vijayapura,Autism Spectrum Disorder,35,60,3,1,4
Karnataka,Vijayapura,Autism Spectrum Disorder,60,80,1,0,1
Madhya Pradesh,Vidisha,Autism Spectrum Disorder,0,6,1,0,1
Madhya Pradesh,Vidisha,Autism Spectrum Disorder,6,15,4,6,10
Madhya Pradesh,Vidisha,Autism Spectrum Disorder,15,35,22,11,33
Madhya Pradesh,Vidisha,Autism Spectrum Disorder,35,60,50,15,65
Madhya Pradesh,Vidisha,Autism Spectrum Disorder,60,80,10,3,13
Madhya Pradesh,Vidisha,Autism Spectrum Disorder,80,100,2,0,2
Tamil Nadu,Vellore,Autism Spectrum Disorder,0,6,3,1,4
Tamil Nadu,Vellore,Autism Spectrum Disorder,6,15,22,11,33
Tamil Nadu,Vellore,Autism Spectrum Disorder,15,35,9,5,14
Tamil Nadu,Vellore,Autism Spectrum Disorder,35,60,2,3,5
Tamil Nadu,Vellore,Autism Spectrum Disorder,60,80,0,2,2
Uttar Pradesh,Varanasi,Autism Spectrum Disorder,0,6,7,1,8
Uttar Pradesh,Varanasi,Autism Spectrum Disorder,6,15,7,1,8
Uttar Pradesh,Varanasi,Autism Spectrum Disorder,15,35,2,2,4
Gujarat,Valsad,Autism Spectrum Disorder,0,6,2,1,3
Gujarat,Valsad,Autism Spectrum Disorder,6,15,5,0,5
Gujarat,Valsad,Autism Spectrum Disorder,15,35,1,0,1
Gujarat,Valsad,Autism Spectrum Disorder,35,60,0,1,1
Bihar,Vaishali,Autism Spectrum Disorder,0,6,6,7,13
Bihar,Vaishali,Autism Spectrum Disorder,6,15,221,140,361
Bihar,Vaishali,Autism Spectrum Disorder,15,35,578,327,905
Bihar,Vaishali,Autism Spectrum Disorder,35,60,589,269,858
Bihar,Vaishali,Autism Spectrum Disorder,60,80,125,50,175
Bihar,Vaishali,Autism Spectrum Disorder,80,100,5,3,8
Gujarat,Vadodara,Autism Spectrum Disorder,0,6,17,8,25
Gujarat,Vadodara,Autism Spectrum Disorder,6,15,34,13,47
Gujarat,Vadodara,Autism Spectrum Disorder,15,35,8,2,10
Karnataka,Uttara Kannada,Autism Spectrum Disorder,0,6,2,2,4
Karnataka,Uttara Kannada,Autism Spectrum Disorder,6,15,15,2,17
Karnataka,Uttara Kannada,Autism Spectrum Disorder,15,35,1,0,1
Karnataka,Uttara Kannada,Autism Spectrum Disorder,35,60,1,1,2
Uttarakhand,Uttar Kashi,Autism Spectrum Disorder,6,15,1,0,1
Uttarakhand,Uttar Kashi,Autism Spectrum Disorder,15,35,2,0,2
Uttarakhand,Uttar Kashi,Autism Spectrum Disorder,35,60,2,0,2
Uttar Pradesh,Unnao,Autism Spectrum Disorder,15,35,4,2,6
Uttar Pradesh,Unnao,Autism Spectrum Disorder,35,60,11,5,16
Uttar Pradesh,Unnao,Autism Spectrum Disorder,60,80,1,0,1
Tripura,Unakoti,Autism Spectrum Disorder,6,15,5,0,5
Himachal Pradesh,Una,Autism Spectrum Disorder,0,6,1,0,1
Himachal Pradesh,Una,Autism Spectrum Disorder,6,15,0,1,1
Himachal Pradesh,Una,Autism Spectrum Disorder,15,35,1,0,1
Himachal Pradesh,Una,Autism Spectrum Disorder,35,60,2,0,2
Madhya Pradesh,Umaria,Autism Spectrum Disorder,6,15,5,0,5
Madhya Pradesh,Umaria,Autism Spectrum Disorder,15,35,3,2,5
Madhya Pradesh,Umaria,Autism Spectrum Disorder,35,60,4,2,6
Madhya Pradesh,Umaria,Autism Spectrum Disorder,60,80,0,1,1
Manipur,Ukhrul,Autism Spectrum Disorder,6,15,1,0,1
Madhya Pradesh,Ujjain,Autism Spectrum Disorder,0,6,7,4,11
Madhya Pradesh,Ujjain,Autism Spectrum Disorder,6,15,16,3,19
Madhya Pradesh,Ujjain,Autism Spectrum Disorder,15,35,5,0,5
Madhya Pradesh,Ujjain,Autism Spectrum Disorder,60,80,1,0,1
Karnataka,Udupi,Autism Spectrum Disorder,0,6,6,2,8
Karnataka,Udupi,Autism Spectrum Disorder,6,15,30,4,34
Karnataka,Udupi,Autism Spectrum Disorder,15,35,7,3,10
Karnataka,Udupi,Autism Spectrum Disorder,35,60,1,0,1
Jammu And Kashmir,Udhampur,Autism Spectrum Disorder,0,6,4,2,6
Jammu And Kashmir,Udhampur,Autism Spectrum Disorder,6,15,3,1,4
Jammu And Kashmir,Udhampur,Autism Spectrum Disorder,15,35,3,0,3
Jammu And Kashmir,Udhampur,Autism Spectrum Disorder,35,60,5,0,5
Uttarakhand,Udam Singh Nagar,Autism Spectrum Disorder,6,15,1,0,1
Uttarakhand,Udam Singh Nagar,Autism Spectrum Disorder,15,35,0,1,1
Uttarakhand,Udam Singh Nagar,Autism Spectrum Disorder,35,60,2,1,3
Uttarakhand,Udam Singh Nagar,Autism Spectrum Disorder,60,80,1,1,2
Assam,Udalguri,Autism Spectrum Disorder,0,6,1,0,1
Assam,Udalguri,Autism Spectrum Disorder,6,15,1,1,2
Assam,Udalguri,Autism Spectrum Disorder,15,35,2,0,2
Assam,Udalguri,Autism Spectrum Disorder,35,60,1,3,4
Rajasthan,Udaipur,Autism Spectrum Disorder,6,15,32,17,49
Rajasthan,Udaipur,Autism Spectrum Disorder,15,35,159,98,257
Rajasthan,Udaipur,Autism Spectrum Disorder,35,60,76,34,110
Rajasthan,Udaipur,Autism Spectrum Disorder,60,80,10,8,18
Rajasthan,Udaipur,Autism Spectrum Disorder,80,100,1,0,1
Tamil Nadu,Tuticorin,Autism Spectrum Disorder,0,6,6,2,8
Tamil Nadu,Tuticorin,Autism Spectrum Disorder,6,15,12,3,15
Tamil Nadu,Tuticorin,Autism Spectrum Disorder,15,35,5,1,6
Tamil Nadu,Tuticorin,Autism Spectrum Disorder,35,60,1,1,2
Karnataka,Tumakuru,Autism Spectrum Disorder,0,6,2,2,4
Karnataka,Tumakuru,Autism Spectrum Disorder,6,15,2,2,4
Karnataka,Tumakuru,Autism Spectrum Disorder,15,35,3,0,3
Karnataka,Tumakuru,Autism Spectrum Disorder,35,60,4,2,6
Karnataka,Tumakuru,Autism Spectrum Disorder,60,80,1,0,1
Nagaland,Tuensang,Autism Spectrum Disorder,15,35,0,1,1
Rajasthan,Tonk,Autism Spectrum Disorder,6,15,5,1,6
Rajasthan,Tonk,Autism Spectrum Disorder,15,35,16,8,24
Rajasthan,Tonk,Autism Spectrum Disorder,35,60,3,1,4
Rajasthan,Tonk,Autism Spectrum Disorder,60,80,0,1,1
Tamil Nadu,Tiruvannamalai,Autism Spectrum Disorder,0,6,13,4,17
Tamil Nadu,Tiruvannamalai,Autism Spectrum Disorder,6,15,24,6,30
Tamil Nadu,Tiruvannamalai,Autism Spectrum Disorder,15,35,4,1,5
Tamil Nadu,Tiruvannamalai,Autism Spectrum Disorder,35,60,2,0,2
Tamil Nadu,Tiruppur,Autism Spectrum Disorder,0,6,1,1,2
Tamil Nadu,Tiruppur,Autism Spectrum Disorder,6,15,17,5,22
Tamil Nadu,Tiruppur,Autism Spectrum Disorder,15,35,9,4,13
Tamil Nadu,Tirupathur,Autism Spectrum Disorder,0,6,6,1,7
Tamil Nadu,Tirupathur,Autism Spectrum Disorder,6,15,12,4,16
Tamil Nadu,Tirupathur,Autism Spectrum Disorder,15,35,3,0,3
Tamil Nadu,Tirunelveli,Autism Spectrum Disorder,0,6,21,7,28
Tamil Nadu,Tirunelveli,Autism Spectrum Disorder,6,15,79,18,97
Tamil Nadu,Tirunelveli,Autism Spectrum Disorder,15,35,14,5,19
Tamil Nadu,Tiruchirappalli,Autism Spectrum Disorder,0,6,27,6,33
Tamil Nadu,Tiruchirappalli,Autism Spectrum Disorder,6,15,78,17,95
Tamil Nadu,Tiruchirappalli,Autism Spectrum Disorder,15,35,29,12,41
Tamil Nadu,Tiruchirappalli,Autism Spectrum Disorder,35,60,6,4,10
Tamil Nadu,Tiruchirappalli,Autism Spectrum Disorder,60,80,1,0,1
Assam,Tinsukia,Autism Spectrum Disorder,6,15,2,0,2
Assam,Tinsukia,Autism Spectrum Disorder,15,35,1,0,1
Madhya Pradesh,Tikamgarh,Autism Spectrum Disorder,15,35,7,2,9
Madhya Pradesh,Tikamgarh,Autism Spectrum Disorder,35,60,7,0,7
Madhya Pradesh,Tikamgarh,Autism Spectrum Disorder,60,80,4,0,4
Kerala,Thrissur,Autism Spectrum Disorder,0,6,12,7,19
Kerala,Thrissur,Autism Spectrum Disorder,6,15,114,30,144
Kerala,Thrissur,Autism Spectrum Disorder,15,35,51,9,60
Tamil Nadu,Thiruvarur,Autism Spectrum Disorder,0,6,4,0,4
Tamil Nadu,Thiruvarur,Autism Spectrum Disorder,6,15,13,2,15
Tamil Nadu,Thiruvarur,Autism Spectrum Disorder,35,60,0,1,1
Kerala,Thiruvananthapuram,Autism Spectrum Disorder,0,6,55,18,73
Kerala,Thiruvananthapuram,Autism Spectrum Disorder,6,15,239,45,284
Kerala,Thiruvananthapuram,Autism Spectrum Disorder,15,35,101,35,136
Kerala,Thiruvananthapuram,Autism Spectrum Disorder,35,60,2,0,2
Tamil Nadu,Thiruvallur,Autism Spectrum Disorder,0,6,15,2,17
Tamil Nadu,Thiruvallur,Autism Spectrum Disorder,6,15,69,9,78
Tamil Nadu,Thiruvallur,Autism Spectrum Disorder,15,35,22,5,27
Tamil Nadu,Thiruvallur,Autism Spectrum Disorder,35,60,9,5,14
Tamil Nadu,Thiruvallur,Autism Spectrum Disorder,60,80,4,1,5
Tamil Nadu,Thiruvallur,Autism Spectrum Disorder,80,100,1,0,1
Tamil Nadu,Theni,Autism Spectrum Disorder,0,6,2,0,2
Tamil Nadu,Theni,Autism Spectrum Disorder,6,15,2,0,2
Tamil Nadu,Theni,Autism Spectrum Disorder,15,35,1,0,1
Tamil Nadu,Theni,Autism Spectrum Disorder,35,60,1,0,1
Tamil Nadu,The Nilgiris,Autism Spectrum Disorder,0,6,2,0,2
Tamil Nadu,The Nilgiris,Autism Spectrum Disorder,6,15,5,0,5
Tamil Nadu,The Nilgiris,Autism Spectrum Disorder,15,35,0,1,1
Tamil Nadu,The Nilgiris,Autism Spectrum Disorder,35,60,1,0,1
Tamil Nadu,The Nilgiris,Autism Spectrum Disorder,60,80,1,0,1
Tamil Nadu,Thanjavur,Autism Spectrum Disorder,0,6,26,7,33
Tamil Nadu,Thanjavur,Autism Spectrum Disorder,6,15,55,8,63
Tamil Nadu,Thanjavur,Autism Spectrum Disorder,15,35,5,1,6
Tamil Nadu,Thanjavur,Autism Spectrum Disorder,35,60,0,1,1
Maharashtra,Thane,Autism Spectrum Disorder,0,6,53,15,68
Maharashtra,Thane,Autism Spectrum Disorder,6,15,196,47,243
Maharashtra,Thane,Autism Spectrum Disorder,15,35,59,6,65
Maharashtra,Thane,Autism Spectrum Disorder,35,60,11,1,12
Maharashtra,Thane,Autism Spectrum Disorder,60,80,1,1,2
Tamil Nadu,Tenkasi,Autism Spectrum Disorder,0,6,6,2,8
Tamil Nadu,Tenkasi,Autism Spectrum Disorder,6,15,28,2,30
Tamil Nadu,Tenkasi,Autism Spectrum Disorder,15,35,3,1,4
Uttarakhand,Tehri Garhwal,Autism Spectrum Disorder,15,35,2,2,4
Arunachal Pradesh,Tawang,Autism Spectrum Disorder,6,15,0,1,1
Punjab,Tarn Taran,Autism Spectrum Disorder,0,6,1,0,1
Punjab,Tarn Taran,Autism Spectrum Disorder,6,15,1,0,1
Punjab,Tarn Taran,Autism Spectrum Disorder,35,60,2,1,3
Punjab,Tarn Taran,Autism Spectrum Disorder,60,80,1,0,1
Gujarat,Tapi,Autism Spectrum Disorder,0,6,2,0,2
Gujarat,Tapi,Autism Spectrum Disorder,6,15,0,1,1
Gujarat,Tapi,Autism Spectrum Disorder,15,35,1,0,1
Manipur,Tamenglong,Autism Spectrum Disorder,6,15,0,1,1
Chhattisgarh,Surguja,Autism Spectrum Disorder,0,6,2,0,2
Chhattisgarh,Surguja,Autism Spectrum Disorder,6,15,2,0,2
Chhattisgarh,Surguja,Autism Spectrum Disorder,35,60,0,1,1
Gujarat,Surendranagar,Autism Spectrum Disorder,0,6,1,0,1
Gujarat,Surendranagar,Autism Spectrum Disorder,6,15,1,1,2
Gujarat,Surendranagar,Autism Spectrum Disorder,15,35,1,0,1
Gujarat,Surendranagar,Autism Spectrum Disorder,35,60,1,0,1
Gujarat,Surat,Autism Spectrum Disorder,0,6,41,17,58
Gujarat,Surat,Autism Spectrum Disorder,6,15,107,18,125
Gujarat,Surat,Autism Spectrum Disorder,15,35,19,7,26
Gujarat,Surat,Autism Spectrum Disorder,35,60,1,0,1
Chhattisgarh,Surajpur,Autism Spectrum Disorder,6,15,2,0,2
Chhattisgarh,Surajpur,Autism Spectrum Disorder,15,35,0,1,1
Chhattisgarh,Surajpur,Autism Spectrum Disorder,35,60,1,2,3
Chhattisgarh,Surajpur,Autism Spectrum Disorder,60,80,1,0,1
Bihar,Supaul,Autism Spectrum Disorder,6,15,129,66,195
Bihar,Supaul,Autism Spectrum Disorder,15,35,452,231,683
Bihar,Supaul,Autism Spectrum Disorder,35,60,452,268,720
Bihar,Supaul,Autism Spectrum Disorder,60,80,163,74,237
Bihar,Supaul,Autism Spectrum Disorder,80,100,3,2,5
Odisha,Sundargarh,Autism Spectrum Disorder,0,6,15,1,16
Odisha,Sundargarh,Autism Spectrum Disorder,6,15,59,22,81
Odisha,Sundargarh,Autism Spectrum Disorder,15,35,41,19,60
Odisha,Sundargarh,Autism Spectrum Disorder,35,60,11,14,25
Odisha,Sundargarh,Autism Spectrum Disorder,60,80,7,4,11
Odisha,Sundargarh,Autism Spectrum Disorder,80,100,0,1,1
Uttar Pradesh,Sultanpur,Autism Spectrum Disorder,6,15,1,0,1
Uttar Pradesh,Sultanpur,Autism Spectrum Disorder,15,35,6,2,8
Uttar Pradesh,Sultanpur,Autism Spectrum Disorder,35,60,6,3,9
Uttar Pradesh,Sultanpur,Autism Spectrum Disorder,60,80,4,1,5
Chhattisgarh,Sukma,Autism Spectrum Disorder,0,6,1,0,1
Chhattisgarh,Sukma,Autism Spectrum Disorder,35,60,1,0,1
Jammu And Kashmir,Srinagar,Autism Spectrum Disorder,0,6,1,2,3
Jammu And Kashmir,Srinagar,Autism Spectrum Disorder,6,15,14,2,16
Jammu And Kashmir,Srinagar,Autism Spectrum Disorder,15,35,6,0,6
Jammu And Kashmir,Srinagar,Autism Spectrum Disorder,35,60,2,0,2
Andhra Pradesh,Srikakulam,Autism Spectrum Disorder,35,60,1,0,1
Punjab,Sri Muktsar Sahib,Autism Spectrum Disorder,6,15,1,0,1
Punjab,Sri Muktsar Sahib,Autism Spectrum Disorder,35,60,0,1,1
Punjab,Sri Muktsar Sahib,Autism Spectrum Disorder,60,80,2,0,2
Andhra Pradesh,Spsr Nellore,Autism Spectrum Disorder,0,6,0,1,1
Meghalaya,South West Garo Hills,Autism Spectrum Disorder,0,6,1,0,1
Meghalaya,South West Garo Hills,Autism Spectrum Disorder,6,15,1,0,1
Meghalaya,South West Garo Hills,Autism Spectrum Disorder,15,35,2,0,2
Delhi,South West,Autism Spectrum Disorder,0,6,21,3,24
Delhi,South West,Autism Spectrum Disorder,6,15,73,14,87
Delhi,South West,Autism Spectrum Disorder,15,35,19,1,20
Goa,South Goa,Autism Spectrum Disorder,0,6,4,1,5
Goa,South Goa,Autism Spectrum Disorder,6,15,26,0,26
Goa,South Goa,Autism Spectrum Disorder,15,35,15,6,21
Meghalaya,South Garo Hills,Autism Spectrum Disorder,6,15,2,0,2
Meghalaya,South Garo Hills,Autism Spectrum Disorder,15,35,1,0,1
Delhi,South East,Autism Spectrum Disorder,0,6,20,5,25
Delhi,South East,Autism Spectrum Disorder,6,15,32,5,37
Delhi,South East,Autism Spectrum Disorder,15,35,4,2,6
Andaman And Nicobar Islands,South Andamans,Autism Spectrum Disorder,0,6,4,1,5
Andaman And Nicobar Islands,South Andamans,Autism Spectrum Disorder,6,15,14,4,18
Andaman And Nicobar Islands,South Andamans,Autism Spectrum Disorder,15,35,1,0,1
Andaman And Nicobar Islands,South Andamans,Autism Spectrum Disorder,35,60,0,1,1
Delhi,South,Autism Spectrum Disorder,0,6,27,8,35
Delhi,South,Autism Spectrum Disorder,6,15,45,11,56
Delhi,South,Autism Spectrum Disorder,15,35,13,0,13
Assam,Sonitpur,Autism Spectrum Disorder,0,6,3,1,4
Assam,Sonitpur,Autism Spectrum Disorder,6,15,8,1,9
Assam,Sonitpur,Autism Spectrum Disorder,15,35,4,0,4
Haryana,Sonipat,Autism Spectrum Disorder,0,6,2,1,3
Haryana,Sonipat,Autism Spectrum Disorder,6,15,4,0,4
Haryana,Sonipat,Autism Spectrum Disorder,15,35,2,0,2
Odisha,Sonepur,Autism Spectrum Disorder,0,6,3,0,3
Odisha,Sonepur,Autism Spectrum Disorder,6,15,5,2,7
Odisha,Sonepur,Autism Spectrum Disorder,15,35,1,2,3
Uttar Pradesh,Sonbhadra,Autism Spectrum Disorder,0,6,1,0,1
Uttar Pradesh,Sonbhadra,Autism Spectrum Disorder,6,15,1,0,1
Uttar Pradesh,Sonbhadra,Autism Spectrum Disorder,15,35,2,2,4
Uttar Pradesh,Sonbhadra,Autism Spectrum Disorder,35,60,7,0,7
Uttar Pradesh,Sonbhadra,Autism Spectrum Disorder,60,80,1,0,1
Maharashtra,Solapur,Autism Spectrum Disorder,0,6,2,0,2
Maharashtra,Solapur,Autism Spectrum Disorder,6,15,10,0,10
Maharashtra,Solapur,Autism Spectrum Disorder,35,60,1,0,1
Himachal Pradesh,Solan,Autism Spectrum Disorder,0,6,1,1,2
Himachal Pradesh,Solan,Autism Spectrum Disorder,6,15,1,0,1
Himachal Pradesh,Solan,Autism Spectrum Disorder,15,35,1,1,2
Bihar,Siwan,Autism Spectrum Disorder,0,6,5,1,6
Bihar,Siwan,Autism Spectrum Disorder,6,15,251,181,432
Bihar,Siwan,Autism Spectrum Disorder,15,35,777,430,1207
Bihar,Siwan,Autism Spectrum Disorder,35,60,875,588,1463
Bihar,Siwan,Autism Spectrum Disorder,60,80,375,237,612
Bihar,Siwan,Autism Spectrum Disorder,80,100,23,12,35
Assam,Sivasagar,Autism Spectrum Disorder,0,6,2,0,2
Assam,Sivasagar,Autism Spectrum Disorder,6,15,1,0,1
Assam,Sivasagar,Autism Spectrum Disorder,15,35,1,0,1
Tamil Nadu,Sivaganga,Autism Spectrum Disorder,0,6,7,0,7
Tamil Nadu,Sivaganga,Autism Spectrum Disorder,6,15,9,4,13
Tamil Nadu,Sivaganga,Autism Spectrum Disorder,15,35,5,1,6
Tamil Nadu,Sivaganga,Autism Spectrum Disorder,35,60,4,4,8
Uttar Pradesh,Sitapur,Autism Spectrum Disorder,6,15,2,1,3
Uttar Pradesh,Sitapur,Autism Spectrum Disorder,15,35,15,3,18
Uttar Pradesh,Sitapur,Autism Spectrum Disorder,35,60,20,2,22
Bihar,Sitamarhi,Autism Spectrum Disorder,0,6,2,2,4
Bihar,Sitamarhi,Autism Spectrum Disorder,6,15,243,144,387
Bihar,Sitamarhi,Autism Spectrum Disorder,15,35,657,357,1014
Bihar,Sitamarhi,Autism Spectrum Disorder,35,60,730,471,1201
Bihar,Sitamarhi,Autism Spectrum Disorder,60,80,254,152,406
Bihar,Sitamarhi,Autism Spectrum Disorder,80,100,12,9,21
Haryana,Sirsa,Autism Spectrum Disorder,0,6,1,0,1
Haryana,Sirsa,Autism Spectrum Disorder,6,15,2,0,2
Haryana,Sirsa,Autism Spectrum Disorder,15,35,1,0,1
Rajasthan,Sirohi,Autism Spectrum Disorder,6,15,3,1,4
Rajasthan,Sirohi,Autism Spectrum Disorder,15,35,11,5,16
Rajasthan,Sirohi,Autism Spectrum Disorder,35,60,6,1,7
Rajasthan,Sirohi,Autism Spectrum Disorder,60,80,1,0,1
Himachal Pradesh,Sirmaur,Autism Spectrum Disorder,6,15,1,0,1
Madhya Pradesh,Singrauli,Autism Spectrum Disorder,6,15,2,0,2
Madhya Pradesh,Singrauli,Autism Spectrum Disorder,15,35,2,1,3
Madhya Pradesh,Singrauli,Autism Spectrum Disorder,35,60,3,2,5
Rajasthan,Sikar,Autism Spectrum Disorder,6,15,6,1,7
Rajasthan,Sikar,Autism Spectrum Disorder,15,35,33,14,47
Rajasthan,Sikar,Autism Spectrum Disorder,35,60,15,5,20
Rajasthan,Sikar,Autism Spectrum Disorder,60,80,3,1,4
Madhya Pradesh,Sidhi,Autism Spectrum Disorder,6,15,1,0,1
Madhya Pradesh,Sidhi,Autism Spectrum Disorder,15,35,13,6,19
Madhya Pradesh,Sidhi,Autism Spectrum Disorder,35,60,10,8,18
Madhya Pradesh,Sidhi,Autism Spectrum Disorder,60,80,6,0,6
Uttar Pradesh,Siddharth Nagar,Autism Spectrum Disorder,0,6,1,0,1
Uttar Pradesh,Siddharth Nagar,Autism Spectrum Disorder,6,15,1,1,2
Uttar Pradesh,Siddharth Nagar,Autism Spectrum Disorder,15,35,6,1,7
Uttar Pradesh,Siddharth Nagar,Autism Spectrum Disorder,35,60,11,3,14
Uttar Pradesh,Siddharth Nagar,Autism Spectrum Disorder,60,80,8,1,9
Uttar Pradesh,Shravasti,Autism Spectrum Disorder,35,60,2,0,2
Jammu And Kashmir,Shopian,Autism Spectrum Disorder,0,6,4,0,4
Jammu And Kashmir,Shopian,Autism Spectrum Disorder,35,60,1,1,2
Jammu And Kashmir,Shopian,Autism Spectrum Disorder,60,80,1,0,1
Madhya Pradesh,Shivpuri,Autism Spectrum Disorder,15,35,3,2,5
Madhya Pradesh,Shivpuri,Autism Spectrum Disorder,35,60,4,3,7
Madhya Pradesh,Shivpuri,Autism Spectrum Disorder,60,80,2,0,2
Madhya Pradesh,Shivpuri,Autism Spectrum Disorder,80,100,1,0,1
Karnataka,Shivamogga,Autism Spectrum Disorder,6,15,3,0,3
Karnataka,Shivamogga,Autism Spectrum Disorder,15,35,2,1,3
Karnataka,Shivamogga,Autism Spectrum Disorder,35,60,6,2,8
Karnataka,Shivamogga,Autism Spectrum Disorder,60,80,4,0,4
Himachal Pradesh,Shimla,Autism Spectrum Disorder,0,6,0,1,1
Himachal Pradesh,Shimla,Autism Spectrum Disorder,6,15,7,0,7
Himachal Pradesh,Shimla,Autism Spectrum Disorder,15,35,3,0,3
Madhya Pradesh,Sheopur,Autism Spectrum Disorder,15,35,1,1,2
Bihar,Sheohar,Autism Spectrum Disorder,0,6,7,4,11
Bihar,Sheohar,Autism Spectrum Disorder,6,15,103,58,161
Bihar,Sheohar,Autism Spectrum Disorder,15,35,166,84,250
Bihar,Sheohar,Autism Spectrum Disorder,35,60,170,74,244
Bihar,Sheohar,Autism Spectrum Disorder,60,80,65,20,85
Bihar,Sheohar,Autism Spectrum Disorder,80,100,4,2,6
Bihar,Sheikhpura,Autism Spectrum Disorder,0,6,5,2,7
Bihar,Sheikhpura,Autism Spectrum Disorder,6,15,78,55,133
Bihar,Sheikhpura,Autism Spectrum Disorder,15,35,170,96,266
Bihar,Sheikhpura,Autism Spectrum Disorder,35,60,170,70,240
Bihar,Sheikhpura,Autism Spectrum Disorder,60,80,66,26,92
Bihar,Sheikhpura,Autism Spectrum Disorder,80,100,1,0,1
Uttar Pradesh,Shamli,Autism Spectrum Disorder,0,6,1,0,1
Uttar Pradesh,Shamli,Autism Spectrum Disorder,6,15,1,0,1
Uttar Pradesh,Shamli,Autism Spectrum Disorder,15,35,2,0,2
Uttar Pradesh,Shamli,Autism Spectrum Disorder,35,60,2,2,4
Madhya Pradesh,Shajapur,Autism Spectrum Disorder,0,6,0,1,1
Uttar Pradesh,Shahjahanpur,Autism Spectrum Disorder,6,15,6,2,8
Uttar Pradesh,Shahjahanpur,Autism Spectrum Disorder,15,35,45,12,57
Uttar Pradesh,Shahjahanpur,Autism Spectrum Disorder,35,60,50,21,71
Uttar Pradesh,Shahjahanpur,Autism Spectrum Disorder,60,80,14,3,17
Punjab,Shahid Bhagat Singh Nagar,Autism Spectrum Disorder,0,6,1,0,1
Punjab,Shahid Bhagat Singh Nagar,Autism Spectrum Disorder,6,15,2,1,3
Punjab,Shahid Bhagat Singh Nagar,Autism Spectrum Disorder,15,35,6,0,6
Punjab,Shahid Bhagat Singh Nagar,Autism Spectrum Disorder,35,60,1,1,2
Punjab,Shahid Bhagat Singh Nagar,Autism Spectrum Disorder,60,80,1,0,1
Madhya Pradesh,Shahdol,Autism Spectrum Disorder,6,15,2,1,3
Madhya Pradesh,Shahdol,Autism Spectrum Disorder,15,35,2,3,5
Madhya Pradesh,Shahdol,Autism Spectrum Disorder,35,60,5,6,11
Madhya Pradesh,Shahdol,Autism Spectrum Disorder,60,80,1,0,1
Delhi,Shahdara,Autism Spectrum Disorder,6,15,3,2,5
Delhi,Shahdara,Autism Spectrum Disorder,15,35,2,0,2
Mizoram,Serchhip,Autism Spectrum Disorder,0,6,1,0,1
Mizoram,Serchhip,Autism Spectrum Disorder,6,15,0,1,1
Tripura,Sepahijala,Autism Spectrum Disorder,0,6,2,0,2
Tripura,Sepahijala,Autism Spectrum Disorder,6,15,1,0,1
Madhya Pradesh,Seoni,Autism Spectrum Disorder,6,15,2,1,3
Madhya Pradesh,Seoni,Autism Spectrum Disorder,15,35,3,5,8
Madhya Pradesh,Seoni,Autism Spectrum Disorder,35,60,1,3,4
Madhya Pradesh,Seoni,Autism Spectrum Disorder,80,100,1,0,1
Madhya Pradesh,Sehore,Autism Spectrum Disorder,6,15,4,0,4
Rajasthan,Sawai Madhopur,Autism Spectrum Disorder,0,6,0,1,1
Rajasthan,Sawai Madhopur,Autism Spectrum Disorder,6,15,22,13,35
Rajasthan,Sawai Madhopur,Autism Spectrum Disorder,15,35,109,36,145
Rajasthan,Sawai Madhopur,Autism Spectrum Disorder,35,60,27,6,33
Rajasthan,Sawai Madhopur,Autism Spectrum Disorder,60,80,3,2,5
Madhya Pradesh,Satna,Autism Spectrum Disorder,15,35,1,4,5
Madhya Pradesh,Satna,Autism Spectrum Disorder,35,60,1,0,1
Madhya Pradesh,Satna,Autism Spectrum Disorder,60,80,0,1,1
Maharashtra,Satara,Autism Spectrum Disorder,0,6,10,1,11
Maharashtra,Satara,Autism Spectrum Disorder,6,15,50,10,60
Maharashtra,Satara,Autism Spectrum Disorder,15,35,7,0,7
Maharashtra,Satara,Autism Spectrum Disorder,35,60,1,0,1
Maharashtra,Satara,Autism Spectrum Disorder,60,80,1,0,1
Bihar,Saran,Autism Spectrum Disorder,0,6,6,5,11
Bihar,Saran,Autism Spectrum Disorder,6,15,122,103,225
Bihar,Saran,Autism Spectrum Disorder,15,35,666,323,989
Bihar,Saran,Autism Spectrum Disorder,35,60,986,644,1630
Bihar,Saran,Autism Spectrum Disorder,60,80,362,212,574
Bihar,Saran,Autism Spectrum Disorder,80,100,30,7,37
Jharkhand,Saraikela Kharsawan,Autism Spectrum Disorder,6,15,1,0,1
Jharkhand,Saraikela Kharsawan,Autism Spectrum Disorder,15,35,2,0,2
Uttar Pradesh,Sant Kabeer Nagar,Autism Spectrum Disorder,6,15,1,0,1
Uttar Pradesh,Sant Kabeer Nagar,Autism Spectrum Disorder,15,35,5,1,6
Uttar Pradesh,Sant Kabeer Nagar,Autism Spectrum Disorder,35,60,2,0,2
Uttar Pradesh,Sant Kabeer Nagar,Autism Spectrum Disorder,60,80,1,0,1
Punjab,Sangrur,Autism Spectrum Disorder,0,6,3,0,3
Punjab,Sangrur,Autism Spectrum Disorder,6,15,10,0,10
Punjab,Sangrur,Autism Spectrum Disorder,15,35,2,2,4
Punjab,Sangrur,Autism Spectrum Disorder,35,60,4,0,4
Punjab,Sangrur,Autism Spectrum Disorder,60,80,2,1,3
Maharashtra,Sangli,Autism Spectrum Disorder,0,6,2,0,2
Maharashtra,Sangli,Autism Spectrum Disorder,6,15,20,7,27
Maharashtra,Sangli,Autism Spectrum Disorder,15,35,4,0,4
Maharashtra,Sangli,Autism Spectrum Disorder,35,60,1,0,1
Maharashtra,Sangli,Autism Spectrum Disorder,60,80,1,0,1
Uttar Pradesh,Sambhal,Autism Spectrum Disorder,15,35,1,0,1
Odisha,Sambalpur,Autism Spectrum Disorder,0,6,9,2,11
Odisha,Sambalpur,Autism Spectrum Disorder,6,15,13,4,17
Odisha,Sambalpur,Autism Spectrum Disorder,15,35,2,0,2
Odisha,Sambalpur,Autism Spectrum Disorder,35,60,1,0,1
Jammu And Kashmir,Samba,Autism Spectrum Disorder,0,6,3,1,4
Jammu And Kashmir,Samba,Autism Spectrum Disorder,6,15,4,0,4
Jammu And Kashmir,Samba,Autism Spectrum Disorder,15,35,4,0,4
Bihar,Samastipur,Autism Spectrum Disorder,0,6,13,5,18
Bihar,Samastipur,Autism Spectrum Disorder,6,15,351,188,539
Bihar,Samastipur,Autism Spectrum Disorder,15,35,959,458,1417
Bihar,Samastipur,Autism Spectrum Disorder,35,60,1320,787,2107
Bihar,Samastipur,Autism Spectrum Disorder,60,80,406,243,649
Bihar,Samastipur,Autism Spectrum Disorder,80,100,12,4,16
Tamil Nadu,Salem,Autism Spectrum Disorder,0,6,14,1,15
Tamil Nadu,Salem,Autism Spectrum Disorder,6,15,44,6,50
Tamil Nadu,Salem,Autism Spectrum Disorder,15,35,5,0,5
Tamil Nadu,Salem,Autism Spectrum Disorder,35,60,0,1,1
Jharkhand,Sahebganj,Autism Spectrum Disorder,15,35,1,0,1
Bihar,Saharsa,Autism Spectrum Disorder,0,6,3,1,4
Bihar,Saharsa,Autism Spectrum Disorder,6,15,26,28,54
Bihar,Saharsa,Autism Spectrum Disorder,15,35,90,45,135
Bihar,Saharsa,Autism Spectrum Disorder,35,60,74,43,117
Bihar,Saharsa,Autism Spectrum Disorder,60,80,40,14,54
Bihar,Saharsa,Autism Spectrum Disorder,80,100,2,1,3
Uttar Pradesh,Saharanpur,Autism Spectrum Disorder,6,15,5,0,5
Uttar Pradesh,Saharanpur,Autism Spectrum Disorder,15,35,17,6,23
Uttar Pradesh,Saharanpur,Autism Spectrum Disorder,35,60,13,2,15
Uttar Pradesh,Saharanpur,Autism Spectrum Disorder,60,80,3,0,3
Madhya Pradesh,Sagar,Autism Spectrum Disorder,0,6,1,0,1
Madhya Pradesh,Sagar,Autism Spectrum Disorder,6,15,5,0,5
Madhya Pradesh,Sagar,Autism Spectrum Disorder,15,35,9,5,14
Madhya Pradesh,Sagar,Autism Spectrum Disorder,35,60,9,3,12
Madhya Pradesh,Sagar,Autism Spectrum Disorder,60,80,0,1,1
Madhya Pradesh,Sagar,Autism Spectrum Disorder,80,100,1,0,1
Gujarat,Sabar Kantha,Autism Spectrum Disorder,0,6,2,1,3
Gujarat,Sabar Kantha,Autism Spectrum Disorder,6,15,0,1,1
Gujarat,Sabar Kantha,Autism Spectrum Disorder,15,35,1,0,1
Punjab,S.A.S Nagar,Autism Spectrum Disorder,0,6,4,3,7
Punjab,S.A.S Nagar,Autism Spectrum Disorder,6,15,31,11,42
Punjab,S.A.S Nagar,Autism Spectrum Disorder,15,35,17,1,18
Punjab,S.A.S Nagar,Autism Spectrum Disorder,35,60,13,4,17
Punjab,S.A.S Nagar,Autism Spectrum Disorder,60,80,0,3,3
Punjab,Rupnagar,Autism Spectrum Disorder,0,6,1,0,1
Punjab,Rupnagar,Autism Spectrum Disorder,6,15,4,1,5
Punjab,Rupnagar,Autism Spectrum Disorder,35,60,1,0,1
Uttarakhand,Rudra Prayag,Autism Spectrum Disorder,15,35,2,2,4
Uttarakhand,Rudra Prayag,Autism Spectrum Disorder,35,60,1,3,4
Uttarakhand,Rudra Prayag,Autism Spectrum Disorder,60,80,2,0,2
Bihar,Rohtas,Autism Spectrum Disorder,0,6,0,2,2
Bihar,Rohtas,Autism Spectrum Disorder,6,15,246,150,396
Bihar,Rohtas,Autism Spectrum Disorder,15,35,914,444,1358
Bihar,Rohtas,Autism Spectrum Disorder,35,60,1051,624,1675
Bihar,Rohtas,Autism Spectrum Disorder,60,80,451,197,648
Bihar,Rohtas,Autism Spectrum Disorder,80,100,25,5,30
Haryana,Rohtak,Autism Spectrum Disorder,6,15,7,0,7
Haryana,Rohtak,Autism Spectrum Disorder,15,35,2,0,2
Haryana,Rohtak,Autism Spectrum Disorder,35,60,0,2,2
Haryana,Rohtak,Autism Spectrum Disorder,60,80,1,0,1
Meghalaya,Ri Bhoi,Autism Spectrum Disorder,6,15,2,1,3
Haryana,Rewari,Autism Spectrum Disorder,0,6,3,0,3
Haryana,Rewari,Autism Spectrum Disorder,6,15,2,0,2
Madhya Pradesh,Rewa,Autism Spectrum Disorder,6,15,1,0,1
Madhya Pradesh,Rewa,Autism Spectrum Disorder,35,60,1,0,1
Jammu And Kashmir,Reasi,Autism Spectrum Disorder,0,6,1,0,1
Odisha,Rayagada,Autism Spectrum Disorder,0,6,1,0,1
Odisha,Rayagada,Autism Spectrum Disorder,6,15,3,1,4
Odisha,Rayagada,Autism Spectrum Disorder,15,35,1,0,1
Odisha,Rayagada,Autism Spectrum Disorder,35,60,0,1,1
Maharashtra,Ratnagiri,Autism Spectrum Disorder,0,6,5,0,5
Maharashtra,Ratnagiri,Autism Spectrum Disorder,6,15,10,1,11
Maharashtra,Ratnagiri,Autism Spectrum Disorder,15,35,1,1,2
Maharashtra,Ratnagiri,Autism Spectrum Disorder,60,80,1,0,1
Madhya Pradesh,Ratlam,Autism Spectrum Disorder,0,6,0,1,1
Madhya Pradesh,Ratlam,Autism Spectrum Disorder,6,15,5,1,6
Madhya Pradesh,Ratlam,Autism Spectrum Disorder,15,35,4,0,4
Madhya Pradesh,Ratlam,Autism Spectrum Disorder,35,60,3,1,4
Tamil Nadu,Ranipet,Autism Spectrum Disorder,0,6,8,2,10
Tamil Nadu,Ranipet,Autism Spectrum Disorder,6,15,5,3,8
Tamil Nadu,Ranipet,Autism Spectrum Disorder,35,60,1,2,3
Jharkhand,Ranchi,Autism Spectrum Disorder,0,6,0,2,2
Jharkhand,Ranchi,Autism Spectrum Disorder,6,15,3,3,6
Jharkhand,Ranchi,Autism Spectrum Disorder,15,35,1,0,1
Uttar Pradesh,Rampur,Autism Spectrum Disorder,6,15,2,0,2
Uttar Pradesh,Rampur,Autism Spectrum Disorder,15,35,9,5,14
Uttar Pradesh,Rampur,Autism Spectrum Disorder,35,60,15,2,17
Uttar Pradesh,Rampur,Autism Spectrum Disorder,60,80,2,0,2
Jharkhand,Ramgarh,Autism Spectrum Disorder,0,6,2,0,2
Jharkhand,Ramgarh,Autism Spectrum Disorder,6,15,4,2,6
Jharkhand,Ramgarh,Autism Spectrum Disorder,15,35,7,13,20
Jharkhand,Ramgarh,Autism Spectrum Disorder,35,60,9,5,14
Jharkhand,Ramgarh,Autism Spectrum Disorder,60,80,3,0,3
Tamil Nadu,Ramanathapuram,Autism Spectrum Disorder,0,6,1,0,1
Tamil Nadu,Ramanathapuram,Autism Spectrum Disorder,6,15,9,0,9
Tamil Nadu,Ramanathapuram,Autism Spectrum Disorder,15,35,3,1,4
Tamil Nadu,Ramanathapuram,Autism Spectrum Disorder,35,60,0,1,1
Karnataka,Ramanagara,Autism Spectrum Disorder,0,6,3,0,3
Karnataka,Ramanagara,Autism Spectrum Disorder,15,35,1,1,2
Karnataka,Ramanagara,Autism Spectrum Disorder,35,60,2,2,4
Karnataka,Ramanagara,Autism Spectrum Disorder,60,80,1,2,3
Rajasthan,Rajsamand,Autism Spectrum Disorder,6,15,22,8,30
Rajasthan,Rajsamand,Autism Spectrum Disorder,15,35,70,39,109
Rajasthan,Rajsamand,Autism Spectrum Disorder,35,60,20,17,37
Rajasthan,Rajsamand,Autism Spectrum Disorder,60,80,1,2,3
Jammu And Kashmir,Rajouri,Autism Spectrum Disorder,0,6,1,0,1
Jammu And Kashmir,Rajouri,Autism Spectrum Disorder,6,15,2,2,4
Jammu And Kashmir,Rajouri,Autism Spectrum Disorder,15,35,0,1,1
Jammu And Kashmir,Rajouri,Autism Spectrum Disorder,35,60,1,1,2
Chhattisgarh,Rajnandgaon,Autism Spectrum Disorder,0,6,8,1,9
Chhattisgarh,Rajnandgaon,Autism Spectrum Disorder,6,15,3,1,4
Chhattisgarh,Rajnandgaon,Autism Spectrum Disorder,15,35,4,0,4
Chhattisgarh,Rajnandgaon,Autism Spectrum Disorder,35,60,2,0,2
Chhattisgarh,Rajnandgaon,Autism Spectrum Disorder,80,100,1,0,1
Gujarat,Rajkot,Autism Spectrum Disorder,0,6,18,4,22
Gujarat,Rajkot,Autism Spectrum Disorder,6,15,13,9,22
Gujarat,Rajkot,Autism Spectrum Disorder,15,35,2,0,2
Madhya Pradesh,Rajgarh,Autism Spectrum Disorder,0,6,1,0,1
Madhya Pradesh,Rajgarh,Autism Spectrum Disorder,6,15,4,1,5
Madhya Pradesh,Rajgarh,Autism Spectrum Disorder,15,35,1,2,3
Madhya Pradesh,Rajgarh,Autism Spectrum Disorder,35,60,6,2,8
Madhya Pradesh,Rajgarh,Autism Spectrum Disorder,60,80,3,0,3
Madhya Pradesh,Raisen,Autism Spectrum Disorder,6,15,2,1,3
Madhya Pradesh,Raisen,Autism Spectrum Disorder,15,35,10,4,14
Madhya Pradesh,Raisen,Autism Spectrum Disorder,35,60,18,7,25
Madhya Pradesh,Raisen,Autism Spectrum Disorder,60,80,4,2,6
Chhattisgarh,Raipur,Autism Spectrum Disorder,0,6,5,1,6
Chhattisgarh,Raipur,Autism Spectrum Disorder,6,15,70,14,84
Chhattisgarh,Raipur,Autism Spectrum Disorder,15,35,15,5,20
Chhattisgarh,Raipur,Autism Spectrum Disorder,35,60,0,1,1
Chhattisgarh,Raipur,Autism Spectrum Disorder,60,80,1,0,1
Chhattisgarh,Raigarh,Autism Spectrum Disorder,0,6,2,0,2
Chhattisgarh,Raigarh,Autism Spectrum Disorder,6,15,5,0,5
Chhattisgarh,Raigarh,Autism Spectrum Disorder,15,35,2,1,3
Chhattisgarh,Raigarh,Autism Spectrum Disorder,35,60,1,0,1
Maharashtra,Raigad,Autism Spectrum Disorder,0,6,15,4,19
Maharashtra,Raigad,Autism Spectrum Disorder,6,15,36,4,40
Maharashtra,Raigad,Autism Spectrum Disorder,15,35,13,4,17
Maharashtra,Raigad,Autism Spectrum Disorder,35,60,2,0,2
Maharashtra,Raigad,Autism Spectrum Disorder,60,80,2,0,2
Karnataka,Raichur,Autism Spectrum Disorder,0,6,1,0,1
Karnataka,Raichur,Autism Spectrum Disorder,15,35,1,0,1
Uttar Pradesh,Rae Bareli,Autism Spectrum Disorder,35,60,2,0,2
Bihar,Purnia,Autism Spectrum Disorder,0,6,18,8,26
Bihar,Purnia,Autism Spectrum Disorder,6,15,338,248,586
Bihar,Purnia,Autism Spectrum Disorder,15,35,572,381,953
Bihar,Purnia,Autism Spectrum Disorder,35,60,678,416,1094
Bihar,Purnia,Autism Spectrum Disorder,60,80,200,92,292
Bihar,Purnia,Autism Spectrum Disorder,80,100,3,1,4
Odisha,Puri,Autism Spectrum Disorder,0,6,5,1,6
Odisha,Puri,Autism Spectrum Disorder,6,15,6,1,7
Odisha,Puri,Autism Spectrum Disorder,15,35,3,2,5
Odisha,Puri,Autism Spectrum Disorder,35,60,6,2,8
Odisha,Puri,Autism Spectrum Disorder,60,80,1,2,3
Odisha,Puri,Autism Spectrum Disorder,80,100,0,1,1
Bihar,Purbi Champaran,Autism Spectrum Disorder,0,6,8,2,10
Bihar,Purbi Champaran,Autism Spectrum Disorder,6,15,253,116,369
Bihar,Purbi Champaran,Autism Spectrum Disorder,15,35,719,403,1122
Bihar,Purbi Champaran,Autism Spectrum Disorder,35,60,828,439,1267
Bihar,Purbi Champaran,Autism Spectrum Disorder,60,80,204,98,302
Bihar,Purbi Champaran,Autism Spectrum Disorder,80,100,8,1,9
Maharashtra,Pune,Autism Spectrum Disorder,0,6,33,6,39
Maharashtra,Pune,Autism Spectrum Disorder,6,15,95,26,121
Maharashtra,Pune,Autism Spectrum Disorder,15,35,34,8,42
Maharashtra,Pune,Autism Spectrum Disorder,35,60,2,1,3
Maharashtra,Pune,Autism Spectrum Disorder,60,80,1,0,1
Jammu And Kashmir,Pulwama,Autism Spectrum Disorder,0,6,2,0,2
Jammu And Kashmir,Pulwama,Autism Spectrum Disorder,6,15,11,3,14
Jammu And Kashmir,Pulwama,Autism Spectrum Disorder,15,35,1,1,2
Jammu And Kashmir,Pulwama,Autism Spectrum Disorder,35,60,1,0,1
Tamil Nadu,Pudukkottai,Autism Spectrum Disorder,0,6,7,1,8
Tamil Nadu,Pudukkottai,Autism Spectrum Disorder,6,15,16,7,23
Uttar Pradesh,Prayagraj,Autism Spectrum Disorder,6,15,5,3,8
Uttar Pradesh,Prayagraj,Autism Spectrum Disorder,15,35,6,0,6
Rajasthan,Pratapgarh,Autism Spectrum Disorder,6,15,5,10,15
Rajasthan,Pratapgarh,Autism Spectrum Disorder,15,35,13,17,30
Rajasthan,Pratapgarh,Autism Spectrum Disorder,35,60,11,9,20
Rajasthan,Pratapgarh,Autism Spectrum Disorder,60,80,2,0,2
Uttar Pradesh,Pratapgarh,Autism Spectrum Disorder,0,6,1,0,1
Uttar Pradesh,Pratapgarh,Autism Spectrum Disorder,15,35,4,0,4
Uttar Pradesh,Pratapgarh,Autism Spectrum Disorder,35,60,10,2,12
Uttar Pradesh,Pratapgarh,Autism Spectrum Disorder,60,80,1,0,1
Gujarat,Porbandar,Autism Spectrum Disorder,0,6,3,1,4
Gujarat,Porbandar,Autism Spectrum Disorder,6,15,11,3,14
Gujarat,Porbandar,Autism Spectrum Disorder,15,35,2,0,2
Jammu And Kashmir,Poonch,Autism Spectrum Disorder,0,6,4,2,6
Jammu And Kashmir,Poonch,Autism Spectrum Disorder,6,15,10,5,15
Jammu And Kashmir,Poonch,Autism Spectrum Disorder,15,35,32,21,53
Jammu And Kashmir,Poonch,Autism Spectrum Disorder,35,60,35,21,56
Jammu And Kashmir,Poonch,Autism Spectrum Disorder,60,80,4,3,7
Puducherry,Pondicherry,Autism Spectrum Disorder,0,6,8,0,8
Puducherry,Pondicherry,Autism Spectrum Disorder,6,15,30,2,32
Puducherry,Pondicherry,Autism Spectrum Disorder,15,35,4,1,5
Uttar Pradesh,Pilibhit,Autism Spectrum Disorder,15,35,10,4,14
Uttar Pradesh,Pilibhit,Autism Spectrum Disorder,35,60,18,5,23
Uttar Pradesh,Pilibhit,Autism Spectrum Disorder,60,80,4,3,7
Tamil Nadu,Perambalur,Autism Spectrum Disorder,0,6,0,1,1
Tamil Nadu,Perambalur,Autism Spectrum Disorder,6,15,3,0,3
Uttarakhand,Pauri Garhwal,Autism Spectrum Disorder,0,6,3,0,3
Uttarakhand,Pauri Garhwal,Autism Spectrum Disorder,6,15,1,0,1
Uttarakhand,Pauri Garhwal,Autism Spectrum Disorder,15,35,1,0,1
Uttarakhand,Pauri Garhwal,Autism Spectrum Disorder,35,60,8,1,9
Uttarakhand,Pauri Garhwal,Autism Spectrum Disorder,60,80,1,1,2
Bihar,Patna,Autism Spectrum Disorder,0,6,27,5,32
Bihar,Patna,Autism Spectrum Disorder,6,15,269,150,419
Bihar,Patna,Autism Spectrum Disorder,15,35,669,380,1049
Bihar,Patna,Autism Spectrum Disorder,35,60,688,386,1074
Bihar,Patna,Autism Spectrum Disorder,60,80,195,109,304
Bihar,Patna,Autism Spectrum Disorder,80,100,13,3,16
Punjab,Patiala,Autism Spectrum Disorder,0,6,4,0,4
Punjab,Patiala,Autism Spectrum Disorder,6,15,28,3,31
Punjab,Patiala,Autism Spectrum Disorder,15,35,9,1,10
Punjab,Patiala,Autism Spectrum Disorder,35,60,7,3,10
Punjab,Pathankot,Autism Spectrum Disorder,0,6,3,2,5
Punjab,Pathankot,Autism Spectrum Disorder,6,15,10,1,11
Punjab,Pathankot,Autism Spectrum Disorder,15,35,1,0,1
Punjab,Pathankot,Autism Spectrum Disorder,60,80,1,0,1
Kerala,Pathanamthitta,Autism Spectrum Disorder,0,6,3,2,5
Kerala,Pathanamthitta,Autism Spectrum Disorder,6,15,37,9,46
Kerala,Pathanamthitta,Autism Spectrum Disorder,15,35,25,4,29
Kerala,Pathanamthitta,Autism Spectrum Disorder,35,60,1,0,1
Gujarat,Patan,Autism Spectrum Disorder,0,6,5,4,9
Gujarat,Patan,Autism Spectrum Disorder,6,15,5,2,7
Gujarat,Patan,Autism Spectrum Disorder,15,35,2,0,2
Bihar,Pashchim Champaran,Autism Spectrum Disorder,0,6,5,0,5
Bihar,Pashchim Champaran,Autism Spectrum Disorder,6,15,339,190,529
Bihar,Pashchim Champaran,Autism Spectrum Disorder,15,35,1136,558,1694
Bihar,Pashchim Champaran,Autism Spectrum Disorder,35,60,1444,1018,2462
Bihar,Pashchim Champaran,Autism Spectrum Disorder,60,80,351,222,573
Bihar,Pashchim Champaran,Autism Spectrum Disorder,80,100,6,3,9
Maharashtra,Parbhani,Autism Spectrum Disorder,0,6,1,0,1
Maharashtra,Parbhani,Autism Spectrum Disorder,6,15,6,0,6
Maharashtra,Parbhani,Autism Spectrum Disorder,15,35,3,2,5
Maharashtra,Parbhani,Autism Spectrum Disorder,35,60,2,2,4
Maharashtra,Parbhani,Autism Spectrum Disorder,60,80,1,0,1
Arunachal Pradesh,Papum Pare,Autism Spectrum Disorder,0,6,3,3,6
Arunachal Pradesh,Papum Pare,Autism Spectrum Disorder,6,15,6,2,8
Madhya Pradesh,Panna,Autism Spectrum Disorder,6,15,2,0,2
Madhya Pradesh,Panna,Autism Spectrum Disorder,15,35,6,2,8
Madhya Pradesh,Panna,Autism Spectrum Disorder,35,60,2,1,3
Haryana,Panipat,Autism Spectrum Disorder,6,15,0,1,1
Haryana,Panipat,Autism Spectrum Disorder,15,35,1,1,2
Haryana,Panchkula,Autism Spectrum Disorder,0,6,2,3,5
Haryana,Panchkula,Autism Spectrum Disorder,6,15,17,2,19
Haryana,Panchkula,Autism Spectrum Disorder,15,35,12,0,12
Haryana,Panchkula,Autism Spectrum Disorder,60,80,0,1,1
Gujarat,Panch Mahals,Autism Spectrum Disorder,0,6,2,0,2
Haryana,Palwal,Autism Spectrum Disorder,6,15,3,1,4
Haryana,Palwal,Autism Spectrum Disorder,15,35,1,0,1
Rajasthan,Pali,Autism Spectrum Disorder,6,15,5,5,10
Rajasthan,Pali,Autism Spectrum Disorder,15,35,27,14,41
Rajasthan,Pali,Autism Spectrum Disorder,35,60,11,6,17
Rajasthan,Pali,Autism Spectrum Disorder,60,80,2,1,3
Maharashtra,Palghar,Autism Spectrum Disorder,0,6,5,1,6
Maharashtra,Palghar,Autism Spectrum Disorder,6,15,26,4,30
Maharashtra,Palghar,Autism Spectrum Disorder,15,35,4,2,6
Maharashtra,Palghar,Autism Spectrum Disorder,35,60,0,1,1
Jharkhand,Palamu,Autism Spectrum Disorder,15,35,1,3,4
Jharkhand,Palamu,Autism Spectrum Disorder,35,60,1,0,1
Kerala,Palakkad,Autism Spectrum Disorder,0,6,17,4,21
Kerala,Palakkad,Autism Spectrum Disorder,6,15,66,20,86
Kerala,Palakkad,Autism Spectrum Disorder,15,35,37,11,48
Kerala,Palakkad,Autism Spectrum Disorder,35,60,2,0,2
Jharkhand,Pakur,Autism Spectrum Disorder,6,15,0,1,1
Jharkhand,Pakur,Autism Spectrum Disorder,35,60,1,0,1
Maharashtra,Osmanabad,Autism Spectrum Disorder,0,6,1,0,1
Maharashtra,Osmanabad,Autism Spectrum Disorder,6,15,3,2,5
Maharashtra,Osmanabad,Autism Spectrum Disorder,15,35,1,1,2
Maharashtra,Osmanabad,Autism Spectrum Disorder,35,60,1,2,3
Haryana,Nuh,Autism Spectrum Disorder,6,15,9,0,9
Haryana,Nuh,Autism Spectrum Disorder,15,35,5,2,7
Odisha,Nuapada,Autism Spectrum Disorder,15,35,1,0,1
Delhi,North West,Autism Spectrum Disorder,0,6,9,4,13
Delhi,North West,Autism Spectrum Disorder,6,15,39,4,43
Delhi,North West,Autism Spectrum Disorder,15,35,9,1,10
Tripura,North Tripura,Autism Spectrum Disorder,0,6,1,1,2
Tripura,North Tripura,Autism Spectrum Disorder,6,15,2,2,4
Tripura,North Tripura,Autism Spectrum Disorder,15,35,0,1,1
Goa,North Goa,Autism Spectrum Disorder,0,6,15,2,17
Goa,North Goa,Autism Spectrum Disorder,6,15,35,7,42
Goa,North Goa,Autism Spectrum Disorder,15,35,10,0,10
Goa,North Goa,Autism Spectrum Disorder,35,60,1,1,2
Meghalaya,North Garo Hills,Autism Spectrum Disorder,6,15,0,1,1
Meghalaya,North Garo Hills,Autism Spectrum Disorder,15,35,1,0,1
Delhi,North East,Autism Spectrum Disorder,0,6,4,0,4
Delhi,North East,Autism Spectrum Disorder,6,15,5,2,7
Delhi,North East,Autism Spectrum Disorder,15,35,1,0,1
Andaman And Nicobar Islands,North And Middle Andaman,Autism Spectrum Disorder,0,6,0,3,3
Andaman And Nicobar Islands,North And Middle Andaman,Autism Spectrum Disorder,6,15,5,3,8
Andaman And Nicobar Islands,North And Middle Andaman,Autism Spectrum Disorder,15,35,1,0,1
Delhi,North,Autism Spectrum Disorder,0,6,1,0,1
Delhi,North,Autism Spectrum Disorder,6,15,12,3,15
Delhi,North,Autism Spectrum Disorder,15,35,3,0,3
Delhi,North,Autism Spectrum Disorder,35,60,1,0,1
Madhya Pradesh,Niwari,Autism Spectrum Disorder,6,15,1,1,2
Madhya Pradesh,Niwari,Autism Spectrum Disorder,15,35,18,4,22
Madhya Pradesh,Niwari,Autism Spectrum Disorder,35,60,30,5,35
Madhya Pradesh,Niwari,Autism Spectrum Disorder,60,80,2,1,3
Delhi,New Delhi,Autism Spectrum Disorder,6,15,9,1,10
Delhi,New Delhi,Autism Spectrum Disorder,15,35,5,1,6
Madhya Pradesh,Neemuch,Autism Spectrum Disorder,35,60,2,0,2
Odisha,Nayagarh,Autism Spectrum Disorder,0,6,3,2,5
Odisha,Nayagarh,Autism Spectrum Disorder,6,15,3,0,3
Odisha,Nayagarh,Autism Spectrum Disorder,15,35,1,2,3
Odisha,Nayagarh,Autism Spectrum Disorder,35,60,1,1,2
Odisha,Nayagarh,Autism Spectrum Disorder,60,80,2,0,2
Bihar,Nawada,Autism Spectrum Disorder,0,6,3,2,5
Bihar,Nawada,Autism Spectrum Disorder,6,15,196,121,317
Bihar,Nawada,Autism Spectrum Disorder,15,35,482,324,806
Bihar,Nawada,Autism Spectrum Disorder,35,60,679,479,1158
Bihar,Nawada,Autism Spectrum Disorder,60,80,332,164,496
Bihar,Nawada,Autism Spectrum Disorder,80,100,22,5,27
Gujarat,Navsari,Autism Spectrum Disorder,0,6,1,0,1
Gujarat,Navsari,Autism Spectrum Disorder,6,15,1,0,1
Maharashtra,Nashik,Autism Spectrum Disorder,0,6,13,0,13
Maharashtra,Nashik,Autism Spectrum Disorder,6,15,10,2,12
Maharashtra,Nashik,Autism Spectrum Disorder,15,35,4,1,5
Madhya Pradesh,Narsinghpur,Autism Spectrum Disorder,6,15,4,1,5
Madhya Pradesh,Narsinghpur,Autism Spectrum Disorder,15,35,22,15,37
Madhya Pradesh,Narsinghpur,Autism Spectrum Disorder,35,60,33,10,43
Madhya Pradesh,Narsinghpur,Autism Spectrum Disorder,60,80,10,5,15
Madhya Pradesh,Narmadapuram,Autism Spectrum Disorder,6,15,2,1,3
Madhya Pradesh,Narmadapuram,Autism Spectrum Disorder,15,35,5,5,10
Madhya Pradesh,Narmadapuram,Autism Spectrum Disorder,35,60,11,4,15
Madhya Pradesh,Narmadapuram,Autism Spectrum Disorder,60,80,3,1,4
Gujarat,Narmada,Autism Spectrum Disorder,15,35,0,1,1
Maharashtra,Nandurbar,Autism Spectrum Disorder,15,35,1,0,1
Maharashtra,Nandurbar,Autism Spectrum Disorder,60,80,1,0,1
Maharashtra,Nanded,Autism Spectrum Disorder,0,6,2,2,4
Maharashtra,Nanded,Autism Spectrum Disorder,6,15,3,0,3
Maharashtra,Nanded,Autism Spectrum Disorder,15,35,4,0,4
Maharashtra,Nanded,Autism Spectrum Disorder,35,60,5,1,6
Maharashtra,Nanded,Autism Spectrum Disorder,60,80,1,0,1
Arunachal Pradesh,Namsai,Autism Spectrum Disorder,15,35,1,0,1
Sikkim,Namchi,Autism Spectrum Disorder,0,6,4,3,7
Sikkim,Namchi,Autism Spectrum Disorder,6,15,5,0,5
Sikkim,Namchi,Autism Spectrum Disorder,15,35,2,0,2
Tamil Nadu,Namakkal,Autism Spectrum Disorder,0,6,3,0,3
Tamil Nadu,Namakkal,Autism Spectrum Disorder,6,15,15,3,18
Tamil Nadu,Namakkal,Autism Spectrum Disorder,15,35,4,0,4
Tamil Nadu,Namakkal,Autism Spectrum Disorder,35,60,1,1,2
Tamil Nadu,Namakkal,Autism Spectrum Disorder,60,80,2,0,2
Assam,Nalbari,Autism Spectrum Disorder,0,6,2,1,3
Assam,Nalbari,Autism Spectrum Disorder,6,15,4,1,5
Assam,Nalbari,Autism Spectrum Disorder,15,35,1,0,1
Assam,Nalbari,Autism Spectrum Disorder,35,60,2,0,2
Bihar,Nalanda,Autism Spectrum Disorder,0,6,4,3,7
Bihar,Nalanda,Autism Spectrum Disorder,6,15,196,139,335
Bihar,Nalanda,Autism Spectrum Disorder,15,35,412,220,632
Bihar,Nalanda,Autism Spectrum Disorder,35,60,409,250,659
Bihar,Nalanda,Autism Spectrum Disorder,60,80,158,68,226
Bihar,Nalanda,Autism Spectrum Disorder,80,100,7,2,9
Uttarakhand,Nainital,Autism Spectrum Disorder,0,6,4,1,5
Uttarakhand,Nainital,Autism Spectrum Disorder,6,15,11,3,14
Uttarakhand,Nainital,Autism Spectrum Disorder,15,35,4,2,6
Uttarakhand,Nainital,Autism Spectrum Disorder,35,60,1,0,1
Maharashtra,Nagpur,Autism Spectrum Disorder,0,6,23,6,29
Maharashtra,Nagpur,Autism Spectrum Disorder,6,15,107,32,139
Maharashtra,Nagpur,Autism Spectrum Disorder,15,35,43,7,50
Maharashtra,Nagpur,Autism Spectrum Disorder,35,60,2,0,2
Rajasthan,Nagaur,Autism Spectrum Disorder,0,6,1,0,1
Rajasthan,Nagaur,Autism Spectrum Disorder,6,15,105,65,170
Rajasthan,Nagaur,Autism Spectrum Disorder,15,35,581,285,866
Rajasthan,Nagaur,Autism Spectrum Disorder,35,60,257,92,349
Rajasthan,Nagaur,Autism Spectrum Disorder,60,80,30,8,38
Rajasthan,Nagaur,Autism Spectrum Disorder,80,100,1,0,1
Tamil Nadu,Nagapattinam,Autism Spectrum Disorder,0,6,1,0,1
Tamil Nadu,Nagapattinam,Autism Spectrum Disorder,6,15,7,0,7
Tamil Nadu,Nagapattinam,Autism Spectrum Disorder,15,35,3,2,5
Tamil Nadu,Nagapattinam,Autism Spectrum Disorder,35,60,2,1,3
Tamil Nadu,Nagapattinam,Autism Spectrum Disorder,60,80,1,0,1
Assam,Nagaon,Autism Spectrum Disorder,6,15,5,4,9
Assam,Nagaon,Autism Spectrum Disorder,15,35,1,2,3
Odisha,Nabarangpur,Autism Spectrum Disorder,0,6,1,1,2
Odisha,Nabarangpur,Autism Spectrum Disorder,6,15,1,1,2
Odisha,Nabarangpur,Autism Spectrum Disorder,35,60,1,0,1
Karnataka,Mysuru,Autism Spectrum Disorder,0,6,3,4,7
Karnataka,Mysuru,Autism Spectrum Disorder,6,15,2,0,2
Karnataka,Mysuru,Autism Spectrum Disorder,15,35,7,1,8
Karnataka,Mysuru,Autism Spectrum Disorder,35,60,4,1,5
Karnataka,Mysuru,Autism Spectrum Disorder,60,80,1,1,2
Bihar,Muzaffarpur,Autism Spectrum Disorder,0,6,5,4,9
Bihar,Muzaffarpur,Autism Spectrum Disorder,6,15,238,110,348
Bihar,Muzaffarpur,Autism Spectrum Disorder,15,35,591,275,866
Bihar,Muzaffarpur,Autism Spectrum Disorder,35,60,465,186,651
Bihar,Muzaffarpur,Autism Spectrum Disorder,60,80,109,48,157
Bihar,Muzaffarpur,Autism Spectrum Disorder,80,100,2,1,3
Uttar Pradesh,Muzaffarnagar,Autism Spectrum Disorder,0,6,2,0,2
Uttar Pradesh,Muzaffarnagar,Autism Spectrum Disorder,15,35,5,3,8
Uttar Pradesh,Muzaffarnagar,Autism Spectrum Disorder,35,60,2,1,3
Uttar Pradesh,Muzaffarnagar,Autism Spectrum Disorder,60,80,2,0,2
Bihar,Munger,Autism Spectrum Disorder,0,6,2,3,5
Bihar,Munger,Autism Spectrum Disorder,6,15,99,61,160
Bihar,Munger,Autism Spectrum Disorder,15,35,473,228,701
Bihar,Munger,Autism Spectrum Disorder,35,60,391,213,604
Bihar,Munger,Autism Spectrum Disorder,60,80,144,51,195
Bihar,Munger,Autism Spectrum Disorder,80,100,2,0,2
Maharashtra,Mumbai Suburban,Autism Spectrum Disorder,0,6,11,1,12
Maharashtra,Mumbai Suburban,Autism Spectrum Disorder,6,15,39,9,48
Maharashtra,Mumbai Suburban,Autism Spectrum Disorder,15,35,48,10,58
Maharashtra,Mumbai Suburban,Autism Spectrum Disorder,35,60,2,0,2
Maharashtra,Mumbai,Autism Spectrum Disorder,0,6,43,11,54
Maharashtra,Mumbai,Autism Spectrum Disorder,6,15,83,17,100
Maharashtra,Mumbai,Autism Spectrum Disorder,15,35,60,6,66
Maharashtra,Mumbai,Autism Spectrum Disorder,35,60,3,1,4
Madhya Pradesh,Morena,Autism Spectrum Disorder,0,6,2,1,3
Madhya Pradesh,Morena,Autism Spectrum Disorder,6,15,2,1,3
Madhya Pradesh,Morena,Autism Spectrum Disorder,15,35,2,1,3
Madhya Pradesh,Morena,Autism Spectrum Disorder,60,80,1,0,1
Gujarat,Morbi,Autism Spectrum Disorder,6,15,1,0,1
Uttar Pradesh,Moradabad,Autism Spectrum Disorder,6,15,2,1,3
Uttar Pradesh,Moradabad,Autism Spectrum Disorder,15,35,0,1,1
Uttar Pradesh,Moradabad,Autism Spectrum Disorder,35,60,2,1,3
Uttar Pradesh,Moradabad,Autism Spectrum Disorder,60,80,1,0,1
Nagaland,Mokokchung,Autism Spectrum Disorder,0,6,1,0,1
Nagaland,Mokokchung,Autism Spectrum Disorder,6,15,1,0,1
Punjab,Moga,Autism Spectrum Disorder,15,35,2,1,3
Punjab,Moga,Autism Spectrum Disorder,60,80,2,0,2
Uttar Pradesh,Mirzapur,Autism Spectrum Disorder,0,6,1,0,1
Uttar Pradesh,Mirzapur,Autism Spectrum Disorder,6,15,5,0,5
Uttar Pradesh,Mirzapur,Autism Spectrum Disorder,15,35,6,1,7
Uttar Pradesh,Mirzapur,Autism Spectrum Disorder,35,60,8,1,9
Uttar Pradesh,Mirzapur,Autism Spectrum Disorder,60,80,1,1,2
Uttar Pradesh,Meerut,Autism Spectrum Disorder,0,6,1,2,3
Uttar Pradesh,Meerut,Autism Spectrum Disorder,6,15,7,0,7
Uttar Pradesh,Meerut,Autism Spectrum Disorder,15,35,4,0,4
Uttar Pradesh,Meerut,Autism Spectrum Disorder,35,60,2,0,2
Odisha,Mayurbhanj,Autism Spectrum Disorder,0,6,2,1,3
Odisha,Mayurbhanj,Autism Spectrum Disorder,6,15,1,2,3
Odisha,Mayurbhanj,Autism Spectrum Disorder,15,35,0,1,1
Tamil Nadu,Mayiladuthurai,Autism Spectrum Disorder,6,15,3,0,3
Uttar Pradesh,Mau,Autism Spectrum Disorder,15,35,2,1,3
Uttar Pradesh,Mau,Autism Spectrum Disorder,35,60,1,0,1
Uttar Pradesh,Mathura,Autism Spectrum Disorder,15,35,1,0,1
Assam,Marigaon,Autism Spectrum Disorder,6,15,2,0,2
Assam,Marigaon,Autism Spectrum Disorder,15,35,0,2,2
Punjab,Mansa,Autism Spectrum Disorder,15,35,1,2,3
Punjab,Mansa,Autism Spectrum Disorder,35,60,3,0,3
Punjab,Mansa,Autism Spectrum Disorder,60,80,4,0,4
Sikkim,Mangan,Autism Spectrum Disorder,6,15,1,0,1
Karnataka,Mandya,Autism Spectrum Disorder,0,6,2,2,4
Karnataka,Mandya,Autism Spectrum Disorder,6,15,4,2,6
Karnataka,Mandya,Autism Spectrum Disorder,15,35,3,2,5
Karnataka,Mandya,Autism Spectrum Disorder,35,60,3,1,4
Karnataka,Mandya,Autism Spectrum Disorder,60,80,1,0,1
Madhya Pradesh,Mandla,Autism Spectrum Disorder,6,15,2,0,2
Madhya Pradesh,Mandla,Autism Spectrum Disorder,15,35,5,3,8
Madhya Pradesh,Mandla,Autism Spectrum Disorder,35,60,6,4,10
Madhya Pradesh,Mandla,Autism Spectrum Disorder,60,80,1,0,1
Himachal Pradesh,Mandi,Autism Spectrum Disorder,0,6,2,0,2
Himachal Pradesh,Mandi,Autism Spectrum Disorder,6,15,2,2,4
Himachal Pradesh,Mandi,Autism Spectrum Disorder,15,35,6,2,8
Himachal Pradesh,Mandi,Autism Spectrum Disorder,35,60,4,2,6
Himachal Pradesh,Mandi,Autism Spectrum Disorder,60,80,1,0,1
Odisha,Malkangiri,Autism Spectrum Disorder,0,6,1,0,1
Odisha,Malkangiri,Autism Spectrum Disorder,6,15,1,0,1
Odisha,Malkangiri,Autism Spectrum Disorder,35,60,0,1,1
Kerala,Malappuram,Autism Spectrum Disorder,0,6,12,2,14
Kerala,Malappuram,Autism Spectrum Disorder,6,15,57,16,73
Kerala,Malappuram,Autism Spectrum Disorder,15,35,19,6,25
Kerala,Malappuram,Autism Spectrum Disorder,35,60,4,2,6
Kerala,Malappuram,Autism Spectrum Disorder,60,80,0,1,1
Assam,Majuli,Autism Spectrum Disorder,6,15,1,0,1
Assam,Majuli,Autism Spectrum Disorder,15,35,0,1,1
Uttar Pradesh,Mainpuri,Autism Spectrum Disorder,15,35,3,3,6
Uttar Pradesh,Mainpuri,Autism Spectrum Disorder,35,60,8,0,8
Uttar Pradesh,Mainpuri,Autism Spectrum Disorder,60,80,1,0,1
Uttar Pradesh,Mahoba,Autism Spectrum Disorder,15,35,4,2,6
Uttar Pradesh,Mahoba,Autism Spectrum Disorder,35,60,12,4,16
Uttar Pradesh,Mahoba,Autism Spectrum Disorder,60,80,3,1,4
Uttar Pradesh,Mahoba,Autism Spectrum Disorder,80,100,1,0,1
Gujarat,Mahesana,Autism Spectrum Disorder,0,6,4,0,4
Gujarat,Mahesana,Autism Spectrum Disorder,6,15,7,1,8
Haryana,Mahendragarh,Autism Spectrum Disorder,35,60,0,1,1
Puducherry,Mahe,Autism Spectrum Disorder,6,15,2,0,2
Chhattisgarh,Mahasamund,Autism Spectrum Disorder,0,6,1,0,1
Chhattisgarh,Mahasamund,Autism Spectrum Disorder,6,15,0,1,1
Chhattisgarh,Mahasamund,Autism Spectrum Disorder,15,35,0,1,1
Chhattisgarh,Mahasamund,Autism Spectrum Disorder,35,60,0,2,2
Uttar Pradesh,Maharajganj,Autism Spectrum Disorder,35,60,2,2,4
Uttar Pradesh,Maharajganj,Autism Spectrum Disorder,60,80,2,0,2
Tamil Nadu,Madurai,Autism Spectrum Disorder,0,6,1,1,2
Tamil Nadu,Madurai,Autism Spectrum Disorder,6,15,43,9,52
Tamil Nadu,Madurai,Autism Spectrum Disorder,15,35,18,3,21
Tamil Nadu,Madurai,Autism Spectrum Disorder,35,60,2,0,2
Tamil Nadu,Madurai,Autism Spectrum Disorder,60,80,1,0,1
Bihar,Madhubani,Autism Spectrum Disorder,0,6,4,3,7
Bihar,Madhubani,Autism Spectrum Disorder,6,15,224,150,374
Bihar,Madhubani,Autism Spectrum Disorder,15,35,968,515,1483
Bihar,Madhubani,Autism Spectrum Disorder,35,60,855,421,1276
Bihar,Madhubani,Autism Spectrum Disorder,60,80,259,103,362
Bihar,Madhubani,Autism Spectrum Disorder,80,100,11,4,15
Bihar,Madhepura,Autism Spectrum Disorder,0,6,4,0,4
Bihar,Madhepura,Autism Spectrum Disorder,6,15,112,59,171
Bihar,Madhepura,Autism Spectrum Disorder,15,35,275,152,427
Bihar,Madhepura,Autism Spectrum Disorder,35,60,246,157,403
Bihar,Madhepura,Autism Spectrum Disorder,60,80,87,38,125
Bihar,Madhepura,Autism Spectrum Disorder,80,100,2,3,5
Mizoram,Lunglei,Autism Spectrum Disorder,6,15,0,1,1
Punjab,Ludhiana,Autism Spectrum Disorder,0,6,1,1,2
Punjab,Ludhiana,Autism Spectrum Disorder,6,15,3,4,7
Punjab,Ludhiana,Autism Spectrum Disorder,15,35,13,3,16
Punjab,Ludhiana,Autism Spectrum Disorder,35,60,30,15,45
Punjab,Ludhiana,Autism Spectrum Disorder,60,80,9,5,14
Uttar Pradesh,Lucknow,Autism Spectrum Disorder,0,6,15,6,21
Uttar Pradesh,Lucknow,Autism Spectrum Disorder,6,15,40,13,53
Uttar Pradesh,Lucknow,Autism Spectrum Disorder,15,35,51,15,66
Uttar Pradesh,Lucknow,Autism Spectrum Disorder,35,60,19,2,21
Uttar Pradesh,Lucknow,Autism Spectrum Disorder,60,80,3,0,3
Arunachal Pradesh,Longding,Autism Spectrum Disorder,6,15,2,0,2
Jharkhand,Lohardaga,Autism Spectrum Disorder,6,15,1,0,1
Jharkhand,Lohardaga,Autism Spectrum Disorder,15,35,0,2,2
Jharkhand,Lohardaga,Autism Spectrum Disorder,35,60,1,0,1
Ladakh,Leh Ladakh,Autism Spectrum Disorder,6,15,1,0,1
Ladakh,Leh Ladakh,Autism Spectrum Disorder,15,35,0,1,1
Maharashtra,Latur,Autism Spectrum Disorder,0,6,1,0,1
Maharashtra,Latur,Autism Spectrum Disorder,6,15,2,0,2
Maharashtra,Latur,Autism Spectrum Disorder,15,35,6,2,8
Maharashtra,Latur,Autism Spectrum Disorder,35,60,3,0,3
Jharkhand,Latehar,Autism Spectrum Disorder,15,35,1,0,1
Jharkhand,Latehar,Autism Spectrum Disorder,35,60,1,0,1
Uttar Pradesh,Lalitpur,Autism Spectrum Disorder,15,35,9,1,10
Uttar Pradesh,Lalitpur,Autism Spectrum Disorder,35,60,2,0,2
Uttar Pradesh,Lalitpur,Autism Spectrum Disorder,60,80,0,1,1
Lakshadweep,Lakshadweep District,Autism Spectrum Disorder,6,15,2,0,2
Bihar,Lakhisarai,Autism Spectrum Disorder,0,6,1,0,1
Bihar,Lakhisarai,Autism Spectrum Disorder,6,15,44,24,68
Bihar,Lakhisarai,Autism Spectrum Disorder,15,35,148,89,237
Bihar,Lakhisarai,Autism Spectrum Disorder,35,60,223,97,320
Bihar,Lakhisarai,Autism Spectrum Disorder,60,80,109,54,163
Bihar,Lakhisarai,Autism Spectrum Disorder,80,100,11,0,11
Assam,Lakhimpur,Autism Spectrum Disorder,0,6,1,0,1
Assam,Lakhimpur,Autism Spectrum Disorder,6,15,2,0,2
Assam,Lakhimpur,Autism Spectrum Disorder,15,35,1,0,1
Assam,Lakhimpur,Autism Spectrum Disorder,60,80,1,0,1
Uttar Pradesh,Kushi Nagar,Autism Spectrum Disorder,6,15,2,0,2
Uttar Pradesh,Kushi Nagar,Autism Spectrum Disorder,15,35,4,2,6
Uttar Pradesh,Kushi Nagar,Autism Spectrum Disorder,35,60,5,1,6
Uttar Pradesh,Kushi Nagar,Autism Spectrum Disorder,60,80,1,0,1
Andhra Pradesh,Kurnool,Autism Spectrum Disorder,35,60,1,0,1
Jammu And Kashmir,Kupwara,Autism Spectrum Disorder,0,6,4,0,4
Jammu And Kashmir,Kupwara,Autism Spectrum Disorder,6,15,3,0,3
Jammu And Kashmir,Kupwara,Autism Spectrum Disorder,15,35,5,4,9
Jammu And Kashmir,Kupwara,Autism Spectrum Disorder,35,60,0,2,2
Himachal Pradesh,Kullu,Autism Spectrum Disorder,0,6,1,0,1
Himachal Pradesh,Kullu,Autism Spectrum Disorder,6,15,2,3,5
Himachal Pradesh,Kullu,Autism Spectrum Disorder,15,35,1,0,1
Himachal Pradesh,Kullu,Autism Spectrum Disorder,35,60,0,1,1
Jammu And Kashmir,Kulgam,Autism Spectrum Disorder,0,6,2,0,2
Jammu And Kashmir,Kulgam,Autism Spectrum Disorder,15,35,1,0,1
Tamil Nadu,Krishnagiri,Autism Spectrum Disorder,0,6,4,2,6
Tamil Nadu,Krishnagiri,Autism Spectrum Disorder,6,15,25,6,31
Tamil Nadu,Krishnagiri,Autism Spectrum Disorder,15,35,7,4,11
Tamil Nadu,Krishnagiri,Autism Spectrum Disorder,35,60,3,6,9
Tamil Nadu,Krishnagiri,Autism Spectrum Disorder,60,80,1,2,3
Andhra Pradesh,Krishna,Autism Spectrum Disorder,15,35,2,0,2
Kerala,Kozhikode,Autism Spectrum Disorder,0,6,10,5,15
Kerala,Kozhikode,Autism Spectrum Disorder,6,15,56,13,69
Kerala,Kozhikode,Autism Spectrum Disorder,15,35,22,16,38
Kerala,Kozhikode,Autism Spectrum Disorder,35,60,0,1,1
Kerala,Kottayam,Autism Spectrum Disorder,0,6,18,4,22
Kerala,Kottayam,Autism Spectrum Disorder,6,15,136,21,157
Kerala,Kottayam,Autism Spectrum Disorder,15,35,78,34,112
Kerala,Kottayam,Autism Spectrum Disorder,35,60,3,3,6
Rajasthan,Kota,Autism Spectrum Disorder,6,15,9,6,15
Rajasthan,Kota,Autism Spectrum Disorder,15,35,50,29,79
Rajasthan,Kota,Autism Spectrum Disorder,35,60,20,13,33
Rajasthan,Kota,Autism Spectrum Disorder,60,80,2,1,3
Chhattisgarh,Korea,Autism Spectrum Disorder,0,6,1,0,1
Chhattisgarh,Korea,Autism Spectrum Disorder,6,15,2,3,5
Chhattisgarh,Korea,Autism Spectrum Disorder,15,35,1,0,1
Chhattisgarh,Korba,Autism Spectrum Disorder,6,15,1,0,1
Chhattisgarh,Korba,Autism Spectrum Disorder,15,35,1,1,2
Chhattisgarh,Korba,Autism Spectrum Disorder,35,60,1,0,1
Odisha,Koraput,Autism Spectrum Disorder,6,15,14,4,18
Odisha,Koraput,Autism Spectrum Disorder,15,35,6,4,10
Odisha,Koraput,Autism Spectrum Disorder,35,60,0,1,1
Karnataka,Koppal,Autism Spectrum Disorder,6,15,0,1,1
Karnataka,Koppal,Autism Spectrum Disorder,15,35,2,1,3
Karnataka,Koppal,Autism Spectrum Disorder,35,60,3,1,4
Chhattisgarh,Kondagaon,Autism Spectrum Disorder,0,6,1,0,1
Chhattisgarh,Kondagaon,Autism Spectrum Disorder,6,15,3,1,4
Chhattisgarh,Kondagaon,Autism Spectrum Disorder,15,35,1,0,1
Kerala,Kollam,Autism Spectrum Disorder,0,6,12,5,17
Kerala,Kollam,Autism Spectrum Disorder,6,15,70,27,97
Kerala,Kollam,Autism Spectrum Disorder,15,35,34,8,42
Kerala,Kollam,Autism Spectrum Disorder,35,60,1,2,3
Maharashtra,Kolhapur,Autism Spectrum Disorder,0,6,2,0,2
Maharashtra,Kolhapur,Autism Spectrum Disorder,6,15,20,5,25
Maharashtra,Kolhapur,Autism Spectrum Disorder,15,35,5,0,5
Maharashtra,Kolhapur,Autism Spectrum Disorder,35,60,1,1,2
Maharashtra,Kolhapur,Autism Spectrum Disorder,60,80,1,0,1
Mizoram,Kolasib,Autism Spectrum Disorder,0,6,2,1,3
Karnataka,Kolar,Autism Spectrum Disorder,0,6,1,0,1
Karnataka,Kolar,Autism Spectrum Disorder,6,15,6,1,7
Karnataka,Kolar,Autism Spectrum Disorder,15,35,2,0,2
Karnataka,Kolar,Autism Spectrum Disorder,35,60,1,1,2
Karnataka,Kolar,Autism Spectrum Disorder,60,80,1,0,1
Assam,Kokrajhar,Autism Spectrum Disorder,0,6,0,1,1
Assam,Kokrajhar,Autism Spectrum Disorder,6,15,1,0,1
Assam,Kokrajhar,Autism Spectrum Disorder,15,35,1,0,1
Nagaland,Kohima,Autism Spectrum Disorder,0,6,1,2,3
Nagaland,Kohima,Autism Spectrum Disorder,6,15,11,0,11
Nagaland,Kohima,Autism Spectrum Disorder,15,35,2,0,2
Nagaland,Kohima,Autism Spectrum Disorder,35,60,1,0,1
Jharkhand,Koderma,Autism Spectrum Disorder,6,15,1,0,1
Jharkhand,Koderma,Autism Spectrum Disorder,15,35,5,1,6
Jharkhand,Koderma,Autism Spectrum Disorder,35,60,3,0,3
Jharkhand,Koderma,Autism Spectrum Disorder,60,80,1,0,1
Karnataka,Kodagu,Autism Spectrum Disorder,6,15,1,0,1
Karnataka,Kodagu,Autism Spectrum Disorder,60,80,1,0,1
Jammu And Kashmir,Kishtwar,Autism Spectrum Disorder,0,6,1,0,1
Jammu And Kashmir,Kishtwar,Autism Spectrum Disorder,6,15,0,1,1
Jammu And Kashmir,Kishtwar,Autism Spectrum Disorder,15,35,0,1,1
Jammu And Kashmir,Kishtwar,Autism Spectrum Disorder,35,60,1,0,1
Bihar,Kishanganj,Autism Spectrum Disorder,0,6,10,6,16
Bihar,Kishanganj,Autism Spectrum Disorder,6,15,162,80,242
Bihar,Kishanganj,Autism Spectrum Disorder,15,35,325,272,597
Bihar,Kishanganj,Autism Spectrum Disorder,35,60,292,110,402
Bihar,Kishanganj,Autism Spectrum Disorder,60,80,80,22,102
Bihar,Kishanganj,Autism Spectrum Disorder,80,100,1,1,2
Jharkhand,Khunti,Autism Spectrum Disorder,6,15,0,1,1
Jharkhand,Khunti,Autism Spectrum Disorder,15,35,3,1,4
Jharkhand,Khunti,Autism Spectrum Disorder,35,60,1,0,1
Tripura,Khowai,Autism Spectrum Disorder,0,6,0,1,1
Tripura,Khowai,Autism Spectrum Disorder,6,15,2,0,2
Odisha,Khordha,Autism Spectrum Disorder,0,6,38,7,45
Odisha,Khordha,Autism Spectrum Disorder,6,15,178,29,207
Odisha,Khordha,Autism Spectrum Disorder,15,35,84,13,97
Odisha,Khordha,Autism Spectrum Disorder,35,60,3,1,4
Odisha,Khordha,Autism Spectrum Disorder,60,80,0,1,1
Uttar Pradesh,Kheri,Autism Spectrum Disorder,15,35,35,8,43
Uttar Pradesh,Kheri,Autism Spectrum Disorder,35,60,41,6,47
Uttar Pradesh,Kheri,Autism Spectrum Disorder,60,80,10,0,10
Gujarat,Kheda,Autism Spectrum Disorder,0,6,8,1,9
Gujarat,Kheda,Autism Spectrum Disorder,6,15,11,0,11
Gujarat,Kheda,Autism Spectrum Disorder,15,35,2,1,3
Madhya Pradesh,Khargone,Autism Spectrum Disorder,6,15,3,0,3
Madhya Pradesh,Khargone,Autism Spectrum Disorder,15,35,5,4,9
Madhya Pradesh,Khargone,Autism Spectrum Disorder,35,60,6,1,7
Madhya Pradesh,Khargone,Autism Spectrum Disorder,60,80,1,1,2
Telangana,Khammam,Autism Spectrum Disorder,6,15,1,0,1
Bihar,Khagaria,Autism Spectrum Disorder,6,15,75,59,134
Bihar,Khagaria,Autism Spectrum Disorder,15,35,265,151,416
Bihar,Khagaria,Autism Spectrum Disorder,35,60,255,121,376
Bihar,Khagaria,Autism Spectrum Disorder,60,80,84,39,123
Bihar,Khagaria,Autism Spectrum Disorder,80,100,5,1,6
Odisha,Kendujhar,Autism Spectrum Disorder,0,6,0,1,1
Odisha,Kendujhar,Autism Spectrum Disorder,6,15,2,0,2
Odisha,Kendrapara,Autism Spectrum Disorder,0,6,6,1,7
Odisha,Kendrapara,Autism Spectrum Disorder,6,15,9,4,13
Odisha,Kendrapara,Autism Spectrum Disorder,15,35,0,2,2
Odisha,Kendrapara,Autism Spectrum Disorder,35,60,0,1,1
Odisha,Kendrapara,Autism Spectrum Disorder,60,80,1,0,1
Uttar Pradesh,Kaushambi,Autism Spectrum Disorder,0,6,1,0,1
Uttar Pradesh,Kaushambi,Autism Spectrum Disorder,15,35,3,1,4
Uttar Pradesh,Kaushambi,Autism Spectrum Disorder,35,60,4,2,6
Madhya Pradesh,Katni,Autism Spectrum Disorder,6,15,1,0,1
Madhya Pradesh,Katni,Autism Spectrum Disorder,15,35,5,1,6
Madhya Pradesh,Katni,Autism Spectrum Disorder,35,60,3,2,5
Madhya Pradesh,Katni,Autism Spectrum Disorder,60,80,2,2,4
Madhya Pradesh,Katni,Autism Spectrum Disorder,80,100,1,0,1
Bihar,Katihar,Autism Spectrum Disorder,0,6,3,0,3
Bihar,Katihar,Autism Spectrum Disorder,6,15,188,144,332
Bihar,Katihar,Autism Spectrum Disorder,15,35,422,265,687
Bihar,Katihar,Autism Spectrum Disorder,35,60,494,340,834
Bihar,Katihar,Autism Spectrum Disorder,60,80,190,80,270
Bihar,Katihar,Autism Spectrum Disorder,80,100,12,3,15
Jammu And Kashmir,Kathua,Autism Spectrum Disorder,0,6,1,0,1
Jammu And Kashmir,Kathua,Autism Spectrum Disorder,6,15,0,1,1
Jammu And Kashmir,Kathua,Autism Spectrum Disorder,15,35,3,2,5
Jammu And Kashmir,Kathua,Autism Spectrum Disorder,35,60,2,1,3
Jammu And Kashmir,Kathua,Autism Spectrum Disorder,60,80,1,1,2
Jammu And Kashmir,Kathua,Autism Spectrum Disorder,80,100,1,0,1
Uttar Pradesh,Kasganj,Autism Spectrum Disorder,15,35,4,0,4
Uttar Pradesh,Kasganj,Autism Spectrum Disorder,35,60,4,0,4
Uttar Pradesh,Kasganj,Autism Spectrum Disorder,60,80,3,0,3
Kerala,Kasaragod,Autism Spectrum Disorder,0,6,4,1,5
Kerala,Kasaragod,Autism Spectrum Disorder,6,15,5,5,10
Kerala,Kasaragod,Autism Spectrum Disorder,15,35,8,3,11
Kerala,Kasaragod,Autism Spectrum Disorder,35,60,1,0,1
Tamil Nadu,Karur,Autism Spectrum Disorder,0,6,6,0,6
Tamil Nadu,Karur,Autism Spectrum Disorder,6,15,20,4,24
Tamil Nadu,Karur,Autism Spectrum Disorder,15,35,3,2,5
Tamil Nadu,Karur,Autism Spectrum Disorder,35,60,0,1,1
Haryana,Karnal,Autism Spectrum Disorder,0,6,2,1,3
Haryana,Karnal,Autism Spectrum Disorder,6,15,5,2,7
Haryana,Karnal,Autism Spectrum Disorder,15,35,1,2,3
Assam,Karimganj,Autism Spectrum Disorder,0,6,3,1,4
Assam,Karimganj,Autism Spectrum Disorder,6,15,12,11,23
Assam,Karimganj,Autism Spectrum Disorder,15,35,9,7,16
Assam,Karimganj,Autism Spectrum Disorder,35,60,3,2,5
Assam,Karbi Anglong,Autism Spectrum Disorder,6,15,2,1,3
Assam,Karbi Anglong,Autism Spectrum Disorder,15,35,1,1,2
Assam,Karbi Anglong,Autism Spectrum Disorder,35,60,0,1,1
Rajasthan,Karauli,Autism Spectrum Disorder,6,15,3,1,4
Rajasthan,Karauli,Autism Spectrum Disorder,15,35,30,13,43
Rajasthan,Karauli,Autism Spectrum Disorder,35,60,6,1,7
Rajasthan,Karauli,Autism Spectrum Disorder,60,80,0,1,1
Puducherry,Karaikal,Autism Spectrum Disorder,6,15,1,0,1
Punjab,Kapurthala,Autism Spectrum Disorder,0,6,4,0,4
Punjab,Kapurthala,Autism Spectrum Disorder,6,15,0,1,1
Punjab,Kapurthala,Autism Spectrum Disorder,15,35,5,1,6
Punjab,Kapurthala,Autism Spectrum Disorder,35,60,4,1,5
Uttar Pradesh,Kanpur Nagar,Autism Spectrum Disorder,0,6,11,8,19
Uttar Pradesh,Kanpur Nagar,Autism Spectrum Disorder,6,15,23,2,25
Uttar Pradesh,Kanpur Nagar,Autism Spectrum Disorder,15,35,15,4,19
Uttar Pradesh,Kanpur Nagar,Autism Spectrum Disorder,35,60,4,1,5
Uttar Pradesh,Kanpur Nagar,Autism Spectrum Disorder,60,80,2,0,2
Uttar Pradesh,Kanpur Dehat,Autism Spectrum Disorder,6,15,2,0,2
Uttar Pradesh,Kanpur Dehat,Autism Spectrum Disorder,15,35,4,1,5
Uttar Pradesh,Kanpur Dehat,Autism Spectrum Disorder,35,60,7,3,10
Uttar Pradesh,Kanpur Dehat,Autism Spectrum Disorder,60,80,2,0,2
Kerala,Kannur,Autism Spectrum Disorder,0,6,5,1,6
Kerala,Kannur,Autism Spectrum Disorder,6,15,34,6,40
Kerala,Kannur,Autism Spectrum Disorder,15,35,19,9,28
Tamil Nadu,Kanniyakumari,Autism Spectrum Disorder,0,6,20,3,23
Tamil Nadu,Kanniyakumari,Autism Spectrum Disorder,6,15,32,6,38
Tamil Nadu,Kanniyakumari,Autism Spectrum Disorder,15,35,8,3,11
Tamil Nadu,Kanniyakumari,Autism Spectrum Disorder,35,60,0,1,1
Tamil Nadu,Kanniyakumari,Autism Spectrum Disorder,60,80,1,0,1
Uttar Pradesh,Kannauj,Autism Spectrum Disorder,15,35,1,0,1
Chhattisgarh,Kanker,Autism Spectrum Disorder,6,15,2,1,3
Chhattisgarh,Kanker,Autism Spectrum Disorder,15,35,3,3,6
Chhattisgarh,Kanker,Autism Spectrum Disorder,35,60,6,2,8
Chhattisgarh,Kanker,Autism Spectrum Disorder,60,80,2,2,4
Himachal Pradesh,Kangra,Autism Spectrum Disorder,0,6,3,0,3
Himachal Pradesh,Kangra,Autism Spectrum Disorder,6,15,6,3,9
Himachal Pradesh,Kangra,Autism Spectrum Disorder,15,35,3,1,4
Himachal Pradesh,Kangra,Autism Spectrum Disorder,35,60,5,2,7
Himachal Pradesh,Kangra,Autism Spectrum Disorder,60,80,0,1,1
Manipur,Kangpokpi,Autism Spectrum Disorder,0,6,1,0,1
Manipur,Kangpokpi,Autism Spectrum Disorder,6,15,1,0,1
Manipur,Kangpokpi,Autism Spectrum Disorder,15,35,0,1,1
Odisha,Kandhamal,Autism Spectrum Disorder,0,6,7,5,12
Odisha,Kandhamal,Autism Spectrum Disorder,6,15,7,2,9
Odisha,Kandhamal,Autism Spectrum Disorder,15,35,2,1,3
Odisha,Kandhamal,Autism Spectrum Disorder,35,60,2,0,2
Odisha,Kandhamal,Autism Spectrum Disorder,60,80,1,1,2
Tamil Nadu,Kanchipuram,Autism Spectrum Disorder,0,6,7,1,8
Tamil Nadu,Kanchipuram,Autism Spectrum Disorder,6,15,80,11,91
Tamil Nadu,Kanchipuram,Autism Spectrum Disorder,15,35,38,5,43
Tamil Nadu,Kanchipuram,Autism Spectrum Disorder,35,60,1,0,1
Assam,Kamrup Metro,Autism Spectrum Disorder,0,6,7,7,14
Assam,Kamrup Metro,Autism Spectrum Disorder,6,15,37,5,42
Assam,Kamrup Metro,Autism Spectrum Disorder,15,35,20,4,24
Assam,Kamrup,Autism Spectrum Disorder,0,6,1,1,2
Assam,Kamrup,Autism Spectrum Disorder,6,15,4,2,6
Assam,Kamrup,Autism Spectrum Disorder,15,35,2,1,3
Tamil Nadu,Kallakurichi,Autism Spectrum Disorder,0,6,1,0,1
Tamil Nadu,Kallakurichi,Autism Spectrum Disorder,6,15,1,3,4
Tamil Nadu,Kallakurichi,Autism Spectrum Disorder,15,35,1,0,1
Tamil Nadu,Kallakurichi,Autism Spectrum Disorder,60,80,2,0,2
Odisha,Kalahandi,Autism Spectrum Disorder,0,6,1,0,1
Odisha,Kalahandi,Autism Spectrum Disorder,6,15,3,0,3
Odisha,Kalahandi,Autism Spectrum Disorder,15,35,1,0,1
Odisha,Kalahandi,Autism Spectrum Disorder,35,60,1,0,1
Karnataka,Kalaburagi,Autism Spectrum Disorder,6,15,1,1,2
Karnataka,Kalaburagi,Autism Spectrum Disorder,15,35,0,3,3
Karnataka,Kalaburagi,Autism Spectrum Disorder,35,60,7,2,9
Manipur,Kakching,Autism Spectrum Disorder,0,6,0,1,1
Manipur,Kakching,Autism Spectrum Disorder,6,15,1,0,1
Manipur,Kakching,Autism Spectrum Disorder,15,35,1,0,1
Haryana,Kaithal,Autism Spectrum Disorder,15,35,2,0,2
Haryana,Kaithal,Autism Spectrum Disorder,35,60,1,1,2
Haryana,Kaithal,Autism Spectrum Disorder,60,80,2,1,3
Bihar,Kaimur (Bhabua),Autism Spectrum Disorder,0,6,2,6,8
Bihar,Kaimur (Bhabua),Autism Spectrum Disorder,6,15,87,43,130
Bihar,Kaimur (Bhabua),Autism Spectrum Disorder,15,35,232,99,331
Bihar,Kaimur (Bhabua),Autism Spectrum Disorder,35,60,198,129,327
Bihar,Kaimur (Bhabua),Autism Spectrum Disorder,60,80,99,49,148
Bihar,Kaimur (Bhabua),Autism Spectrum Disorder,80,100,8,1,9
Gujarat,Kachchh,Autism Spectrum Disorder,0,6,3,0,3
Gujarat,Kachchh,Autism Spectrum Disorder,6,15,6,0,6
Gujarat,Kachchh,Autism Spectrum Disorder,15,35,3,0,3
Gujarat,Junagadh,Autism Spectrum Disorder,0,6,1,0,1
Gujarat,Junagadh,Autism Spectrum Disorder,6,15,22,2,24
Gujarat,Junagadh,Autism Spectrum Disorder,15,35,3,0,3
Gujarat,Junagadh,Autism Spectrum Disorder,35,60,1,0,1
Assam,Jorhat,Autism Spectrum Disorder,0,6,0,1,1
Assam,Jorhat,Autism Spectrum Disorder,6,15,5,2,7
Assam,Jorhat,Autism Spectrum Disorder,15,35,1,1,2
Assam,Jorhat,Autism Spectrum Disorder,35,60,0,1,1
Rajasthan,Jodhpur,Autism Spectrum Disorder,0,6,1,1,2
Rajasthan,Jodhpur,Autism Spectrum Disorder,6,15,19,12,31
Rajasthan,Jodhpur,Autism Spectrum Disorder,15,35,124,50,174
Rajasthan,Jodhpur,Autism Spectrum Disorder,35,60,37,14,51
Rajasthan,Jodhpur,Autism Spectrum Disorder,60,80,5,3,8
Haryana,Jind,Autism Spectrum Disorder,6,15,0,1,1
Haryana,Jind,Autism Spectrum Disorder,15,35,1,0,1
Rajasthan,Jhunjhunu,Autism Spectrum Disorder,0,6,0,1,1
Rajasthan,Jhunjhunu,Autism Spectrum Disorder,6,15,29,26,55
Rajasthan,Jhunjhunu,Autism Spectrum Disorder,15,35,306,128,434
Rajasthan,Jhunjhunu,Autism Spectrum Disorder,35,60,177,53,230
Rajasthan,Jhunjhunu,Autism Spectrum Disorder,60,80,30,4,34
Rajasthan,Jhunjhunu,Autism Spectrum Disorder,80,100,1,4,5
Odisha,Jharsuguda,Autism Spectrum Disorder,0,6,4,1,5
Odisha,Jharsuguda,Autism Spectrum Disorder,6,15,9,1,10
Odisha,Jharsuguda,Autism Spectrum Disorder,15,35,6,0,6
Odisha,Jharsuguda,Autism Spectrum Disorder,35,60,3,0,3
Odisha,Jharsuguda,Autism Spectrum Disorder,60,80,1,0,1
Uttar Pradesh,Jhansi,Autism Spectrum Disorder,0,6,1,1,2
Uttar Pradesh,Jhansi,Autism Spectrum Disorder,6,15,1,0,1
Uttar Pradesh,Jhansi,Autism Spectrum Disorder,15,35,3,1,4
Uttar Pradesh,Jhansi,Autism Spectrum Disorder,35,60,8,1,9
Uttar Pradesh,Jhansi,Autism Spectrum Disorder,60,80,1,1,2
Rajasthan,Jhalawar,Autism Spectrum Disorder,6,15,4,7,11
Rajasthan,Jhalawar,Autism Spectrum Disorder,15,35,76,54,130
Rajasthan,Jhalawar,Autism Spectrum Disorder,35,60,25,19,44
Rajasthan,Jhalawar,Autism Spectrum Disorder,60,80,4,2,6
Haryana,Jhajjar,Autism Spectrum Disorder,0,6,1,0,1
Haryana,Jhajjar,Autism Spectrum Disorder,6,15,1,1,2
Haryana,Jhajjar,Autism Spectrum Disorder,15,35,3,0,3
Haryana,Jhajjar,Autism Spectrum Disorder,35,60,1,0,1
Haryana,Jhajjar,Autism Spectrum Disorder,60,80,1,0,1
Madhya Pradesh,Jhabua,Autism Spectrum Disorder,15,35,1,0,1
Madhya Pradesh,Jhabua,Autism Spectrum Disorder,35,60,1,0,1
Madhya Pradesh,Jhabua,Autism Spectrum Disorder,60,80,1,0,1
Bihar,Jehanabad,Autism Spectrum Disorder,0,6,2,3,5
Bihar,Jehanabad,Autism Spectrum Disorder,6,15,76,40,116
Bihar,Jehanabad,Autism Spectrum Disorder,15,35,148,88,236
Bihar,Jehanabad,Autism Spectrum Disorder,35,60,193,122,315
Bihar,Jehanabad,Autism Spectrum Disorder,60,80,61,38,99
Bihar,Jehanabad,Autism Spectrum Disorder,80,100,2,3,5
Uttar Pradesh,Jaunpur,Autism Spectrum Disorder,0,6,1,0,1
Uttar Pradesh,Jaunpur,Autism Spectrum Disorder,6,15,1,4,5
Uttar Pradesh,Jaunpur,Autism Spectrum Disorder,15,35,9,4,13
Uttar Pradesh,Jaunpur,Autism Spectrum Disorder,35,60,5,2,7
Uttar Pradesh,Jaunpur,Autism Spectrum Disorder,60,80,3,0,3
Chhattisgarh,Jashpur,Autism Spectrum Disorder,6,15,1,0,1
Chhattisgarh,Jashpur,Autism Spectrum Disorder,15,35,3,0,3
Chhattisgarh,Jashpur,Autism Spectrum Disorder,35,60,2,0,2
Chhattisgarh,Janjgir-Champa,Autism Spectrum Disorder,15,35,1,0,1
Chhattisgarh,Janjgir-Champa,Autism Spectrum Disorder,35,60,1,0,1
Chhattisgarh,Janjgir-Champa,Autism Spectrum Disorder,60,80,0,1,1
Bihar,Jamui,Autism Spectrum Disorder,0,6,1,0,1
Bihar,Jamui,Autism Spectrum Disorder,6,15,126,87,213
Bihar,Jamui,Autism Spectrum Disorder,15,35,396,212,608
Bihar,Jamui,Autism Spectrum Disorder,35,60,481,271,752
Bihar,Jamui,Autism Spectrum Disorder,60,80,170,91,261
Bihar,Jamui,Autism Spectrum Disorder,80,100,9,6,15
Jharkhand,Jamtara,Autism Spectrum Disorder,15,35,0,1,1
Jharkhand,Jamtara,Autism Spectrum Disorder,60,80,0,1,1
Gujarat,Jamnagar,Autism Spectrum Disorder,0,6,3,0,3
Gujarat,Jamnagar,Autism Spectrum Disorder,6,15,6,1,7
Gujarat,Jamnagar,Autism Spectrum Disorder,15,35,1,0,1
Gujarat,Jamnagar,Autism Spectrum Disorder,35,60,1,0,1
Jammu And Kashmir,Jammu,Autism Spectrum Disorder,0,6,11,2,13
Jammu And Kashmir,Jammu,Autism Spectrum Disorder,6,15,20,13,33
Jammu And Kashmir,Jammu,Autism Spectrum Disorder,15,35,15,5,20
Jammu And Kashmir,Jammu,Autism Spectrum Disorder,35,60,4,1,5
Jammu And Kashmir,Jammu,Autism Spectrum Disorder,60,80,0,1,1
Rajasthan,Jalore,Autism Spectrum Disorder,6,15,0,3,3
Rajasthan,Jalore,Autism Spectrum Disorder,15,35,4,5,9
Rajasthan,Jalore,Autism Spectrum Disorder,35,60,1,1,2
Maharashtra,Jalna,Autism Spectrum Disorder,0,6,1,1,2
Maharashtra,Jalna,Autism Spectrum Disorder,6,15,2,0,2
Maharashtra,Jalgaon,Autism Spectrum Disorder,15,35,2,1,3
Maharashtra,Jalgaon,Autism Spectrum Disorder,35,60,1,0,1
Uttar Pradesh,Jalaun,Autism Spectrum Disorder,0,6,1,0,1
Uttar Pradesh,Jalaun,Autism Spectrum Disorder,6,15,2,0,2
Uttar Pradesh,Jalaun,Autism Spectrum Disorder,15,35,11,2,13
Uttar Pradesh,Jalaun,Autism Spectrum Disorder,35,60,16,4,20
Uttar Pradesh,Jalaun,Autism Spectrum Disorder,60,80,5,2,7
Punjab,Jalandhar,Autism Spectrum Disorder,0,6,9,0,9
Punjab,Jalandhar,Autism Spectrum Disorder,6,15,16,6,22
Punjab,Jalandhar,Autism Spectrum Disorder,15,35,7,0,7
Punjab,Jalandhar,Autism Spectrum Disorder,35,60,3,0,3
Punjab,Jalandhar,Autism Spectrum Disorder,60,80,1,1,2
Odisha,Jajapur,Autism Spectrum Disorder,0,6,5,4,9
Odisha,Jajapur,Autism Spectrum Disorder,6,15,40,11,51
Odisha,Jajapur,Autism Spectrum Disorder,15,35,5,5,10
Odisha,Jajapur,Autism Spectrum Disorder,35,60,1,0,1
Rajasthan,Jaisalmer,Autism Spectrum Disorder,15,35,1,2,3
Rajasthan,Jaisalmer,Autism Spectrum Disorder,35,60,1,0,1
Rajasthan,Jaipur,Autism Spectrum Disorder,0,6,5,3,8
Rajasthan,Jaipur,Autism Spectrum Disorder,6,15,97,47,144
Rajasthan,Jaipur,Autism Spectrum Disorder,15,35,321,128,449
Rajasthan,Jaipur,Autism Spectrum Disorder,35,60,73,22,95
Rajasthan,Jaipur,Autism Spectrum Disorder,60,80,10,3,13
Rajasthan,Jaipur,Autism Spectrum Disorder,80,100,1,1,2
Odisha,Jagatsinghapur,Autism Spectrum Disorder,0,6,1,0,1
Odisha,Jagatsinghapur,Autism Spectrum Disorder,6,15,2,1,3
Odisha,Jagatsinghapur,Autism Spectrum Disorder,35,60,2,3,5
Odisha,Jagatsinghapur,Autism Spectrum Disorder,60,80,0,1,1
Madhya Pradesh,Jabalpur,Autism Spectrum Disorder,0,6,8,5,13
Madhya Pradesh,Jabalpur,Autism Spectrum Disorder,6,15,14,5,19
Madhya Pradesh,Jabalpur,Autism Spectrum Disorder,15,35,13,5,18
Madhya Pradesh,Jabalpur,Autism Spectrum Disorder,35,60,26,3,29
Madhya Pradesh,Jabalpur,Autism Spectrum Disorder,60,80,2,2,4
Madhya Pradesh,Indore,Autism Spectrum Disorder,0,6,1,1,2
Madhya Pradesh,Indore,Autism Spectrum Disorder,6,15,5,0,5
Madhya Pradesh,Indore,Autism Spectrum Disorder,15,35,3,1,4
Madhya Pradesh,Indore,Autism Spectrum Disorder,35,60,3,0,3
Madhya Pradesh,Indore,Autism Spectrum Disorder,60,80,3,0,3
Manipur,Imphal West,Autism Spectrum Disorder,0,6,3,0,3
Manipur,Imphal West,Autism Spectrum Disorder,6,15,11,0,11
Manipur,Imphal West,Autism Spectrum Disorder,15,35,2,1,3
Manipur,Imphal East,Autism Spectrum Disorder,0,6,3,1,4
Manipur,Imphal East,Autism Spectrum Disorder,6,15,4,0,4
Kerala,Idukki,Autism Spectrum Disorder,6,15,14,7,21
Kerala,Idukki,Autism Spectrum Disorder,15,35,22,7,29
Punjab,Hoshiarpur,Autism Spectrum Disorder,0,6,8,2,10
Punjab,Hoshiarpur,Autism Spectrum Disorder,6,15,9,3,12
Punjab,Hoshiarpur,Autism Spectrum Disorder,15,35,2,0,2
Punjab,Hoshiarpur,Autism Spectrum Disorder,35,60,12,3,15
Punjab,Hoshiarpur,Autism Spectrum Disorder,60,80,4,1,5
Assam,Hojai,Autism Spectrum Disorder,0,6,0,1,1
Assam,Hojai,Autism Spectrum Disorder,6,15,1,2,3
Assam,Hojai,Autism Spectrum Disorder,15,35,1,0,1
Haryana,Hisar,Autism Spectrum Disorder,0,6,1,1,2
Haryana,Hisar,Autism Spectrum Disorder,6,15,2,0,2
Haryana,Hisar,Autism Spectrum Disorder,15,35,4,1,5
Haryana,Hisar,Autism Spectrum Disorder,35,60,4,0,4
Maharashtra,Hingoli,Autism Spectrum Disorder,6,15,2,0,2
Jharkhand,Hazaribagh,Autism Spectrum Disorder,0,6,2,0,2
Jharkhand,Hazaribagh,Autism Spectrum Disorder,6,15,3,2,5
Jharkhand,Hazaribagh,Autism Spectrum Disorder,15,35,4,1,5
Jharkhand,Hazaribagh,Autism Spectrum Disorder,35,60,5,1,6
Karnataka,Haveri,Autism Spectrum Disorder,0,6,0,1,1
Karnataka,Haveri,Autism Spectrum Disorder,15,35,0,1,1
Karnataka,Haveri,Autism Spectrum Disorder,60,80,1,0,1
Uttar Pradesh,Hathras,Autism Spectrum Disorder,6,15,2,2,4
Uttar Pradesh,Hathras,Autism Spectrum Disorder,15,35,39,10,49
Uttar Pradesh,Hathras,Autism Spectrum Disorder,35,60,48,8,56
Uttar Pradesh,Hathras,Autism Spectrum Disorder,60,80,8,0,8
Karnataka,Hassan,Autism Spectrum Disorder,0,6,2,0,2
Karnataka,Hassan,Autism Spectrum Disorder,6,15,9,0,9
Karnataka,Hassan,Autism Spectrum Disorder,15,35,3,0,3
Karnataka,Hassan,Autism Spectrum Disorder,35,60,2,3,5
Karnataka,Hassan,Autism Spectrum Disorder,60,80,3,0,3
Uttarakhand,Haridwar,Autism Spectrum Disorder,0,6,1,0,1
Uttarakhand,Haridwar,Autism Spectrum Disorder,6,15,5,3,8
Uttarakhand,Haridwar,Autism Spectrum Disorder,15,35,10,2,12
Uttarakhand,Haridwar,Autism Spectrum Disorder,35,60,12,4,16
Uttar Pradesh,Hardoi,Autism Spectrum Disorder,15,35,6,2,8
Uttar Pradesh,Hardoi,Autism Spectrum Disorder,35,60,18,2,20
Uttar Pradesh,Hardoi,Autism Spectrum Disorder,60,80,6,0,6
Madhya Pradesh,Harda,Autism Spectrum Disorder,6,15,1,0,1
Uttar Pradesh,Hapur,Autism Spectrum Disorder,0,6,1,0,1
Uttar Pradesh,Hapur,Autism Spectrum Disorder,15,35,7,1,8
Uttar Pradesh,Hapur,Autism Spectrum Disorder,35,60,9,0,9
Uttar Pradesh,Hapur,Autism Spectrum Disorder,60,80,4,0,4
Rajasthan,Hanumangarh,Autism Spectrum Disorder,6,15,37,36,73
Rajasthan,Hanumangarh,Autism Spectrum Disorder,15,35,236,106,342
Rajasthan,Hanumangarh,Autism Spectrum Disorder,35,60,80,34,114
Rajasthan,Hanumangarh,Autism Spectrum Disorder,60,80,10,2,12
Himachal Pradesh,Hamirpur,Autism Spectrum Disorder,0,6,1,0,1
Himachal Pradesh,Hamirpur,Autism Spectrum Disorder,6,15,3,0,3
Himachal Pradesh,Hamirpur,Autism Spectrum Disorder,35,60,4,0,4
Uttar Pradesh,Hamirpur,Autism Spectrum Disorder,6,15,1,1,2
Uttar Pradesh,Hamirpur,Autism Spectrum Disorder,15,35,8,4,12
Uttar Pradesh,Hamirpur,Autism Spectrum Disorder,35,60,20,7,27
Uttar Pradesh,Hamirpur,Autism Spectrum Disorder,60,80,5,2,7
Uttar Pradesh,Hamirpur,Autism Spectrum Disorder,80,100,1,0,1
Assam,Hailakandi,Autism Spectrum Disorder,15,35,1,0,1
Sikkim,Gyalshing,Autism Spectrum Disorder,0,6,1,0,1
Sikkim,Gyalshing,Autism Spectrum Disorder,6,15,1,2,3
Sikkim,Gyalshing,Autism Spectrum Disorder,15,35,1,1,2
Madhya Pradesh,Gwalior,Autism Spectrum Disorder,0,6,2,2,4
Madhya Pradesh,Gwalior,Autism Spectrum Disorder,6,15,5,2,7
Madhya Pradesh,Gwalior,Autism Spectrum Disorder,15,35,10,1,11
Madhya Pradesh,Gwalior,Autism Spectrum Disorder,35,60,11,3,14
Madhya Pradesh,Gwalior,Autism Spectrum Disorder,60,80,1,0,1
Madhya Pradesh,Gwalior,Autism Spectrum Disorder,80,100,1,0,1
Haryana,Gurugram,Autism Spectrum Disorder,0,6,6,4,10
Haryana,Gurugram,Autism Spectrum Disorder,6,15,53,12,65
Haryana,Gurugram,Autism Spectrum Disorder,15,35,34,6,40
Punjab,Gurdaspur,Autism Spectrum Disorder,0,6,1,0,1
Punjab,Gurdaspur,Autism Spectrum Disorder,6,15,1,0,1
Punjab,Gurdaspur,Autism Spectrum Disorder,15,35,2,1,3
Punjab,Gurdaspur,Autism Spectrum Disorder,35,60,0,1,1
Punjab,Gurdaspur,Autism Spectrum Disorder,60,80,0,1,1
Andhra Pradesh,Guntur,Autism Spectrum Disorder,6,15,1,0,1
Andhra Pradesh,Guntur,Autism Spectrum Disorder,15,35,1,0,1
Madhya Pradesh,Guna,Autism Spectrum Disorder,0,6,2,0,2
Madhya Pradesh,Guna,Autism Spectrum Disorder,35,60,1,0,1
Jharkhand,Gumla,Autism Spectrum Disorder,6,15,3,2,5
Jharkhand,Gumla,Autism Spectrum Disorder,15,35,29,22,51
Jharkhand,Gumla,Autism Spectrum Disorder,35,60,36,21,57
Jharkhand,Gumla,Autism Spectrum Disorder,60,80,8,2,10
Uttar Pradesh,Gorakhpur,Autism Spectrum Disorder,0,6,10,1,11
Uttar Pradesh,Gorakhpur,Autism Spectrum Disorder,6,15,18,5,23
Uttar Pradesh,Gorakhpur,Autism Spectrum Disorder,15,35,21,4,25
Uttar Pradesh,Gorakhpur,Autism Spectrum Disorder,35,60,13,2,15
Uttar Pradesh,Gorakhpur,Autism Spectrum Disorder,60,80,5,0,5
Bihar,Gopalganj,Autism Spectrum Disorder,0,6,8,2,10
Bihar,Gopalganj,Autism Spectrum Disorder,6,15,107,59,166
Bihar,Gopalganj,Autism Spectrum Disorder,15,35,427,243,670
Bihar,Gopalganj,Autism Spectrum Disorder,35,60,440,212,652
Bihar,Gopalganj,Autism Spectrum Disorder,60,80,146,58,204
Bihar,Gopalganj,Autism Spectrum Disorder,80,100,10,6,16
Maharashtra,Gondia,Autism Spectrum Disorder,0,6,1,0,1
Maharashtra,Gondia,Autism Spectrum Disorder,6,15,1,0,1
Maharashtra,Gondia,Autism Spectrum Disorder,35,60,1,0,1
Uttar Pradesh,Gonda,Autism Spectrum Disorder,6,15,1,1,2
Uttar Pradesh,Gonda,Autism Spectrum Disorder,15,35,13,1,14
Uttar Pradesh,Gonda,Autism Spectrum Disorder,35,60,18,0,18
Uttar Pradesh,Gonda,Autism Spectrum Disorder,60,80,4,1,5
Tripura,Gomati,Autism Spectrum Disorder,6,15,1,0,1
Assam,Golaghat,Autism Spectrum Disorder,0,6,3,1,4
Assam,Golaghat,Autism Spectrum Disorder,6,15,3,2,5
Assam,Golaghat,Autism Spectrum Disorder,15,35,2,0,2
Jharkhand,Godda,Autism Spectrum Disorder,15,35,11,1,12
Jharkhand,Godda,Autism Spectrum Disorder,35,60,10,8,18
Jharkhand,Godda,Autism Spectrum Disorder,60,80,4,0,4
Assam,Goalpara,Autism Spectrum Disorder,0,6,1,0,1
Assam,Goalpara,Autism Spectrum Disorder,15,35,4,2,6
Assam,Goalpara,Autism Spectrum Disorder,35,60,2,2,4
Jharkhand,Giridih,Autism Spectrum Disorder,6,15,1,0,1
Jharkhand,Giridih,Autism Spectrum Disorder,15,35,6,1,7
Jharkhand,Giridih,Autism Spectrum Disorder,35,60,1,1,2
Jharkhand,Giridih,Autism Spectrum Disorder,60,80,1,1,2
Gujarat,Gir Somnath,Autism Spectrum Disorder,0,6,2,0,2
Gujarat,Gir Somnath,Autism Spectrum Disorder,6,15,2,0,2
Gujarat,Gir Somnath,Autism Spectrum Disorder,15,35,0,1,1
Uttar Pradesh,Ghazipur,Autism Spectrum Disorder,15,35,6,0,6
Uttar Pradesh,Ghazipur,Autism Spectrum Disorder,35,60,3,0,3
Uttar Pradesh,Ghazipur,Autism Spectrum Disorder,60,80,1,0,1
Uttar Pradesh,Ghaziabad,Autism Spectrum Disorder,0,6,9,6,15
Uttar Pradesh,Ghaziabad,Autism Spectrum Disorder,6,15,78,17,95
Uttar Pradesh,Ghaziabad,Autism Spectrum Disorder,15,35,23,5,28
Uttar Pradesh,Ghaziabad,Autism Spectrum Disorder,35,60,4,2,6
Bihar,Gaya,Autism Spectrum Disorder,0,6,5,4,9
Bihar,Gaya,Autism Spectrum Disorder,6,15,230,143,373
Bihar,Gaya,Autism Spectrum Disorder,15,35,790,492,1282
Bihar,Gaya,Autism Spectrum Disorder,35,60,817,418,1235
Bihar,Gaya,Autism Spectrum Disorder,60,80,270,106,376
Bihar,Gaya,Autism Spectrum Disorder,80,100,6,5,11
Uttar Pradesh,Gautam Buddha Nagar,Autism Spectrum Disorder,0,6,30,6,36
Uttar Pradesh,Gautam Buddha Nagar,Autism Spectrum Disorder,6,15,63,16,79
Uttar Pradesh,Gautam Buddha Nagar,Autism Spectrum Disorder,15,35,39,7,46
Uttar Pradesh,Gautam Buddha Nagar,Autism Spectrum Disorder,35,60,3,0,3
Chhattisgarh,Gariyaband,Autism Spectrum Disorder,6,15,1,0,1
Chhattisgarh,Gariyaband,Autism Spectrum Disorder,15,35,0,2,2
Chhattisgarh,Gariyaband,Autism Spectrum Disorder,35,60,3,0,3
Jharkhand,Garhwa,Autism Spectrum Disorder,6,15,6,2,8
Jharkhand,Garhwa,Autism Spectrum Disorder,15,35,22,7,29
Jharkhand,Garhwa,Autism Spectrum Disorder,35,60,18,10,28
Jharkhand,Garhwa,Autism Spectrum Disorder,60,80,5,0,5
Odisha,Ganjam,Autism Spectrum Disorder,0,6,1,0,1
Odisha,Ganjam,Autism Spectrum Disorder,6,15,10,4,14
Odisha,Ganjam,Autism Spectrum Disorder,15,35,0,3,3
Sikkim,Gangtok,Autism Spectrum Disorder,0,6,1,2,3
Sikkim,Gangtok,Autism Spectrum Disorder,6,15,10,0,10
Sikkim,Gangtok,Autism Spectrum Disorder,15,35,4,0,4
Sikkim,Gangtok,Autism Spectrum Disorder,35,60,1,0,1
Rajasthan,Ganganagar,Autism Spectrum Disorder,6,15,9,3,12
Rajasthan,Ganganagar,Autism Spectrum Disorder,15,35,48,22,70
Rajasthan,Ganganagar,Autism Spectrum Disorder,35,60,16,10,26
Rajasthan,Ganganagar,Autism Spectrum Disorder,60,80,5,0,5
Rajasthan,Ganganagar,Autism Spectrum Disorder,80,100,1,0,1
Gujarat,Gandhinagar,Autism Spectrum Disorder,6,15,14,2,16
Gujarat,Gandhinagar,Autism Spectrum Disorder,15,35,2,0,2
Gujarat,Gandhinagar,Autism Spectrum Disorder,35,60,1,0,1
Jammu And Kashmir,Ganderbal,Autism Spectrum Disorder,0,6,1,0,1
Jammu And Kashmir,Ganderbal,Autism Spectrum Disorder,6,15,1,0,1
Jammu And Kashmir,Ganderbal,Autism Spectrum Disorder,15,35,2,0,2
Jammu And Kashmir,Ganderbal,Autism Spectrum Disorder,35,60,0,2,2
Jammu And Kashmir,Ganderbal,Autism Spectrum Disorder,60,80,0,3,3
Odisha,Gajapati,Autism Spectrum Disorder,0,6,1,1,2
Odisha,Gajapati,Autism Spectrum Disorder,15,35,1,0,1
Odisha,Gajapati,Autism Spectrum Disorder,35,60,1,0,1
Maharashtra,Gadchiroli,Autism Spectrum Disorder,6,15,1,1,2
Maharashtra,Gadchiroli,Autism Spectrum Disorder,15,35,1,1,2
Maharashtra,Gadchiroli,Autism Spectrum Disorder,35,60,4,1,5
Maharashtra,Gadchiroli,Autism Spectrum Disorder,60,80,0,1,1
Karnataka,Gadag,Autism Spectrum Disorder,6,15,0,1,1
Karnataka,Gadag,Autism Spectrum Disorder,15,35,1,1,2
Karnataka,Gadag,Autism Spectrum Disorder,35,60,2,0,2
Uttar Pradesh,Firozabad,Autism Spectrum Disorder,0,6,2,0,2
Uttar Pradesh,Firozabad,Autism Spectrum Disorder,6,15,5,0,5
Uttar Pradesh,Firozabad,Autism Spectrum Disorder,15,35,1,1,2
Uttar Pradesh,Firozabad,Autism Spectrum Disorder,35,60,6,3,9
Punjab,Ferozepur,Autism Spectrum Disorder,6,15,0,1,1
Punjab,Ferozepur,Autism Spectrum Disorder,15,35,1,3,4
Punjab,Ferozepur,Autism Spectrum Disorder,35,60,7,2,9
Punjab,Fazilka,Autism Spectrum Disorder,0,6,3,0,3
Punjab,Fazilka,Autism Spectrum Disorder,6,15,2,0,2
Punjab,Fazilka,Autism Spectrum Disorder,35,60,1,0,1
Uttar Pradesh,Fatehpur,Autism Spectrum Disorder,6,15,0,1,1
Uttar Pradesh,Fatehpur,Autism Spectrum Disorder,15,35,13,5,18
Uttar Pradesh,Fatehpur,Autism Spectrum Disorder,35,60,23,10,33
Uttar Pradesh,Fatehpur,Autism Spectrum Disorder,60,80,3,3,6
Uttar Pradesh,Fatehpur,Autism Spectrum Disorder,80,100,1,0,1
Punjab,Fatehgarh Sahib,Autism Spectrum Disorder,6,15,3,1,4
Punjab,Fatehgarh Sahib,Autism Spectrum Disorder,15,35,2,2,4
Punjab,Fatehgarh Sahib,Autism Spectrum Disorder,35,60,4,1,5
Punjab,Fatehgarh Sahib,Autism Spectrum Disorder,60,80,2,1,3
Haryana,Fatehabad,Autism Spectrum Disorder,15,35,1,1,2
Haryana,Fatehabad,Autism Spectrum Disorder,35,60,2,0,2
Uttar Pradesh,Farrukhabad,Autism Spectrum Disorder,6,15,3,1,4
Uttar Pradesh,Farrukhabad,Autism Spectrum Disorder,15,35,5,4,9
Uttar Pradesh,Farrukhabad,Autism Spectrum Disorder,35,60,13,0,13
Uttar Pradesh,Farrukhabad,Autism Spectrum Disorder,60,80,2,0,2
Punjab,Faridkot,Autism Spectrum Disorder,0,6,0,1,1
Punjab,Faridkot,Autism Spectrum Disorder,6,15,1,0,1
Punjab,Faridkot,Autism Spectrum Disorder,15,35,1,0,1
Punjab,Faridkot,Autism Spectrum Disorder,35,60,0,1,1
Haryana,Faridabad,Autism Spectrum Disorder,0,6,7,4,11
Haryana,Faridabad,Autism Spectrum Disorder,6,15,20,6,26
Haryana,Faridabad,Autism Spectrum Disorder,15,35,9,1,10
Uttar Pradesh,Etawah,Autism Spectrum Disorder,15,35,8,1,9
Uttar Pradesh,Etawah,Autism Spectrum Disorder,35,60,7,2,9
Uttar Pradesh,Etawah,Autism Spectrum Disorder,60,80,4,2,6
Uttar Pradesh,Etah,Autism Spectrum Disorder,15,35,3,0,3
Uttar Pradesh,Etah,Autism Spectrum Disorder,35,60,7,0,7
Uttar Pradesh,Etah,Autism Spectrum Disorder,60,80,1,0,1
Tamil Nadu,Erode,Autism Spectrum Disorder,0,6,6,0,6
Tamil Nadu,Erode,Autism Spectrum Disorder,6,15,23,8,31
Tamil Nadu,Erode,Autism Spectrum Disorder,15,35,5,1,6
Tamil Nadu,Erode,Autism Spectrum Disorder,35,60,3,0,3
Kerala,Ernakulam,Autism Spectrum Disorder,0,6,19,1,20
Kerala,Ernakulam,Autism Spectrum Disorder,6,15,85,18,103
Kerala,Ernakulam,Autism Spectrum Disorder,15,35,83,15,98
Kerala,Ernakulam,Autism Spectrum Disorder,35,60,5,1,6
Meghalaya,Eastern West Khasi Hills,Autism Spectrum Disorder,6,15,2,0,2
Jharkhand,East Singhbum,Autism Spectrum Disorder,0,6,4,0,4
Jharkhand,East Singhbum,Autism Spectrum Disorder,6,15,14,0,14
Jharkhand,East Singhbum,Autism Spectrum Disorder,15,35,6,4,10
Jharkhand,East Singhbum,Autism Spectrum Disorder,35,60,1,0,1
Jharkhand,East Singhbum,Autism Spectrum Disorder,60,80,2,0,2
Madhya Pradesh,East Nimar,Autism Spectrum Disorder,6,15,1,0,1
Madhya Pradesh,East Nimar,Autism Spectrum Disorder,15,35,4,2,6
Madhya Pradesh,East Nimar,Autism Spectrum Disorder,35,60,1,1,2
Meghalaya,East Khasi Hills,Autism Spectrum Disorder,0,6,7,4,11
Meghalaya,East Khasi Hills,Autism Spectrum Disorder,6,15,21,7,28
Meghalaya,East Khasi Hills,Autism Spectrum Disorder,15,35,5,0,5
Meghalaya,East Jaintia Hills,Autism Spectrum Disorder,0,6,1,0,1
Meghalaya,East Jaintia Hills,Autism Spectrum Disorder,6,15,0,2,2
Meghalaya,East Jaintia Hills,Autism Spectrum Disorder,15,35,1,2,3
Meghalaya,East Garo Hills,Autism Spectrum Disorder,6,15,1,0,1
Meghalaya,East Garo Hills,Autism Spectrum Disorder,15,35,0,1,1
Delhi,East,Autism Spectrum Disorder,0,6,5,1,6
Delhi,East,Autism Spectrum Disorder,6,15,18,3,21
Delhi,East,Autism Spectrum Disorder,15,35,10,1,11
Chhattisgarh,Durg,Autism Spectrum Disorder,6,15,6,4,10
Chhattisgarh,Durg,Autism Spectrum Disorder,15,35,3,3,6
Chhattisgarh,Durg,Autism Spectrum Disorder,35,60,2,1,3
Chhattisgarh,Durg,Autism Spectrum Disorder,60,80,2,1,3
Rajasthan,Dungarpur,Autism Spectrum Disorder,6,15,5,2,7
Rajasthan,Dungarpur,Autism Spectrum Disorder,15,35,45,25,70
Rajasthan,Dungarpur,Autism Spectrum Disorder,35,60,11,4,15
Rajasthan,Dungarpur,Autism Spectrum Disorder,60,80,1,1,2
Jharkhand,Dumka,Autism Spectrum Disorder,15,35,3,4,7
Jharkhand,Dumka,Autism Spectrum Disorder,35,60,3,0,3
Jammu And Kashmir,Doda,Autism Spectrum Disorder,0,6,1,0,1
Madhya Pradesh,Dindori,Autism Spectrum Disorder,6,15,1,0,1
Madhya Pradesh,Dindori,Autism Spectrum Disorder,15,35,3,6,9
Madhya Pradesh,Dindori,Autism Spectrum Disorder,35,60,6,1,7
Tamil Nadu,Dindigul,Autism Spectrum Disorder,0,6,2,1,3
Tamil Nadu,Dindigul,Autism Spectrum Disorder,6,15,20,3,23
Tamil Nadu,Dindigul,Autism Spectrum Disorder,15,35,11,5,16
Tamil Nadu,Dindigul,Autism Spectrum Disorder,35,60,3,0,3
Nagaland,Dimapur,Autism Spectrum Disorder,6,15,1,1,2
Assam,Dima Hasao,Autism Spectrum Disorder,6,15,0,1,1
Assam,Dima Hasao,Autism Spectrum Disorder,15,35,3,0,3
Assam,Dibrugarh,Autism Spectrum Disorder,0,6,2,0,2
Assam,Dibrugarh,Autism Spectrum Disorder,6,15,10,0,10
Assam,Dibrugarh,Autism Spectrum Disorder,15,35,1,0,1
Maharashtra,Dhule,Autism Spectrum Disorder,0,6,1,0,1
Maharashtra,Dhule,Autism Spectrum Disorder,6,15,2,0,2
Maharashtra,Dhule,Autism Spectrum Disorder,15,35,1,2,3
Maharashtra,Dhule,Autism Spectrum Disorder,35,60,3,0,3
Maharashtra,Dhule,Autism Spectrum Disorder,60,80,0,1,1
Assam,Dhubri,Autism Spectrum Disorder,15,35,1,0,1
Rajasthan,Dholpur,Autism Spectrum Disorder,15,35,5,2,7
Rajasthan,Dholpur,Autism Spectrum Disorder,35,60,5,1,6
Rajasthan,Dholpur,Autism Spectrum Disorder,60,80,1,0,1
Odisha,Dhenkanal,Autism Spectrum Disorder,0,6,1,2,3
Odisha,Dhenkanal,Autism Spectrum Disorder,6,15,15,6,21
Odisha,Dhenkanal,Autism Spectrum Disorder,15,35,4,4,8
Odisha,Dhenkanal,Autism Spectrum Disorder,35,60,2,0,2
Odisha,Dhenkanal,Autism Spectrum Disorder,60,80,0,1,1
Odisha,Dhenkanal,Autism Spectrum Disorder,80,100,1,0,1
Assam,Dhemaji,Autism Spectrum Disorder,6,15,1,0,1
Karnataka,Dharwad,Autism Spectrum Disorder,6,15,1,0,1
Karnataka,Dharwad,Autism Spectrum Disorder,15,35,2,0,2
Karnataka,Dharwad,Autism Spectrum Disorder,35,60,1,0,1
Tamil Nadu,Dharmapuri,Autism Spectrum Disorder,0,6,0,1,1
Tamil Nadu,Dharmapuri,Autism Spectrum Disorder,6,15,2,1,3
Tamil Nadu,Dharmapuri,Autism Spectrum Disorder,15,35,4,0,4
Tamil Nadu,Dharmapuri,Autism Spectrum Disorder,35,60,1,0,1
Madhya Pradesh,Dhar,Autism Spectrum Disorder,0,6,1,0,1
Madhya Pradesh,Dhar,Autism Spectrum Disorder,6,15,2,1,3
Madhya Pradesh,Dhar,Autism Spectrum Disorder,15,35,7,1,8
Madhya Pradesh,Dhar,Autism Spectrum Disorder,35,60,3,5,8
Madhya Pradesh,Dhar,Autism Spectrum Disorder,60,80,1,0,1
Jharkhand,Dhanbad,Autism Spectrum Disorder,0,6,1,0,1
Jharkhand,Dhanbad,Autism Spectrum Disorder,6,15,1,0,1
Jharkhand,Dhanbad,Autism Spectrum Disorder,15,35,5,5,10
Jharkhand,Dhanbad,Autism Spectrum Disorder,35,60,6,2,8
Chhattisgarh,Dhamtari,Autism Spectrum Disorder,6,15,0,1,1
Chhattisgarh,Dhamtari,Autism Spectrum Disorder,15,35,0,1,1
Chhattisgarh,Dhamtari,Autism Spectrum Disorder,35,60,2,1,3
Tripura,Dhalai,Autism Spectrum Disorder,6,15,2,0,2
Tripura,Dhalai,Autism Spectrum Disorder,35,60,0,1,1
Madhya Pradesh,Dewas,Autism Spectrum Disorder,15,35,6,1,7
Madhya Pradesh,Dewas,Autism Spectrum Disorder,35,60,10,6,16
Madhya Pradesh,Dewas,Autism Spectrum Disorder,60,80,1,1,2
Uttar Pradesh,Deoria,Autism Spectrum Disorder,0,6,0,1,1
Uttar Pradesh,Deoria,Autism Spectrum Disorder,6,15,1,0,1
Uttar Pradesh,Deoria,Autism Spectrum Disorder,15,35,10,2,12
Uttar Pradesh,Deoria,Autism Spectrum Disorder,35,60,5,1,6
Uttar Pradesh,Deoria,Autism Spectrum Disorder,60,80,3,0,3
Jharkhand,Deoghar,Autism Spectrum Disorder,0,6,2,0,2
Jharkhand,Deoghar,Autism Spectrum Disorder,6,15,3,2,5
Jharkhand,Deoghar,Autism Spectrum Disorder,15,35,1,2,3
Jharkhand,Deoghar,Autism Spectrum Disorder,35,60,2,2,4
Jharkhand,Deoghar,Autism Spectrum Disorder,60,80,0,1,1
Odisha,Deogarh,Autism Spectrum Disorder,0,6,1,1,2
Odisha,Deogarh,Autism Spectrum Disorder,6,15,0,2,2
Uttarakhand,Dehradun,Autism Spectrum Disorder,0,6,16,6,22
Uttarakhand,Dehradun,Autism Spectrum Disorder,6,15,44,10,54
Uttarakhand,Dehradun,Autism Spectrum Disorder,15,35,13,4,17
Uttarakhand,Dehradun,Autism Spectrum Disorder,35,60,3,1,4
Uttarakhand,Dehradun,Autism Spectrum Disorder,60,80,1,0,1
Karnataka,Davangere,Autism Spectrum Disorder,0,6,0,2,2
Karnataka,Davangere,Autism Spectrum Disorder,6,15,2,2,4
Karnataka,Davangere,Autism Spectrum Disorder,15,35,2,0,2
Karnataka,Davangere,Autism Spectrum Disorder,35,60,2,1,3
Rajasthan,Dausa,Autism Spectrum Disorder,6,15,14,15,29
Rajasthan,Dausa,Autism Spectrum Disorder,15,35,45,13,58
Rajasthan,Dausa,Autism Spectrum Disorder,35,60,11,1,12
Rajasthan,Dausa,Autism Spectrum Disorder,60,80,2,0,2
Rajasthan,Dausa,Autism Spectrum Disorder,80,100,1,0,1
Madhya Pradesh,Datia,Autism Spectrum Disorder,6,15,4,1,5
Madhya Pradesh,Datia,Autism Spectrum Disorder,35,60,1,0,1
Madhya Pradesh,Datia,Autism Spectrum Disorder,60,80,0,1,1
Assam,Darrang,Autism Spectrum Disorder,15,35,1,0,1
Assam,Darrang,Autism Spectrum Disorder,35,60,1,0,1
Assam,Darrang,Autism Spectrum Disorder,60,80,0,1,1
West Bengal,Darjeeling,Autism Spectrum Disorder,6,15,1,0,1
Bihar,Darbhanga,Autism Spectrum Disorder,0,6,7,2,9
Bihar,Darbhanga,Autism Spectrum Disorder,6,15,209,165,374
Bihar,Darbhanga,Autism Spectrum Disorder,15,35,708,379,1087
Bihar,Darbhanga,Autism Spectrum Disorder,35,60,722,333,1055
Bihar,Darbhanga,Autism Spectrum Disorder,60,80,255,67,322
Bihar,Darbhanga,Autism Spectrum Disorder,80,100,8,6,14
Chhattisgarh,Dantewada,Autism Spectrum Disorder,6,15,2,0,2
Chhattisgarh,Dantewada,Autism Spectrum Disorder,35,60,1,0,1
Madhya Pradesh,Damoh,Autism Spectrum Disorder,15,35,20,13,33
Madhya Pradesh,Damoh,Autism Spectrum Disorder,35,60,25,4,29
Madhya Pradesh,Damoh,Autism Spectrum Disorder,60,80,2,1,3
Dadra Nagar Haveli And Daman And Diu,Daman,Autism Spectrum Disorder,0,6,1,0,1
Dadra Nagar Haveli And Daman And Diu,Daman,Autism Spectrum Disorder,6,15,3,0,3
Karnataka,Dakshina Kannada,Autism Spectrum Disorder,0,6,8,1,9
Karnataka,Dakshina Kannada,Autism Spectrum Disorder,6,15,33,14,47
Karnataka,Dakshina Kannada,Autism Spectrum Disorder,15,35,13,1,14
Karnataka,Dakshina Kannada,Autism Spectrum Disorder,35,60,1,1,2
Dadra Nagar Haveli And Daman And Diu,Dadra And Nagar Haveli,Autism Spectrum Disorder,6,15,8,0,8
Dadra Nagar Haveli And Daman And Diu,Dadra And Nagar Haveli,Autism Spectrum Disorder,15,35,1,1,2
Odisha,Cuttack,Autism Spectrum Disorder,0,6,6,2,8
Odisha,Cuttack,Autism Spectrum Disorder,6,15,66,13,79
Odisha,Cuttack,Autism Spectrum Disorder,15,35,48,9,57
Odisha,Cuttack,Autism Spectrum Disorder,35,60,4,1,5
Odisha,Cuttack,Autism Spectrum Disorder,60,80,1,0,1
Tamil Nadu,Cuddalore,Autism Spectrum Disorder,6,15,8,1,9
Tamil Nadu,Cuddalore,Autism Spectrum Disorder,15,35,7,0,7
Tamil Nadu,Cuddalore,Autism Spectrum Disorder,35,60,1,0,1
Tamil Nadu,Cuddalore,Autism Spectrum Disorder,60,80,0,1,1
Tamil Nadu,Coimbatore,Autism Spectrum Disorder,0,6,20,5,25
Tamil Nadu,Coimbatore,Autism Spectrum Disorder,6,15,91,24,115
Tamil Nadu,Coimbatore,Autism Spectrum Disorder,15,35,37,8,45
Tamil Nadu,Coimbatore,Autism Spectrum Disorder,35,60,2,2,4
Rajasthan,Churu,Autism Spectrum Disorder,6,15,9,4,13
Rajasthan,Churu,Autism Spectrum Disorder,15,35,53,13,66
Rajasthan,Churu,Autism Spectrum Disorder,35,60,27,6,33
Rajasthan,Churu,Autism Spectrum Disorder,60,80,1,0,1
Manipur,Churachandpur,Autism Spectrum Disorder,0,6,8,0,8
Manipur,Churachandpur,Autism Spectrum Disorder,6,15,8,3,11
Manipur,Churachandpur,Autism Spectrum Disorder,35,60,1,0,1
Rajasthan,Chittorgarh,Autism Spectrum Disorder,6,15,22,12,34
Rajasthan,Chittorgarh,Autism Spectrum Disorder,15,35,96,60,156
Rajasthan,Chittorgarh,Autism Spectrum Disorder,35,60,43,18,61
Rajasthan,Chittorgarh,Autism Spectrum Disorder,60,80,13,4,17
Uttar Pradesh,Chitrakoot,Autism Spectrum Disorder,6,15,3,3,6
Uttar Pradesh,Chitrakoot,Autism Spectrum Disorder,15,35,13,3,16
Uttar Pradesh,Chitrakoot,Autism Spectrum Disorder,35,60,19,1,20
Uttar Pradesh,Chitrakoot,Autism Spectrum Disorder,60,80,1,0,1
Karnataka,Chitradurga,Autism Spectrum Disorder,15,35,1,1,2
Karnataka,Chitradurga,Autism Spectrum Disorder,35,60,4,2,6
Assam,Chirang,Autism Spectrum Disorder,0,6,1,0,1
Assam,Chirang,Autism Spectrum Disorder,6,15,1,0,1
Assam,Chirang,Autism Spectrum Disorder,15,35,1,0,1
Karnataka,Chikkamagaluru,Autism Spectrum Disorder,0,6,2,1,3
Karnataka,Chikkamagaluru,Autism Spectrum Disorder,6,15,8,2,10
Karnataka,Chikkamagaluru,Autism Spectrum Disorder,15,35,8,5,13
Karnataka,Chikkamagaluru,Autism Spectrum Disorder,35,60,15,7,22
Karnataka,Chikkamagaluru,Autism Spectrum Disorder,60,80,5,0,5
Karnataka,Chikkaballapura,Autism Spectrum Disorder,0,6,3,0,3
Karnataka,Chikkaballapura,Autism Spectrum Disorder,6,15,6,2,8
Karnataka,Chikkaballapura,Autism Spectrum Disorder,15,35,5,0,5
Karnataka,Chikkaballapura,Autism Spectrum Disorder,35,60,4,2,6
Karnataka,Chikkaballapura,Autism Spectrum Disorder,60,80,1,0,1
Madhya Pradesh,Chhindwara,Autism Spectrum Disorder,6,15,2,0,2
Madhya Pradesh,Chhindwara,Autism Spectrum Disorder,15,35,5,2,7
Madhya Pradesh,Chhindwara,Autism Spectrum Disorder,35,60,14,6,20
Madhya Pradesh,Chhindwara,Autism Spectrum Disorder,60,80,5,3,8
Madhya Pradesh,Chhatarpur,Autism Spectrum Disorder,6,15,3,0,3
Madhya Pradesh,Chhatarpur,Autism Spectrum Disorder,15,35,12,4,16
Madhya Pradesh,Chhatarpur,Autism Spectrum Disorder,35,60,10,1,11
Madhya Pradesh,Chhatarpur,Autism Spectrum Disorder,60,80,1,0,1
Tamil Nadu,Chennai,Autism Spectrum Disorder,0,6,6,4,10
Tamil Nadu,Chennai,Autism Spectrum Disorder,6,15,160,35,195
Tamil Nadu,Chennai,Autism Spectrum Disorder,15,35,164,33,197
Tamil Nadu,Chennai,Autism Spectrum Disorder,35,60,8,5,13
Tamil Nadu,Chengalpattu,Autism Spectrum Disorder,0,6,8,3,11
Tamil Nadu,Chengalpattu,Autism Spectrum Disorder,6,15,91,16,107
Tamil Nadu,Chengalpattu,Autism Spectrum Disorder,15,35,18,2,20
Tamil Nadu,Chengalpattu,Autism Spectrum Disorder,35,60,3,0,3
Jharkhand,Chatra,Autism Spectrum Disorder,35,60,1,0,1
Haryana,Charki Dadri,Autism Spectrum Disorder,0,6,1,1,2
Haryana,Charki Dadri,Autism Spectrum Disorder,6,15,0,1,1
Assam,Charaideo,Autism Spectrum Disorder,0,6,2,0,2
Assam,Charaideo,Autism Spectrum Disorder,6,15,2,0,2
Assam,Charaideo,Autism Spectrum Disorder,15,35,0,1,1
Maharashtra,Chandrapur,Autism Spectrum Disorder,0,6,5,2,7
Maharashtra,Chandrapur,Autism Spectrum Disorder,6,15,30,4,34
Maharashtra,Chandrapur,Autism Spectrum Disorder,15,35,2,0,2
Chandigarh,Chandigarh,Autism Spectrum Disorder,0,6,13,3,16
Chandigarh,Chandigarh,Autism Spectrum Disorder,6,15,42,4,46
Chandigarh,Chandigarh,Autism Spectrum Disorder,15,35,21,5,26
Uttar Pradesh,Chandauli,Autism Spectrum Disorder,15,35,1,1,2
Mizoram,Champhai,Autism Spectrum Disorder,0,6,1,0,1
Mizoram,Champhai,Autism Spectrum Disorder,6,15,1,0,1
Uttarakhand,Champawat,Autism Spectrum Disorder,0,6,1,0,1
Uttarakhand,Champawat,Autism Spectrum Disorder,15,35,1,0,1
Uttarakhand,Champawat,Autism Spectrum Disorder,35,60,0,1,1
Uttarakhand,Chamoli,Autism Spectrum Disorder,35,60,2,1,3
Uttarakhand,Chamoli,Autism Spectrum Disorder,60,80,1,0,1
Himachal Pradesh,Chamba,Autism Spectrum Disorder,6,15,1,0,1
Himachal Pradesh,Chamba,Autism Spectrum Disorder,15,35,1,0,1
Karnataka,Chamarajanagara,Autism Spectrum Disorder,6,15,0,1,1
Karnataka,Chamarajanagara,Autism Spectrum Disorder,35,60,2,1,3
Karnataka,Chamarajanagara,Autism Spectrum Disorder,60,80,1,0,1
Delhi,Central,Autism Spectrum Disorder,0,6,3,1,4
Delhi,Central,Autism Spectrum Disorder,6,15,9,3,12
Delhi,Central,Autism Spectrum Disorder,15,35,3,0,3
Assam,Cachar,Autism Spectrum Disorder,6,15,1,0,1
Assam,Cachar,Autism Spectrum Disorder,35,60,2,0,2
Bihar,Buxar,Autism Spectrum Disorder,0,6,5,0,5
Bihar,Buxar,Autism Spectrum Disorder,6,15,117,70,187
Bihar,Buxar,Autism Spectrum Disorder,15,35,209,117,326
Bihar,Buxar,Autism Spectrum Disorder,35,60,242,126,368
Bihar,Buxar,Autism Spectrum Disorder,60,80,85,38,123
Bihar,Buxar,Autism Spectrum Disorder,80,100,2,4,6
Madhya Pradesh,Burhanpur,Autism Spectrum Disorder,6,15,3,1,4
Madhya Pradesh,Burhanpur,Autism Spectrum Disorder,15,35,2,0,2
Madhya Pradesh,Burhanpur,Autism Spectrum Disorder,35,60,1,1,2
Madhya Pradesh,Burhanpur,Autism Spectrum Disorder,60,80,1,0,1
Rajasthan,Bundi,Autism Spectrum Disorder,6,15,20,17,37
Rajasthan,Bundi,Autism Spectrum Disorder,15,35,119,71,190
Rajasthan,Bundi,Autism Spectrum Disorder,35,60,55,28,83
Rajasthan,Bundi,Autism Spectrum Disorder,60,80,7,4,11
Maharashtra,Buldhana,Autism Spectrum Disorder,0,6,1,0,1
Maharashtra,Buldhana,Autism Spectrum Disorder,6,15,16,2,18
Maharashtra,Buldhana,Autism Spectrum Disorder,15,35,0,1,1
Maharashtra,Buldhana,Autism Spectrum Disorder,35,60,0,1,1
Uttar Pradesh,Bulandshahr,Autism Spectrum Disorder,0,6,1,0,1
Uttar Pradesh,Bulandshahr,Autism Spectrum Disorder,6,15,1,0,1
Uttar Pradesh,Bulandshahr,Autism Spectrum Disorder,15,35,5,1,6
Uttar Pradesh,Bulandshahr,Autism Spectrum Disorder,35,60,13,1,14
Uttar Pradesh,Bulandshahr,Autism Spectrum Disorder,60,80,6,0,6
Jammu And Kashmir,Budgam,Autism Spectrum Disorder,6,15,6,1,7
Jammu And Kashmir,Budgam,Autism Spectrum Disorder,15,35,1,2,3
Jammu And Kashmir,Budgam,Autism Spectrum Disorder,35,60,2,0,2
Uttar Pradesh,Budaun,Autism Spectrum Disorder,0,6,1,1,2
Uttar Pradesh,Budaun,Autism Spectrum Disorder,6,15,10,7,17
Uttar Pradesh,Budaun,Autism Spectrum Disorder,15,35,26,10,36
Uttar Pradesh,Budaun,Autism Spectrum Disorder,35,60,7,2,9
Odisha,Boudh,Autism Spectrum Disorder,0,6,1,0,1
Odisha,Boudh,Autism Spectrum Disorder,6,15,5,0,5
Gujarat,Botad,Autism Spectrum Disorder,0,6,1,0,1
Gujarat,Botad,Autism Spectrum Disorder,6,15,2,0,2
Assam,Bongaigaon,Autism Spectrum Disorder,0,6,2,1,3
Assam,Bongaigaon,Autism Spectrum Disorder,6,15,2,2,4
Jharkhand,Bokaro,Autism Spectrum Disorder,6,15,0,6,6
Jharkhand,Bokaro,Autism Spectrum Disorder,15,35,7,3,10
Jharkhand,Bokaro,Autism Spectrum Disorder,35,60,9,7,16
Jharkhand,Bokaro,Autism Spectrum Disorder,60,80,3,0,3
Assam,Biswanath,Autism Spectrum Disorder,15,35,0,1,1
Manipur,Bishnupur,Autism Spectrum Disorder,6,15,1,0,1
West Bengal,Birbhum,Autism Spectrum Disorder,6,15,1,0,1
Chhattisgarh,Bilaspur,Autism Spectrum Disorder,6,15,2,1,3
Chhattisgarh,Bilaspur,Autism Spectrum Disorder,15,35,2,0,2
Himachal Pradesh,Bilaspur,Autism Spectrum Disorder,0,6,1,0,1
Himachal Pradesh,Bilaspur,Autism Spectrum Disorder,35,60,1,2,3
Rajasthan,Bikaner,Autism Spectrum Disorder,0,6,2,0,2
Rajasthan,Bikaner,Autism Spectrum Disorder,6,15,19,6,25
Rajasthan,Bikaner,Autism Spectrum Disorder,15,35,44,28,72
Rajasthan,Bikaner,Autism Spectrum Disorder,35,60,18,6,24
Rajasthan,Bikaner,Autism Spectrum Disorder,60,80,2,0,2
Uttar Pradesh,Bijnor,Autism Spectrum Disorder,6,15,6,2,8
Uttar Pradesh,Bijnor,Autism Spectrum Disorder,15,35,17,15,32
Uttar Pradesh,Bijnor,Autism Spectrum Disorder,35,60,31,8,39
Uttar Pradesh,Bijnor,Autism Spectrum Disorder,60,80,10,0,10
Chhattisgarh,Bijapur,Autism Spectrum Disorder,15,35,1,0,1
Karnataka,Bidar,Autism Spectrum Disorder,6,15,2,0,2
Karnataka,Bidar,Autism Spectrum Disorder,15,35,6,1,7
Karnataka,Bidar,Autism Spectrum Disorder,35,60,2,2,4
Madhya Pradesh,Bhopal,Autism Spectrum Disorder,0,6,28,9,37
Madhya Pradesh,Bhopal,Autism Spectrum Disorder,6,15,64,13,77
Madhya Pradesh,Bhopal,Autism Spectrum Disorder,15,35,26,10,36
Madhya Pradesh,Bhopal,Autism Spectrum Disorder,35,60,26,8,34
Madhya Pradesh,Bhopal,Autism Spectrum Disorder,60,80,8,2,10
Bihar,Bhojpur,Autism Spectrum Disorder,0,6,9,3,12
Bihar,Bhojpur,Autism Spectrum Disorder,6,15,172,114,286
Bihar,Bhojpur,Autism Spectrum Disorder,15,35,561,292,853
Bihar,Bhojpur,Autism Spectrum Disorder,35,60,490,215,705
Bihar,Bhojpur,Autism Spectrum Disorder,60,80,134,71,205
Bihar,Bhojpur,Autism Spectrum Disorder,80,100,10,1,11
Haryana,Bhiwani,Autism Spectrum Disorder,6,15,3,0,3
Haryana,Bhiwani,Autism Spectrum Disorder,15,35,2,0,2
Haryana,Bhiwani,Autism Spectrum Disorder,35,60,2,0,2
Madhya Pradesh,Bhind,Autism Spectrum Disorder,15,35,3,1,4
Madhya Pradesh,Bhind,Autism Spectrum Disorder,35,60,10,5,15
Madhya Pradesh,Bhind,Autism Spectrum Disorder,60,80,1,0,1
Rajasthan,Bhilwara,Autism Spectrum Disorder,6,15,27,19,46
Rajasthan,Bhilwara,Autism Spectrum Disorder,15,35,93,50,143
Rajasthan,Bhilwara,Autism Spectrum Disorder,35,60,36,16,52
Rajasthan,Bhilwara,Autism Spectrum Disorder,60,80,5,1,6
Rajasthan,Bhilwara,Autism Spectrum Disorder,80,100,1,1,2
Gujarat,Bhavnagar,Autism Spectrum Disorder,0,6,25,4,29
Gujarat,Bhavnagar,Autism Spectrum Disorder,6,15,37,5,42
Gujarat,Bhavnagar,Autism Spectrum Disorder,15,35,3,0,3
Gujarat,Bharuch,Autism Spectrum Disorder,0,6,2,0,2
Gujarat,Bharuch,Autism Spectrum Disorder,6,15,5,2,7
Gujarat,Bharuch,Autism Spectrum Disorder,15,35,1,0,1
Rajasthan,Bharatpur,Autism Spectrum Disorder,6,15,15,4,19
Rajasthan,Bharatpur,Autism Spectrum Disorder,15,35,88,28,116
Rajasthan,Bharatpur,Autism Spectrum Disorder,35,60,24,11,35
Rajasthan,Bharatpur,Autism Spectrum Disorder,60,80,3,2,5
Maharashtra,Bhandara,Autism Spectrum Disorder,35,60,2,5,7
Maharashtra,Bhandara,Autism Spectrum Disorder,60,80,0,1,1
Bihar,Bhagalpur,Autism Spectrum Disorder,0,6,3,4,7
Bihar,Bhagalpur,Autism Spectrum Disorder,6,15,145,108,253
Bihar,Bhagalpur,Autism Spectrum Disorder,15,35,370,194,564
Bihar,Bhagalpur,Autism Spectrum Disorder,35,60,359,203,562
Bihar,Bhagalpur,Autism Spectrum Disorder,60,80,124,54,178
Bihar,Bhagalpur,Autism Spectrum Disorder,80,100,4,2,6
Odisha,Bhadrak,Autism Spectrum Disorder,0,6,3,1,4
Odisha,Bhadrak,Autism Spectrum Disorder,6,15,16,4,20
Odisha,Bhadrak,Autism Spectrum Disorder,15,35,3,2,5
Odisha,Bhadrak,Autism Spectrum Disorder,35,60,3,1,4
Uttar Pradesh,Bhadohi,Autism Spectrum Disorder,0,6,0,1,1
Uttar Pradesh,Bhadohi,Autism Spectrum Disorder,6,15,0,1,1
Madhya Pradesh,Betul,Autism Spectrum Disorder,6,15,1,0,1
Madhya Pradesh,Betul,Autism Spectrum Disorder,15,35,6,2,8
Madhya Pradesh,Betul,Autism Spectrum Disorder,35,60,4,2,6
Madhya Pradesh,Betul,Autism Spectrum Disorder,60,80,1,1,2
Karnataka,Bengaluru Urban,Autism Spectrum Disorder,0,6,48,6,54
Karnataka,Bengaluru Urban,Autism Spectrum Disorder,6,15,259,54,313
Karnataka,Bengaluru Urban,Autism Spectrum Disorder,15,35,161,33,194
Karnataka,Bengaluru Urban,Autism Spectrum Disorder,35,60,4,3,7
Karnataka,Bengaluru Urban,Autism Spectrum Disorder,60,80,3,0,3
Karnataka,Bengaluru Rural,Autism Spectrum Disorder,0,6,2,0,2
Karnataka,Bengaluru Rural,Autism Spectrum Disorder,6,15,9,1,10
Karnataka,Bengaluru Rural,Autism Spectrum Disorder,15,35,4,0,4
Karnataka,Bengaluru Rural,Autism Spectrum Disorder,35,60,1,0,1
Chhattisgarh,Bemetara,Autism Spectrum Disorder,0,6,0,1,1
Chhattisgarh,Bemetara,Autism Spectrum Disorder,6,15,1,0,1
Karnataka,Belagavi,Autism Spectrum Disorder,0,6,3,0,3
Karnataka,Belagavi,Autism Spectrum Disorder,6,15,6,4,10
Karnataka,Belagavi,Autism Spectrum Disorder,15,35,10,4,14
Karnataka,Belagavi,Autism Spectrum Disorder,35,60,8,4,12
Karnataka,Belagavi,Autism Spectrum Disorder,60,80,5,3,8
Bihar,Begusarai,Autism Spectrum Disorder,0,6,3,0,3
Bihar,Begusarai,Autism Spectrum Disorder,6,15,204,110,314
Bihar,Begusarai,Autism Spectrum Disorder,15,35,583,306,889
Bihar,Begusarai,Autism Spectrum Disorder,35,60,487,253,740
Bihar,Begusarai,Autism Spectrum Disorder,60,80,132,49,181
Bihar,Begusarai,Autism Spectrum Disorder,80,100,7,1,8
Maharashtra,Beed,Autism Spectrum Disorder,6,15,2,2,4
Punjab,Bathinda,Autism Spectrum Disorder,0,6,2,1,3
Punjab,Bathinda,Autism Spectrum Disorder,6,15,4,2,6
Punjab,Bathinda,Autism Spectrum Disorder,15,35,3,1,4
Punjab,Bathinda,Autism Spectrum Disorder,35,60,1,0,1
Uttar Pradesh,Basti,Autism Spectrum Disorder,15,35,0,2,2
Uttar Pradesh,Basti,Autism Spectrum Disorder,35,60,2,0,2
Uttar Pradesh,Basti,Autism Spectrum Disorder,60,80,1,0,1
Chhattisgarh,Bastar,Autism Spectrum Disorder,0,6,1,0,1
Chhattisgarh,Bastar,Autism Spectrum Disorder,6,15,3,2,5
Chhattisgarh,Bastar,Autism Spectrum Disorder,15,35,2,2,4
Madhya Pradesh,Barwani,Autism Spectrum Disorder,0,6,1,0,1
Madhya Pradesh,Barwani,Autism Spectrum Disorder,15,35,1,1,2
Assam,Barpeta,Autism Spectrum Disorder,6,15,1,3,4
Assam,Barpeta,Autism Spectrum Disorder,15,35,5,1,6
Assam,Barpeta,Autism Spectrum Disorder,35,60,1,2,3
Punjab,Barnala,Autism Spectrum Disorder,6,15,2,0,2
Punjab,Barnala,Autism Spectrum Disorder,35,60,0,1,1
Rajasthan,Barmer,Autism Spectrum Disorder,6,15,13,5,18
Rajasthan,Barmer,Autism Spectrum Disorder,15,35,25,5,30
Rajasthan,Barmer,Autism Spectrum Disorder,35,60,4,3,7
Rajasthan,Barmer,Autism Spectrum Disorder,60,80,1,0,1
Odisha,Bargarh,Autism Spectrum Disorder,0,6,1,0,1
Odisha,Bargarh,Autism Spectrum Disorder,6,15,2,0,2
Odisha,Bargarh,Autism Spectrum Disorder,35,60,1,1,2
Uttar Pradesh,Bareilly,Autism Spectrum Disorder,0,6,6,0,6
Uttar Pradesh,Bareilly,Autism Spectrum Disorder,6,15,8,0,8
Uttar Pradesh,Bareilly,Autism Spectrum Disorder,15,35,15,4,19
Uttar Pradesh,Bareilly,Autism Spectrum Disorder,35,60,24,1,25
Uttar Pradesh,Bareilly,Autism Spectrum Disorder,60,80,3,0,3
Rajasthan,Baran,Autism Spectrum Disorder,6,15,14,4,18
Rajasthan,Baran,Autism Spectrum Disorder,15,35,63,40,103
Rajasthan,Baran,Autism Spectrum Disorder,35,60,35,18,53
Rajasthan,Baran,Autism Spectrum Disorder,60,80,4,4,8
Rajasthan,Baran,Autism Spectrum Disorder,80,100,1,0,1
Jammu And Kashmir,Baramulla,Autism Spectrum Disorder,0,6,1,0,1
Jammu And Kashmir,Baramulla,Autism Spectrum Disorder,6,15,7,6,13
Jammu And Kashmir,Baramulla,Autism Spectrum Disorder,15,35,5,3,8
Jammu And Kashmir,Baramulla,Autism Spectrum Disorder,35,60,4,3,7
Uttar Pradesh,Barabanki,Autism Spectrum Disorder,0,6,1,0,1
Uttar Pradesh,Barabanki,Autism Spectrum Disorder,6,15,3,1,4
Uttar Pradesh,Barabanki,Autism Spectrum Disorder,15,35,11,7,18
Uttar Pradesh,Barabanki,Autism Spectrum Disorder,35,60,13,0,13
Uttar Pradesh,Barabanki,Autism Spectrum Disorder,60,80,3,0,3
Rajasthan,Banswara,Autism Spectrum Disorder,6,15,8,3,11
Rajasthan,Banswara,Autism Spectrum Disorder,15,35,30,18,48
Rajasthan,Banswara,Autism Spectrum Disorder,35,60,21,9,30
Rajasthan,Banswara,Autism Spectrum Disorder,60,80,2,1,3
Bihar,Banka,Autism Spectrum Disorder,0,6,6,1,7
Bihar,Banka,Autism Spectrum Disorder,6,15,110,68,178
Bihar,Banka,Autism Spectrum Disorder,15,35,246,112,358
Bihar,Banka,Autism Spectrum Disorder,35,60,212,119,331
Bihar,Banka,Autism Spectrum Disorder,60,80,107,51,158
Bihar,Banka,Autism Spectrum Disorder,80,100,7,3,10
Jammu And Kashmir,Bandipora,Autism Spectrum Disorder,0,6,2,1,3
Jammu And Kashmir,Bandipora,Autism Spectrum Disorder,6,15,5,1,6
Jammu And Kashmir,Bandipora,Autism Spectrum Disorder,15,35,12,7,19
Jammu And Kashmir,Bandipora,Autism Spectrum Disorder,35,60,2,2,4
Jammu And Kashmir,Bandipora,Autism Spectrum Disorder,60,80,0,1,1
Uttar Pradesh,Banda,Autism Spectrum Disorder,6,15,1,0,1
Uttar Pradesh,Banda,Autism Spectrum Disorder,15,35,2,1,3
Uttar Pradesh,Banda,Autism Spectrum Disorder,35,60,9,2,11
Uttar Pradesh,Banda,Autism Spectrum Disorder,60,80,2,0,2
Gujarat,Banas Kantha,Autism Spectrum Disorder,15,35,0,1,1
Gujarat,Banas Kantha,Autism Spectrum Disorder,35,60,1,0,1
Chhattisgarh,Balrampur,Autism Spectrum Disorder,6,15,1,0,1
Uttar Pradesh,Balrampur,Autism Spectrum Disorder,6,15,2,0,2
Uttar Pradesh,Balrampur,Autism Spectrum Disorder,15,35,10,3,13
Uttar Pradesh,Balrampur,Autism Spectrum Disorder,35,60,8,5,13
Chhattisgarh,Baloda Bazar,Autism Spectrum Disorder,15,35,1,2,3
Chhattisgarh,Baloda Bazar,Autism Spectrum Disorder,35,60,2,2,4
Chhattisgarh,Balod,Autism Spectrum Disorder,6,15,1,0,1
Chhattisgarh,Balod,Autism Spectrum Disorder,15,35,4,0,4
Chhattisgarh,Balod,Autism Spectrum Disorder,35,60,4,1,5
Chhattisgarh,Balod,Autism Spectrum Disorder,60,80,1,0,1
Uttar Pradesh,Ballia,Autism Spectrum Disorder,0,6,1,1,2
Uttar Pradesh,Ballia,Autism Spectrum Disorder,6,15,1,0,1
Uttar Pradesh,Ballia,Autism Spectrum Disorder,15,35,2,2,4
Uttar Pradesh,Ballia,Autism Spectrum Disorder,35,60,6,2,8
Uttar Pradesh,Ballia,Autism Spectrum Disorder,60,80,3,0,3
Uttar Pradesh,Ballia,Autism Spectrum Disorder,80,100,1,0,1
Karnataka,Ballari,Autism Spectrum Disorder,0,6,1,0,1
Karnataka,Ballari,Autism Spectrum Disorder,6,15,4,1,5
Karnataka,Ballari,Autism Spectrum Disorder,15,35,6,2,8
Karnataka,Ballari,Autism Spectrum Disorder,35,60,8,7,15
Karnataka,Ballari,Autism Spectrum Disorder,60,80,1,1,2
Odisha,Baleshwar,Autism Spectrum Disorder,0,6,3,1,4
Odisha,Baleshwar,Autism Spectrum Disorder,6,15,15,4,19
Odisha,Baleshwar,Autism Spectrum Disorder,15,35,10,4,14
Odisha,Baleshwar,Autism Spectrum Disorder,35,60,5,4,9
Odisha,Baleshwar,Autism Spectrum Disorder,60,80,5,0,5
Odisha,Balangir,Autism Spectrum Disorder,0,6,7,1,8
Odisha,Balangir,Autism Spectrum Disorder,6,15,9,2,11
Odisha,Balangir,Autism Spectrum Disorder,15,35,2,5,7
Odisha,Balangir,Autism Spectrum Disorder,35,60,2,1,3
Odisha,Balangir,Autism Spectrum Disorder,60,80,4,1,5
Madhya Pradesh,Balaghat,Autism Spectrum Disorder,0,6,3,0,3
Madhya Pradesh,Balaghat,Autism Spectrum Disorder,6,15,5,3,8
Madhya Pradesh,Balaghat,Autism Spectrum Disorder,15,35,0,2,2
Madhya Pradesh,Balaghat,Autism Spectrum Disorder,35,60,1,0,1
Madhya Pradesh,Balaghat,Autism Spectrum Disorder,60,80,1,0,1
Assam,Baksa,Autism Spectrum Disorder,15,35,1,0,1
Uttar Pradesh,Bahraich,Autism Spectrum Disorder,15,35,0,2,2
Uttar Pradesh,Bahraich,Autism Spectrum Disorder,35,60,4,2,6
Uttar Pradesh,Bahraich,Autism Spectrum Disorder,80,100,1,0,1
Uttar Pradesh,Baghpat,Autism Spectrum Disorder,6,15,1,0,1
Uttar Pradesh,Baghpat,Autism Spectrum Disorder,15,35,6,0,6
Uttar Pradesh,Baghpat,Autism Spectrum Disorder,35,60,7,4,11
Uttar Pradesh,Baghpat,Autism Spectrum Disorder,60,80,3,0,3
Uttarakhand,Bageshwar,Autism Spectrum Disorder,6,15,0,1,1
Uttarakhand,Bageshwar,Autism Spectrum Disorder,15,35,0,1,1
Uttarakhand,Bageshwar,Autism Spectrum Disorder,35,60,1,2,3
Karnataka,Bagalkote,Autism Spectrum Disorder,6,15,1,0,1
Karnataka,Bagalkote,Autism Spectrum Disorder,15,35,1,1,2
Karnataka,Bagalkote,Autism Spectrum Disorder,35,60,1,0,1
Uttar Pradesh,Azamgarh,Autism Spectrum Disorder,0,6,1,0,1
Uttar Pradesh,Azamgarh,Autism Spectrum Disorder,15,35,1,0,1
Uttar Pradesh,Ayodhya,Autism Spectrum Disorder,0,6,1,0,1
Uttar Pradesh,Ayodhya,Autism Spectrum Disorder,6,15,1,1,2
Uttar Pradesh,Ayodhya,Autism Spectrum Disorder,15,35,3,2,5
Uttar Pradesh,Ayodhya,Autism Spectrum Disorder,35,60,1,1,2
Bihar,Aurangabad,Autism Spectrum Disorder,0,6,4,4,8
Bihar,Aurangabad,Autism Spectrum Disorder,6,15,134,71,205
Bihar,Aurangabad,Autism Spectrum Disorder,15,35,619,329,948
Bihar,Aurangabad,Autism Spectrum Disorder,35,60,763,353,1116
Bihar,Aurangabad,Autism Spectrum Disorder,60,80,266,156,422
Bihar,Aurangabad,Autism Spectrum Disorder,80,100,18,4,22
Maharashtra,Aurangabad,Autism Spectrum Disorder,0,6,1,0,1
Maharashtra,Aurangabad,Autism Spectrum Disorder,6,15,8,1,9
Maharashtra,Aurangabad,Autism Spectrum Disorder,15,35,4,0,4
Maharashtra,Aurangabad,Autism Spectrum Disorder,35,60,0,1,1
Uttar Pradesh,Auraiya,Autism Spectrum Disorder,0,6,1,0,1
Uttar Pradesh,Auraiya,Autism Spectrum Disorder,6,15,1,0,1
Uttar Pradesh,Auraiya,Autism Spectrum Disorder,15,35,4,1,5
Uttar Pradesh,Auraiya,Autism Spectrum Disorder,35,60,18,3,21
Uttar Pradesh,Auraiya,Autism Spectrum Disorder,60,80,7,1,8
Bihar,Arwal,Autism Spectrum Disorder,0,6,1,2,3
Bihar,Arwal,Autism Spectrum Disorder,6,15,57,33,90
Bihar,Arwal,Autism Spectrum Disorder,15,35,218,105,323
Bihar,Arwal,Autism Spectrum Disorder,35,60,296,273,569
Bihar,Arwal,Autism Spectrum Disorder,60,80,167,131,298
Bihar,Arwal,Autism Spectrum Disorder,80,100,13,5,18
Gujarat,Arvalli,Autism Spectrum Disorder,35,60,1,0,1
Tamil Nadu,Ariyalur,Autism Spectrum Disorder,0,6,2,0,2
Tamil Nadu,Ariyalur,Autism Spectrum Disorder,6,15,2,1,3
Tamil Nadu,Ariyalur,Autism Spectrum Disorder,15,35,1,0,1
Tamil Nadu,Ariyalur,Autism Spectrum Disorder,35,60,1,0,1
Bihar,Araria,Autism Spectrum Disorder,0,6,8,0,8
Bihar,Araria,Autism Spectrum Disorder,6,15,146,103,249
Bihar,Araria,Autism Spectrum Disorder,15,35,366,207,573
Bihar,Araria,Autism Spectrum Disorder,35,60,365,178,543
Bihar,Araria,Autism Spectrum Disorder,60,80,115,50,165
Bihar,Araria,Autism Spectrum Disorder,80,100,7,1,8
Madhya Pradesh,Anuppur,Autism Spectrum Disorder,6,15,1,0,1
Madhya Pradesh,Anuppur,Autism Spectrum Disorder,15,35,1,0,1
Odisha,Anugul,Autism Spectrum Disorder,0,6,8,1,9
Odisha,Anugul,Autism Spectrum Disorder,6,15,9,3,12
Odisha,Anugul,Autism Spectrum Disorder,15,35,7,1,8
Jammu And Kashmir,Anantnag,Autism Spectrum Disorder,0,6,5,0,5
Jammu And Kashmir,Anantnag,Autism Spectrum Disorder,6,15,3,3,6
Jammu And Kashmir,Anantnag,Autism Spectrum Disorder,15,35,1,0,1
Jammu And Kashmir,Anantnag,Autism Spectrum Disorder,35,60,1,1,2
Jammu And Kashmir,Anantnag,Autism Spectrum Disorder,60,80,0,1,1
Andhra Pradesh,Anantapur,Autism Spectrum Disorder,6,15,2,0,2
Gujarat,Anand,Autism Spectrum Disorder,0,6,4,1,5
Gujarat,Anand,Autism Spectrum Disorder,6,15,40,16,56
Gujarat,Anand,Autism Spectrum Disorder,15,35,8,5,13
Gujarat,Anand,Autism Spectrum Disorder,35,60,1,0,1
Uttar Pradesh,Amroha,Autism Spectrum Disorder,15,35,12,1,13
Uttar Pradesh,Amroha,Autism Spectrum Disorder,35,60,12,1,13
Uttar Pradesh,Amroha,Autism Spectrum Disorder,60,80,6,0,6
Punjab,Amritsar,Autism Spectrum Disorder,0,6,1,1,2
Punjab,Amritsar,Autism Spectrum Disorder,6,15,13,2,15
Punjab,Amritsar,Autism Spectrum Disorder,15,35,3,0,3
Punjab,Amritsar,Autism Spectrum Disorder,35,60,1,1,2
Gujarat,Amreli,Autism Spectrum Disorder,0,6,1,1,2
Gujarat,Amreli,Autism Spectrum Disorder,6,15,5,1,6
Gujarat,Amreli,Autism Spectrum Disorder,15,35,1,0,1
Gujarat,Amreli,Autism Spectrum Disorder,35,60,2,0,2
Maharashtra,Amravati,Autism Spectrum Disorder,0,6,4,2,6
Maharashtra,Amravati,Autism Spectrum Disorder,6,15,6,2,8
Maharashtra,Amravati,Autism Spectrum Disorder,15,35,1,3,4
Maharashtra,Amravati,Autism Spectrum Disorder,35,60,1,0,1
Maharashtra,Amravati,Autism Spectrum Disorder,60,80,1,0,1
Uttar Pradesh,Amethi,Autism Spectrum Disorder,15,35,1,0,1
Uttar Pradesh,Amethi,Autism Spectrum Disorder,35,60,0,1,1
Uttar Pradesh,Ambedkar Nagar,Autism Spectrum Disorder,15,35,6,0,6
Uttar Pradesh,Ambedkar Nagar,Autism Spectrum Disorder,35,60,5,0,5
Uttar Pradesh,Ambedkar Nagar,Autism Spectrum Disorder,60,80,2,0,2
Haryana,Ambala,Autism Spectrum Disorder,0,6,5,1,6
Haryana,Ambala,Autism Spectrum Disorder,6,15,6,2,8
Haryana,Ambala,Autism Spectrum Disorder,15,35,1,0,1
Haryana,Ambala,Autism Spectrum Disorder,35,60,2,0,2
Haryana,Ambala,Autism Spectrum Disorder,60,80,1,0,1
Rajasthan,Alwar,Autism Spectrum Disorder,6,15,70,39,109
Rajasthan,Alwar,Autism Spectrum Disorder,15,35,129,80,209
Rajasthan,Alwar,Autism Spectrum Disorder,35,60,39,17,56
Rajasthan,Alwar,Autism Spectrum Disorder,60,80,2,1,3
Rajasthan,Alwar,Autism Spectrum Disorder,80,100,0,1,1
Uttarakhand,Almora,Autism Spectrum Disorder,6,15,3,0,3
Uttar Pradesh,Aligarh,Autism Spectrum Disorder,0,6,5,1,6
Uttar Pradesh,Aligarh,Autism Spectrum Disorder,6,15,7,1,8
Uttar Pradesh,Aligarh,Autism Spectrum Disorder,15,35,9,3,12
Uttar Pradesh,Aligarh,Autism Spectrum Disorder,35,60,7,1,8
Uttar Pradesh,Aligarh,Autism Spectrum Disorder,60,80,3,1,4
Kerala,Alappuzha,Autism Spectrum Disorder,0,6,8,5,13
Kerala,Alappuzha,Autism Spectrum Disorder,6,15,85,21,106
Kerala,Alappuzha,Autism Spectrum Disorder,15,35,27,6,33
Maharashtra,Akola,Autism Spectrum Disorder,0,6,3,2,5
Maharashtra,Akola,Autism Spectrum Disorder,6,15,5,3,8
Maharashtra,Akola,Autism Spectrum Disorder,15,35,1,0,1
Rajasthan,Ajmer,Autism Spectrum Disorder,6,15,4,1,5
Rajasthan,Ajmer,Autism Spectrum Disorder,15,35,33,22,55
Rajasthan,Ajmer,Autism Spectrum Disorder,35,60,24,7,31
Rajasthan,Ajmer,Autism Spectrum Disorder,60,80,1,1,2
Mizoram,Aizawl,Autism Spectrum Disorder,0,6,4,2,6
Mizoram,Aizawl,Autism Spectrum Disorder,6,15,13,5,18
Mizoram,Aizawl,Autism Spectrum Disorder,15,35,2,0,2
Maharashtra,Ahmednagar,Autism Spectrum Disorder,0,6,2,0,2
Maharashtra,Ahmednagar,Autism Spectrum Disorder,6,15,3,0,3
Maharashtra,Ahmednagar,Autism Spectrum Disorder,15,35,3,1,4
Maharashtra,Ahmednagar,Autism Spectrum Disorder,35,60,3,1,4
Gujarat,Ahmadabad,Autism Spectrum Disorder,0,6,21,7,28
Gujarat,Ahmadabad,Autism Spectrum Disorder,6,15,65,22,87
Gujarat,Ahmadabad,Autism Spectrum Disorder,15,35,19,1,20
Uttar Pradesh,Agra,Autism Spectrum Disorder,0,6,2,3,5
Uttar Pradesh,Agra,Autism Spectrum Disorder,6,15,8,0,8
Uttar Pradesh,Agra,Autism Spectrum Disorder,15,35,1,0,1
Uttar Pradesh,Agra,Autism Spectrum Disorder,35,60,1,1,2
Madhya Pradesh,Agar Malwa,Autism Spectrum Disorder,0,6,2,0,2
Madhya Pradesh,Agar Malwa,Autism Spectrum Disorder,6,15,2,2,4
West Bengal,24 Paraganas North,Autism Spectrum Disorder,15,35,0,1,1
Nagaland,Zunheboto,Blindness,15,35,1,1,2
Nagaland,Zunheboto,Blindness,35,60,2,0,2
Maharashtra,Yavatmal,Blindness,0,6,15,15,30
Maharashtra,Yavatmal,Blindness,6,15,86,91,177
Maharashtra,Yavatmal,Blindness,15,35,539,321,860
Maharashtra,Yavatmal,Blindness,35,60,774,313,1087
Maharashtra,Yavatmal,Blindness,60,80,374,131,505
Maharashtra,Yavatmal,Blindness,80,100,21,8,29
Puducherry,Yanam,Blindness,6,15,3,0,3
Puducherry,Yanam,Blindness,15,35,17,16,33
Puducherry,Yanam,Blindness,35,60,44,44,88
Puducherry,Yanam,Blindness,60,80,26,9,35
Puducherry,Yanam,Blindness,80,100,6,3,9
Haryana,Yamunanagar,Blindness,0,6,2,5,7
Haryana,Yamunanagar,Blindness,6,15,33,27,60
Haryana,Yamunanagar,Blindness,15,35,77,55,132
Haryana,Yamunanagar,Blindness,35,60,101,43,144
Haryana,Yamunanagar,Blindness,60,80,32,19,51
Haryana,Yamunanagar,Blindness,80,100,5,2,7
Karnataka,Yadgir,Blindness,0,6,18,19,37
Karnataka,Yadgir,Blindness,6,15,165,123,288
Karnataka,Yadgir,Blindness,15,35,550,613,1163
Karnataka,Yadgir,Blindness,35,60,877,835,1712
Karnataka,Yadgir,Blindness,60,80,124,80,204
Karnataka,Yadgir,Blindness,80,100,6,3,9
Andhra Pradesh,Y.S.R.,Blindness,0,6,5,6,11
Andhra Pradesh,Y.S.R.,Blindness,6,15,107,101,208
Andhra Pradesh,Y.S.R.,Blindness,15,35,545,209,754
Andhra Pradesh,Y.S.R.,Blindness,35,60,1506,97,1603
Andhra Pradesh,Y.S.R.,Blindness,60,80,471,23,494
Andhra Pradesh,Y.S.R.,Blindness,80,100,48,4,52
Nagaland,Wokha,Blindness,0,6,1,0,1
Nagaland,Wokha,Blindness,6,15,1,0,1
Nagaland,Wokha,Blindness,15,35,6,2,8
Nagaland,Wokha,Blindness,35,60,3,3,6
Nagaland,Wokha,Blindness,60,80,1,0,1
Tripura,West Tripura,Blindness,0,6,1,0,1
Tripura,West Tripura,Blindness,6,15,6,5,11
Tripura,West Tripura,Blindness,15,35,65,47,112
Tripura,West Tripura,Blindness,35,60,106,68,174
Tripura,West Tripura,Blindness,60,80,34,19,53
Tripura,West Tripura,Blindness,80,100,3,4,7
Jharkhand,West Singhbhum,Blindness,0,6,4,4,8
Jharkhand,West Singhbhum,Blindness,6,15,69,40,109
Jharkhand,West Singhbhum,Blindness,15,35,124,74,198
Jharkhand,West Singhbhum,Blindness,35,60,151,73,224
Jharkhand,West Singhbhum,Blindness,60,80,30,13,43
Jharkhand,West Singhbhum,Blindness,80,100,2,2,4
Arunachal Pradesh,West Siang,Blindness,15,35,0,1,1
Arunachal Pradesh,West Siang,Blindness,35,60,2,1,3
Arunachal Pradesh,West Siang,Blindness,60,80,0,1,1
Meghalaya,West Khasi Hills,Blindness,0,6,0,1,1
Meghalaya,West Khasi Hills,Blindness,6,15,9,8,17
Meghalaya,West Khasi Hills,Blindness,15,35,15,15,30
Meghalaya,West Khasi Hills,Blindness,35,60,11,5,16
Meghalaya,West Khasi Hills,Blindness,60,80,7,7,14
Meghalaya,West Khasi Hills,Blindness,80,100,0,2,2
Assam,West Karbi Anglong,Blindness,0,6,0,1,1
Assam,West Karbi Anglong,Blindness,6,15,0,1,1
Assam,West Karbi Anglong,Blindness,15,35,2,6,8
Assam,West Karbi Anglong,Blindness,35,60,3,6,9
Assam,West Karbi Anglong,Blindness,60,80,2,1,3
Arunachal Pradesh,West Kameng,Blindness,15,35,0,1,1
Meghalaya,West Jaintia Hills,Blindness,0,6,2,2,4
Meghalaya,West Jaintia Hills,Blindness,6,15,13,18,31
Meghalaya,West Jaintia Hills,Blindness,15,35,24,28,52
Meghalaya,West Jaintia Hills,Blindness,35,60,18,17,35
Meghalaya,West Jaintia Hills,Blindness,60,80,4,3,7
Meghalaya,West Jaintia Hills,Blindness,80,100,2,0,2
Andhra Pradesh,West Godavari,Blindness,0,6,3,11,14
Andhra Pradesh,West Godavari,Blindness,6,15,78,57,135
Andhra Pradesh,West Godavari,Blindness,15,35,355,128,483
Andhra Pradesh,West Godavari,Blindness,35,60,960,53,1013
Andhra Pradesh,West Godavari,Blindness,60,80,326,19,345
Andhra Pradesh,West Godavari,Blindness,80,100,22,0,22
Meghalaya,West Garo Hills,Blindness,6,15,15,4,19
Meghalaya,West Garo Hills,Blindness,15,35,84,93,177
Meghalaya,West Garo Hills,Blindness,35,60,112,71,183
Meghalaya,West Garo Hills,Blindness,60,80,67,34,101
Meghalaya,West Garo Hills,Blindness,80,100,4,1,5
Delhi,West,Blindness,0,6,3,4,7
Delhi,West,Blindness,6,15,36,25,61
Delhi,West,Blindness,15,35,142,98,240
Delhi,West,Blindness,35,60,121,50,171
Delhi,West,Blindness,60,80,37,14,51
Delhi,West,Blindness,80,100,1,1,2
Kerala,Wayanad,Blindness,0,6,1,2,3
Kerala,Wayanad,Blindness,6,15,8,12,20
Kerala,Wayanad,Blindness,15,35,43,32,75
Kerala,Wayanad,Blindness,35,60,140,111,251
Kerala,Wayanad,Blindness,60,80,88,54,142
Kerala,Wayanad,Blindness,80,100,5,5,10
Maharashtra,Washim,Blindness,0,6,15,9,24
Maharashtra,Washim,Blindness,6,15,94,72,166
Maharashtra,Washim,Blindness,15,35,457,247,704
Maharashtra,Washim,Blindness,35,60,643,277,920
Maharashtra,Washim,Blindness,60,80,358,160,518
Maharashtra,Washim,Blindness,80,100,20,14,34
Maharashtra,Wardha,Blindness,0,6,5,2,7
Maharashtra,Wardha,Blindness,6,15,30,30,60
Maharashtra,Wardha,Blindness,15,35,165,100,265
Maharashtra,Wardha,Blindness,35,60,239,142,381
Maharashtra,Wardha,Blindness,60,80,148,63,211
Maharashtra,Wardha,Blindness,80,100,12,5,17
Andhra Pradesh,Vizianagaram,Blindness,0,6,8,10,18
Andhra Pradesh,Vizianagaram,Blindness,6,15,116,75,191
Andhra Pradesh,Vizianagaram,Blindness,15,35,640,283,923
Andhra Pradesh,Vizianagaram,Blindness,35,60,1408,149,1557
Andhra Pradesh,Vizianagaram,Blindness,60,80,679,73,752
Andhra Pradesh,Vizianagaram,Blindness,80,100,77,14,91
Andhra Pradesh,Visakhapatanam,Blindness,0,6,7,4,11
Andhra Pradesh,Visakhapatanam,Blindness,6,15,132,82,214
Andhra Pradesh,Visakhapatanam,Blindness,15,35,787,315,1102
Andhra Pradesh,Visakhapatanam,Blindness,35,60,1535,214,1749
Andhra Pradesh,Visakhapatanam,Blindness,60,80,531,64,595
Andhra Pradesh,Visakhapatanam,Blindness,80,100,35,13,48
Tamil Nadu,Virudhunagar,Blindness,0,6,5,1,6
Tamil Nadu,Virudhunagar,Blindness,6,15,41,26,67
Tamil Nadu,Virudhunagar,Blindness,15,35,203,147,350
Tamil Nadu,Virudhunagar,Blindness,35,60,405,250,655
Tamil Nadu,Virudhunagar,Blindness,60,80,153,83,236
Tamil Nadu,Virudhunagar,Blindness,80,100,7,3,10
Tamil Nadu,Villupuram,Blindness,0,6,2,1,3
Tamil Nadu,Villupuram,Blindness,6,15,28,27,55
Tamil Nadu,Villupuram,Blindness,15,35,127,111,238
Tamil Nadu,Villupuram,Blindness,35,60,322,229,551
Tamil Nadu,Villupuram,Blindness,60,80,133,52,185
Tamil Nadu,Villupuram,Blindness,80,100,9,3,12
Karnataka,Vijayapura,Blindness,0,6,22,17,39
Karnataka,Vijayapura,Blindness,6,15,178,129,307
Karnataka,Vijayapura,Blindness,15,35,605,395,1000
Karnataka,Vijayapura,Blindness,35,60,741,386,1127
Karnataka,Vijayapura,Blindness,60,80,163,64,227
Karnataka,Vijayapura,Blindness,80,100,6,8,14
Madhya Pradesh,Vidisha,Blindness,0,6,8,6,14
Madhya Pradesh,Vidisha,Blindness,6,15,78,58,136
Madhya Pradesh,Vidisha,Blindness,15,35,398,203,601
Madhya Pradesh,Vidisha,Blindness,35,60,384,191,575
Madhya Pradesh,Vidisha,Blindness,60,80,160,72,232
Madhya Pradesh,Vidisha,Blindness,80,100,19,5,24
Tamil Nadu,Vellore,Blindness,0,6,2,0,2
Tamil Nadu,Vellore,Blindness,6,15,23,25,48
Tamil Nadu,Vellore,Blindness,15,35,218,132,350
Tamil Nadu,Vellore,Blindness,35,60,404,220,624
Tamil Nadu,Vellore,Blindness,60,80,152,49,201
Tamil Nadu,Vellore,Blindness,80,100,19,4,23
Uttar Pradesh,Varanasi,Blindness,0,6,8,10,18
Uttar Pradesh,Varanasi,Blindness,6,15,65,59,124
Uttar Pradesh,Varanasi,Blindness,15,35,411,265,676
Uttar Pradesh,Varanasi,Blindness,35,60,385,184,569
Uttar Pradesh,Varanasi,Blindness,60,80,137,49,186
Uttar Pradesh,Varanasi,Blindness,80,100,6,7,13
Gujarat,Valsad,Blindness,0,6,5,5,10
Gujarat,Valsad,Blindness,6,15,76,63,139
Gujarat,Valsad,Blindness,15,35,269,182,451
Gujarat,Valsad,Blindness,35,60,235,109,344
Gujarat,Valsad,Blindness,60,80,78,32,110
Gujarat,Valsad,Blindness,80,100,8,7,15
Bihar,Vaishali,Blindness,0,6,10,9,19
Bihar,Vaishali,Blindness,6,15,62,40,102
Bihar,Vaishali,Blindness,15,35,173,119,292
Bihar,Vaishali,Blindness,35,60,120,57,177
Bihar,Vaishali,Blindness,60,80,32,14,46
Bihar,Vaishali,Blindness,80,100,4,0,4
Gujarat,Vadodara,Blindness,0,6,10,4,14
Gujarat,Vadodara,Blindness,6,15,37,32,69
Gujarat,Vadodara,Blindness,15,35,209,148,357
Gujarat,Vadodara,Blindness,35,60,279,135,414
Gujarat,Vadodara,Blindness,60,80,188,56,244
Gujarat,Vadodara,Blindness,80,100,11,6,17
Karnataka,Uttara Kannada,Blindness,0,6,7,1,8
Karnataka,Uttara Kannada,Blindness,6,15,23,17,40
Karnataka,Uttara Kannada,Blindness,15,35,123,88,211
Karnataka,Uttara Kannada,Blindness,35,60,294,195,489
Karnataka,Uttara Kannada,Blindness,60,80,183,99,282
Karnataka,Uttara Kannada,Blindness,80,100,5,9,14
Uttarakhand,Uttar Kashi,Blindness,0,6,1,0,1
Uttarakhand,Uttar Kashi,Blindness,6,15,19,12,31
Uttarakhand,Uttar Kashi,Blindness,15,35,106,58,164
Uttarakhand,Uttar Kashi,Blindness,35,60,133,79,212
Uttarakhand,Uttar Kashi,Blindness,60,80,24,26,50
Uttarakhand,Uttar Kashi,Blindness,80,100,1,0,1
Arunachal Pradesh,Upper Subansiri,Blindness,15,35,5,1,6
Arunachal Pradesh,Upper Subansiri,Blindness,35,60,1,1,2
Arunachal Pradesh,Upper Siang,Blindness,15,35,1,3,4
Uttar Pradesh,Unnao,Blindness,0,6,4,2,6
Uttar Pradesh,Unnao,Blindness,6,15,27,15,42
Uttar Pradesh,Unnao,Blindness,15,35,193,112,305
Uttar Pradesh,Unnao,Blindness,35,60,329,136,465
Uttar Pradesh,Unnao,Blindness,60,80,222,98,320
Uttar Pradesh,Unnao,Blindness,80,100,13,6,19
Tripura,Unakoti,Blindness,6,15,8,5,13
Tripura,Unakoti,Blindness,15,35,57,34,91
Tripura,Unakoti,Blindness,35,60,55,54,109
Tripura,Unakoti,Blindness,60,80,16,14,30
Tripura,Unakoti,Blindness,80,100,4,1,5
Himachal Pradesh,Una,Blindness,6,15,11,6,17
Himachal Pradesh,Una,Blindness,15,35,33,16,49
Himachal Pradesh,Una,Blindness,35,60,65,31,96
Himachal Pradesh,Una,Blindness,60,80,65,20,85
Himachal Pradesh,Una,Blindness,80,100,7,7,14
Madhya Pradesh,Umaria,Blindness,0,6,1,1,2
Madhya Pradesh,Umaria,Blindness,6,15,26,27,53
Madhya Pradesh,Umaria,Blindness,15,35,135,94,229
Madhya Pradesh,Umaria,Blindness,35,60,150,85,235
Madhya Pradesh,Umaria,Blindness,60,80,75,33,108
Madhya Pradesh,Umaria,Blindness,80,100,5,3,8
Manipur,Ukhrul,Blindness,6,15,0,2,2
Manipur,Ukhrul,Blindness,15,35,6,4,10
Manipur,Ukhrul,Blindness,35,60,8,7,15
Manipur,Ukhrul,Blindness,60,80,2,3,5
Madhya Pradesh,Ujjain,Blindness,0,6,1,1,2
Madhya Pradesh,Ujjain,Blindness,6,15,38,16,54
Madhya Pradesh,Ujjain,Blindness,15,35,143,90,233
Madhya Pradesh,Ujjain,Blindness,35,60,233,101,334
Madhya Pradesh,Ujjain,Blindness,60,80,107,43,150
Madhya Pradesh,Ujjain,Blindness,80,100,14,5,19
Karnataka,Udupi,Blindness,0,6,2,5,7
Karnataka,Udupi,Blindness,6,15,18,10,28
Karnataka,Udupi,Blindness,15,35,79,57,136
Karnataka,Udupi,Blindness,35,60,186,137,323
Karnataka,Udupi,Blindness,60,80,121,65,186
Karnataka,Udupi,Blindness,80,100,4,4,8
Jammu And Kashmir,Udhampur,Blindness,0,6,3,0,3
Jammu And Kashmir,Udhampur,Blindness,6,15,29,16,45
Jammu And Kashmir,Udhampur,Blindness,15,35,139,54,193
Jammu And Kashmir,Udhampur,Blindness,35,60,154,74,228
Jammu And Kashmir,Udhampur,Blindness,60,80,41,15,56
Jammu And Kashmir,Udhampur,Blindness,80,100,3,2,5
Uttarakhand,Udam Singh Nagar,Blindness,0,6,1,2,3
Uttarakhand,Udam Singh Nagar,Blindness,6,15,16,19,35
Uttarakhand,Udam Singh Nagar,Blindness,15,35,116,52,168
Uttarakhand,Udam Singh Nagar,Blindness,35,60,152,69,221
Uttarakhand,Udam Singh Nagar,Blindness,60,80,34,28,62
Uttarakhand,Udam Singh Nagar,Blindness,80,100,0,2,2
Assam,Udalguri,Blindness,0,6,2,11,13
Assam,Udalguri,Blindness,6,15,20,18,38
Assam,Udalguri,Blindness,15,35,71,51,122
Assam,Udalguri,Blindness,35,60,78,60,138
Assam,Udalguri,Blindness,60,80,23,16,39
Assam,Udalguri,Blindness,80,100,1,2,3
Rajasthan,Udaipur,Blindness,0,6,4,4,8
Rajasthan,Udaipur,Blindness,6,15,58,37,95
Rajasthan,Udaipur,Blindness,15,35,258,141,399
Rajasthan,Udaipur,Blindness,35,60,259,150,409
Rajasthan,Udaipur,Blindness,60,80,121,62,183
Rajasthan,Udaipur,Blindness,80,100,14,11,25
Tamil Nadu,Tuticorin,Blindness,0,6,2,5,7
Tamil Nadu,Tuticorin,Blindness,6,15,37,28,65
Tamil Nadu,Tuticorin,Blindness,15,35,149,139,288
Tamil Nadu,Tuticorin,Blindness,35,60,390,319,709
Tamil Nadu,Tuticorin,Blindness,60,80,195,92,287
Tamil Nadu,Tuticorin,Blindness,80,100,20,6,26
Karnataka,Tumakuru,Blindness,0,6,7,6,13
Karnataka,Tumakuru,Blindness,6,15,135,95,230
Karnataka,Tumakuru,Blindness,15,35,648,479,1127
Karnataka,Tumakuru,Blindness,35,60,1164,765,1929
Karnataka,Tumakuru,Blindness,60,80,361,164,525
Karnataka,Tumakuru,Blindness,80,100,19,6,25
Nagaland,Tuensang,Blindness,15,35,1,1,2
Nagaland,Tuensang,Blindness,35,60,2,0,2
Rajasthan,Tonk,Blindness,0,6,5,5,10
Rajasthan,Tonk,Blindness,6,15,37,27,64
Rajasthan,Tonk,Blindness,15,35,295,124,419
Rajasthan,Tonk,Blindness,35,60,283,127,410
Rajasthan,Tonk,Blindness,60,80,110,73,183
Rajasthan,Tonk,Blindness,80,100,16,13,29
Tamil Nadu,Tiruvannamalai,Blindness,0,6,5,5,10
Tamil Nadu,Tiruvannamalai,Blindness,6,15,23,21,44
Tamil Nadu,Tiruvannamalai,Blindness,15,35,177,110,287
Tamil Nadu,Tiruvannamalai,Blindness,35,60,458,310,768
Tamil Nadu,Tiruvannamalai,Blindness,60,80,212,122,334
Tamil Nadu,Tiruvannamalai,Blindness,80,100,18,6,24
Tamil Nadu,Tiruppur,Blindness,0,6,2,0,2
Tamil Nadu,Tiruppur,Blindness,6,15,12,15,27
Tamil Nadu,Tiruppur,Blindness,15,35,94,55,149
Tamil Nadu,Tiruppur,Blindness,35,60,183,107,290
Tamil Nadu,Tiruppur,Blindness,60,80,50,18,68
Tamil Nadu,Tiruppur,Blindness,80,100,3,2,5
Tamil Nadu,Tirupathur,Blindness,0,6,1,1,2
Tamil Nadu,Tirupathur,Blindness,6,15,3,10,13
Tamil Nadu,Tirupathur,Blindness,15,35,40,16,56
Tamil Nadu,Tirupathur,Blindness,35,60,94,46,140
Tamil Nadu,Tirupathur,Blindness,60,80,35,15,50
Tamil Nadu,Tirupathur,Blindness,80,100,2,1,3
Tamil Nadu,Tirunelveli,Blindness,0,6,4,4,8
Tamil Nadu,Tirunelveli,Blindness,6,15,44,27,71
Tamil Nadu,Tirunelveli,Blindness,15,35,236,141,377
Tamil Nadu,Tirunelveli,Blindness,35,60,469,270,739
Tamil Nadu,Tirunelveli,Blindness,60,80,162,94,256
Tamil Nadu,Tirunelveli,Blindness,80,100,10,10,20
Tamil Nadu,Tiruchirappalli,Blindness,0,6,11,7,18
Tamil Nadu,Tiruchirappalli,Blindness,6,15,44,39,83
Tamil Nadu,Tiruchirappalli,Blindness,15,35,303,215,518
Tamil Nadu,Tiruchirappalli,Blindness,35,60,792,562,1354
Tamil Nadu,Tiruchirappalli,Blindness,60,80,360,165,525
Tamil Nadu,Tiruchirappalli,Blindness,80,100,19,11,30
Arunachal Pradesh,Tirap,Blindness,15,35,5,3,8
Arunachal Pradesh,Tirap,Blindness,35,60,0,1,1
Arunachal Pradesh,Tirap,Blindness,60,80,0,1,1
Assam,Tinsukia,Blindness,0,6,1,0,1
Assam,Tinsukia,Blindness,6,15,6,4,10
Assam,Tinsukia,Blindness,15,35,21,19,40
Assam,Tinsukia,Blindness,35,60,40,16,56
Assam,Tinsukia,Blindness,60,80,11,5,16
Madhya Pradesh,Tikamgarh,Blindness,0,6,10,2,12
Madhya Pradesh,Tikamgarh,Blindness,6,15,24,29,53
Madhya Pradesh,Tikamgarh,Blindness,15,35,194,123,317
Madhya Pradesh,Tikamgarh,Blindness,35,60,223,142,365
Madhya Pradesh,Tikamgarh,Blindness,60,80,130,61,191
Madhya Pradesh,Tikamgarh,Blindness,80,100,10,9,19
Kerala,Thrissur,Blindness,0,6,2,1,3
Kerala,Thrissur,Blindness,6,15,28,27,55
Kerala,Thrissur,Blindness,15,35,154,75,229
Kerala,Thrissur,Blindness,35,60,376,222,598
Kerala,Thrissur,Blindness,60,80,251,138,389
Kerala,Thrissur,Blindness,80,100,19,11,30
Manipur,Thoubal,Blindness,0,6,0,1,1
Manipur,Thoubal,Blindness,6,15,4,1,5
Manipur,Thoubal,Blindness,15,35,12,15,27
Manipur,Thoubal,Blindness,35,60,22,6,28
Manipur,Thoubal,Blindness,60,80,4,4,8
Tamil Nadu,Thiruvarur,Blindness,6,15,20,19,39
Tamil Nadu,Thiruvarur,Blindness,15,35,124,98,222
Tamil Nadu,Thiruvarur,Blindness,35,60,219,124,343
Tamil Nadu,Thiruvarur,Blindness,60,80,107,24,131
Tamil Nadu,Thiruvarur,Blindness,80,100,5,1,6
Kerala,Thiruvananthapuram,Blindness,0,6,6,7,13
Kerala,Thiruvananthapuram,Blindness,6,15,54,39,93
Kerala,Thiruvananthapuram,Blindness,15,35,259,195,454
Kerala,Thiruvananthapuram,Blindness,35,60,391,287,678
Kerala,Thiruvananthapuram,Blindness,60,80,258,132,390
Kerala,Thiruvananthapuram,Blindness,80,100,18,14,32
Tamil Nadu,Thiruvallur,Blindness,0,6,2,1,3
Tamil Nadu,Thiruvallur,Blindness,6,15,30,28,58
Tamil Nadu,Thiruvallur,Blindness,15,35,206,145,351
Tamil Nadu,Thiruvallur,Blindness,35,60,403,286,689
Tamil Nadu,Thiruvallur,Blindness,60,80,152,64,216
Tamil Nadu,Thiruvallur,Blindness,80,100,6,2,8
Tamil Nadu,Theni,Blindness,0,6,3,2,5
Tamil Nadu,Theni,Blindness,6,15,14,17,31
Tamil Nadu,Theni,Blindness,15,35,127,70,197
Tamil Nadu,Theni,Blindness,35,60,259,168,427
Tamil Nadu,Theni,Blindness,60,80,126,79,205
Tamil Nadu,Theni,Blindness,80,100,10,6,16
Tamil Nadu,The Nilgiris,Blindness,0,6,0,3,3
Tamil Nadu,The Nilgiris,Blindness,6,15,3,4,7
Tamil Nadu,The Nilgiris,Blindness,15,35,30,11,41
Tamil Nadu,The Nilgiris,Blindness,35,60,60,49,109
Tamil Nadu,The Nilgiris,Blindness,60,80,60,15,75
Tamil Nadu,The Nilgiris,Blindness,80,100,1,1,2
Tamil Nadu,Thanjavur,Blindness,0,6,3,4,7
Tamil Nadu,Thanjavur,Blindness,6,15,36,27,63
Tamil Nadu,Thanjavur,Blindness,15,35,186,149,335
Tamil Nadu,Thanjavur,Blindness,35,60,393,210,603
Tamil Nadu,Thanjavur,Blindness,60,80,158,60,218
Tamil Nadu,Thanjavur,Blindness,80,100,8,1,9
Maharashtra,Thane,Blindness,0,6,23,18,41
Maharashtra,Thane,Blindness,6,15,197,160,357
Maharashtra,Thane,Blindness,15,35,929,518,1447
Maharashtra,Thane,Blindness,35,60,1330,631,1961
Maharashtra,Thane,Blindness,60,80,484,150,634
Maharashtra,Thane,Blindness,80,100,34,10,44
Tamil Nadu,Tenkasi,Blindness,0,6,5,5,10
Tamil Nadu,Tenkasi,Blindness,6,15,16,19,35
Tamil Nadu,Tenkasi,Blindness,15,35,60,40,100
Tamil Nadu,Tenkasi,Blindness,35,60,123,96,219
Tamil Nadu,Tenkasi,Blindness,60,80,66,34,100
Tamil Nadu,Tenkasi,Blindness,80,100,2,4,6
Manipur,Tengnoupal,Blindness,6,15,5,0,5
Manipur,Tengnoupal,Blindness,15,35,7,5,12
Manipur,Tengnoupal,Blindness,35,60,10,6,16
Manipur,Tengnoupal,Blindness,60,80,7,5,12
Manipur,Tengnoupal,Blindness,80,100,1,0,1
Uttarakhand,Tehri Garhwal,Blindness,0,6,4,2,6
Uttarakhand,Tehri Garhwal,Blindness,6,15,30,21,51
Uttarakhand,Tehri Garhwal,Blindness,15,35,151,75,226
Uttarakhand,Tehri Garhwal,Blindness,35,60,210,102,312
Uttarakhand,Tehri Garhwal,Blindness,60,80,51,53,104
Uttarakhand,Tehri Garhwal,Blindness,80,100,4,6,10
Arunachal Pradesh,Tawang,Blindness,15,35,1,0,1
Arunachal Pradesh,Tawang,Blindness,35,60,1,1,2
Punjab,Tarn Taran,Blindness,0,6,1,1,2
Punjab,Tarn Taran,Blindness,6,15,22,17,39
Punjab,Tarn Taran,Blindness,15,35,103,56,159
Punjab,Tarn Taran,Blindness,35,60,167,69,236
Punjab,Tarn Taran,Blindness,60,80,49,19,68
Punjab,Tarn Taran,Blindness,80,100,1,1,2
Gujarat,Tapi,Blindness,0,6,5,7,12
Gujarat,Tapi,Blindness,6,15,37,23,60
Gujarat,Tapi,Blindness,15,35,89,51,140
Gujarat,Tapi,Blindness,35,60,118,57,175
Gujarat,Tapi,Blindness,60,80,44,15,59
Gujarat,Tapi,Blindness,80,100,5,0,5
Manipur,Tamenglong,Blindness,6,15,2,0,2
Manipur,Tamenglong,Blindness,15,35,9,7,16
Manipur,Tamenglong,Blindness,35,60,10,7,17
Manipur,Tamenglong,Blindness,60,80,2,3,5
Manipur,Tamenglong,Blindness,80,100,0,2,2
Chhattisgarh,Surguja,Blindness,0,6,3,6,9
Chhattisgarh,Surguja,Blindness,6,15,59,49,108
Chhattisgarh,Surguja,Blindness,15,35,182,147,329
Chhattisgarh,Surguja,Blindness,35,60,140,78,218
Chhattisgarh,Surguja,Blindness,60,80,40,17,57
Chhattisgarh,Surguja,Blindness,80,100,5,4,9
Gujarat,Surendranagar,Blindness,0,6,3,4,7
Gujarat,Surendranagar,Blindness,6,15,33,28,61
Gujarat,Surendranagar,Blindness,15,35,239,219,458
Gujarat,Surendranagar,Blindness,35,60,229,129,358
Gujarat,Surendranagar,Blindness,60,80,147,40,187
Gujarat,Surendranagar,Blindness,80,100,23,9,32
Gujarat,Surat,Blindness,0,6,10,10,20
Gujarat,Surat,Blindness,6,15,119,86,205
Gujarat,Surat,Blindness,15,35,344,179,523
Gujarat,Surat,Blindness,35,60,321,126,447
Gujarat,Surat,Blindness,60,80,143,53,196
Gujarat,Surat,Blindness,80,100,13,2,15
Chhattisgarh,Surajpur,Blindness,0,6,0,1,1
Chhattisgarh,Surajpur,Blindness,6,15,23,18,41
Chhattisgarh,Surajpur,Blindness,15,35,93,69,162
Chhattisgarh,Surajpur,Blindness,35,60,83,32,115
Chhattisgarh,Surajpur,Blindness,60,80,27,18,45
Chhattisgarh,Surajpur,Blindness,80,100,2,1,3
Bihar,Supaul,Blindness,0,6,1,2,3
Bihar,Supaul,Blindness,6,15,28,12,40
Bihar,Supaul,Blindness,15,35,91,52,143
Bihar,Supaul,Blindness,35,60,87,35,122
Bihar,Supaul,Blindness,60,80,37,14,51
Bihar,Supaul,Blindness,80,100,2,0,2
Odisha,Sundargarh,Blindness,0,6,10,7,17
Odisha,Sundargarh,Blindness,6,15,122,75,197
Odisha,Sundargarh,Blindness,15,35,351,239,590
Odisha,Sundargarh,Blindness,35,60,384,288,672
Odisha,Sundargarh,Blindness,60,80,130,85,215
Odisha,Sundargarh,Blindness,80,100,14,7,21
Uttar Pradesh,Sultanpur,Blindness,0,6,3,1,4
Uttar Pradesh,Sultanpur,Blindness,6,15,55,38,93
Uttar Pradesh,Sultanpur,Blindness,15,35,245,130,375
Uttar Pradesh,Sultanpur,Blindness,35,60,308,128,436
Uttar Pradesh,Sultanpur,Blindness,60,80,106,36,142
Uttar Pradesh,Sultanpur,Blindness,80,100,7,2,9
Chhattisgarh,Sukma,Blindness,0,6,1,1,2
Chhattisgarh,Sukma,Blindness,6,15,21,6,27
Chhattisgarh,Sukma,Blindness,15,35,34,23,57
Chhattisgarh,Sukma,Blindness,35,60,31,28,59
Chhattisgarh,Sukma,Blindness,60,80,12,18,30
Jammu And Kashmir,Srinagar,Blindness,0,6,0,1,1
Jammu And Kashmir,Srinagar,Blindness,6,15,18,16,34
Jammu And Kashmir,Srinagar,Blindness,15,35,99,82,181
Jammu And Kashmir,Srinagar,Blindness,35,60,144,99,243
Jammu And Kashmir,Srinagar,Blindness,60,80,40,22,62
Jammu And Kashmir,Srinagar,Blindness,80,100,1,2,3
Andhra Pradesh,Srikakulam,Blindness,0,6,10,8,18
Andhra Pradesh,Srikakulam,Blindness,6,15,114,67,181
Andhra Pradesh,Srikakulam,Blindness,15,35,495,191,686
Andhra Pradesh,Srikakulam,Blindness,35,60,1063,61,1124
Andhra Pradesh,Srikakulam,Blindness,60,80,300,16,316
Andhra Pradesh,Srikakulam,Blindness,80,100,19,2,21
Punjab,Sri Muktsar Sahib,Blindness,0,6,1,2,3
Punjab,Sri Muktsar Sahib,Blindness,6,15,26,29,55
Punjab,Sri Muktsar Sahib,Blindness,15,35,94,41,135
Punjab,Sri Muktsar Sahib,Blindness,35,60,113,53,166
Punjab,Sri Muktsar Sahib,Blindness,60,80,58,16,74
Punjab,Sri Muktsar Sahib,Blindness,80,100,5,3,8
Andhra Pradesh,Spsr Nellore,Blindness,0,6,0,1,1
Andhra Pradesh,Spsr Nellore,Blindness,6,15,34,35,69
Andhra Pradesh,Spsr Nellore,Blindness,15,35,226,120,346
Andhra Pradesh,Spsr Nellore,Blindness,35,60,502,62,564
Andhra Pradesh,Spsr Nellore,Blindness,60,80,168,14,182
Andhra Pradesh,Spsr Nellore,Blindness,80,100,15,0,15
Meghalaya,South West Khasi Hills,Blindness,0,6,1,2,3
Meghalaya,South West Khasi Hills,Blindness,6,15,3,1,4
Meghalaya,South West Khasi Hills,Blindness,15,35,24,13,37
Meghalaya,South West Khasi Hills,Blindness,35,60,15,12,27
Meghalaya,South West Khasi Hills,Blindness,60,80,3,4,7
Meghalaya,South West Khasi Hills,Blindness,80,100,0,2,2
Meghalaya,South West Garo Hills,Blindness,0,6,1,1,2
Meghalaya,South West Garo Hills,Blindness,6,15,4,7,11
Meghalaya,South West Garo Hills,Blindness,15,35,35,43,78
Meghalaya,South West Garo Hills,Blindness,35,60,28,29,57
Meghalaya,South West Garo Hills,Blindness,60,80,10,11,21
Delhi,South West,Blindness,0,6,5,2,7
Delhi,South West,Blindness,6,15,35,30,65
Delhi,South West,Blindness,15,35,124,87,211
Delhi,South West,Blindness,35,60,113,42,155
Delhi,South West,Blindness,60,80,26,14,40
Delhi,South West,Blindness,80,100,2,1,3
Tripura,South Tripura,Blindness,0,6,1,0,1
Tripura,South Tripura,Blindness,6,15,4,4,8
Tripura,South Tripura,Blindness,15,35,30,18,48
Tripura,South Tripura,Blindness,35,60,49,28,77
Tripura,South Tripura,Blindness,60,80,13,10,23
Tripura,South Tripura,Blindness,80,100,1,1,2
Assam,South Salmara Mancachar,Blindness,6,15,0,2,2
Assam,South Salmara Mancachar,Blindness,15,35,3,3,6
Assam,South Salmara Mancachar,Blindness,35,60,4,1,5
Assam,South Salmara Mancachar,Blindness,60,80,1,1,2
Goa,South Goa,Blindness,6,15,10,6,16
Goa,South Goa,Blindness,15,35,35,35,70
Goa,South Goa,Blindness,35,60,84,49,133
Goa,South Goa,Blindness,60,80,34,10,44
Goa,South Goa,Blindness,80,100,0,1,1
Meghalaya,South Garo Hills,Blindness,6,15,3,1,4
Meghalaya,South Garo Hills,Blindness,15,35,15,7,22
Meghalaya,South Garo Hills,Blindness,35,60,19,11,30
Meghalaya,South Garo Hills,Blindness,60,80,6,7,13
Meghalaya,South Garo Hills,Blindness,80,100,1,1,2
Delhi,South East,Blindness,0,6,1,0,1
Delhi,South East,Blindness,6,15,19,9,28
Delhi,South East,Blindness,15,35,53,35,88
Delhi,South East,Blindness,35,60,26,9,35
Delhi,South East,Blindness,60,80,6,2,8
Andaman And Nicobar Islands,South Andamans,Blindness,0,6,1,2,3
Andaman And Nicobar Islands,South Andamans,Blindness,6,15,3,5,8
Andaman And Nicobar Islands,South Andamans,Blindness,15,35,42,30,72
Andaman And Nicobar Islands,South Andamans,Blindness,35,60,66,67,133
Andaman And Nicobar Islands,South Andamans,Blindness,60,80,16,9,25
Andaman And Nicobar Islands,South Andamans,Blindness,80,100,1,0,1
Delhi,South,Blindness,0,6,2,3,5
Delhi,South,Blindness,6,15,25,20,45
Delhi,South,Blindness,15,35,128,61,189
Delhi,South,Blindness,35,60,80,21,101
Delhi,South,Blindness,60,80,20,5,25
Delhi,South,Blindness,80,100,0,1,1
Assam,Sonitpur,Blindness,0,6,5,3,8
Assam,Sonitpur,Blindness,6,15,27,26,53
Assam,Sonitpur,Blindness,15,35,117,87,204
Assam,Sonitpur,Blindness,35,60,137,79,216
Assam,Sonitpur,Blindness,60,80,23,15,38
Assam,Sonitpur,Blindness,80,100,2,1,3
Haryana,Sonipat,Blindness,0,6,4,4,8
Haryana,Sonipat,Blindness,6,15,24,12,36
Haryana,Sonipat,Blindness,15,35,104,49,153
Haryana,Sonipat,Blindness,35,60,116,48,164
Haryana,Sonipat,Blindness,60,80,48,31,79
Haryana,Sonipat,Blindness,80,100,4,4,8
Odisha,Sonepur,Blindness,0,6,3,14,17
Odisha,Sonepur,Blindness,6,15,69,53,122
Odisha,Sonepur,Blindness,15,35,257,195,452
Odisha,Sonepur,Blindness,35,60,261,135,396
Odisha,Sonepur,Blindness,60,80,112,41,153
Odisha,Sonepur,Blindness,80,100,7,1,8
Uttar Pradesh,Sonbhadra,Blindness,0,6,1,1,2
Uttar Pradesh,Sonbhadra,Blindness,6,15,20,24,44
Uttar Pradesh,Sonbhadra,Blindness,15,35,142,70,212
Uttar Pradesh,Sonbhadra,Blindness,35,60,156,66,222
Uttar Pradesh,Sonbhadra,Blindness,60,80,49,16,65
Uttar Pradesh,Sonbhadra,Blindness,80,100,2,0,2
Maharashtra,Solapur,Blindness,0,6,27,13,40
Maharashtra,Solapur,Blindness,6,15,102,88,190
Maharashtra,Solapur,Blindness,15,35,530,260,790
Maharashtra,Solapur,Blindness,35,60,644,294,938
Maharashtra,Solapur,Blindness,60,80,226,78,304
Maharashtra,Solapur,Blindness,80,100,18,4,22
Himachal Pradesh,Solan,Blindness,0,6,2,4,6
Himachal Pradesh,Solan,Blindness,6,15,10,7,17
Himachal Pradesh,Solan,Blindness,15,35,71,36,107
Himachal Pradesh,Solan,Blindness,35,60,110,68,178
Himachal Pradesh,Solan,Blindness,60,80,42,31,73
Himachal Pradesh,Solan,Blindness,80,100,3,2,5
Bihar,Siwan,Blindness,0,6,9,6,15
Bihar,Siwan,Blindness,6,15,104,92,196
Bihar,Siwan,Blindness,15,35,413,208,621
Bihar,Siwan,Blindness,35,60,407,200,607
Bihar,Siwan,Blindness,60,80,129,50,179
Bihar,Siwan,Blindness,80,100,7,5,12
Assam,Sivasagar,Blindness,6,15,7,7,14
Assam,Sivasagar,Blindness,15,35,49,37,86
Assam,Sivasagar,Blindness,35,60,62,50,112
Assam,Sivasagar,Blindness,60,80,7,7,14
Assam,Sivasagar,Blindness,80,100,3,0,3
Tamil Nadu,Sivaganga,Blindness,0,6,4,5,9
Tamil Nadu,Sivaganga,Blindness,6,15,45,26,71
Tamil Nadu,Sivaganga,Blindness,15,35,152,96,248
Tamil Nadu,Sivaganga,Blindness,35,60,289,190,479
Tamil Nadu,Sivaganga,Blindness,60,80,147,66,213
Tamil Nadu,Sivaganga,Blindness,80,100,17,5,22
Uttar Pradesh,Sitapur,Blindness,0,6,4,6,10
Uttar Pradesh,Sitapur,Blindness,6,15,163,132,295
Uttar Pradesh,Sitapur,Blindness,15,35,435,201,636
Uttar Pradesh,Sitapur,Blindness,35,60,350,114,464
Uttar Pradesh,Sitapur,Blindness,60,80,141,45,186
Uttar Pradesh,Sitapur,Blindness,80,100,13,7,20
Bihar,Sitamarhi,Blindness,0,6,14,12,26
Bihar,Sitamarhi,Blindness,6,15,114,71,185
Bihar,Sitamarhi,Blindness,15,35,282,198,480
Bihar,Sitamarhi,Blindness,35,60,331,196,527
Bihar,Sitamarhi,Blindness,60,80,117,65,182
Bihar,Sitamarhi,Blindness,80,100,2,5,7
Haryana,Sirsa,Blindness,0,6,4,2,6
Haryana,Sirsa,Blindness,6,15,26,18,44
Haryana,Sirsa,Blindness,15,35,76,36,112
Haryana,Sirsa,Blindness,35,60,99,47,146
Haryana,Sirsa,Blindness,60,80,45,15,60
Haryana,Sirsa,Blindness,80,100,5,3,8
Rajasthan,Sirohi,Blindness,0,6,3,1,4
Rajasthan,Sirohi,Blindness,6,15,40,25,65
Rajasthan,Sirohi,Blindness,15,35,153,67,220
Rajasthan,Sirohi,Blindness,35,60,215,115,330
Rajasthan,Sirohi,Blindness,60,80,72,46,118
Rajasthan,Sirohi,Blindness,80,100,7,5,12
Himachal Pradesh,Sirmaur,Blindness,0,6,4,6,10
Himachal Pradesh,Sirmaur,Blindness,6,15,17,8,25
Himachal Pradesh,Sirmaur,Blindness,15,35,79,60,139
Himachal Pradesh,Sirmaur,Blindness,35,60,124,52,176
Himachal Pradesh,Sirmaur,Blindness,60,80,53,18,71
Himachal Pradesh,Sirmaur,Blindness,80,100,6,1,7
Madhya Pradesh,Singrauli,Blindness,0,6,2,1,3
Madhya Pradesh,Singrauli,Blindness,6,15,31,18,49
Madhya Pradesh,Singrauli,Blindness,15,35,205,115,320
Madhya Pradesh,Singrauli,Blindness,35,60,177,85,262
Madhya Pradesh,Singrauli,Blindness,60,80,34,21,55
Madhya Pradesh,Singrauli,Blindness,80,100,6,1,7
Maharashtra,Sindhudurg,Blindness,0,6,0,2,2
Maharashtra,Sindhudurg,Blindness,6,15,7,11,18
Maharashtra,Sindhudurg,Blindness,15,35,54,29,83
Maharashtra,Sindhudurg,Blindness,35,60,165,69,234
Maharashtra,Sindhudurg,Blindness,60,80,71,17,88
Maharashtra,Sindhudurg,Blindness,80,100,1,0,1
Jharkhand,Simdega,Blindness,6,15,21,21,42
Jharkhand,Simdega,Blindness,15,35,49,54,103
Jharkhand,Simdega,Blindness,35,60,82,53,135
Jharkhand,Simdega,Blindness,60,80,22,14,36
Jharkhand,Simdega,Blindness,80,100,1,2,3
Rajasthan,Sikar,Blindness,0,6,3,4,7
Rajasthan,Sikar,Blindness,6,15,37,23,60
Rajasthan,Sikar,Blindness,15,35,137,59,196
Rajasthan,Sikar,Blindness,35,60,200,65,265
Rajasthan,Sikar,Blindness,60,80,79,29,108
Rajasthan,Sikar,Blindness,80,100,3,2,5
Madhya Pradesh,Sidhi,Blindness,0,6,3,2,5
Madhya Pradesh,Sidhi,Blindness,6,15,65,49,114
Madhya Pradesh,Sidhi,Blindness,15,35,274,180,454
Madhya Pradesh,Sidhi,Blindness,35,60,249,127,376
Madhya Pradesh,Sidhi,Blindness,60,80,86,37,123
Madhya Pradesh,Sidhi,Blindness,80,100,8,8,16
Uttar Pradesh,Siddharth Nagar,Blindness,0,6,2,3,5
Uttar Pradesh,Siddharth Nagar,Blindness,6,15,54,54,108
Uttar Pradesh,Siddharth Nagar,Blindness,15,35,473,323,796
Uttar Pradesh,Siddharth Nagar,Blindness,35,60,578,346,924
Uttar Pradesh,Siddharth Nagar,Blindness,60,80,267,125,392
Uttar Pradesh,Siddharth Nagar,Blindness,80,100,22,3,25
Arunachal Pradesh,Siang,Blindness,15,35,2,0,2
Uttar Pradesh,Shravasti,Blindness,0,6,1,2,3
Uttar Pradesh,Shravasti,Blindness,6,15,26,24,50
Uttar Pradesh,Shravasti,Blindness,15,35,86,42,128
Uttar Pradesh,Shravasti,Blindness,35,60,129,63,192
Uttar Pradesh,Shravasti,Blindness,60,80,34,17,51
Uttar Pradesh,Shravasti,Blindness,80,100,5,3,8
Jammu And Kashmir,Shopian,Blindness,0,6,1,1,2
Jammu And Kashmir,Shopian,Blindness,6,15,1,4,5
Jammu And Kashmir,Shopian,Blindness,15,35,20,15,35
Jammu And Kashmir,Shopian,Blindness,35,60,19,19,38
Jammu And Kashmir,Shopian,Blindness,60,80,17,8,25
Jammu And Kashmir,Shopian,Blindness,80,100,2,0,2
Madhya Pradesh,Shivpuri,Blindness,0,6,10,4,14
Madhya Pradesh,Shivpuri,Blindness,6,15,40,41,81
Madhya Pradesh,Shivpuri,Blindness,15,35,289,153,442
Madhya Pradesh,Shivpuri,Blindness,35,60,287,124,411
Madhya Pradesh,Shivpuri,Blindness,60,80,109,53,162
Madhya Pradesh,Shivpuri,Blindness,80,100,3,6,9
Karnataka,Shivamogga,Blindness,0,6,4,3,7
Karnataka,Shivamogga,Blindness,6,15,49,36,85
Karnataka,Shivamogga,Blindness,15,35,227,162,389
Karnataka,Shivamogga,Blindness,35,60,429,299,728
Karnataka,Shivamogga,Blindness,60,80,107,52,159
Karnataka,Shivamogga,Blindness,80,100,5,3,8
Himachal Pradesh,Shimla,Blindness,0,6,2,1,3
Himachal Pradesh,Shimla,Blindness,6,15,13,8,21
Himachal Pradesh,Shimla,Blindness,15,35,91,93,184
Himachal Pradesh,Shimla,Blindness,35,60,248,123,371
Himachal Pradesh,Shimla,Blindness,60,80,89,39,128
Himachal Pradesh,Shimla,Blindness,80,100,11,2,13
Madhya Pradesh,Sheopur,Blindness,0,6,1,2,3
Madhya Pradesh,Sheopur,Blindness,6,15,34,29,63
Madhya Pradesh,Sheopur,Blindness,15,35,148,70,218
Madhya Pradesh,Sheopur,Blindness,35,60,108,67,175
Madhya Pradesh,Sheopur,Blindness,60,80,54,30,84
Madhya Pradesh,Sheopur,Blindness,80,100,7,1,8
Bihar,Sheohar,Blindness,0,6,4,3,7
Bihar,Sheohar,Blindness,6,15,24,23,47
Bihar,Sheohar,Blindness,15,35,58,30,88
Bihar,Sheohar,Blindness,35,60,50,30,80
Bihar,Sheohar,Blindness,60,80,19,5,24
Bihar,Sheohar,Blindness,80,100,2,2,4
Bihar,Sheikhpura,Blindness,6,15,12,11,23
Bihar,Sheikhpura,Blindness,15,35,39,22,61
Bihar,Sheikhpura,Blindness,35,60,38,27,65
Bihar,Sheikhpura,Blindness,60,80,17,2,19
Bihar,Sheikhpura,Blindness,80,100,1,1,2
Uttar Pradesh,Shamli,Blindness,0,6,1,1,2
Uttar Pradesh,Shamli,Blindness,6,15,14,4,18
Uttar Pradesh,Shamli,Blindness,15,35,61,42,103
Uttar Pradesh,Shamli,Blindness,35,60,103,34,137
Uttar Pradesh,Shamli,Blindness,60,80,64,18,82
Uttar Pradesh,Shamli,Blindness,80,100,2,2,4
Madhya Pradesh,Shajapur,Blindness,0,6,2,3,5
Madhya Pradesh,Shajapur,Blindness,6,15,23,11,34
Madhya Pradesh,Shajapur,Blindness,15,35,158,70,228
Madhya Pradesh,Shajapur,Blindness,35,60,186,90,276
Madhya Pradesh,Shajapur,Blindness,60,80,77,36,113
Madhya Pradesh,Shajapur,Blindness,80,100,10,3,13
Uttar Pradesh,Shahjahanpur,Blindness,0,6,2,4,6
Uttar Pradesh,Shahjahanpur,Blindness,6,15,89,65,154
Uttar Pradesh,Shahjahanpur,Blindness,15,35,437,231,668
Uttar Pradesh,Shahjahanpur,Blindness,35,60,559,218,777
Uttar Pradesh,Shahjahanpur,Blindness,60,80,347,111,458
Uttar Pradesh,Shahjahanpur,Blindness,80,100,15,5,20
Punjab,Shahid Bhagat Singh Nagar,Blindness,0,6,1,1,2
Punjab,Shahid Bhagat Singh Nagar,Blindness,6,15,13,13,26
Punjab,Shahid Bhagat Singh Nagar,Blindness,15,35,75,48,123
Punjab,Shahid Bhagat Singh Nagar,Blindness,35,60,148,76,224
Punjab,Shahid Bhagat Singh Nagar,Blindness,60,80,154,54,208
Punjab,Shahid Bhagat Singh Nagar,Blindness,80,100,19,4,23
Madhya Pradesh,Shahdol,Blindness,6,15,57,41,98
Madhya Pradesh,Shahdol,Blindness,15,35,322,211,533
Madhya Pradesh,Shahdol,Blindness,35,60,415,241,656
Madhya Pradesh,Shahdol,Blindness,60,80,135,70,205
Madhya Pradesh,Shahdol,Blindness,80,100,12,4,16
Delhi,Shahdara,Blindness,0,6,1,0,1
Delhi,Shahdara,Blindness,6,15,8,5,13
Delhi,Shahdara,Blindness,15,35,28,14,42
Delhi,Shahdara,Blindness,35,60,32,16,48
Delhi,Shahdara,Blindness,60,80,11,5,16
Mizoram,Serchhip,Blindness,6,15,1,0,1
Mizoram,Serchhip,Blindness,15,35,1,3,4
Mizoram,Serchhip,Blindness,35,60,4,2,6
Mizoram,Serchhip,Blindness,60,80,2,0,2
Tripura,Sepahijala,Blindness,0,6,2,1,3
Tripura,Sepahijala,Blindness,6,15,3,2,5
Tripura,Sepahijala,Blindness,15,35,32,20,52
Tripura,Sepahijala,Blindness,35,60,47,29,76
Tripura,Sepahijala,Blindness,60,80,9,8,17
Tripura,Sepahijala,Blindness,80,100,2,0,2
Madhya Pradesh,Seoni,Blindness,0,6,1,0,1
Madhya Pradesh,Seoni,Blindness,6,15,18,15,33
Madhya Pradesh,Seoni,Blindness,15,35,259,147,406
Madhya Pradesh,Seoni,Blindness,35,60,301,165,466
Madhya Pradesh,Seoni,Blindness,60,80,90,69,159
Madhya Pradesh,Seoni,Blindness,80,100,6,7,13
Manipur,Senapati,Blindness,6,15,2,0,2
Manipur,Senapati,Blindness,15,35,4,1,5
Manipur,Senapati,Blindness,35,60,1,1,2
Manipur,Senapati,Blindness,60,80,1,1,2
Manipur,Senapati,Blindness,80,100,0,1,1
Madhya Pradesh,Sehore,Blindness,0,6,3,4,7
Madhya Pradesh,Sehore,Blindness,6,15,26,24,50
Madhya Pradesh,Sehore,Blindness,15,35,223,113,336
Madhya Pradesh,Sehore,Blindness,35,60,346,125,471
Madhya Pradesh,Sehore,Blindness,60,80,130,86,216
Madhya Pradesh,Sehore,Blindness,80,100,16,8,24
Rajasthan,Sawai Madhopur,Blindness,0,6,1,0,1
Rajasthan,Sawai Madhopur,Blindness,6,15,20,11,31
Rajasthan,Sawai Madhopur,Blindness,15,35,115,74,189
Rajasthan,Sawai Madhopur,Blindness,35,60,128,61,189
Rajasthan,Sawai Madhopur,Blindness,60,80,54,23,77
Rajasthan,Sawai Madhopur,Blindness,80,100,3,6,9
Madhya Pradesh,Satna,Blindness,0,6,11,5,16
Madhya Pradesh,Satna,Blindness,6,15,71,52,123
Madhya Pradesh,Satna,Blindness,15,35,461,296,757
Madhya Pradesh,Satna,Blindness,35,60,712,382,1094
Madhya Pradesh,Satna,Blindness,60,80,253,129,382
Madhya Pradesh,Satna,Blindness,80,100,21,9,30
Maharashtra,Satara,Blindness,0,6,7,5,12
Maharashtra,Satara,Blindness,6,15,66,53,119
Maharashtra,Satara,Blindness,15,35,293,154,447
Maharashtra,Satara,Blindness,35,60,405,167,572
Maharashtra,Satara,Blindness,60,80,164,49,213
Maharashtra,Satara,Blindness,80,100,11,1,12
Bihar,Saran,Blindness,0,6,4,11,15
Bihar,Saran,Blindness,6,15,71,46,117
Bihar,Saran,Blindness,15,35,211,88,299
Bihar,Saran,Blindness,35,60,227,115,342
Bihar,Saran,Blindness,60,80,73,31,104
Bihar,Saran,Blindness,80,100,2,0,2
Jharkhand,Saraikela Kharsawan,Blindness,0,6,1,0,1
Jharkhand,Saraikela Kharsawan,Blindness,6,15,18,17,35
Jharkhand,Saraikela Kharsawan,Blindness,15,35,70,38,108
Jharkhand,Saraikela Kharsawan,Blindness,35,60,82,19,101
Jharkhand,Saraikela Kharsawan,Blindness,60,80,15,5,20
Jharkhand,Saraikela Kharsawan,Blindness,80,100,2,0,2
Uttar Pradesh,Sant Kabeer Nagar,Blindness,6,15,13,15,28
Uttar Pradesh,Sant Kabeer Nagar,Blindness,15,35,160,77,237
Uttar Pradesh,Sant Kabeer Nagar,Blindness,35,60,142,67,209
Uttar Pradesh,Sant Kabeer Nagar,Blindness,60,80,40,14,54
Uttar Pradesh,Sant Kabeer Nagar,Blindness,80,100,0,2,2
Punjab,Sangrur,Blindness,0,6,4,2,6
Punjab,Sangrur,Blindness,6,15,29,18,47
Punjab,Sangrur,Blindness,15,35,138,72,210
Punjab,Sangrur,Blindness,35,60,277,106,383
Punjab,Sangrur,Blindness,60,80,155,55,210
Punjab,Sangrur,Blindness,80,100,10,3,13
Maharashtra,Sangli,Blindness,0,6,4,1,5
Maharashtra,Sangli,Blindness,6,15,83,53,136
Maharashtra,Sangli,Blindness,15,35,596,252,848
Maharashtra,Sangli,Blindness,35,60,665,251,916
Maharashtra,Sangli,Blindness,60,80,301,81,382
Maharashtra,Sangli,Blindness,80,100,31,10,41
Uttar Pradesh,Sambhal,Blindness,0,6,3,0,3
Uttar Pradesh,Sambhal,Blindness,6,15,36,11,47
Uttar Pradesh,Sambhal,Blindness,15,35,106,28,134
Uttar Pradesh,Sambhal,Blindness,35,60,141,34,175
Uttar Pradesh,Sambhal,Blindness,60,80,58,15,73
Uttar Pradesh,Sambhal,Blindness,80,100,1,0,1
Odisha,Sambalpur,Blindness,0,6,3,2,5
Odisha,Sambalpur,Blindness,6,15,31,28,59
Odisha,Sambalpur,Blindness,15,35,119,101,220
Odisha,Sambalpur,Blindness,35,60,157,97,254
Odisha,Sambalpur,Blindness,60,80,58,20,78
Odisha,Sambalpur,Blindness,80,100,5,1,6
Jammu And Kashmir,Samba,Blindness,0,6,1,1,2
Jammu And Kashmir,Samba,Blindness,6,15,8,4,12
Jammu And Kashmir,Samba,Blindness,15,35,47,23,70
Jammu And Kashmir,Samba,Blindness,35,60,105,43,148
Jammu And Kashmir,Samba,Blindness,60,80,53,23,76
Jammu And Kashmir,Samba,Blindness,80,100,11,3,14
Bihar,Samastipur,Blindness,0,6,31,17,48
Bihar,Samastipur,Blindness,6,15,162,122,284
Bihar,Samastipur,Blindness,15,35,521,354,875
Bihar,Samastipur,Blindness,35,60,480,312,792
Bihar,Samastipur,Blindness,60,80,208,98,306
Bihar,Samastipur,Blindness,80,100,9,2,11
Tamil Nadu,Salem,Blindness,0,6,1,4,5
Tamil Nadu,Salem,Blindness,6,15,38,29,67
Tamil Nadu,Salem,Blindness,15,35,186,108,294
Tamil Nadu,Salem,Blindness,35,60,315,169,484
Tamil Nadu,Salem,Blindness,60,80,123,44,167
Tamil Nadu,Salem,Blindness,80,100,10,5,15
Mizoram,Saitual,Blindness,15,35,2,0,2
Mizoram,Saitual,Blindness,60,80,1,0,1
Mizoram,Saitual,Blindness,80,100,1,0,1
Mizoram,Saiha,Blindness,6,15,0,1,1
Mizoram,Saiha,Blindness,15,35,5,5,10
Mizoram,Saiha,Blindness,35,60,4,0,4
Mizoram,Saiha,Blindness,60,80,2,0,2
Jharkhand,Sahebganj,Blindness,0,6,4,3,7
Jharkhand,Sahebganj,Blindness,6,15,38,31,69
Jharkhand,Sahebganj,Blindness,15,35,94,64,158
Jharkhand,Sahebganj,Blindness,35,60,64,29,93
Jharkhand,Sahebganj,Blindness,60,80,17,7,24
Jharkhand,Sahebganj,Blindness,80,100,0,2,2
Bihar,Saharsa,Blindness,0,6,5,5,10
Bihar,Saharsa,Blindness,6,15,53,30,83
Bihar,Saharsa,Blindness,15,35,120,72,192
Bihar,Saharsa,Blindness,35,60,113,61,174
Bihar,Saharsa,Blindness,60,80,45,23,68
Bihar,Saharsa,Blindness,80,100,5,0,5
Uttar Pradesh,Saharanpur,Blindness,0,6,5,2,7
Uttar Pradesh,Saharanpur,Blindness,6,15,43,15,58
Uttar Pradesh,Saharanpur,Blindness,15,35,185,96,281
Uttar Pradesh,Saharanpur,Blindness,35,60,235,80,315
Uttar Pradesh,Saharanpur,Blindness,60,80,122,24,146
Uttar Pradesh,Saharanpur,Blindness,80,100,9,2,11
Madhya Pradesh,Sagar,Blindness,0,6,5,4,9
Madhya Pradesh,Sagar,Blindness,6,15,123,113,236
Madhya Pradesh,Sagar,Blindness,15,35,822,483,1305
Madhya Pradesh,Sagar,Blindness,35,60,742,375,1117
Madhya Pradesh,Sagar,Blindness,60,80,269,124,393
Madhya Pradesh,Sagar,Blindness,80,100,17,11,28
Gujarat,Sabar Kantha,Blindness,0,6,5,1,6
Gujarat,Sabar Kantha,Blindness,6,15,44,38,82
Gujarat,Sabar Kantha,Blindness,15,35,215,151,366
Gujarat,Sabar Kantha,Blindness,35,60,239,101,340
Gujarat,Sabar Kantha,Blindness,60,80,119,39,158
Gujarat,Sabar Kantha,Blindness,80,100,8,3,11
Punjab,S.A.S Nagar,Blindness,0,6,4,3,7
Punjab,S.A.S Nagar,Blindness,6,15,24,17,41
Punjab,S.A.S Nagar,Blindness,15,35,86,42,128
Punjab,S.A.S Nagar,Blindness,35,60,136,46,182
Punjab,S.A.S Nagar,Blindness,60,80,62,11,73
Punjab,S.A.S Nagar,Blindness,80,100,5,0,5
Punjab,Rupnagar,Blindness,0,6,0,1,1
Punjab,Rupnagar,Blindness,6,15,10,14,24
Punjab,Rupnagar,Blindness,15,35,61,35,96
Punjab,Rupnagar,Blindness,35,60,119,41,160
Punjab,Rupnagar,Blindness,60,80,74,23,97
Punjab,Rupnagar,Blindness,80,100,9,3,12
Uttarakhand,Rudra Prayag,Blindness,6,15,16,13,29
Uttarakhand,Rudra Prayag,Blindness,15,35,89,59,148
Uttarakhand,Rudra Prayag,Blindness,35,60,130,78,208
Uttarakhand,Rudra Prayag,Blindness,60,80,35,28,63
Uttarakhand,Rudra Prayag,Blindness,80,100,3,1,4
Bihar,Rohtas,Blindness,0,6,6,5,11
Bihar,Rohtas,Blindness,6,15,75,53,128
Bihar,Rohtas,Blindness,15,35,255,171,426
Bihar,Rohtas,Blindness,35,60,268,135,403
Bihar,Rohtas,Blindness,60,80,96,46,142
Bihar,Rohtas,Blindness,80,100,1,3,4
Haryana,Rohtak,Blindness,0,6,2,8,10
Haryana,Rohtak,Blindness,6,15,25,10,35
Haryana,Rohtak,Blindness,15,35,80,46,126
Haryana,Rohtak,Blindness,35,60,163,87,250
Haryana,Rohtak,Blindness,60,80,78,47,125
Haryana,Rohtak,Blindness,80,100,6,11,17
Meghalaya,Ri Bhoi,Blindness,0,6,0,1,1
Meghalaya,Ri Bhoi,Blindness,6,15,12,8,20
Meghalaya,Ri Bhoi,Blindness,15,35,46,24,70
Meghalaya,Ri Bhoi,Blindness,35,60,37,20,57
Meghalaya,Ri Bhoi,Blindness,60,80,16,6,22
Meghalaya,Ri Bhoi,Blindness,80,100,3,1,4
Haryana,Rewari,Blindness,0,6,4,4,8
Haryana,Rewari,Blindness,6,15,18,5,23
Haryana,Rewari,Blindness,15,35,56,30,86
Haryana,Rewari,Blindness,35,60,83,40,123
Haryana,Rewari,Blindness,60,80,43,20,63
Haryana,Rewari,Blindness,80,100,5,5,10
Madhya Pradesh,Rewa,Blindness,0,6,6,7,13
Madhya Pradesh,Rewa,Blindness,6,15,39,39,78
Madhya Pradesh,Rewa,Blindness,15,35,386,225,611
Madhya Pradesh,Rewa,Blindness,35,60,461,227,688
Madhya Pradesh,Rewa,Blindness,60,80,123,74,197
Madhya Pradesh,Rewa,Blindness,80,100,10,4,14
Jammu And Kashmir,Reasi,Blindness,0,6,1,1,2
Jammu And Kashmir,Reasi,Blindness,6,15,6,9,15
Jammu And Kashmir,Reasi,Blindness,15,35,36,27,63
Jammu And Kashmir,Reasi,Blindness,35,60,39,17,56
Jammu And Kashmir,Reasi,Blindness,60,80,11,1,12
Odisha,Rayagada,Blindness,0,6,7,5,12
Odisha,Rayagada,Blindness,6,15,35,29,64
Odisha,Rayagada,Blindness,15,35,129,91,220
Odisha,Rayagada,Blindness,35,60,153,131,284
Odisha,Rayagada,Blindness,60,80,56,64,120
Odisha,Rayagada,Blindness,80,100,2,3,5
Maharashtra,Ratnagiri,Blindness,0,6,3,3,6
Maharashtra,Ratnagiri,Blindness,6,15,42,24,66
Maharashtra,Ratnagiri,Blindness,15,35,186,88,274
Maharashtra,Ratnagiri,Blindness,35,60,324,161,485
Maharashtra,Ratnagiri,Blindness,60,80,170,50,220
Maharashtra,Ratnagiri,Blindness,80,100,18,5,23
Madhya Pradesh,Ratlam,Blindness,0,6,5,2,7
Madhya Pradesh,Ratlam,Blindness,6,15,33,30,63
Madhya Pradesh,Ratlam,Blindness,15,35,148,88,236
Madhya Pradesh,Ratlam,Blindness,35,60,221,99,320
Madhya Pradesh,Ratlam,Blindness,60,80,88,37,125
Madhya Pradesh,Ratlam,Blindness,80,100,7,4,11
Tamil Nadu,Ranipet,Blindness,6,15,4,1,5
Tamil Nadu,Ranipet,Blindness,15,35,28,22,50
Tamil Nadu,Ranipet,Blindness,35,60,54,41,95
Tamil Nadu,Ranipet,Blindness,60,80,25,7,32
Tamil Nadu,Ranipet,Blindness,80,100,2,0,2
Jharkhand,Ranchi,Blindness,0,6,6,2,8
Jharkhand,Ranchi,Blindness,6,15,68,45,113
Jharkhand,Ranchi,Blindness,15,35,182,128,310
Jharkhand,Ranchi,Blindness,35,60,200,88,288
Jharkhand,Ranchi,Blindness,60,80,38,25,63
Jharkhand,Ranchi,Blindness,80,100,2,0,2
Uttar Pradesh,Rampur,Blindness,6,15,17,14,31
Uttar Pradesh,Rampur,Blindness,15,35,123,43,166
Uttar Pradesh,Rampur,Blindness,35,60,157,53,210
Uttar Pradesh,Rampur,Blindness,60,80,71,20,91
Uttar Pradesh,Rampur,Blindness,80,100,2,0,2
Jharkhand,Ramgarh,Blindness,0,6,2,0,2
Jharkhand,Ramgarh,Blindness,6,15,27,19,46
Jharkhand,Ramgarh,Blindness,15,35,129,89,218
Jharkhand,Ramgarh,Blindness,35,60,135,69,204
Jharkhand,Ramgarh,Blindness,60,80,34,17,51
Jharkhand,Ramgarh,Blindness,80,100,1,1,2
Jammu And Kashmir,Ramban,Blindness,0,6,2,1,3
Jammu And Kashmir,Ramban,Blindness,6,15,8,6,14
Jammu And Kashmir,Ramban,Blindness,15,35,20,14,34
Jammu And Kashmir,Ramban,Blindness,35,60,29,16,45
Jammu And Kashmir,Ramban,Blindness,60,80,8,0,8
Jammu And Kashmir,Ramban,Blindness,80,100,1,0,1
Tamil Nadu,Ramanathapuram,Blindness,0,6,1,1,2
Tamil Nadu,Ramanathapuram,Blindness,6,15,18,15,33
Tamil Nadu,Ramanathapuram,Blindness,15,35,112,81,193
Tamil Nadu,Ramanathapuram,Blindness,35,60,250,137,387
Tamil Nadu,Ramanathapuram,Blindness,60,80,134,54,188
Tamil Nadu,Ramanathapuram,Blindness,80,100,9,2,11
Karnataka,Ramanagara,Blindness,0,6,3,3,6
Karnataka,Ramanagara,Blindness,6,15,42,30,72
Karnataka,Ramanagara,Blindness,15,35,226,160,386
Karnataka,Ramanagara,Blindness,35,60,494,235,729
Karnataka,Ramanagara,Blindness,60,80,188,70,258
Karnataka,Ramanagara,Blindness,80,100,18,3,21
Rajasthan,Rajsamand,Blindness,0,6,2,0,2
Rajasthan,Rajsamand,Blindness,6,15,44,13,57
Rajasthan,Rajsamand,Blindness,15,35,157,88,245
Rajasthan,Rajsamand,Blindness,35,60,266,129,395
Rajasthan,Rajsamand,Blindness,60,80,122,64,186
Rajasthan,Rajsamand,Blindness,80,100,5,11,16
Jammu And Kashmir,Rajouri,Blindness,0,6,3,3,6
Jammu And Kashmir,Rajouri,Blindness,6,15,40,20,60
Jammu And Kashmir,Rajouri,Blindness,15,35,133,70,203
Jammu And Kashmir,Rajouri,Blindness,35,60,189,85,274
Jammu And Kashmir,Rajouri,Blindness,60,80,56,17,73
Jammu And Kashmir,Rajouri,Blindness,80,100,6,4,10
Chhattisgarh,Rajnandgaon,Blindness,0,6,4,4,8
Chhattisgarh,Rajnandgaon,Blindness,6,15,24,24,48
Chhattisgarh,Rajnandgaon,Blindness,15,35,99,89,188
Chhattisgarh,Rajnandgaon,Blindness,35,60,115,57,172
Chhattisgarh,Rajnandgaon,Blindness,60,80,40,25,65
Chhattisgarh,Rajnandgaon,Blindness,80,100,6,2,8
Gujarat,Rajkot,Blindness,0,6,6,7,13
Gujarat,Rajkot,Blindness,6,15,60,33,93
Gujarat,Rajkot,Blindness,15,35,256,196,452
Gujarat,Rajkot,Blindness,35,60,447,236,683
Gujarat,Rajkot,Blindness,60,80,332,123,455
Gujarat,Rajkot,Blindness,80,100,36,8,44
Madhya Pradesh,Rajgarh,Blindness,0,6,1,2,3
Madhya Pradesh,Rajgarh,Blindness,6,15,21,23,44
Madhya Pradesh,Rajgarh,Blindness,15,35,209,96,305
Madhya Pradesh,Rajgarh,Blindness,35,60,228,96,324
Madhya Pradesh,Rajgarh,Blindness,60,80,109,37,146
Madhya Pradesh,Rajgarh,Blindness,80,100,9,3,12
Madhya Pradesh,Raisen,Blindness,0,6,15,11,26
Madhya Pradesh,Raisen,Blindness,6,15,120,124,244
Madhya Pradesh,Raisen,Blindness,15,35,448,276,724
Madhya Pradesh,Raisen,Blindness,35,60,441,225,666
Madhya Pradesh,Raisen,Blindness,60,80,158,65,223
Madhya Pradesh,Raisen,Blindness,80,100,24,5,29
Chhattisgarh,Raipur,Blindness,0,6,8,4,12
Chhattisgarh,Raipur,Blindness,6,15,46,58,104
Chhattisgarh,Raipur,Blindness,15,35,216,171,387
Chhattisgarh,Raipur,Blindness,35,60,146,80,226
Chhattisgarh,Raipur,Blindness,60,80,48,19,67
Chhattisgarh,Raipur,Blindness,80,100,5,0,5
Chhattisgarh,Raigarh,Blindness,0,6,10,12,22
Chhattisgarh,Raigarh,Blindness,6,15,134,136,270
Chhattisgarh,Raigarh,Blindness,15,35,263,248,511
Chhattisgarh,Raigarh,Blindness,35,60,212,131,343
Chhattisgarh,Raigarh,Blindness,60,80,87,44,131
Chhattisgarh,Raigarh,Blindness,80,100,6,4,10
Maharashtra,Raigad,Blindness,0,6,7,3,10
Maharashtra,Raigad,Blindness,6,15,35,29,64
Maharashtra,Raigad,Blindness,15,35,173,98,271
Maharashtra,Raigad,Blindness,35,60,299,126,425
Maharashtra,Raigad,Blindness,60,80,114,45,159
Maharashtra,Raigad,Blindness,80,100,6,0,6
Karnataka,Raichur,Blindness,0,6,12,11,23
Karnataka,Raichur,Blindness,6,15,102,82,184
Karnataka,Raichur,Blindness,15,35,349,224,573
Karnataka,Raichur,Blindness,35,60,335,175,510
Karnataka,Raichur,Blindness,60,80,80,35,115
Karnataka,Raichur,Blindness,80,100,10,5,15
Uttar Pradesh,Rae Bareli,Blindness,0,6,1,4,5
Uttar Pradesh,Rae Bareli,Blindness,6,15,53,46,99
Uttar Pradesh,Rae Bareli,Blindness,15,35,275,165,440
Uttar Pradesh,Rae Bareli,Blindness,35,60,402,159,561
Uttar Pradesh,Rae Bareli,Blindness,60,80,183,67,250
Uttar Pradesh,Rae Bareli,Blindness,80,100,13,5,18
Bihar,Purnia,Blindness,0,6,5,4,9
Bihar,Purnia,Blindness,6,15,76,64,140
Bihar,Purnia,Blindness,15,35,213,175,388
Bihar,Purnia,Blindness,35,60,212,129,341
Bihar,Purnia,Blindness,60,80,104,48,152
Bihar,Purnia,Blindness,80,100,3,0,3
Odisha,Puri,Blindness,0,6,2,4,6
Odisha,Puri,Blindness,6,15,73,60,133
Odisha,Puri,Blindness,15,35,257,193,450
Odisha,Puri,Blindness,35,60,452,263,715
Odisha,Puri,Blindness,60,80,166,71,237
Odisha,Puri,Blindness,80,100,11,8,19
Bihar,Purbi Champaran,Blindness,0,6,4,11,15
Bihar,Purbi Champaran,Blindness,6,15,66,53,119
Bihar,Purbi Champaran,Blindness,15,35,280,152,432
Bihar,Purbi Champaran,Blindness,35,60,309,169,478
Bihar,Purbi Champaran,Blindness,60,80,89,32,121
Bihar,Purbi Champaran,Blindness,80,100,3,1,4
Maharashtra,Pune,Blindness,0,6,17,15,32
Maharashtra,Pune,Blindness,6,15,230,136,366
Maharashtra,Pune,Blindness,15,35,871,548,1419
Maharashtra,Pune,Blindness,35,60,1407,707,2114
Maharashtra,Pune,Blindness,60,80,576,230,806
Maharashtra,Pune,Blindness,80,100,36,14,50
Jammu And Kashmir,Pulwama,Blindness,0,6,4,0,4
Jammu And Kashmir,Pulwama,Blindness,6,15,19,15,34
Jammu And Kashmir,Pulwama,Blindness,15,35,41,25,66
Jammu And Kashmir,Pulwama,Blindness,35,60,58,32,90
Jammu And Kashmir,Pulwama,Blindness,60,80,33,8,41
Jammu And Kashmir,Pulwama,Blindness,80,100,3,1,4
Tamil Nadu,Pudukkottai,Blindness,0,6,1,3,4
Tamil Nadu,Pudukkottai,Blindness,6,15,30,23,53
Tamil Nadu,Pudukkottai,Blindness,15,35,128,111,239
Tamil Nadu,Pudukkottai,Blindness,35,60,321,172,493
Tamil Nadu,Pudukkottai,Blindness,60,80,100,45,145
Tamil Nadu,Pudukkottai,Blindness,80,100,3,3,6
Uttar Pradesh,Prayagraj,Blindness,0,6,7,4,11
Uttar Pradesh,Prayagraj,Blindness,6,15,95,89,184
Uttar Pradesh,Prayagraj,Blindness,15,35,704,357,1061
Uttar Pradesh,Prayagraj,Blindness,35,60,600,253,853
Uttar Pradesh,Prayagraj,Blindness,60,80,162,45,207
Uttar Pradesh,Prayagraj,Blindness,80,100,8,6,14
Rajasthan,Pratapgarh,Blindness,0,6,1,0,1
Rajasthan,Pratapgarh,Blindness,6,15,35,22,57
Rajasthan,Pratapgarh,Blindness,15,35,133,83,216
Rajasthan,Pratapgarh,Blindness,35,60,229,138,367
Rajasthan,Pratapgarh,Blindness,60,80,129,93,222
Rajasthan,Pratapgarh,Blindness,80,100,19,29,48
Uttar Pradesh,Pratapgarh,Blindness,0,6,0,1,1
Uttar Pradesh,Pratapgarh,Blindness,6,15,20,12,32
Uttar Pradesh,Pratapgarh,Blindness,15,35,279,153,432
Uttar Pradesh,Pratapgarh,Blindness,35,60,365,144,509
Uttar Pradesh,Pratapgarh,Blindness,60,80,134,33,167
Uttar Pradesh,Pratapgarh,Blindness,80,100,6,1,7
Andhra Pradesh,Prakasam,Blindness,0,6,5,9,14
Andhra Pradesh,Prakasam,Blindness,6,15,96,66,162
Andhra Pradesh,Prakasam,Blindness,15,35,472,161,633
Andhra Pradesh,Prakasam,Blindness,35,60,1118,43,1161
Andhra Pradesh,Prakasam,Blindness,60,80,316,8,324
Andhra Pradesh,Prakasam,Blindness,80,100,23,0,23
Gujarat,Porbandar,Blindness,0,6,1,2,3
Gujarat,Porbandar,Blindness,6,15,6,5,11
Gujarat,Porbandar,Blindness,15,35,100,73,173
Gujarat,Porbandar,Blindness,35,60,123,53,176
Gujarat,Porbandar,Blindness,60,80,106,50,156
Gujarat,Porbandar,Blindness,80,100,14,4,18
Jammu And Kashmir,Poonch,Blindness,0,6,9,11,20
Jammu And Kashmir,Poonch,Blindness,6,15,77,55,132
Jammu And Kashmir,Poonch,Blindness,15,35,265,147,412
Jammu And Kashmir,Poonch,Blindness,35,60,304,188,492
Jammu And Kashmir,Poonch,Blindness,60,80,57,26,83
Jammu And Kashmir,Poonch,Blindness,80,100,11,4,15
Puducherry,Pondicherry,Blindness,6,15,14,8,22
Puducherry,Pondicherry,Blindness,15,35,152,112,264
Puducherry,Pondicherry,Blindness,35,60,364,309,673
Puducherry,Pondicherry,Blindness,60,80,192,210,402
Puducherry,Pondicherry,Blindness,80,100,44,51,95
Uttarakhand,Pithoragarh,Blindness,0,6,0,1,1
Uttarakhand,Pithoragarh,Blindness,6,15,10,9,19
Uttarakhand,Pithoragarh,Blindness,15,35,82,42,124
Uttarakhand,Pithoragarh,Blindness,35,60,124,52,176
Uttarakhand,Pithoragarh,Blindness,60,80,20,11,31
Uttarakhand,Pithoragarh,Blindness,80,100,0,4,4
Uttar Pradesh,Pilibhit,Blindness,0,6,4,8,12
Uttar Pradesh,Pilibhit,Blindness,6,15,68,51,119
Uttar Pradesh,Pilibhit,Blindness,15,35,322,172,494
Uttar Pradesh,Pilibhit,Blindness,35,60,577,236,813
Uttar Pradesh,Pilibhit,Blindness,60,80,276,120,396
Uttar Pradesh,Pilibhit,Blindness,80,100,11,4,15
Nagaland,Phek,Blindness,15,35,4,1,5
Nagaland,Phek,Blindness,35,60,4,2,6
Nagaland,Phek,Blindness,60,80,1,0,1
Nagaland,Phek,Blindness,80,100,2,0,2
Nagaland,Peren,Blindness,35,60,0,1,1
Tamil Nadu,Perambalur,Blindness,0,6,5,1,6
Tamil Nadu,Perambalur,Blindness,6,15,26,17,43
Tamil Nadu,Perambalur,Blindness,15,35,79,66,145
Tamil Nadu,Perambalur,Blindness,35,60,160,91,251
Tamil Nadu,Perambalur,Blindness,60,80,78,38,116
Tamil Nadu,Perambalur,Blindness,80,100,11,3,14
Uttarakhand,Pauri Garhwal,Blindness,0,6,0,2,2
Uttarakhand,Pauri Garhwal,Blindness,6,15,14,7,21
Uttarakhand,Pauri Garhwal,Blindness,15,35,94,52,146
Uttarakhand,Pauri Garhwal,Blindness,35,60,185,61,246
Uttarakhand,Pauri Garhwal,Blindness,60,80,30,19,49
Uttarakhand,Pauri Garhwal,Blindness,80,100,5,4,9
Bihar,Patna,Blindness,0,6,8,7,15
Bihar,Patna,Blindness,6,15,93,74,167
Bihar,Patna,Blindness,15,35,263,129,392
Bihar,Patna,Blindness,35,60,207,92,299
Bihar,Patna,Blindness,60,80,52,14,66
Bihar,Patna,Blindness,80,100,5,1,6
Punjab,Patiala,Blindness,0,6,8,11,19
Punjab,Patiala,Blindness,6,15,55,51,106
Punjab,Patiala,Blindness,15,35,297,129,426
Punjab,Patiala,Blindness,35,60,372,187,559
Punjab,Patiala,Blindness,60,80,148,51,199
Punjab,Patiala,Blindness,80,100,21,7,28
Punjab,Pathankot,Blindness,0,6,3,4,7
Punjab,Pathankot,Blindness,6,15,24,24,48
Punjab,Pathankot,Blindness,15,35,101,54,155
Punjab,Pathankot,Blindness,35,60,140,82,222
Punjab,Pathankot,Blindness,60,80,66,19,85
Punjab,Pathankot,Blindness,80,100,10,2,12
Kerala,Pathanamthitta,Blindness,0,6,1,1,2
Kerala,Pathanamthitta,Blindness,6,15,10,10,20
Kerala,Pathanamthitta,Blindness,15,35,76,51,127
Kerala,Pathanamthitta,Blindness,35,60,127,77,204
Kerala,Pathanamthitta,Blindness,60,80,90,54,144
Kerala,Pathanamthitta,Blindness,80,100,8,7,15
Gujarat,Patan,Blindness,0,6,6,2,8
Gujarat,Patan,Blindness,6,15,67,37,104
Gujarat,Patan,Blindness,15,35,237,147,384
Gujarat,Patan,Blindness,35,60,272,98,370
Gujarat,Patan,Blindness,60,80,134,45,179
Gujarat,Patan,Blindness,80,100,11,5,16
Bihar,Pashchim Champaran,Blindness,0,6,7,1,8
Bihar,Pashchim Champaran,Blindness,6,15,82,67,149
Bihar,Pashchim Champaran,Blindness,15,35,273,144,417
Bihar,Pashchim Champaran,Blindness,35,60,310,178,488
Bihar,Pashchim Champaran,Blindness,60,80,72,49,121
Bihar,Pashchim Champaran,Blindness,80,100,1,0,1
Maharashtra,Parbhani,Blindness,0,6,18,12,30
Maharashtra,Parbhani,Blindness,6,15,145,130,275
Maharashtra,Parbhani,Blindness,15,35,648,382,1030
Maharashtra,Parbhani,Blindness,35,60,744,337,1081
Maharashtra,Parbhani,Blindness,60,80,477,248,725
Maharashtra,Parbhani,Blindness,80,100,42,12,54
Arunachal Pradesh,Papum Pare,Blindness,0,6,3,0,3
Arunachal Pradesh,Papum Pare,Blindness,6,15,7,11,18
Arunachal Pradesh,Papum Pare,Blindness,15,35,44,25,69
Arunachal Pradesh,Papum Pare,Blindness,35,60,17,6,23
Arunachal Pradesh,Papum Pare,Blindness,60,80,4,3,7
Arunachal Pradesh,Papum Pare,Blindness,80,100,1,0,1
Madhya Pradesh,Panna,Blindness,0,6,5,5,10
Madhya Pradesh,Panna,Blindness,6,15,45,50,95
Madhya Pradesh,Panna,Blindness,15,35,305,162,467
Madhya Pradesh,Panna,Blindness,35,60,322,154,476
Madhya Pradesh,Panna,Blindness,60,80,104,52,156
Madhya Pradesh,Panna,Blindness,80,100,6,3,9
Haryana,Panipat,Blindness,0,6,1,3,4
Haryana,Panipat,Blindness,6,15,16,15,31
Haryana,Panipat,Blindness,15,35,70,41,111
Haryana,Panipat,Blindness,35,60,121,60,181
Haryana,Panipat,Blindness,60,80,39,27,66
Haryana,Panipat,Blindness,80,100,1,2,3
Haryana,Panchkula,Blindness,0,6,1,2,3
Haryana,Panchkula,Blindness,6,15,16,14,30
Haryana,Panchkula,Blindness,15,35,58,31,89
Haryana,Panchkula,Blindness,35,60,70,39,109
Haryana,Panchkula,Blindness,60,80,25,13,38
Haryana,Panchkula,Blindness,80,100,4,0,4
Gujarat,Panch Mahals,Blindness,0,6,7,6,13
Gujarat,Panch Mahals,Blindness,6,15,43,42,85
Gujarat,Panch Mahals,Blindness,15,35,274,167,441
Gujarat,Panch Mahals,Blindness,35,60,196,85,281
Gujarat,Panch Mahals,Blindness,60,80,75,33,108
Gujarat,Panch Mahals,Blindness,80,100,11,3,14
Haryana,Palwal,Blindness,0,6,3,4,7
Haryana,Palwal,Blindness,6,15,10,7,17
Haryana,Palwal,Blindness,15,35,39,27,66
Haryana,Palwal,Blindness,35,60,78,30,108
Haryana,Palwal,Blindness,60,80,20,8,28
Haryana,Palwal,Blindness,80,100,4,1,5
Rajasthan,Pali,Blindness,0,6,4,6,10
Rajasthan,Pali,Blindness,6,15,40,19,59
Rajasthan,Pali,Blindness,15,35,169,110,279
Rajasthan,Pali,Blindness,35,60,287,141,428
Rajasthan,Pali,Blindness,60,80,277,160,437
Rajasthan,Pali,Blindness,80,100,36,31,67
Maharashtra,Palghar,Blindness,0,6,6,5,11
Maharashtra,Palghar,Blindness,6,15,56,34,90
Maharashtra,Palghar,Blindness,15,35,163,95,258
Maharashtra,Palghar,Blindness,35,60,245,102,347
Maharashtra,Palghar,Blindness,60,80,84,20,104
Maharashtra,Palghar,Blindness,80,100,0,1,1
Jharkhand,Palamu,Blindness,0,6,4,3,7
Jharkhand,Palamu,Blindness,6,15,32,13,45
Jharkhand,Palamu,Blindness,15,35,144,76,220
Jharkhand,Palamu,Blindness,35,60,132,59,191
Jharkhand,Palamu,Blindness,60,80,34,19,53
Jharkhand,Palamu,Blindness,80,100,2,3,5
Kerala,Palakkad,Blindness,0,6,2,5,7
Kerala,Palakkad,Blindness,6,15,30,15,45
Kerala,Palakkad,Blindness,15,35,114,64,178
Kerala,Palakkad,Blindness,35,60,334,226,560
Kerala,Palakkad,Blindness,60,80,180,119,299
Kerala,Palakkad,Blindness,80,100,13,13,26
Jharkhand,Pakur,Blindness,0,6,2,2,4
Jharkhand,Pakur,Blindness,6,15,35,54,89
Jharkhand,Pakur,Blindness,15,35,72,81,153
Jharkhand,Pakur,Blindness,35,60,99,64,163
Jharkhand,Pakur,Blindness,60,80,29,10,39
Jharkhand,Pakur,Blindness,80,100,2,1,3
Maharashtra,Osmanabad,Blindness,0,6,5,5,10
Maharashtra,Osmanabad,Blindness,6,15,35,14,49
Maharashtra,Osmanabad,Blindness,15,35,155,94,249
Maharashtra,Osmanabad,Blindness,35,60,247,133,380
Maharashtra,Osmanabad,Blindness,60,80,167,60,227
Maharashtra,Osmanabad,Blindness,80,100,27,7,34
Haryana,Nuh,Blindness,0,6,4,3,7
Haryana,Nuh,Blindness,6,15,27,12,39
Haryana,Nuh,Blindness,15,35,101,35,136
Haryana,Nuh,Blindness,35,60,86,34,120
Haryana,Nuh,Blindness,60,80,54,16,70
Haryana,Nuh,Blindness,80,100,5,3,8
Odisha,Nuapada,Blindness,0,6,38,46,84
Odisha,Nuapada,Blindness,6,15,172,137,309
Odisha,Nuapada,Blindness,15,35,218,135,353
Odisha,Nuapada,Blindness,35,60,155,103,258
Odisha,Nuapada,Blindness,60,80,45,35,80
Odisha,Nuapada,Blindness,80,100,3,3,6
Delhi,North West,Blindness,0,6,6,7,13
Delhi,North West,Blindness,6,15,80,76,156
Delhi,North West,Blindness,15,35,423,208,631
Delhi,North West,Blindness,35,60,282,94,376
Delhi,North West,Blindness,60,80,55,17,72
Delhi,North West,Blindness,80,100,8,1,9
Tripura,North Tripura,Blindness,0,6,1,1,2
Tripura,North Tripura,Blindness,6,15,13,8,21
Tripura,North Tripura,Blindness,15,35,56,42,98
Tripura,North Tripura,Blindness,35,60,81,36,117
Tripura,North Tripura,Blindness,60,80,12,11,23
Tripura,North Tripura,Blindness,80,100,3,1,4
Goa,North Goa,Blindness,0,6,3,1,4
Goa,North Goa,Blindness,6,15,11,6,17
Goa,North Goa,Blindness,15,35,48,24,72
Goa,North Goa,Blindness,35,60,89,55,144
Goa,North Goa,Blindness,60,80,40,16,56
Goa,North Goa,Blindness,80,100,1,2,3
Meghalaya,North Garo Hills,Blindness,0,6,2,0,2
Meghalaya,North Garo Hills,Blindness,6,15,4,1,5
Meghalaya,North Garo Hills,Blindness,15,35,23,23,46
Meghalaya,North Garo Hills,Blindness,35,60,30,25,55
Meghalaya,North Garo Hills,Blindness,60,80,11,12,23
Meghalaya,North Garo Hills,Blindness,80,100,1,1,2
Delhi,North East,Blindness,0,6,4,2,6
Delhi,North East,Blindness,6,15,39,30,69
Delhi,North East,Blindness,15,35,128,81,209
Delhi,North East,Blindness,35,60,110,51,161
Delhi,North East,Blindness,60,80,29,8,37
Delhi,North East,Blindness,80,100,0,1,1
Andaman And Nicobar Islands,North And Middle Andaman,Blindness,6,15,3,4,7
Andaman And Nicobar Islands,North And Middle Andaman,Blindness,15,35,12,17,29
Andaman And Nicobar Islands,North And Middle Andaman,Blindness,35,60,33,23,56
Andaman And Nicobar Islands,North And Middle Andaman,Blindness,60,80,13,6,19
Andaman And Nicobar Islands,North And Middle Andaman,Blindness,80,100,2,0,2
Delhi,North,Blindness,0,6,5,2,7
Delhi,North,Blindness,6,15,28,13,41
Delhi,North,Blindness,15,35,128,166,294
Delhi,North,Blindness,35,60,132,61,193
Delhi,North,Blindness,60,80,28,3,31
Manipur,Noney,Blindness,6,15,1,1,2
Manipur,Noney,Blindness,15,35,6,6,12
Manipur,Noney,Blindness,35,60,1,5,6
Manipur,Noney,Blindness,60,80,3,1,4
Nagaland,Noklak,Blindness,35,60,0,1,1
Madhya Pradesh,Niwari,Blindness,0,6,1,1,2
Madhya Pradesh,Niwari,Blindness,6,15,9,11,20
Madhya Pradesh,Niwari,Blindness,15,35,107,53,160
Madhya Pradesh,Niwari,Blindness,35,60,147,59,206
Madhya Pradesh,Niwari,Blindness,60,80,41,33,74
Madhya Pradesh,Niwari,Blindness,80,100,7,4,11
Andaman And Nicobar Islands,Nicobars,Blindness,6,15,1,1,2
Andaman And Nicobar Islands,Nicobars,Blindness,15,35,2,0,2
Andaman And Nicobar Islands,Nicobars,Blindness,35,60,16,4,20
Andaman And Nicobar Islands,Nicobars,Blindness,60,80,3,1,4
Delhi,New Delhi,Blindness,6,15,5,0,5
Delhi,New Delhi,Blindness,15,35,62,9,71
Delhi,New Delhi,Blindness,35,60,13,2,15
Delhi,New Delhi,Blindness,60,80,3,1,4
Madhya Pradesh,Neemuch,Blindness,0,6,3,2,5
Madhya Pradesh,Neemuch,Blindness,6,15,20,11,31
Madhya Pradesh,Neemuch,Blindness,15,35,152,84,236
Madhya Pradesh,Neemuch,Blindness,35,60,165,54,219
Madhya Pradesh,Neemuch,Blindness,60,80,67,21,88
Madhya Pradesh,Neemuch,Blindness,80,100,8,2,10
Odisha,Nayagarh,Blindness,0,6,19,6,25
Odisha,Nayagarh,Blindness,6,15,97,63,160
Odisha,Nayagarh,Blindness,15,35,422,236,658
Odisha,Nayagarh,Blindness,35,60,807,481,1288
Odisha,Nayagarh,Blindness,60,80,417,180,597
Odisha,Nayagarh,Blindness,80,100,30,14,44
Bihar,Nawada,Blindness,0,6,3,1,4
Bihar,Nawada,Blindness,6,15,55,39,94
Bihar,Nawada,Blindness,15,35,151,88,239
Bihar,Nawada,Blindness,35,60,123,51,174
Bihar,Nawada,Blindness,60,80,45,17,62
Bihar,Nawada,Blindness,80,100,3,1,4
Gujarat,Navsari,Blindness,0,6,5,1,6
Gujarat,Navsari,Blindness,6,15,20,18,38
Gujarat,Navsari,Blindness,15,35,87,59,146
Gujarat,Navsari,Blindness,35,60,154,62,216
Gujarat,Navsari,Blindness,60,80,46,30,76
Gujarat,Navsari,Blindness,80,100,3,6,9
Maharashtra,Nashik,Blindness,0,6,22,19,41
Maharashtra,Nashik,Blindness,6,15,161,151,312
Maharashtra,Nashik,Blindness,15,35,649,369,1018
Maharashtra,Nashik,Blindness,35,60,926,395,1321
Maharashtra,Nashik,Blindness,60,80,341,114,455
Maharashtra,Nashik,Blindness,80,100,11,7,18
Madhya Pradesh,Narsinghpur,Blindness,0,6,1,1,2
Madhya Pradesh,Narsinghpur,Blindness,6,15,29,25,54
Madhya Pradesh,Narsinghpur,Blindness,15,35,240,180,420
Madhya Pradesh,Narsinghpur,Blindness,35,60,411,198,609
Madhya Pradesh,Narsinghpur,Blindness,60,80,153,57,210
Madhya Pradesh,Narsinghpur,Blindness,80,100,8,2,10
Madhya Pradesh,Narmadapuram,Blindness,0,6,2,2,4
Madhya Pradesh,Narmadapuram,Blindness,6,15,42,35,77
Madhya Pradesh,Narmadapuram,Blindness,15,35,256,163,419
Madhya Pradesh,Narmadapuram,Blindness,35,60,264,119,383
Madhya Pradesh,Narmadapuram,Blindness,60,80,94,45,139
Madhya Pradesh,Narmadapuram,Blindness,80,100,10,2,12
Gujarat,Narmada,Blindness,0,6,3,1,4
Gujarat,Narmada,Blindness,6,15,18,19,37
Gujarat,Narmada,Blindness,15,35,75,39,114
Gujarat,Narmada,Blindness,35,60,73,51,124
Gujarat,Narmada,Blindness,60,80,34,12,46
Gujarat,Narmada,Blindness,80,100,5,0,5
Chhattisgarh,Narayanpur,Blindness,6,15,10,3,13
Chhattisgarh,Narayanpur,Blindness,15,35,17,10,27
Chhattisgarh,Narayanpur,Blindness,35,60,9,3,12
Chhattisgarh,Narayanpur,Blindness,60,80,2,0,2
Maharashtra,Nandurbar,Blindness,0,6,10,1,11
Maharashtra,Nandurbar,Blindness,6,15,79,40,119
Maharashtra,Nandurbar,Blindness,15,35,307,127,434
Maharashtra,Nandurbar,Blindness,35,60,281,126,407
Maharashtra,Nandurbar,Blindness,60,80,145,50,195
Maharashtra,Nandurbar,Blindness,80,100,10,0,10
Maharashtra,Nanded,Blindness,0,6,27,23,50
Maharashtra,Nanded,Blindness,6,15,273,205,478
Maharashtra,Nanded,Blindness,15,35,971,552,1523
Maharashtra,Nanded,Blindness,35,60,876,402,1278
Maharashtra,Nanded,Blindness,60,80,355,146,501
Maharashtra,Nanded,Blindness,80,100,28,14,42
Arunachal Pradesh,Namsai,Blindness,6,15,2,1,3
Arunachal Pradesh,Namsai,Blindness,15,35,0,4,4
Arunachal Pradesh,Namsai,Blindness,35,60,3,4,7
Arunachal Pradesh,Namsai,Blindness,60,80,1,1,2
Sikkim,Namchi,Blindness,0,6,1,0,1
Sikkim,Namchi,Blindness,6,15,3,0,3
Sikkim,Namchi,Blindness,15,35,18,10,28
Sikkim,Namchi,Blindness,35,60,32,19,51
Sikkim,Namchi,Blindness,60,80,6,2,8
Sikkim,Namchi,Blindness,80,100,1,0,1
Tamil Nadu,Namakkal,Blindness,0,6,2,0,2
Tamil Nadu,Namakkal,Blindness,6,15,19,10,29
Tamil Nadu,Namakkal,Blindness,15,35,115,65,180
Tamil Nadu,Namakkal,Blindness,35,60,319,197,516
Tamil Nadu,Namakkal,Blindness,60,80,165,88,253
Tamil Nadu,Namakkal,Blindness,80,100,5,1,6
Assam,Nalbari,Blindness,0,6,1,2,3
Assam,Nalbari,Blindness,6,15,20,20,40
Assam,Nalbari,Blindness,15,35,136,104,240
Assam,Nalbari,Blindness,35,60,184,114,298
Assam,Nalbari,Blindness,60,80,66,32,98
Assam,Nalbari,Blindness,80,100,2,1,3
Bihar,Nalanda,Blindness,0,6,15,12,27
Bihar,Nalanda,Blindness,6,15,91,65,156
Bihar,Nalanda,Blindness,15,35,191,107,298
Bihar,Nalanda,Blindness,35,60,173,86,259
Bihar,Nalanda,Blindness,60,80,38,19,57
Bihar,Nalanda,Blindness,80,100,2,1,3
Uttarakhand,Nainital,Blindness,0,6,0,3,3
Uttarakhand,Nainital,Blindness,6,15,26,18,44
Uttarakhand,Nainital,Blindness,15,35,116,84,200
Uttarakhand,Nainital,Blindness,35,60,176,133,309
Uttarakhand,Nainital,Blindness,60,80,64,41,105
Uttarakhand,Nainital,Blindness,80,100,2,4,6
Maharashtra,Nagpur,Blindness,0,6,19,12,31
Maharashtra,Nagpur,Blindness,6,15,96,81,177
Maharashtra,Nagpur,Blindness,15,35,471,303,774
Maharashtra,Nagpur,Blindness,35,60,606,329,935
Maharashtra,Nagpur,Blindness,60,80,209,62,271
Maharashtra,Nagpur,Blindness,80,100,6,0,6
Rajasthan,Nagaur,Blindness,0,6,4,5,9
Rajasthan,Nagaur,Blindness,6,15,54,26,80
Rajasthan,Nagaur,Blindness,15,35,314,156,470
Rajasthan,Nagaur,Blindness,35,60,453,204,657
Rajasthan,Nagaur,Blindness,60,80,193,121,314
Rajasthan,Nagaur,Blindness,80,100,14,17,31
Tamil Nadu,Nagapattinam,Blindness,0,6,2,4,6
Tamil Nadu,Nagapattinam,Blindness,6,15,16,16,32
Tamil Nadu,Nagapattinam,Blindness,15,35,137,94,231
Tamil Nadu,Nagapattinam,Blindness,35,60,225,123,348
Tamil Nadu,Nagapattinam,Blindness,60,80,92,37,129
Tamil Nadu,Nagapattinam,Blindness,80,100,8,2,10
Assam,Nagaon,Blindness,0,6,4,3,7
Assam,Nagaon,Blindness,6,15,24,37,61
Assam,Nagaon,Blindness,15,35,168,128,296
Assam,Nagaon,Blindness,35,60,148,95,243
Assam,Nagaon,Blindness,60,80,52,23,75
Assam,Nagaon,Blindness,80,100,3,1,4
Odisha,Nabarangpur,Blindness,0,6,22,32,54
Odisha,Nabarangpur,Blindness,6,15,136,113,249
Odisha,Nabarangpur,Blindness,15,35,214,127,341
Odisha,Nabarangpur,Blindness,35,60,249,163,412
Odisha,Nabarangpur,Blindness,60,80,90,50,140
Odisha,Nabarangpur,Blindness,80,100,6,8,14
Karnataka,Mysuru,Blindness,0,6,7,3,10
Karnataka,Mysuru,Blindness,6,15,88,69,157
Karnataka,Mysuru,Blindness,15,35,528,418,946
Karnataka,Mysuru,Blindness,35,60,1084,651,1735
Karnataka,Mysuru,Blindness,60,80,374,139,513
Karnataka,Mysuru,Blindness,80,100,22,8,30
Bihar,Muzaffarpur,Blindness,0,6,9,2,11
Bihar,Muzaffarpur,Blindness,6,15,50,31,81
Bihar,Muzaffarpur,Blindness,15,35,126,63,189
Bihar,Muzaffarpur,Blindness,35,60,77,32,109
Bihar,Muzaffarpur,Blindness,60,80,18,6,24
Uttar Pradesh,Muzaffarnagar,Blindness,0,6,2,2,4
Uttar Pradesh,Muzaffarnagar,Blindness,6,15,18,17,35
Uttar Pradesh,Muzaffarnagar,Blindness,15,35,120,68,188
Uttar Pradesh,Muzaffarnagar,Blindness,35,60,183,69,252
Uttar Pradesh,Muzaffarnagar,Blindness,60,80,101,33,134
Uttar Pradesh,Muzaffarnagar,Blindness,80,100,8,3,11
West Bengal,Murshidabad,Blindness,15,35,3,0,3
West Bengal,Murshidabad,Blindness,35,60,1,0,1
Bihar,Munger,Blindness,0,6,5,2,7
Bihar,Munger,Blindness,6,15,30,24,54
Bihar,Munger,Blindness,15,35,95,57,152
Bihar,Munger,Blindness,35,60,108,48,156
Bihar,Munger,Blindness,60,80,29,21,50
Bihar,Munger,Blindness,80,100,5,0,5
Chhattisgarh,Mungeli,Blindness,0,6,1,0,1
Chhattisgarh,Mungeli,Blindness,6,15,19,20,39
Chhattisgarh,Mungeli,Blindness,15,35,97,54,151
Chhattisgarh,Mungeli,Blindness,35,60,85,39,124
Chhattisgarh,Mungeli,Blindness,60,80,29,11,40
Chhattisgarh,Mungeli,Blindness,80,100,4,1,5
Maharashtra,Mumbai Suburban,Blindness,0,6,7,9,16
Maharashtra,Mumbai Suburban,Blindness,6,15,75,43,118
Maharashtra,Mumbai Suburban,Blindness,15,35,363,201,564
Maharashtra,Mumbai Suburban,Blindness,35,60,473,198,671
Maharashtra,Mumbai Suburban,Blindness,60,80,162,35,197
Maharashtra,Mumbai Suburban,Blindness,80,100,10,1,11
Maharashtra,Mumbai,Blindness,0,6,6,2,8
Maharashtra,Mumbai,Blindness,6,15,32,22,54
Maharashtra,Mumbai,Blindness,15,35,182,98,280
Maharashtra,Mumbai,Blindness,35,60,313,129,442
Maharashtra,Mumbai,Blindness,60,80,152,36,188
Maharashtra,Mumbai,Blindness,80,100,10,3,13
Madhya Pradesh,Morena,Blindness,0,6,9,3,12
Madhya Pradesh,Morena,Blindness,6,15,66,49,115
Madhya Pradesh,Morena,Blindness,15,35,329,151,480
Madhya Pradesh,Morena,Blindness,35,60,412,154,566
Madhya Pradesh,Morena,Blindness,60,80,173,103,276
Madhya Pradesh,Morena,Blindness,80,100,11,3,14
Gujarat,Morbi,Blindness,0,6,3,0,3
Gujarat,Morbi,Blindness,6,15,28,21,49
Gujarat,Morbi,Blindness,15,35,118,51,169
Gujarat,Morbi,Blindness,35,60,150,57,207
Gujarat,Morbi,Blindness,60,80,88,28,116
Gujarat,Morbi,Blindness,80,100,8,1,9
Uttar Pradesh,Moradabad,Blindness,0,6,5,4,9
Uttar Pradesh,Moradabad,Blindness,6,15,30,28,58
Uttar Pradesh,Moradabad,Blindness,15,35,159,82,241
Uttar Pradesh,Moradabad,Blindness,35,60,230,68,298
Uttar Pradesh,Moradabad,Blindness,60,80,87,23,110
Uttar Pradesh,Moradabad,Blindness,80,100,4,0,4
Nagaland,Mon,Blindness,0,6,1,0,1
Nagaland,Mon,Blindness,6,15,3,2,5
Nagaland,Mon,Blindness,15,35,19,7,26
Nagaland,Mon,Blindness,35,60,10,8,18
Nagaland,Mon,Blindness,60,80,4,4,8
Nagaland,Mon,Blindness,80,100,1,2,3
Nagaland,Mokokchung,Blindness,6,15,2,1,3
Nagaland,Mokokchung,Blindness,15,35,6,2,8
Nagaland,Mokokchung,Blindness,35,60,10,2,12
Nagaland,Mokokchung,Blindness,60,80,2,4,6
Nagaland,Mokokchung,Blindness,80,100,1,0,1
Punjab,Moga,Blindness,0,6,3,3,6
Punjab,Moga,Blindness,6,15,23,6,29
Punjab,Moga,Blindness,15,35,82,44,126
Punjab,Moga,Blindness,35,60,178,79,257
Punjab,Moga,Blindness,60,80,73,23,96
Punjab,Moga,Blindness,80,100,5,1,6
Uttar Pradesh,Mirzapur,Blindness,0,6,7,1,8
Uttar Pradesh,Mirzapur,Blindness,6,15,31,15,46
Uttar Pradesh,Mirzapur,Blindness,15,35,220,111,331
Uttar Pradesh,Mirzapur,Blindness,35,60,239,113,352
Uttar Pradesh,Mirzapur,Blindness,60,80,70,21,91
Uttar Pradesh,Mirzapur,Blindness,80,100,5,1,6
Uttar Pradesh,Meerut,Blindness,0,6,3,2,5
Uttar Pradesh,Meerut,Blindness,6,15,37,17,54
Uttar Pradesh,Meerut,Blindness,15,35,159,85,244
Uttar Pradesh,Meerut,Blindness,35,60,242,92,334
Uttar Pradesh,Meerut,Blindness,60,80,158,31,189
Uttar Pradesh,Meerut,Blindness,80,100,8,5,13
West Bengal,Medinipur East,Blindness,35,60,1,0,1
Telangana,Medchal Malkajgiri,Blindness,15,35,2,1,3
Odisha,Mayurbhanj,Blindness,0,6,20,10,30
Odisha,Mayurbhanj,Blindness,6,15,103,108,211
Odisha,Mayurbhanj,Blindness,15,35,431,356,787
Odisha,Mayurbhanj,Blindness,35,60,591,417,1008
Odisha,Mayurbhanj,Blindness,60,80,382,222,604
Odisha,Mayurbhanj,Blindness,80,100,38,29,67
Tamil Nadu,Mayiladuthurai,Blindness,0,6,1,0,1
Tamil Nadu,Mayiladuthurai,Blindness,6,15,6,5,11
Tamil Nadu,Mayiladuthurai,Blindness,15,35,17,8,25
Tamil Nadu,Mayiladuthurai,Blindness,35,60,30,16,46
Tamil Nadu,Mayiladuthurai,Blindness,60,80,10,4,14
Tamil Nadu,Mayiladuthurai,Blindness,80,100,2,0,2
Uttar Pradesh,Mau,Blindness,0,6,2,2,4
Uttar Pradesh,Mau,Blindness,6,15,19,17,36
Uttar Pradesh,Mau,Blindness,15,35,134,84,218
Uttar Pradesh,Mau,Blindness,35,60,158,52,210
Uttar Pradesh,Mau,Blindness,60,80,87,21,108
Uttar Pradesh,Mau,Blindness,80,100,5,1,6
Uttar Pradesh,Mathura,Blindness,0,6,4,2,6
Uttar Pradesh,Mathura,Blindness,6,15,26,15,41
Uttar Pradesh,Mathura,Blindness,15,35,144,54,198
Uttar Pradesh,Mathura,Blindness,35,60,209,73,282
Uttar Pradesh,Mathura,Blindness,60,80,78,37,115
Uttar Pradesh,Mathura,Blindness,80,100,6,1,7
Assam,Marigaon,Blindness,0,6,4,2,6
Assam,Marigaon,Blindness,6,15,29,25,54
Assam,Marigaon,Blindness,15,35,153,108,261
Assam,Marigaon,Blindness,35,60,185,98,283
Assam,Marigaon,Blindness,60,80,37,22,59
Assam,Marigaon,Blindness,80,100,0,2,2
Punjab,Mansa,Blindness,0,6,7,7,14
Punjab,Mansa,Blindness,6,15,21,16,37
Punjab,Mansa,Blindness,15,35,100,50,150
Punjab,Mansa,Blindness,35,60,172,94,266
Punjab,Mansa,Blindness,60,80,83,27,110
Punjab,Mansa,Blindness,80,100,5,5,10
Sikkim,Mangan,Blindness,15,35,3,4,7
Sikkim,Mangan,Blindness,35,60,4,0,4
Sikkim,Mangan,Blindness,60,80,3,1,4
Karnataka,Mandya,Blindness,0,6,6,4,10
Karnataka,Mandya,Blindness,6,15,34,31,65
Karnataka,Mandya,Blindness,15,35,214,160,374
Karnataka,Mandya,Blindness,35,60,581,375,956
Karnataka,Mandya,Blindness,60,80,216,105,321
Karnataka,Mandya,Blindness,80,100,17,5,22
Madhya Pradesh,Mandsaur,Blindness,0,6,1,1,2
Madhya Pradesh,Mandsaur,Blindness,6,15,8,14,22
Madhya Pradesh,Mandsaur,Blindness,15,35,107,79,186
Madhya Pradesh,Mandsaur,Blindness,35,60,164,84,248
Madhya Pradesh,Mandsaur,Blindness,60,80,82,72,154
Madhya Pradesh,Mandsaur,Blindness,80,100,18,15,33
Madhya Pradesh,Mandla,Blindness,6,15,32,23,55
Madhya Pradesh,Mandla,Blindness,15,35,181,119,300
Madhya Pradesh,Mandla,Blindness,35,60,191,120,311
Madhya Pradesh,Mandla,Blindness,60,80,89,61,150
Madhya Pradesh,Mandla,Blindness,80,100,7,3,10
Himachal Pradesh,Mandi,Blindness,0,6,7,4,11
Himachal Pradesh,Mandi,Blindness,6,15,32,25,57
Himachal Pradesh,Mandi,Blindness,15,35,195,129,324
Himachal Pradesh,Mandi,Blindness,35,60,303,188,491
Himachal Pradesh,Mandi,Blindness,60,80,142,75,217
Himachal Pradesh,Mandi,Blindness,80,100,22,8,30
Mizoram,Mamit,Blindness,0,6,2,0,2
Mizoram,Mamit,Blindness,6,15,1,0,1
Mizoram,Mamit,Blindness,15,35,6,2,8
Mizoram,Mamit,Blindness,35,60,5,1,6
Mizoram,Mamit,Blindness,60,80,1,1,2
Mizoram,Mamit,Blindness,80,100,0,1,1
Odisha,Malkangiri,Blindness,0,6,7,7,14
Odisha,Malkangiri,Blindness,6,15,91,72,163
Odisha,Malkangiri,Blindness,15,35,220,140,360
Odisha,Malkangiri,Blindness,35,60,261,174,435
Odisha,Malkangiri,Blindness,60,80,90,45,135
Odisha,Malkangiri,Blindness,80,100,4,3,7
Punjab,Malerkotla,Blindness,0,6,1,0,1
Punjab,Malerkotla,Blindness,6,15,0,1,1
Punjab,Malerkotla,Blindness,15,35,9,5,14
Punjab,Malerkotla,Blindness,35,60,22,13,35
Punjab,Malerkotla,Blindness,60,80,6,2,8
Punjab,Malerkotla,Blindness,80,100,1,2,3
Kerala,Malappuram,Blindness,0,6,6,4,10
Kerala,Malappuram,Blindness,6,15,47,35,82
Kerala,Malappuram,Blindness,15,35,223,172,395
Kerala,Malappuram,Blindness,35,60,510,279,789
Kerala,Malappuram,Blindness,60,80,250,129,379
Kerala,Malappuram,Blindness,80,100,26,16,42
Assam,Majuli,Blindness,0,6,1,0,1
Assam,Majuli,Blindness,6,15,6,3,9
Assam,Majuli,Blindness,15,35,14,11,25
Assam,Majuli,Blindness,35,60,18,8,26
Assam,Majuli,Blindness,60,80,6,1,7
Uttar Pradesh,Mainpuri,Blindness,0,6,2,1,3
Uttar Pradesh,Mainpuri,Blindness,6,15,43,43,86
Uttar Pradesh,Mainpuri,Blindness,15,35,188,117,305
Uttar Pradesh,Mainpuri,Blindness,35,60,296,127,423
Uttar Pradesh,Mainpuri,Blindness,60,80,185,66,251
Uttar Pradesh,Mainpuri,Blindness,80,100,15,5,20
Uttar Pradesh,Mahoba,Blindness,6,15,15,13,28
Uttar Pradesh,Mahoba,Blindness,15,35,78,26,104
Uttar Pradesh,Mahoba,Blindness,35,60,125,37,162
Uttar Pradesh,Mahoba,Blindness,60,80,38,6,44
Uttar Pradesh,Mahoba,Blindness,80,100,6,0,6
Gujarat,Mahisagar,Blindness,0,6,1,1,2
Gujarat,Mahisagar,Blindness,6,15,34,24,58
Gujarat,Mahisagar,Blindness,15,35,174,120,294
Gujarat,Mahisagar,Blindness,35,60,138,44,182
Gujarat,Mahisagar,Blindness,60,80,34,6,40
Gujarat,Mahisagar,Blindness,80,100,4,1,5
Gujarat,Mahesana,Blindness,0,6,7,3,10
Gujarat,Mahesana,Blindness,6,15,64,30,94
Gujarat,Mahesana,Blindness,15,35,239,171,410
Gujarat,Mahesana,Blindness,35,60,300,116,416
Gujarat,Mahesana,Blindness,60,80,176,45,221
Gujarat,Mahesana,Blindness,80,100,16,2,18
Haryana,Mahendragarh,Blindness,0,6,1,5,6
Haryana,Mahendragarh,Blindness,6,15,14,6,20
Haryana,Mahendragarh,Blindness,15,35,120,52,172
Haryana,Mahendragarh,Blindness,35,60,235,95,330
Haryana,Mahendragarh,Blindness,60,80,157,86,243
Haryana,Mahendragarh,Blindness,80,100,26,21,47
Puducherry,Mahe,Blindness,6,15,1,1,2
Puducherry,Mahe,Blindness,15,35,7,2,9
Puducherry,Mahe,Blindness,35,60,12,5,17
Puducherry,Mahe,Blindness,60,80,7,7,14
Puducherry,Mahe,Blindness,80,100,0,2,2
Chhattisgarh,Mahasamund,Blindness,0,6,4,8,12
Chhattisgarh,Mahasamund,Blindness,6,15,66,54,120
Chhattisgarh,Mahasamund,Blindness,15,35,103,103,206
Chhattisgarh,Mahasamund,Blindness,35,60,92,34,126
Chhattisgarh,Mahasamund,Blindness,60,80,33,16,49
Chhattisgarh,Mahasamund,Blindness,80,100,0,1,1
Uttar Pradesh,Maharajganj,Blindness,0,6,7,0,7
Uttar Pradesh,Maharajganj,Blindness,6,15,32,19,51
Uttar Pradesh,Maharajganj,Blindness,15,35,242,94,336
Uttar Pradesh,Maharajganj,Blindness,35,60,257,91,348
Uttar Pradesh,Maharajganj,Blindness,60,80,83,29,112
Uttar Pradesh,Maharajganj,Blindness,80,100,2,2,4
Telangana,Mahabubabad,Blindness,35,60,1,0,1
Tamil Nadu,Madurai,Blindness,0,6,2,2,4
Tamil Nadu,Madurai,Blindness,6,15,32,34,66
Tamil Nadu,Madurai,Blindness,15,35,271,151,422
Tamil Nadu,Madurai,Blindness,35,60,567,353,920
Tamil Nadu,Madurai,Blindness,60,80,148,89,237
Tamil Nadu,Madurai,Blindness,80,100,11,2,13
Bihar,Madhubani,Blindness,0,6,2,1,3
Bihar,Madhubani,Blindness,6,15,35,13,48
Bihar,Madhubani,Blindness,15,35,138,55,193
Bihar,Madhubani,Blindness,35,60,99,32,131
Bihar,Madhubani,Blindness,60,80,23,15,38
Bihar,Madhubani,Blindness,80,100,1,0,1
Bihar,Madhepura,Blindness,0,6,1,0,1
Bihar,Madhepura,Blindness,6,15,14,21,35
Bihar,Madhepura,Blindness,15,35,113,55,168
Bihar,Madhepura,Blindness,35,60,124,65,189
Bihar,Madhepura,Blindness,60,80,51,11,62
Bihar,Madhepura,Blindness,80,100,0,1,1
Mizoram,Lunglei,Blindness,6,15,0,1,1
Mizoram,Lunglei,Blindness,15,35,4,3,7
Mizoram,Lunglei,Blindness,35,60,3,4,7
Mizoram,Lunglei,Blindness,60,80,1,3,4
Punjab,Ludhiana,Blindness,0,6,11,18,29
Punjab,Ludhiana,Blindness,6,15,104,72,176
Punjab,Ludhiana,Blindness,15,35,429,244,673
Punjab,Ludhiana,Blindness,35,60,678,317,995
Punjab,Ludhiana,Blindness,60,80,409,152,561
Punjab,Ludhiana,Blindness,80,100,28,11,39
Uttar Pradesh,Lucknow,Blindness,0,6,4,3,7
Uttar Pradesh,Lucknow,Blindness,6,15,44,50,94
Uttar Pradesh,Lucknow,Blindness,15,35,271,162,433
Uttar Pradesh,Lucknow,Blindness,35,60,295,108,403
Uttar Pradesh,Lucknow,Blindness,60,80,114,33,147
Uttar Pradesh,Lucknow,Blindness,80,100,4,1,5
Arunachal Pradesh,Lower Subansiri,Blindness,15,35,0,1,1
Arunachal Pradesh,Lower Dibang Valley,Blindness,15,35,7,1,8
Arunachal Pradesh,Lower Dibang Valley,Blindness,35,60,3,3,6
Arunachal Pradesh,Lower Dibang Valley,Blindness,60,80,2,4,6
Arunachal Pradesh,Longding,Blindness,6,15,1,0,1
Arunachal Pradesh,Longding,Blindness,15,35,5,4,9
Arunachal Pradesh,Longding,Blindness,35,60,0,1,1
Arunachal Pradesh,Longding,Blindness,60,80,2,1,3
Arunachal Pradesh,Lohit,Blindness,15,35,1,0,1
Jharkhand,Lohardaga,Blindness,6,15,16,30,46
Jharkhand,Lohardaga,Blindness,15,35,93,69,162
Jharkhand,Lohardaga,Blindness,35,60,88,44,132
Jharkhand,Lohardaga,Blindness,60,80,21,9,30
Ladakh,Leh Ladakh,Blindness,0,6,2,0,2
Ladakh,Leh Ladakh,Blindness,6,15,2,1,3
Ladakh,Leh Ladakh,Blindness,15,35,6,3,9
Ladakh,Leh Ladakh,Blindness,35,60,13,7,20
Ladakh,Leh Ladakh,Blindness,60,80,10,2,12
Ladakh,Leh Ladakh,Blindness,80,100,1,1,2
Mizoram,Lawngtlai,Blindness,6,15,5,0,5
Mizoram,Lawngtlai,Blindness,15,35,1,0,1
Mizoram,Lawngtlai,Blindness,35,60,3,1,4
Mizoram,Lawngtlai,Blindness,60,80,2,0,2
Maharashtra,Latur,Blindness,0,6,8,5,13
Maharashtra,Latur,Blindness,6,15,114,83,197
Maharashtra,Latur,Blindness,15,35,595,299,894
Maharashtra,Latur,Blindness,35,60,708,329,1037
Maharashtra,Latur,Blindness,60,80,444,184,628
Maharashtra,Latur,Blindness,80,100,55,17,72
Jharkhand,Latehar,Blindness,0,6,1,0,1
Jharkhand,Latehar,Blindness,6,15,13,17,30
Jharkhand,Latehar,Blindness,15,35,79,59,138
Jharkhand,Latehar,Blindness,35,60,58,33,91
Jharkhand,Latehar,Blindness,60,80,10,3,13
Uttar Pradesh,Lalitpur,Blindness,0,6,2,0,2
Uttar Pradesh,Lalitpur,Blindness,6,15,30,50,80
Uttar Pradesh,Lalitpur,Blindness,15,35,164,96,260
Uttar Pradesh,Lalitpur,Blindness,35,60,125,68,193
Uttar Pradesh,Lalitpur,Blindness,60,80,35,21,56
Uttar Pradesh,Lalitpur,Blindness,80,100,1,1,2
Lakshadweep,Lakshadweep District,Blindness,6,15,1,1,2
Lakshadweep,Lakshadweep District,Blindness,15,35,8,10,18
Lakshadweep,Lakshadweep District,Blindness,35,60,16,8,24
Lakshadweep,Lakshadweep District,Blindness,60,80,4,4,8
Lakshadweep,Lakshadweep District,Blindness,80,100,1,0,1
Bihar,Lakhisarai,Blindness,0,6,3,1,4
Bihar,Lakhisarai,Blindness,6,15,19,11,30
Bihar,Lakhisarai,Blindness,15,35,67,44,111
Bihar,Lakhisarai,Blindness,35,60,94,46,140
Bihar,Lakhisarai,Blindness,60,80,45,17,62
Bihar,Lakhisarai,Blindness,80,100,5,2,7
Assam,Lakhimpur,Blindness,0,6,8,1,9
Assam,Lakhimpur,Blindness,6,15,32,32,64
Assam,Lakhimpur,Blindness,15,35,95,64,159
Assam,Lakhimpur,Blindness,35,60,104,65,169
Assam,Lakhimpur,Blindness,60,80,20,8,28
Assam,Lakhimpur,Blindness,80,100,2,4,6
Himachal Pradesh,Lahul And Spiti,Blindness,6,15,1,0,1
Himachal Pradesh,Lahul And Spiti,Blindness,15,35,6,1,7
Himachal Pradesh,Lahul And Spiti,Blindness,35,60,7,8,15
Himachal Pradesh,Lahul And Spiti,Blindness,60,80,4,6,10
Uttar Pradesh,Kushi Nagar,Blindness,0,6,1,1,2
Uttar Pradesh,Kushi Nagar,Blindness,6,15,49,33,82
Uttar Pradesh,Kushi Nagar,Blindness,15,35,286,139,425
Uttar Pradesh,Kushi Nagar,Blindness,35,60,244,85,329
Uttar Pradesh,Kushi Nagar,Blindness,60,80,56,19,75
Uttar Pradesh,Kushi Nagar,Blindness,80,100,0,1,1
Arunachal Pradesh,Kurung Kumey,Blindness,15,35,0,1,1
Arunachal Pradesh,Kurung Kumey,Blindness,35,60,4,0,4
Haryana,Kurukshetra,Blindness,0,6,3,0,3
Haryana,Kurukshetra,Blindness,6,15,19,10,29
Haryana,Kurukshetra,Blindness,15,35,77,54,131
Haryana,Kurukshetra,Blindness,35,60,151,75,226
Haryana,Kurukshetra,Blindness,60,80,55,23,78
Haryana,Kurukshetra,Blindness,80,100,1,7,8
Andhra Pradesh,Kurnool,Blindness,0,6,20,20,40
Andhra Pradesh,Kurnool,Blindness,6,15,149,135,284
Andhra Pradesh,Kurnool,Blindness,15,35,960,474,1434
Andhra Pradesh,Kurnool,Blindness,35,60,2056,350,2406
Andhra Pradesh,Kurnool,Blindness,60,80,822,177,999
Andhra Pradesh,Kurnool,Blindness,80,100,87,28,115
Jammu And Kashmir,Kupwara,Blindness,0,6,4,8,12
Jammu And Kashmir,Kupwara,Blindness,6,15,32,37,69
Jammu And Kashmir,Kupwara,Blindness,15,35,119,66,185
Jammu And Kashmir,Kupwara,Blindness,35,60,109,66,175
Jammu And Kashmir,Kupwara,Blindness,60,80,29,12,41
Jammu And Kashmir,Kupwara,Blindness,80,100,1,0,1
Himachal Pradesh,Kullu,Blindness,0,6,3,2,5
Himachal Pradesh,Kullu,Blindness,6,15,27,14,41
Himachal Pradesh,Kullu,Blindness,15,35,139,87,226
Himachal Pradesh,Kullu,Blindness,35,60,182,120,302
Himachal Pradesh,Kullu,Blindness,60,80,66,30,96
Himachal Pradesh,Kullu,Blindness,80,100,6,2,8
Jammu And Kashmir,Kulgam,Blindness,0,6,1,3,4
Jammu And Kashmir,Kulgam,Blindness,6,15,24,21,45
Jammu And Kashmir,Kulgam,Blindness,15,35,117,74,191
Jammu And Kashmir,Kulgam,Blindness,35,60,118,63,181
Jammu And Kashmir,Kulgam,Blindness,60,80,42,26,68
Jammu And Kashmir,Kulgam,Blindness,80,100,7,3,10
Tamil Nadu,Krishnagiri,Blindness,0,6,4,0,4
Tamil Nadu,Krishnagiri,Blindness,6,15,60,26,86
Tamil Nadu,Krishnagiri,Blindness,15,35,197,130,327
Tamil Nadu,Krishnagiri,Blindness,35,60,326,169,495
Tamil Nadu,Krishnagiri,Blindness,60,80,120,48,168
Tamil Nadu,Krishnagiri,Blindness,80,100,10,4,14
Andhra Pradesh,Krishna,Blindness,0,6,5,3,8
Andhra Pradesh,Krishna,Blindness,6,15,63,46,109
Andhra Pradesh,Krishna,Blindness,15,35,422,158,580
Andhra Pradesh,Krishna,Blindness,35,60,1404,40,1444
Andhra Pradesh,Krishna,Blindness,60,80,389,9,398
Andhra Pradesh,Krishna,Blindness,80,100,26,1,27
Kerala,Kozhikode,Blindness,0,6,4,3,7
Kerala,Kozhikode,Blindness,6,15,36,36,72
Kerala,Kozhikode,Blindness,15,35,188,111,299
Kerala,Kozhikode,Blindness,35,60,450,294,744
Kerala,Kozhikode,Blindness,60,80,315,147,462
Kerala,Kozhikode,Blindness,80,100,23,12,35
Kerala,Kottayam,Blindness,0,6,1,1,2
Kerala,Kottayam,Blindness,6,15,15,6,21
Kerala,Kottayam,Blindness,15,35,35,35,70
Kerala,Kottayam,Blindness,35,60,115,91,206
Kerala,Kottayam,Blindness,60,80,98,56,154
Kerala,Kottayam,Blindness,80,100,7,14,21
Rajasthan,Kota,Blindness,0,6,4,1,5
Rajasthan,Kota,Blindness,6,15,14,12,26
Rajasthan,Kota,Blindness,15,35,126,86,212
Rajasthan,Kota,Blindness,35,60,164,85,249
Rajasthan,Kota,Blindness,60,80,57,46,103
Rajasthan,Kota,Blindness,80,100,5,4,9
Chhattisgarh,Korea,Blindness,0,6,3,0,3
Chhattisgarh,Korea,Blindness,6,15,38,36,74
Chhattisgarh,Korea,Blindness,15,35,154,132,286
Chhattisgarh,Korea,Blindness,35,60,162,78,240
Chhattisgarh,Korea,Blindness,60,80,50,27,77
Chhattisgarh,Korea,Blindness,80,100,4,4,8
Chhattisgarh,Korba,Blindness,0,6,2,0,2
Chhattisgarh,Korba,Blindness,6,15,38,36,74
Chhattisgarh,Korba,Blindness,15,35,167,95,262
Chhattisgarh,Korba,Blindness,35,60,118,35,153
Chhattisgarh,Korba,Blindness,60,80,20,14,34
Chhattisgarh,Korba,Blindness,80,100,1,0,1
Odisha,Koraput,Blindness,0,6,13,13,26
Odisha,Koraput,Blindness,6,15,97,61,158
Odisha,Koraput,Blindness,15,35,295,190,485
Odisha,Koraput,Blindness,35,60,310,202,512
Odisha,Koraput,Blindness,60,80,139,121,260
Odisha,Koraput,Blindness,80,100,11,13,24
Karnataka,Koppal,Blindness,0,6,8,9,17
Karnataka,Koppal,Blindness,6,15,97,66,163
Karnataka,Koppal,Blindness,15,35,396,263,659
Karnataka,Koppal,Blindness,35,60,457,228,685
Karnataka,Koppal,Blindness,60,80,117,54,171
Karnataka,Koppal,Blindness,80,100,4,0,4
Chhattisgarh,Kondagaon,Blindness,0,6,3,1,4
Chhattisgarh,Kondagaon,Blindness,6,15,28,28,56
Chhattisgarh,Kondagaon,Blindness,15,35,99,75,174
Chhattisgarh,Kondagaon,Blindness,35,60,72,40,112
Chhattisgarh,Kondagaon,Blindness,60,80,13,12,25
Chhattisgarh,Kondagaon,Blindness,80,100,0,1,1
Kerala,Kollam,Blindness,0,6,1,2,3
Kerala,Kollam,Blindness,6,15,14,18,32
Kerala,Kollam,Blindness,15,35,51,45,96
Kerala,Kollam,Blindness,35,60,138,89,227
Kerala,Kollam,Blindness,60,80,93,68,161
Kerala,Kollam,Blindness,80,100,8,6,14
Maharashtra,Kolhapur,Blindness,0,6,6,4,10
Maharashtra,Kolhapur,Blindness,6,15,135,88,223
Maharashtra,Kolhapur,Blindness,15,35,601,275,876
Maharashtra,Kolhapur,Blindness,35,60,930,382,1312
Maharashtra,Kolhapur,Blindness,60,80,358,114,472
Maharashtra,Kolhapur,Blindness,80,100,17,5,22
Mizoram,Kolasib,Blindness,0,6,1,0,1
Mizoram,Kolasib,Blindness,6,15,3,0,3
Mizoram,Kolasib,Blindness,15,35,19,8,27
Mizoram,Kolasib,Blindness,35,60,12,5,17
Mizoram,Kolasib,Blindness,60,80,3,2,5
Mizoram,Kolasib,Blindness,80,100,1,0,1
Karnataka,Kolar,Blindness,0,6,10,3,13
Karnataka,Kolar,Blindness,6,15,53,50,103
Karnataka,Kolar,Blindness,15,35,299,210,509
Karnataka,Kolar,Blindness,35,60,524,310,834
Karnataka,Kolar,Blindness,60,80,210,102,312
Karnataka,Kolar,Blindness,80,100,23,5,28
Assam,Kokrajhar,Blindness,0,6,10,7,17
Assam,Kokrajhar,Blindness,6,15,86,68,154
Assam,Kokrajhar,Blindness,15,35,298,227,525
Assam,Kokrajhar,Blindness,35,60,292,202,494
Assam,Kokrajhar,Blindness,60,80,82,60,142
Assam,Kokrajhar,Blindness,80,100,6,1,7
Nagaland,Kohima,Blindness,6,15,5,3,8
Nagaland,Kohima,Blindness,15,35,8,8,16
Nagaland,Kohima,Blindness,35,60,4,6,10
Nagaland,Kohima,Blindness,60,80,3,1,4
Nagaland,Kohima,Blindness,80,100,0,1,1
Jharkhand,Koderma,Blindness,0,6,5,1,6
Jharkhand,Koderma,Blindness,6,15,35,22,57
Jharkhand,Koderma,Blindness,15,35,124,51,175
Jharkhand,Koderma,Blindness,35,60,127,56,183
Jharkhand,Koderma,Blindness,60,80,25,12,37
Jharkhand,Koderma,Blindness,80,100,1,1,2
Karnataka,Kodagu,Blindness,0,6,0,1,1
Karnataka,Kodagu,Blindness,6,15,4,2,6
Karnataka,Kodagu,Blindness,15,35,22,15,37
Karnataka,Kodagu,Blindness,35,60,61,35,96
Karnataka,Kodagu,Blindness,60,80,36,23,59
Karnataka,Kodagu,Blindness,80,100,0,2,2
Jammu And Kashmir,Kishtwar,Blindness,0,6,1,1,2
Jammu And Kashmir,Kishtwar,Blindness,6,15,17,17,34
Jammu And Kashmir,Kishtwar,Blindness,15,35,69,48,117
Jammu And Kashmir,Kishtwar,Blindness,35,60,88,46,134
Jammu And Kashmir,Kishtwar,Blindness,60,80,30,19,49
Jammu And Kashmir,Kishtwar,Blindness,80,100,1,0,1
Bihar,Kishanganj,Blindness,0,6,6,3,9
Bihar,Kishanganj,Blindness,6,15,41,39,80
Bihar,Kishanganj,Blindness,15,35,147,112,259
Bihar,Kishanganj,Blindness,35,60,128,70,198
Bihar,Kishanganj,Blindness,60,80,35,6,41
Bihar,Kishanganj,Blindness,80,100,2,1,3
Nagaland,Kiphire,Blindness,6,15,1,0,1
Nagaland,Kiphire,Blindness,15,35,1,1,2
Himachal Pradesh,Kinnaur,Blindness,0,6,1,0,1
Himachal Pradesh,Kinnaur,Blindness,6,15,1,0,1
Himachal Pradesh,Kinnaur,Blindness,15,35,6,7,13
Himachal Pradesh,Kinnaur,Blindness,35,60,22,10,32
Himachal Pradesh,Kinnaur,Blindness,60,80,11,2,13
Himachal Pradesh,Kinnaur,Blindness,80,100,0,1,1
Jharkhand,Khunti,Blindness,0,6,1,0,1
Jharkhand,Khunti,Blindness,6,15,14,14,28
Jharkhand,Khunti,Blindness,15,35,50,29,79
Jharkhand,Khunti,Blindness,35,60,48,21,69
Jharkhand,Khunti,Blindness,60,80,4,3,7
Tripura,Khowai,Blindness,0,6,0,1,1
Tripura,Khowai,Blindness,6,15,5,3,8
Tripura,Khowai,Blindness,15,35,26,12,38
Tripura,Khowai,Blindness,35,60,26,12,38
Tripura,Khowai,Blindness,60,80,7,3,10
Tripura,Khowai,Blindness,80,100,1,2,3
Odisha,Khordha,Blindness,0,6,5,10,15
Odisha,Khordha,Blindness,6,15,62,62,124
Odisha,Khordha,Blindness,15,35,275,215,490
Odisha,Khordha,Blindness,35,60,439,274,713
Odisha,Khordha,Blindness,60,80,185,97,282
Odisha,Khordha,Blindness,80,100,14,4,18
Uttar Pradesh,Kheri,Blindness,0,6,6,3,9
Uttar Pradesh,Kheri,Blindness,6,15,46,50,96
Uttar Pradesh,Kheri,Blindness,15,35,226,113,339
Uttar Pradesh,Kheri,Blindness,35,60,243,71,314
Uttar Pradesh,Kheri,Blindness,60,80,110,42,152
Uttar Pradesh,Kheri,Blindness,80,100,7,2,9
Gujarat,Kheda,Blindness,0,6,17,8,25
Gujarat,Kheda,Blindness,6,15,141,117,258
Gujarat,Kheda,Blindness,15,35,438,265,703
Gujarat,Kheda,Blindness,35,60,401,137,538
Gujarat,Kheda,Blindness,60,80,149,47,196
Gujarat,Kheda,Blindness,80,100,18,2,20
Mizoram,Khawzawl,Blindness,6,15,0,1,1
Mizoram,Khawzawl,Blindness,15,35,1,2,3
Mizoram,Khawzawl,Blindness,35,60,3,0,3
Mizoram,Khawzawl,Blindness,60,80,1,0,1
Madhya Pradesh,Khargone,Blindness,0,6,5,4,9
Madhya Pradesh,Khargone,Blindness,6,15,41,36,77
Madhya Pradesh,Khargone,Blindness,15,35,312,178,490
Madhya Pradesh,Khargone,Blindness,35,60,434,220,654
Madhya Pradesh,Khargone,Blindness,60,80,223,77,300
Madhya Pradesh,Khargone,Blindness,80,100,17,5,22
Bihar,Khagaria,Blindness,0,6,2,1,3
Bihar,Khagaria,Blindness,6,15,24,17,41
Bihar,Khagaria,Blindness,15,35,85,65,150
Bihar,Khagaria,Blindness,35,60,87,33,120
Bihar,Khagaria,Blindness,60,80,35,16,51
Bihar,Khagaria,Blindness,80,100,1,1,2
Odisha,Kendujhar,Blindness,0,6,7,3,10
Odisha,Kendujhar,Blindness,6,15,25,36,61
Odisha,Kendujhar,Blindness,15,35,128,59,187
Odisha,Kendujhar,Blindness,35,60,144,70,214
Odisha,Kendujhar,Blindness,60,80,58,21,79
Odisha,Kendujhar,Blindness,80,100,2,3,5
Odisha,Kendrapara,Blindness,0,6,1,4,5
Odisha,Kendrapara,Blindness,6,15,68,44,112
Odisha,Kendrapara,Blindness,15,35,208,167,375
Odisha,Kendrapara,Blindness,35,60,385,258,643
Odisha,Kendrapara,Blindness,60,80,157,66,223
Odisha,Kendrapara,Blindness,80,100,15,7,22
Uttar Pradesh,Kaushambi,Blindness,0,6,1,1,2
Uttar Pradesh,Kaushambi,Blindness,6,15,26,22,48
Uttar Pradesh,Kaushambi,Blindness,15,35,149,73,222
Uttar Pradesh,Kaushambi,Blindness,35,60,165,64,229
Uttar Pradesh,Kaushambi,Blindness,60,80,42,13,55
Uttar Pradesh,Kaushambi,Blindness,80,100,2,0,2
Madhya Pradesh,Katni,Blindness,0,6,4,10,14
Madhya Pradesh,Katni,Blindness,6,15,52,40,92
Madhya Pradesh,Katni,Blindness,15,35,412,275,687
Madhya Pradesh,Katni,Blindness,35,60,402,262,664
Madhya Pradesh,Katni,Blindness,60,80,222,145,367
Madhya Pradesh,Katni,Blindness,80,100,29,10,39
Bihar,Katihar,Blindness,0,6,8,12,20
Bihar,Katihar,Blindness,6,15,92,76,168
Bihar,Katihar,Blindness,15,35,282,245,527
Bihar,Katihar,Blindness,35,60,283,180,463
Bihar,Katihar,Blindness,60,80,102,54,156
Bihar,Katihar,Blindness,80,100,8,2,10
Jammu And Kashmir,Kathua,Blindness,0,6,9,4,13
Jammu And Kashmir,Kathua,Blindness,6,15,24,20,44
Jammu And Kashmir,Kathua,Blindness,15,35,155,77,232
Jammu And Kashmir,Kathua,Blindness,35,60,219,101,320
Jammu And Kashmir,Kathua,Blindness,60,80,74,23,97
Jammu And Kashmir,Kathua,Blindness,80,100,9,2,11
Uttar Pradesh,Kasganj,Blindness,0,6,2,0,2
Uttar Pradesh,Kasganj,Blindness,6,15,16,15,31
Uttar Pradesh,Kasganj,Blindness,15,35,77,43,120
Uttar Pradesh,Kasganj,Blindness,35,60,111,49,160
Uttar Pradesh,Kasganj,Blindness,60,80,65,17,82
Uttar Pradesh,Kasganj,Blindness,80,100,4,2,6
Kerala,Kasaragod,Blindness,0,6,2,3,5
Kerala,Kasaragod,Blindness,6,15,13,8,21
Kerala,Kasaragod,Blindness,15,35,83,60,143
Kerala,Kasaragod,Blindness,35,60,188,129,317
Kerala,Kasaragod,Blindness,60,80,76,49,125
Kerala,Kasaragod,Blindness,80,100,2,3,5
Tamil Nadu,Karur,Blindness,0,6,4,3,7
Tamil Nadu,Karur,Blindness,6,15,27,22,49
Tamil Nadu,Karur,Blindness,15,35,107,82,189
Tamil Nadu,Karur,Blindness,35,60,291,213,504
Tamil Nadu,Karur,Blindness,60,80,128,63,191
Tamil Nadu,Karur,Blindness,80,100,10,5,15
Haryana,Karnal,Blindness,0,6,7,6,13
Haryana,Karnal,Blindness,6,15,63,33,96
Haryana,Karnal,Blindness,15,35,187,96,283
Haryana,Karnal,Blindness,35,60,243,112,355
Haryana,Karnal,Blindness,60,80,75,36,111
Haryana,Karnal,Blindness,80,100,7,7,14
Assam,Karimganj,Blindness,0,6,15,13,28
Assam,Karimganj,Blindness,6,15,70,53,123
Assam,Karimganj,Blindness,15,35,191,169,360
Assam,Karimganj,Blindness,35,60,150,107,257
Assam,Karimganj,Blindness,60,80,30,22,52
Assam,Karimganj,Blindness,80,100,2,1,3
Ladakh,Kargil,Blindness,6,15,7,3,10
Ladakh,Kargil,Blindness,15,35,37,19,56
Ladakh,Kargil,Blindness,35,60,58,46,104
Ladakh,Kargil,Blindness,60,80,36,21,57
Ladakh,Kargil,Blindness,80,100,5,2,7
Assam,Karbi Anglong,Blindness,0,6,2,5,7
Assam,Karbi Anglong,Blindness,6,15,18,21,39
Assam,Karbi Anglong,Blindness,15,35,56,43,99
Assam,Karbi Anglong,Blindness,35,60,62,73,135
Assam,Karbi Anglong,Blindness,60,80,30,38,68
Assam,Karbi Anglong,Blindness,80,100,4,3,7
Rajasthan,Karauli,Blindness,0,6,1,1,2
Rajasthan,Karauli,Blindness,6,15,26,9,35
Rajasthan,Karauli,Blindness,15,35,71,31,102
Rajasthan,Karauli,Blindness,35,60,67,33,100
Rajasthan,Karauli,Blindness,60,80,24,15,39
Rajasthan,Karauli,Blindness,80,100,3,0,3
Puducherry,Karaikal,Blindness,6,15,3,5,8
Puducherry,Karaikal,Blindness,15,35,18,22,40
Puducherry,Karaikal,Blindness,35,60,52,41,93
Puducherry,Karaikal,Blindness,60,80,29,17,46
Punjab,Kapurthala,Blindness,0,6,4,1,5
Punjab,Kapurthala,Blindness,6,15,14,13,27
Punjab,Kapurthala,Blindness,15,35,78,47,125
Punjab,Kapurthala,Blindness,35,60,155,66,221
Punjab,Kapurthala,Blindness,60,80,110,22,132
Punjab,Kapurthala,Blindness,80,100,6,0,6
Uttar Pradesh,Kanpur Nagar,Blindness,0,6,7,20,27
Uttar Pradesh,Kanpur Nagar,Blindness,6,15,47,42,89
Uttar Pradesh,Kanpur Nagar,Blindness,15,35,322,131,453
Uttar Pradesh,Kanpur Nagar,Blindness,35,60,401,171,572
Uttar Pradesh,Kanpur Nagar,Blindness,60,80,270,72,342
Uttar Pradesh,Kanpur Nagar,Blindness,80,100,17,4,21
Uttar Pradesh,Kanpur Dehat,Blindness,0,6,3,3,6
Uttar Pradesh,Kanpur Dehat,Blindness,6,15,24,19,43
Uttar Pradesh,Kanpur Dehat,Blindness,15,35,142,61,203
Uttar Pradesh,Kanpur Dehat,Blindness,35,60,208,85,293
Uttar Pradesh,Kanpur Dehat,Blindness,60,80,184,64,248
Uttar Pradesh,Kanpur Dehat,Blindness,80,100,16,6,22
Kerala,Kannur,Blindness,0,6,0,6,6
Kerala,Kannur,Blindness,6,15,40,16,56
Kerala,Kannur,Blindness,15,35,121,88,209
Kerala,Kannur,Blindness,35,60,294,186,480
Kerala,Kannur,Blindness,60,80,195,101,296
Kerala,Kannur,Blindness,80,100,18,15,33
Tamil Nadu,Kanniyakumari,Blindness,0,6,1,2,3
Tamil Nadu,Kanniyakumari,Blindness,6,15,28,26,54
Tamil Nadu,Kanniyakumari,Blindness,15,35,112,96,208
Tamil Nadu,Kanniyakumari,Blindness,35,60,253,149,402
Tamil Nadu,Kanniyakumari,Blindness,60,80,128,52,180
Tamil Nadu,Kanniyakumari,Blindness,80,100,10,2,12
Uttar Pradesh,Kannauj,Blindness,0,6,5,4,9
Uttar Pradesh,Kannauj,Blindness,6,15,25,25,50
Uttar Pradesh,Kannauj,Blindness,15,35,165,83,248
Uttar Pradesh,Kannauj,Blindness,35,60,220,99,319
Uttar Pradesh,Kannauj,Blindness,60,80,181,58,239
Uttar Pradesh,Kannauj,Blindness,80,100,12,6,18
Chhattisgarh,Kanker,Blindness,0,6,2,0,2
Chhattisgarh,Kanker,Blindness,6,15,43,33,76
Chhattisgarh,Kanker,Blindness,15,35,144,66,210
Chhattisgarh,Kanker,Blindness,35,60,93,32,125
Chhattisgarh,Kanker,Blindness,60,80,17,11,28
Himachal Pradesh,Kangra,Blindness,0,6,5,4,9
Himachal Pradesh,Kangra,Blindness,6,15,45,15,60
Himachal Pradesh,Kangra,Blindness,15,35,186,93,279
Himachal Pradesh,Kangra,Blindness,35,60,366,162,528
Himachal Pradesh,Kangra,Blindness,60,80,148,67,215
Himachal Pradesh,Kangra,Blindness,80,100,13,5,18
Manipur,Kangpokpi,Blindness,6,15,1,1,2
Manipur,Kangpokpi,Blindness,15,35,6,1,7
Manipur,Kangpokpi,Blindness,35,60,2,5,7
Manipur,Kangpokpi,Blindness,60,80,1,0,1
Manipur,Kangpokpi,Blindness,80,100,1,0,1
Odisha,Kandhamal,Blindness,0,6,10,11,21
Odisha,Kandhamal,Blindness,6,15,83,69,152
Odisha,Kandhamal,Blindness,15,35,180,170,350
Odisha,Kandhamal,Blindness,35,60,219,154,373
Odisha,Kandhamal,Blindness,60,80,91,54,145
Odisha,Kandhamal,Blindness,80,100,3,2,5
Tamil Nadu,Kanchipuram,Blindness,6,15,24,15,39
Tamil Nadu,Kanchipuram,Blindness,15,35,107,84,191
Tamil Nadu,Kanchipuram,Blindness,35,60,185,111,296
Tamil Nadu,Kanchipuram,Blindness,60,80,81,26,107
Tamil Nadu,Kanchipuram,Blindness,80,100,2,1,3
Assam,Kamrup Metro,Blindness,0,6,2,3,5
Assam,Kamrup Metro,Blindness,6,15,9,3,12
Assam,Kamrup Metro,Blindness,15,35,66,32,98
Assam,Kamrup Metro,Blindness,35,60,62,32,94
Assam,Kamrup Metro,Blindness,60,80,5,6,11
Assam,Kamrup,Blindness,0,6,6,3,9
Assam,Kamrup,Blindness,6,15,26,17,43
Assam,Kamrup,Blindness,15,35,194,141,335
Assam,Kamrup,Blindness,35,60,210,153,363
Assam,Kamrup,Blindness,60,80,65,43,108
Assam,Kamrup,Blindness,80,100,2,5,7
Arunachal Pradesh,Kamle,Blindness,15,35,1,0,1
Manipur,Kamjong,Blindness,6,15,2,1,3
Manipur,Kamjong,Blindness,15,35,3,1,4
Manipur,Kamjong,Blindness,35,60,3,0,3
Manipur,Kamjong,Blindness,60,80,1,0,1
Telangana,Kamareddy,Blindness,15,35,1,0,1
Tamil Nadu,Kallakurichi,Blindness,0,6,1,1,2
Tamil Nadu,Kallakurichi,Blindness,6,15,6,3,9
Tamil Nadu,Kallakurichi,Blindness,15,35,21,15,36
Tamil Nadu,Kallakurichi,Blindness,35,60,60,34,94
Tamil Nadu,Kallakurichi,Blindness,60,80,12,24,36
Tamil Nadu,Kallakurichi,Blindness,80,100,3,1,4
Odisha,Kalahandi,Blindness,0,6,37,21,58
Odisha,Kalahandi,Blindness,6,15,134,108,242
Odisha,Kalahandi,Blindness,15,35,339,247,586
Odisha,Kalahandi,Blindness,35,60,377,181,558
Odisha,Kalahandi,Blindness,60,80,131,53,184
Odisha,Kalahandi,Blindness,80,100,12,5,17
Karnataka,Kalaburagi,Blindness,0,6,7,13,20
Karnataka,Kalaburagi,Blindness,6,15,95,73,168
Karnataka,Kalaburagi,Blindness,15,35,428,282,710
Karnataka,Kalaburagi,Blindness,35,60,500,230,730
Karnataka,Kalaburagi,Blindness,60,80,162,41,203
Karnataka,Kalaburagi,Blindness,80,100,8,5,13
Manipur,Kakching,Blindness,6,15,5,3,8
Manipur,Kakching,Blindness,15,35,7,9,16
Manipur,Kakching,Blindness,35,60,21,11,32
Manipur,Kakching,Blindness,60,80,6,4,10
Haryana,Kaithal,Blindness,0,6,4,5,9
Haryana,Kaithal,Blindness,6,15,9,7,16
Haryana,Kaithal,Blindness,15,35,66,19,85
Haryana,Kaithal,Blindness,35,60,81,22,103
Haryana,Kaithal,Blindness,60,80,32,10,42
Haryana,Kaithal,Blindness,80,100,3,1,4
Bihar,Kaimur (Bhabua),Blindness,0,6,9,6,15
Bihar,Kaimur (Bhabua),Blindness,6,15,77,64,141
Bihar,Kaimur (Bhabua),Blindness,15,35,288,175,463
Bihar,Kaimur (Bhabua),Blindness,35,60,339,243,582
Bihar,Kaimur (Bhabua),Blindness,60,80,181,106,287
Bihar,Kaimur (Bhabua),Blindness,80,100,8,6,14
Gujarat,Kachchh,Blindness,0,6,5,4,9
Gujarat,Kachchh,Blindness,6,15,75,61,136
Gujarat,Kachchh,Blindness,15,35,315,146,461
Gujarat,Kachchh,Blindness,35,60,288,151,439
Gujarat,Kachchh,Blindness,60,80,166,38,204
Gujarat,Kachchh,Blindness,80,100,17,5,22
Chhattisgarh,Kabirdham,Blindness,0,6,2,3,5
Chhattisgarh,Kabirdham,Blindness,6,15,26,12,38
Chhattisgarh,Kabirdham,Blindness,15,35,84,55,139
Chhattisgarh,Kabirdham,Blindness,35,60,107,78,185
Chhattisgarh,Kabirdham,Blindness,60,80,53,27,80
Chhattisgarh,Kabirdham,Blindness,80,100,4,3,7
Gujarat,Junagadh,Blindness,0,6,6,2,8
Gujarat,Junagadh,Blindness,6,15,48,32,80
Gujarat,Junagadh,Blindness,15,35,213,100,313
Gujarat,Junagadh,Blindness,35,60,287,111,398
Gujarat,Junagadh,Blindness,60,80,170,36,206
Gujarat,Junagadh,Blindness,80,100,17,10,27
Assam,Jorhat,Blindness,0,6,9,9,18
Assam,Jorhat,Blindness,6,15,24,20,44
Assam,Jorhat,Blindness,15,35,149,92,241
Assam,Jorhat,Blindness,35,60,182,122,304
Assam,Jorhat,Blindness,60,80,30,18,48
Assam,Jorhat,Blindness,80,100,0,1,1
Rajasthan,Jodhpur,Blindness,0,6,2,2,4
Rajasthan,Jodhpur,Blindness,6,15,56,24,80
Rajasthan,Jodhpur,Blindness,15,35,381,157,538
Rajasthan,Jodhpur,Blindness,35,60,396,143,539
Rajasthan,Jodhpur,Blindness,60,80,178,81,259
Rajasthan,Jodhpur,Blindness,80,100,14,6,20
Manipur,Jiribam,Blindness,6,15,4,4,8
Manipur,Jiribam,Blindness,15,35,14,8,22
Manipur,Jiribam,Blindness,35,60,7,4,11
Manipur,Jiribam,Blindness,60,80,1,4,5
Haryana,Jind,Blindness,0,6,6,5,11
Haryana,Jind,Blindness,6,15,35,16,51
Haryana,Jind,Blindness,15,35,109,42,151
Haryana,Jind,Blindness,35,60,156,44,200
Haryana,Jind,Blindness,60,80,34,18,52
Haryana,Jind,Blindness,80,100,5,0,5
Rajasthan,Jhunjhunu,Blindness,0,6,3,2,5
Rajasthan,Jhunjhunu,Blindness,6,15,30,17,47
Rajasthan,Jhunjhunu,Blindness,15,35,169,105,274
Rajasthan,Jhunjhunu,Blindness,35,60,260,99,359
Rajasthan,Jhunjhunu,Blindness,60,80,130,65,195
Rajasthan,Jhunjhunu,Blindness,80,100,16,12,28
Odisha,Jharsuguda,Blindness,0,6,7,2,9
Odisha,Jharsuguda,Blindness,6,15,27,30,57
Odisha,Jharsuguda,Blindness,15,35,74,60,134
Odisha,Jharsuguda,Blindness,35,60,91,69,160
Odisha,Jharsuguda,Blindness,60,80,36,21,57
Odisha,Jharsuguda,Blindness,80,100,2,2,4
Uttar Pradesh,Jhansi,Blindness,0,6,4,1,5
Uttar Pradesh,Jhansi,Blindness,6,15,23,23,46
Uttar Pradesh,Jhansi,Blindness,15,35,147,76,223
Uttar Pradesh,Jhansi,Blindness,35,60,193,60,253
Uttar Pradesh,Jhansi,Blindness,60,80,58,12,70
Uttar Pradesh,Jhansi,Blindness,80,100,4,3,7
Rajasthan,Jhalawar,Blindness,0,6,0,1,1
Rajasthan,Jhalawar,Blindness,6,15,39,39,78
Rajasthan,Jhalawar,Blindness,15,35,448,385,833
Rajasthan,Jhalawar,Blindness,35,60,495,385,880
Rajasthan,Jhalawar,Blindness,60,80,165,107,272
Rajasthan,Jhalawar,Blindness,80,100,24,21,45
Haryana,Jhajjar,Blindness,0,6,2,3,5
Haryana,Jhajjar,Blindness,6,15,13,4,17
Haryana,Jhajjar,Blindness,15,35,47,23,70
Haryana,Jhajjar,Blindness,35,60,96,35,131
Haryana,Jhajjar,Blindness,60,80,25,8,33
Haryana,Jhajjar,Blindness,80,100,3,0,3
Madhya Pradesh,Jhabua,Blindness,6,15,23,14,37
Madhya Pradesh,Jhabua,Blindness,15,35,108,59,167
Madhya Pradesh,Jhabua,Blindness,35,60,110,57,167
Madhya Pradesh,Jhabua,Blindness,60,80,32,17,49
Madhya Pradesh,Jhabua,Blindness,80,100,4,2,6
Bihar,Jehanabad,Blindness,0,6,6,11,17
Bihar,Jehanabad,Blindness,6,15,53,46,99
Bihar,Jehanabad,Blindness,15,35,117,53,170
Bihar,Jehanabad,Blindness,35,60,124,76,200
Bihar,Jehanabad,Blindness,60,80,63,30,93
Bihar,Jehanabad,Blindness,80,100,6,2,8
Uttar Pradesh,Jaunpur,Blindness,0,6,9,6,15
Uttar Pradesh,Jaunpur,Blindness,6,15,88,52,140
Uttar Pradesh,Jaunpur,Blindness,15,35,412,242,654
Uttar Pradesh,Jaunpur,Blindness,35,60,422,183,605
Uttar Pradesh,Jaunpur,Blindness,60,80,167,45,212
Uttar Pradesh,Jaunpur,Blindness,80,100,15,1,16
Chhattisgarh,Jashpur,Blindness,0,6,4,4,8
Chhattisgarh,Jashpur,Blindness,6,15,34,28,62
Chhattisgarh,Jashpur,Blindness,15,35,135,125,260
Chhattisgarh,Jashpur,Blindness,35,60,129,62,191
Chhattisgarh,Jashpur,Blindness,60,80,31,23,54
Chhattisgarh,Jashpur,Blindness,80,100,1,2,3
Chhattisgarh,Janjgir-Champa,Blindness,0,6,2,2,4
Chhattisgarh,Janjgir-Champa,Blindness,6,15,79,58,137
Chhattisgarh,Janjgir-Champa,Blindness,15,35,294,207,501
Chhattisgarh,Janjgir-Champa,Blindness,35,60,250,113,363
Chhattisgarh,Janjgir-Champa,Blindness,60,80,98,47,145
Chhattisgarh,Janjgir-Champa,Blindness,80,100,3,3,6
Bihar,Jamui,Blindness,0,6,3,2,5
Bihar,Jamui,Blindness,6,15,40,20,60
Bihar,Jamui,Blindness,15,35,128,84,212
Bihar,Jamui,Blindness,35,60,155,64,219
Bihar,Jamui,Blindness,60,80,53,33,86
Bihar,Jamui,Blindness,80,100,2,2,4
Jharkhand,Jamtara,Blindness,0,6,5,4,9
Jharkhand,Jamtara,Blindness,6,15,27,28,55
Jharkhand,Jamtara,Blindness,15,35,129,94,223
Jharkhand,Jamtara,Blindness,35,60,169,97,266
Jharkhand,Jamtara,Blindness,60,80,46,27,73
Jharkhand,Jamtara,Blindness,80,100,1,1,2
Gujarat,Jamnagar,Blindness,0,6,4,6,10
Gujarat,Jamnagar,Blindness,6,15,44,42,86
Gujarat,Jamnagar,Blindness,15,35,290,136,426
Gujarat,Jamnagar,Blindness,35,60,400,176,576
Gujarat,Jamnagar,Blindness,60,80,263,79,342
Gujarat,Jamnagar,Blindness,80,100,25,12,37
Jammu And Kashmir,Jammu,Blindness,0,6,4,1,5
Jammu And Kashmir,Jammu,Blindness,6,15,21,16,37
Jammu And Kashmir,Jammu,Blindness,15,35,147,80,227
Jammu And Kashmir,Jammu,Blindness,35,60,249,94,343
Jammu And Kashmir,Jammu,Blindness,60,80,92,31,123
Jammu And Kashmir,Jammu,Blindness,80,100,11,3,14
Rajasthan,Jalore,Blindness,0,6,1,3,4
Rajasthan,Jalore,Blindness,6,15,27,24,51
Rajasthan,Jalore,Blindness,15,35,114,52,166
Rajasthan,Jalore,Blindness,35,60,221,116,337
Rajasthan,Jalore,Blindness,60,80,117,73,190
Rajasthan,Jalore,Blindness,80,100,8,7,15
Maharashtra,Jalna,Blindness,0,6,28,12,40
Maharashtra,Jalna,Blindness,6,15,193,151,344
Maharashtra,Jalna,Blindness,15,35,827,442,1269
Maharashtra,Jalna,Blindness,35,60,1176,574,1750
Maharashtra,Jalna,Blindness,60,80,875,435,1310
Maharashtra,Jalna,Blindness,80,100,93,39,132
Maharashtra,Jalgaon,Blindness,0,6,15,12,27
Maharashtra,Jalgaon,Blindness,6,15,122,84,206
Maharashtra,Jalgaon,Blindness,15,35,558,269,827
Maharashtra,Jalgaon,Blindness,35,60,865,432,1297
Maharashtra,Jalgaon,Blindness,60,80,359,163,522
Maharashtra,Jalgaon,Blindness,80,100,23,8,31
Uttar Pradesh,Jalaun,Blindness,0,6,3,1,4
Uttar Pradesh,Jalaun,Blindness,6,15,27,18,45
Uttar Pradesh,Jalaun,Blindness,15,35,203,116,319
Uttar Pradesh,Jalaun,Blindness,35,60,418,197,615
Uttar Pradesh,Jalaun,Blindness,60,80,202,90,292
Uttar Pradesh,Jalaun,Blindness,80,100,7,8,15
Punjab,Jalandhar,Blindness,0,6,3,5,8
Punjab,Jalandhar,Blindness,6,15,91,54,145
Punjab,Jalandhar,Blindness,15,35,315,153,468
Punjab,Jalandhar,Blindness,35,60,512,202,714
Punjab,Jalandhar,Blindness,60,80,337,79,416
Punjab,Jalandhar,Blindness,80,100,39,11,50
Odisha,Jajapur,Blindness,0,6,6,6,12
Odisha,Jajapur,Blindness,6,15,59,50,109
Odisha,Jajapur,Blindness,15,35,217,155,372
Odisha,Jajapur,Blindness,35,60,373,197,570
Odisha,Jajapur,Blindness,60,80,133,60,193
Odisha,Jajapur,Blindness,80,100,11,4,15
Rajasthan,Jaisalmer,Blindness,0,6,2,0,2
Rajasthan,Jaisalmer,Blindness,6,15,13,8,21
Rajasthan,Jaisalmer,Blindness,15,35,74,29,103
Rajasthan,Jaisalmer,Blindness,35,60,75,30,105
Rajasthan,Jaisalmer,Blindness,60,80,48,23,71
Rajasthan,Jaisalmer,Blindness,80,100,13,3,16
Rajasthan,Jaipur,Blindness,0,6,8,5,13
Rajasthan,Jaipur,Blindness,6,15,100,49,149
Rajasthan,Jaipur,Blindness,15,35,478,249,727
Rajasthan,Jaipur,Blindness,35,60,493,263,756
Rajasthan,Jaipur,Blindness,60,80,205,142,347
Rajasthan,Jaipur,Blindness,80,100,38,15,53
Odisha,Jagatsinghapur,Blindness,0,6,4,2,6
Odisha,Jagatsinghapur,Blindness,6,15,42,25,67
Odisha,Jagatsinghapur,Blindness,15,35,140,135,275
Odisha,Jagatsinghapur,Blindness,35,60,315,195,510
Odisha,Jagatsinghapur,Blindness,60,80,113,62,175
Odisha,Jagatsinghapur,Blindness,80,100,11,8,19
Madhya Pradesh,Jabalpur,Blindness,0,6,3,7,10
Madhya Pradesh,Jabalpur,Blindness,6,15,64,54,118
Madhya Pradesh,Jabalpur,Blindness,15,35,559,431,990
Madhya Pradesh,Jabalpur,Blindness,35,60,645,355,1000
Madhya Pradesh,Jabalpur,Blindness,60,80,258,113,371
Madhya Pradesh,Jabalpur,Blindness,80,100,13,3,16
Madhya Pradesh,Indore,Blindness,0,6,2,0,2
Madhya Pradesh,Indore,Blindness,6,15,51,38,89
Madhya Pradesh,Indore,Blindness,15,35,216,172,388
Madhya Pradesh,Indore,Blindness,35,60,293,165,458
Madhya Pradesh,Indore,Blindness,60,80,95,27,122
Madhya Pradesh,Indore,Blindness,80,100,11,4,15
Manipur,Imphal West,Blindness,0,6,2,0,2
Manipur,Imphal West,Blindness,6,15,2,5,7
Manipur,Imphal West,Blindness,15,35,23,14,37
Manipur,Imphal West,Blindness,35,60,41,23,64
Manipur,Imphal West,Blindness,60,80,7,5,12
Manipur,Imphal West,Blindness,80,100,0,1,1
Manipur,Imphal East,Blindness,0,6,0,3,3
Manipur,Imphal East,Blindness,6,15,2,5,7
Manipur,Imphal East,Blindness,15,35,21,20,41
Manipur,Imphal East,Blindness,35,60,33,20,53
Manipur,Imphal East,Blindness,60,80,8,2,10
Manipur,Imphal East,Blindness,80,100,0,1,1
Kerala,Idukki,Blindness,6,15,14,5,19
Kerala,Idukki,Blindness,15,35,31,42,73
Kerala,Idukki,Blindness,35,60,87,50,137
Kerala,Idukki,Blindness,60,80,51,18,69
Kerala,Idukki,Blindness,80,100,6,2,8
Telangana,Hyderabad,Blindness,15,35,1,1,2
Telangana,Hyderabad,Blindness,35,60,1,0,1
Punjab,Hoshiarpur,Blindness,0,6,4,3,7
Punjab,Hoshiarpur,Blindness,6,15,34,12,46
Punjab,Hoshiarpur,Blindness,15,35,117,61,178
Punjab,Hoshiarpur,Blindness,35,60,240,95,335
Punjab,Hoshiarpur,Blindness,60,80,199,42,241
Punjab,Hoshiarpur,Blindness,80,100,18,10,28
Assam,Hojai,Blindness,0,6,1,2,3
Assam,Hojai,Blindness,6,15,14,10,24
Assam,Hojai,Blindness,15,35,62,40,102
Assam,Hojai,Blindness,35,60,48,32,80
Assam,Hojai,Blindness,60,80,19,7,26
Assam,Hojai,Blindness,80,100,0,3,3
Mizoram,Hnahthial,Blindness,15,35,1,0,1
Mizoram,Hnahthial,Blindness,35,60,1,0,1
Haryana,Hisar,Blindness,0,6,5,7,12
Haryana,Hisar,Blindness,6,15,44,36,80
Haryana,Hisar,Blindness,15,35,156,95,251
Haryana,Hisar,Blindness,35,60,236,73,309
Haryana,Hisar,Blindness,60,80,85,31,116
Haryana,Hisar,Blindness,80,100,7,5,12
Maharashtra,Hingoli,Blindness,0,6,4,5,9
Maharashtra,Hingoli,Blindness,6,15,45,29,74
Maharashtra,Hingoli,Blindness,15,35,249,122,371
Maharashtra,Hingoli,Blindness,35,60,185,70,255
Maharashtra,Hingoli,Blindness,60,80,98,35,133
Maharashtra,Hingoli,Blindness,80,100,10,5,15
Jharkhand,Hazaribagh,Blindness,0,6,3,0,3
Jharkhand,Hazaribagh,Blindness,6,15,36,29,65
Jharkhand,Hazaribagh,Blindness,15,35,92,72,164
Jharkhand,Hazaribagh,Blindness,35,60,86,46,132
Jharkhand,Hazaribagh,Blindness,60,80,17,8,25
Jharkhand,Hazaribagh,Blindness,80,100,1,1,2
Karnataka,Haveri,Blindness,0,6,18,10,28
Karnataka,Haveri,Blindness,6,15,122,83,205
Karnataka,Haveri,Blindness,15,35,466,298,764
Karnataka,Haveri,Blindness,35,60,784,457,1241
Karnataka,Haveri,Blindness,60,80,275,94,369
Karnataka,Haveri,Blindness,80,100,13,2,15
Uttar Pradesh,Hathras,Blindness,0,6,1,1,2
Uttar Pradesh,Hathras,Blindness,6,15,19,15,34
Uttar Pradesh,Hathras,Blindness,15,35,144,48,192
Uttar Pradesh,Hathras,Blindness,35,60,133,64,197
Uttar Pradesh,Hathras,Blindness,60,80,59,15,74
Uttar Pradesh,Hathras,Blindness,80,100,3,1,4
Karnataka,Hassan,Blindness,0,6,8,1,9
Karnataka,Hassan,Blindness,6,15,61,35,96
Karnataka,Hassan,Blindness,15,35,401,263,664
Karnataka,Hassan,Blindness,35,60,947,668,1615
Karnataka,Hassan,Blindness,60,80,362,171,533
Karnataka,Hassan,Blindness,80,100,28,6,34
Uttarakhand,Haridwar,Blindness,0,6,2,0,2
Uttarakhand,Haridwar,Blindness,6,15,31,15,46
Uttarakhand,Haridwar,Blindness,15,35,174,87,261
Uttarakhand,Haridwar,Blindness,35,60,215,86,301
Uttarakhand,Haridwar,Blindness,60,80,77,24,101
Uttarakhand,Haridwar,Blindness,80,100,7,1,8
Uttar Pradesh,Hardoi,Blindness,0,6,4,4,8
Uttar Pradesh,Hardoi,Blindness,6,15,94,81,175
Uttar Pradesh,Hardoi,Blindness,15,35,395,158,553
Uttar Pradesh,Hardoi,Blindness,35,60,530,230,760
Uttar Pradesh,Hardoi,Blindness,60,80,343,142,485
Uttar Pradesh,Hardoi,Blindness,80,100,33,9,42
Madhya Pradesh,Harda,Blindness,6,15,21,10,31
Madhya Pradesh,Harda,Blindness,15,35,170,81,251
Madhya Pradesh,Harda,Blindness,35,60,145,62,207
Madhya Pradesh,Harda,Blindness,60,80,78,47,125
Madhya Pradesh,Harda,Blindness,80,100,11,6,17
Uttar Pradesh,Hapur,Blindness,0,6,1,0,1
Uttar Pradesh,Hapur,Blindness,6,15,8,8,16
Uttar Pradesh,Hapur,Blindness,15,35,42,17,59
Uttar Pradesh,Hapur,Blindness,35,60,67,19,86
Uttar Pradesh,Hapur,Blindness,60,80,37,10,47
Uttar Pradesh,Hapur,Blindness,80,100,1,0,1
Rajasthan,Hanumangarh,Blindness,0,6,2,0,2
Rajasthan,Hanumangarh,Blindness,6,15,22,22,44
Rajasthan,Hanumangarh,Blindness,15,35,149,86,235
Rajasthan,Hanumangarh,Blindness,35,60,189,83,272
Rajasthan,Hanumangarh,Blindness,60,80,105,57,162
Rajasthan,Hanumangarh,Blindness,80,100,12,9,21
Himachal Pradesh,Hamirpur,Blindness,6,15,13,9,22
Himachal Pradesh,Hamirpur,Blindness,15,35,54,37,91
Himachal Pradesh,Hamirpur,Blindness,35,60,118,50,168
Himachal Pradesh,Hamirpur,Blindness,60,80,94,41,135
Himachal Pradesh,Hamirpur,Blindness,80,100,14,7,21
Uttar Pradesh,Hamirpur,Blindness,0,6,1,0,1
Uttar Pradesh,Hamirpur,Blindness,6,15,16,9,25
Uttar Pradesh,Hamirpur,Blindness,15,35,134,47,181
Uttar Pradesh,Hamirpur,Blindness,35,60,238,93,331
Uttar Pradesh,Hamirpur,Blindness,60,80,118,34,152
Uttar Pradesh,Hamirpur,Blindness,80,100,3,2,5
Assam,Hailakandi,Blindness,0,6,6,8,14
Assam,Hailakandi,Blindness,6,15,40,35,75
Assam,Hailakandi,Blindness,15,35,85,84,169
Assam,Hailakandi,Blindness,35,60,67,39,106
Assam,Hailakandi,Blindness,60,80,10,6,16
Assam,Hailakandi,Blindness,80,100,1,0,1
Sikkim,Gyalshing,Blindness,6,15,2,0,2
Sikkim,Gyalshing,Blindness,15,35,20,12,32
Sikkim,Gyalshing,Blindness,35,60,15,10,25
Sikkim,Gyalshing,Blindness,60,80,4,0,4
Sikkim,Gyalshing,Blindness,80,100,1,0,1
Madhya Pradesh,Gwalior,Blindness,0,6,5,2,7
Madhya Pradesh,Gwalior,Blindness,6,15,66,48,114
Madhya Pradesh,Gwalior,Blindness,15,35,247,117,364
Madhya Pradesh,Gwalior,Blindness,35,60,249,103,352
Madhya Pradesh,Gwalior,Blindness,60,80,113,39,152
Madhya Pradesh,Gwalior,Blindness,80,100,14,6,20
Haryana,Gurugram,Blindness,0,6,1,2,3
Haryana,Gurugram,Blindness,6,15,9,10,19
Haryana,Gurugram,Blindness,15,35,61,20,81
Haryana,Gurugram,Blindness,35,60,62,21,83
Haryana,Gurugram,Blindness,60,80,16,18,34
Haryana,Gurugram,Blindness,80,100,2,0,2
Punjab,Gurdaspur,Blindness,0,6,5,1,6
Punjab,Gurdaspur,Blindness,6,15,27,20,47
Punjab,Gurdaspur,Blindness,15,35,115,81,196
Punjab,Gurdaspur,Blindness,35,60,227,97,324
Punjab,Gurdaspur,Blindness,60,80,171,62,233
Punjab,Gurdaspur,Blindness,80,100,25,11,36
Andhra Pradesh,Guntur,Blindness,0,6,10,5,15
Andhra Pradesh,Guntur,Blindness,6,15,139,80,219
Andhra Pradesh,Guntur,Blindness,15,35,757,325,1082
Andhra Pradesh,Guntur,Blindness,35,60,2009,221,2230
Andhra Pradesh,Guntur,Blindness,60,80,675,48,723
Andhra Pradesh,Guntur,Blindness,80,100,68,9,77
Madhya Pradesh,Guna,Blindness,0,6,0,1,1
Madhya Pradesh,Guna,Blindness,6,15,13,11,24
Madhya Pradesh,Guna,Blindness,15,35,149,92,241
Madhya Pradesh,Guna,Blindness,35,60,174,81,255
Madhya Pradesh,Guna,Blindness,60,80,66,30,96
Madhya Pradesh,Guna,Blindness,80,100,3,2,5
Jharkhand,Gumla,Blindness,0,6,8,1,9
Jharkhand,Gumla,Blindness,6,15,89,77,166
Jharkhand,Gumla,Blindness,15,35,263,186,449
Jharkhand,Gumla,Blindness,35,60,282,168,450
Jharkhand,Gumla,Blindness,60,80,82,40,122
Jharkhand,Gumla,Blindness,80,100,6,4,10
Uttar Pradesh,Gorakhpur,Blindness,0,6,11,1,12
Uttar Pradesh,Gorakhpur,Blindness,6,15,80,41,121
Uttar Pradesh,Gorakhpur,Blindness,15,35,442,280,722
Uttar Pradesh,Gorakhpur,Blindness,35,60,447,196,643
Uttar Pradesh,Gorakhpur,Blindness,60,80,160,37,197
Uttar Pradesh,Gorakhpur,Blindness,80,100,6,3,9
Bihar,Gopalganj,Blindness,0,6,8,7,15
Bihar,Gopalganj,Blindness,6,15,47,31,78
Bihar,Gopalganj,Blindness,15,35,145,70,215
Bihar,Gopalganj,Blindness,35,60,114,38,152
Bihar,Gopalganj,Blindness,60,80,45,6,51
Bihar,Gopalganj,Blindness,80,100,3,0,3
Maharashtra,Gondia,Blindness,0,6,1,4,5
Maharashtra,Gondia,Blindness,6,15,18,8,26
Maharashtra,Gondia,Blindness,15,35,62,52,114
Maharashtra,Gondia,Blindness,35,60,90,49,139
Maharashtra,Gondia,Blindness,60,80,25,8,33
Maharashtra,Gondia,Blindness,80,100,1,1,2
Uttar Pradesh,Gonda,Blindness,0,6,8,5,13
Uttar Pradesh,Gonda,Blindness,6,15,51,52,103
Uttar Pradesh,Gonda,Blindness,15,35,241,136,377
Uttar Pradesh,Gonda,Blindness,35,60,275,102,377
Uttar Pradesh,Gonda,Blindness,60,80,114,34,148
Uttar Pradesh,Gonda,Blindness,80,100,1,1,2
Tripura,Gomati,Blindness,0,6,1,4,5
Tripura,Gomati,Blindness,6,15,8,6,14
Tripura,Gomati,Blindness,15,35,34,23,57
Tripura,Gomati,Blindness,35,60,56,42,98
Tripura,Gomati,Blindness,60,80,21,12,33
Tripura,Gomati,Blindness,80,100,1,1,2
Assam,Golaghat,Blindness,0,6,3,5,8
Assam,Golaghat,Blindness,6,15,49,31,80
Assam,Golaghat,Blindness,15,35,188,148,336
Assam,Golaghat,Blindness,35,60,219,156,375
Assam,Golaghat,Blindness,60,80,37,24,61
Assam,Golaghat,Blindness,80,100,3,1,4
Jharkhand,Godda,Blindness,0,6,3,2,5
Jharkhand,Godda,Blindness,6,15,40,32,72
Jharkhand,Godda,Blindness,15,35,153,116,269
Jharkhand,Godda,Blindness,35,60,130,93,223
Jharkhand,Godda,Blindness,60,80,56,33,89
Jharkhand,Godda,Blindness,80,100,5,2,7
Assam,Goalpara,Blindness,0,6,5,8,13
Assam,Goalpara,Blindness,6,15,84,57,141
Assam,Goalpara,Blindness,15,35,263,202,465
Assam,Goalpara,Blindness,35,60,310,240,550
Assam,Goalpara,Blindness,60,80,131,114,245
Assam,Goalpara,Blindness,80,100,20,4,24
Jharkhand,Giridih,Blindness,0,6,3,3,6
Jharkhand,Giridih,Blindness,6,15,85,49,134
Jharkhand,Giridih,Blindness,15,35,206,126,332
Jharkhand,Giridih,Blindness,35,60,179,85,264
Jharkhand,Giridih,Blindness,60,80,32,20,52
Jharkhand,Giridih,Blindness,80,100,2,1,3
Gujarat,Gir Somnath,Blindness,0,6,2,4,6
Gujarat,Gir Somnath,Blindness,6,15,29,24,53
Gujarat,Gir Somnath,Blindness,15,35,122,71,193
Gujarat,Gir Somnath,Blindness,35,60,128,51,179
Gujarat,Gir Somnath,Blindness,60,80,40,13,53
Gujarat,Gir Somnath,Blindness,80,100,6,0,6
Uttar Pradesh,Ghazipur,Blindness,0,6,4,6,10
Uttar Pradesh,Ghazipur,Blindness,6,15,68,85,153
Uttar Pradesh,Ghazipur,Blindness,15,35,380,231,611
Uttar Pradesh,Ghazipur,Blindness,35,60,384,217,601
Uttar Pradesh,Ghazipur,Blindness,60,80,175,93,268
Uttar Pradesh,Ghazipur,Blindness,80,100,6,1,7
Uttar Pradesh,Ghaziabad,Blindness,0,6,3,2,5
Uttar Pradesh,Ghaziabad,Blindness,6,15,23,18,41
Uttar Pradesh,Ghaziabad,Blindness,15,35,114,53,167
Uttar Pradesh,Ghaziabad,Blindness,35,60,151,60,211
Uttar Pradesh,Ghaziabad,Blindness,60,80,85,21,106
Uttar Pradesh,Ghaziabad,Blindness,80,100,5,1,6
Bihar,Gaya,Blindness,0,6,4,12,16
Bihar,Gaya,Blindness,6,15,70,44,114
Bihar,Gaya,Blindness,15,35,232,124,356
Bihar,Gaya,Blindness,35,60,201,101,302
Bihar,Gaya,Blindness,60,80,57,27,84
Bihar,Gaya,Blindness,80,100,3,1,4
Uttar Pradesh,Gautam Buddha Nagar,Blindness,0,6,2,1,3
Uttar Pradesh,Gautam Buddha Nagar,Blindness,6,15,16,15,31
Uttar Pradesh,Gautam Buddha Nagar,Blindness,15,35,57,36,93
Uttar Pradesh,Gautam Buddha Nagar,Blindness,35,60,64,23,87
Uttar Pradesh,Gautam Buddha Nagar,Blindness,60,80,29,7,36
Chhattisgarh,Gaurella Pendra Marwahi,Blindness,0,6,0,1,1
Chhattisgarh,Gaurella Pendra Marwahi,Blindness,6,15,3,10,13
Chhattisgarh,Gaurella Pendra Marwahi,Blindness,15,35,16,11,27
Chhattisgarh,Gaurella Pendra Marwahi,Blindness,35,60,8,3,11
Chhattisgarh,Gaurella Pendra Marwahi,Blindness,60,80,1,2,3
Chhattisgarh,Gariyaband,Blindness,0,6,16,15,31
Chhattisgarh,Gariyaband,Blindness,6,15,78,54,132
Chhattisgarh,Gariyaband,Blindness,15,35,205,119,324
Chhattisgarh,Gariyaband,Blindness,35,60,93,46,139
Chhattisgarh,Gariyaband,Blindness,60,80,34,20,54
Chhattisgarh,Gariyaband,Blindness,80,100,1,1,2
Jharkhand,Garhwa,Blindness,0,6,4,3,7
Jharkhand,Garhwa,Blindness,6,15,88,59,147
Jharkhand,Garhwa,Blindness,15,35,244,144,388
Jharkhand,Garhwa,Blindness,35,60,239,145,384
Jharkhand,Garhwa,Blindness,60,80,28,24,52
Jharkhand,Garhwa,Blindness,80,100,1,1,2
Odisha,Ganjam,Blindness,0,6,8,3,11
Odisha,Ganjam,Blindness,6,15,113,82,195
Odisha,Ganjam,Blindness,15,35,613,425,1038
Odisha,Ganjam,Blindness,35,60,770,462,1232
Odisha,Ganjam,Blindness,60,80,299,150,449
Odisha,Ganjam,Blindness,80,100,20,2,22
Sikkim,Gangtok,Blindness,0,6,1,0,1
Sikkim,Gangtok,Blindness,6,15,5,2,7
Sikkim,Gangtok,Blindness,15,35,18,21,39
Sikkim,Gangtok,Blindness,35,60,28,17,45
Sikkim,Gangtok,Blindness,60,80,5,2,7
Rajasthan,Ganganagar,Blindness,0,6,1,5,6
Rajasthan,Ganganagar,Blindness,6,15,56,42,98
Rajasthan,Ganganagar,Blindness,15,35,275,139,414
Rajasthan,Ganganagar,Blindness,35,60,276,133,409
Rajasthan,Ganganagar,Blindness,60,80,131,50,181
Rajasthan,Ganganagar,Blindness,80,100,14,11,25
Gujarat,Gandhinagar,Blindness,0,6,5,0,5
Gujarat,Gandhinagar,Blindness,6,15,45,27,72
Gujarat,Gandhinagar,Blindness,15,35,119,59,178
Gujarat,Gandhinagar,Blindness,35,60,102,38,140
Gujarat,Gandhinagar,Blindness,60,80,49,11,60
Gujarat,Gandhinagar,Blindness,80,100,9,1,10
Jammu And Kashmir,Ganderbal,Blindness,0,6,2,4,6
Jammu And Kashmir,Ganderbal,Blindness,6,15,14,10,24
Jammu And Kashmir,Ganderbal,Blindness,15,35,53,53,106
Jammu And Kashmir,Ganderbal,Blindness,35,60,80,39,119
Jammu And Kashmir,Ganderbal,Blindness,60,80,22,17,39
Jammu And Kashmir,Ganderbal,Blindness,80,100,2,2,4
Odisha,Gajapati,Blindness,0,6,4,2,6
Odisha,Gajapati,Blindness,6,15,15,20,35
Odisha,Gajapati,Blindness,15,35,90,82,172
Odisha,Gajapati,Blindness,35,60,144,117,261
Odisha,Gajapati,Blindness,60,80,106,68,174
Odisha,Gajapati,Blindness,80,100,13,10,23
Maharashtra,Gadchiroli,Blindness,0,6,2,6,8
Maharashtra,Gadchiroli,Blindness,6,15,17,16,33
Maharashtra,Gadchiroli,Blindness,15,35,113,68,181
Maharashtra,Gadchiroli,Blindness,35,60,152,88,240
Maharashtra,Gadchiroli,Blindness,60,80,39,25,64
Maharashtra,Gadchiroli,Blindness,80,100,1,2,3
Karnataka,Gadag,Blindness,0,6,4,4,8
Karnataka,Gadag,Blindness,6,15,40,31,71
Karnataka,Gadag,Blindness,15,35,228,138,366
Karnataka,Gadag,Blindness,35,60,361,191,552
Karnataka,Gadag,Blindness,60,80,119,45,164
Karnataka,Gadag,Blindness,80,100,8,2,10
Uttar Pradesh,Firozabad,Blindness,0,6,2,3,5
Uttar Pradesh,Firozabad,Blindness,6,15,48,29,77
Uttar Pradesh,Firozabad,Blindness,15,35,184,78,262
Uttar Pradesh,Firozabad,Blindness,35,60,454,153,607
Uttar Pradesh,Firozabad,Blindness,60,80,142,38,180
Uttar Pradesh,Firozabad,Blindness,80,100,7,3,10
Punjab,Ferozepur,Blindness,0,6,3,3,6
Punjab,Ferozepur,Blindness,6,15,12,11,23
Punjab,Ferozepur,Blindness,15,35,47,29,76
Punjab,Ferozepur,Blindness,35,60,68,26,94
Punjab,Ferozepur,Blindness,60,80,35,7,42
Punjab,Ferozepur,Blindness,80,100,3,0,3
Punjab,Fazilka,Blindness,0,6,7,2,9
Punjab,Fazilka,Blindness,6,15,29,16,45
Punjab,Fazilka,Blindness,15,35,157,78,235
Punjab,Fazilka,Blindness,35,60,216,63,279
Punjab,Fazilka,Blindness,60,80,69,18,87
Punjab,Fazilka,Blindness,80,100,11,2,13
Uttar Pradesh,Fatehpur,Blindness,0,6,5,3,8
Uttar Pradesh,Fatehpur,Blindness,6,15,39,22,61
Uttar Pradesh,Fatehpur,Blindness,15,35,313,135,448
Uttar Pradesh,Fatehpur,Blindness,35,60,433,129,562
Uttar Pradesh,Fatehpur,Blindness,60,80,248,65,313
Uttar Pradesh,Fatehpur,Blindness,80,100,21,4,25
Punjab,Fatehgarh Sahib,Blindness,0,6,3,3,6
Punjab,Fatehgarh Sahib,Blindness,6,15,16,12,28
Punjab,Fatehgarh Sahib,Blindness,15,35,48,31,79
Punjab,Fatehgarh Sahib,Blindness,35,60,116,52,168
Punjab,Fatehgarh Sahib,Blindness,60,80,71,26,97
Punjab,Fatehgarh Sahib,Blindness,80,100,5,5,10
Haryana,Fatehabad,Blindness,0,6,8,7,15
Haryana,Fatehabad,Blindness,6,15,21,16,37
Haryana,Fatehabad,Blindness,15,35,100,52,152
Haryana,Fatehabad,Blindness,35,60,112,69,181
Haryana,Fatehabad,Blindness,60,80,44,25,69
Haryana,Fatehabad,Blindness,80,100,7,3,10
Uttar Pradesh,Farrukhabad,Blindness,0,6,2,2,4
Uttar Pradesh,Farrukhabad,Blindness,6,15,27,25,52
Uttar Pradesh,Farrukhabad,Blindness,15,35,158,93,251
Uttar Pradesh,Farrukhabad,Blindness,35,60,274,129,403
Uttar Pradesh,Farrukhabad,Blindness,60,80,152,50,202
Uttar Pradesh,Farrukhabad,Blindness,80,100,10,4,14
Punjab,Faridkot,Blindness,0,6,7,0,7
Punjab,Faridkot,Blindness,6,15,19,12,31
Punjab,Faridkot,Blindness,15,35,56,24,80
Punjab,Faridkot,Blindness,35,60,98,41,139
Punjab,Faridkot,Blindness,60,80,48,13,61
Punjab,Faridkot,Blindness,80,100,9,4,13
Haryana,Faridabad,Blindness,0,6,2,3,5
Haryana,Faridabad,Blindness,6,15,46,35,81
Haryana,Faridabad,Blindness,15,35,121,99,220
Haryana,Faridabad,Blindness,35,60,106,57,163
Haryana,Faridabad,Blindness,60,80,39,15,54
Haryana,Faridabad,Blindness,80,100,1,1,2
Uttar Pradesh,Etawah,Blindness,0,6,1,1,2
Uttar Pradesh,Etawah,Blindness,6,15,25,16,41
Uttar Pradesh,Etawah,Blindness,15,35,120,49,169
Uttar Pradesh,Etawah,Blindness,35,60,228,90,318
Uttar Pradesh,Etawah,Blindness,60,80,138,53,191
Uttar Pradesh,Etawah,Blindness,80,100,15,7,22
Uttar Pradesh,Etah,Blindness,0,6,3,2,5
Uttar Pradesh,Etah,Blindness,6,15,19,13,32
Uttar Pradesh,Etah,Blindness,15,35,155,53,208
Uttar Pradesh,Etah,Blindness,35,60,226,83,309
Uttar Pradesh,Etah,Blindness,60,80,191,46,237
Uttar Pradesh,Etah,Blindness,80,100,11,5,16
Tamil Nadu,Erode,Blindness,0,6,1,0,1
Tamil Nadu,Erode,Blindness,6,15,13,8,21
Tamil Nadu,Erode,Blindness,15,35,101,58,159
Tamil Nadu,Erode,Blindness,35,60,268,157,425
Tamil Nadu,Erode,Blindness,60,80,76,37,113
Tamil Nadu,Erode,Blindness,80,100,6,1,7
Kerala,Ernakulam,Blindness,0,6,2,2,4
Kerala,Ernakulam,Blindness,6,15,23,15,38
Kerala,Ernakulam,Blindness,15,35,95,61,156
Kerala,Ernakulam,Blindness,35,60,246,178,424
Kerala,Ernakulam,Blindness,60,80,196,109,305
Kerala,Ernakulam,Blindness,80,100,13,4,17
Meghalaya,Eastern West Khasi Hills,Blindness,0,6,0,2,2
Meghalaya,Eastern West Khasi Hills,Blindness,6,15,5,4,9
Meghalaya,Eastern West Khasi Hills,Blindness,15,35,14,8,22
Meghalaya,Eastern West Khasi Hills,Blindness,35,60,9,6,15
Meghalaya,Eastern West Khasi Hills,Blindness,60,80,2,2,4
Jharkhand,East Singhbum,Blindness,0,6,9,3,12
Jharkhand,East Singhbum,Blindness,6,15,84,58,142
Jharkhand,East Singhbum,Blindness,15,35,289,211,500
Jharkhand,East Singhbum,Blindness,35,60,338,204,542
Jharkhand,East Singhbum,Blindness,60,80,53,40,93
Jharkhand,East Singhbum,Blindness,80,100,8,0,8
Arunachal Pradesh,East Siang,Blindness,6,15,1,3,4
Arunachal Pradesh,East Siang,Blindness,15,35,16,4,20
Arunachal Pradesh,East Siang,Blindness,35,60,9,7,16
Arunachal Pradesh,East Siang,Blindness,60,80,0,1,1
Arunachal Pradesh,East Siang,Blindness,80,100,1,0,1
Madhya Pradesh,East Nimar,Blindness,0,6,1,1,2
Madhya Pradesh,East Nimar,Blindness,6,15,33,32,65
Madhya Pradesh,East Nimar,Blindness,15,35,283,172,455
Madhya Pradesh,East Nimar,Blindness,35,60,280,145,425
Madhya Pradesh,East Nimar,Blindness,60,80,81,48,129
Madhya Pradesh,East Nimar,Blindness,80,100,10,1,11
Meghalaya,East Khasi Hills,Blindness,0,6,8,10,18
Meghalaya,East Khasi Hills,Blindness,6,15,44,23,67
Meghalaya,East Khasi Hills,Blindness,15,35,90,74,164
Meghalaya,East Khasi Hills,Blindness,35,60,83,65,148
Meghalaya,East Khasi Hills,Blindness,60,80,27,33,60
Meghalaya,East Khasi Hills,Blindness,80,100,5,7,12
Arunachal Pradesh,East Kameng,Blindness,0,6,2,0,2
Arunachal Pradesh,East Kameng,Blindness,6,15,1,1,2
Arunachal Pradesh,East Kameng,Blindness,15,35,11,8,19
Arunachal Pradesh,East Kameng,Blindness,35,60,7,6,13
Arunachal Pradesh,East Kameng,Blindness,60,80,6,0,6
Meghalaya,East Jaintia Hills,Blindness,0,6,0,2,2
Meghalaya,East Jaintia Hills,Blindness,6,15,13,5,18
Meghalaya,East Jaintia Hills,Blindness,15,35,16,8,24
Meghalaya,East Jaintia Hills,Blindness,35,60,4,6,10
Meghalaya,East Jaintia Hills,Blindness,60,80,0,1,1
Andhra Pradesh,East Godavari,Blindness,0,6,22,16,38
Andhra Pradesh,East Godavari,Blindness,6,15,140,123,263
Andhra Pradesh,East Godavari,Blindness,15,35,865,341,1206
Andhra Pradesh,East Godavari,Blindness,35,60,2154,93,2247
Andhra Pradesh,East Godavari,Blindness,60,80,734,33,767
Andhra Pradesh,East Godavari,Blindness,80,100,49,4,53
Meghalaya,East Garo Hills,Blindness,0,6,1,1,2
Meghalaya,East Garo Hills,Blindness,6,15,5,3,8
Meghalaya,East Garo Hills,Blindness,15,35,20,17,37
Meghalaya,East Garo Hills,Blindness,35,60,20,12,32
Meghalaya,East Garo Hills,Blindness,60,80,26,18,44
Meghalaya,East Garo Hills,Blindness,80,100,3,5,8
Delhi,East,Blindness,0,6,1,4,5
Delhi,East,Blindness,6,15,23,23,46
Delhi,East,Blindness,15,35,79,74,153
Delhi,East,Blindness,35,60,97,43,140
Delhi,East,Blindness,60,80,29,15,44
Delhi,East,Blindness,80,100,1,0,1
Chhattisgarh,Durg,Blindness,0,6,4,1,5
Chhattisgarh,Durg,Blindness,6,15,56,46,102
Chhattisgarh,Durg,Blindness,15,35,291,222,513
Chhattisgarh,Durg,Blindness,35,60,375,157,532
Chhattisgarh,Durg,Blindness,60,80,149,44,193
Chhattisgarh,Durg,Blindness,80,100,15,3,18
Rajasthan,Dungarpur,Blindness,6,15,17,13,30
Rajasthan,Dungarpur,Blindness,15,35,107,63,170
Rajasthan,Dungarpur,Blindness,35,60,81,40,121
Rajasthan,Dungarpur,Blindness,60,80,19,6,25
Rajasthan,Dungarpur,Blindness,80,100,1,2,3
Jharkhand,Dumka,Blindness,0,6,5,5,10
Jharkhand,Dumka,Blindness,6,15,60,59,119
Jharkhand,Dumka,Blindness,15,35,181,121,302
Jharkhand,Dumka,Blindness,35,60,192,118,310
Jharkhand,Dumka,Blindness,60,80,24,21,45
Jharkhand,Dumka,Blindness,80,100,1,0,1
Gujarat,Dohad,Blindness,0,6,5,1,6
Gujarat,Dohad,Blindness,6,15,85,76,161
Gujarat,Dohad,Blindness,15,35,298,192,490
Gujarat,Dohad,Blindness,35,60,162,84,246
Gujarat,Dohad,Blindness,60,80,44,21,65
Gujarat,Dohad,Blindness,80,100,0,2,2
Jammu And Kashmir,Doda,Blindness,0,6,4,0,4
Jammu And Kashmir,Doda,Blindness,6,15,51,27,78
Jammu And Kashmir,Doda,Blindness,15,35,166,129,295
Jammu And Kashmir,Doda,Blindness,35,60,199,102,301
Jammu And Kashmir,Doda,Blindness,60,80,71,29,100
Jammu And Kashmir,Doda,Blindness,80,100,17,4,21
Dadra Nagar Haveli And Daman And Diu,Diu,Blindness,0,6,0,1,1
Dadra Nagar Haveli And Daman And Diu,Diu,Blindness,6,15,5,2,7
Dadra Nagar Haveli And Daman And Diu,Diu,Blindness,15,35,3,4,7
Dadra Nagar Haveli And Daman And Diu,Diu,Blindness,35,60,8,4,12
Dadra Nagar Haveli And Daman And Diu,Diu,Blindness,60,80,8,4,12
Dadra Nagar Haveli And Daman And Diu,Diu,Blindness,80,100,0,1,1
Madhya Pradesh,Dindori,Blindness,0,6,0,1,1
Madhya Pradesh,Dindori,Blindness,6,15,10,26,36
Madhya Pradesh,Dindori,Blindness,15,35,135,85,220
Madhya Pradesh,Dindori,Blindness,35,60,118,77,195
Madhya Pradesh,Dindori,Blindness,60,80,41,29,70
Madhya Pradesh,Dindori,Blindness,80,100,1,2,3
Tamil Nadu,Dindigul,Blindness,0,6,0,1,1
Tamil Nadu,Dindigul,Blindness,6,15,21,22,43
Tamil Nadu,Dindigul,Blindness,15,35,149,116,265
Tamil Nadu,Dindigul,Blindness,35,60,413,283,696
Tamil Nadu,Dindigul,Blindness,60,80,197,86,283
Tamil Nadu,Dindigul,Blindness,80,100,10,5,15
Nagaland,Dimapur,Blindness,0,6,2,0,2
Nagaland,Dimapur,Blindness,6,15,2,3,5
Nagaland,Dimapur,Blindness,15,35,15,10,25
Nagaland,Dimapur,Blindness,35,60,3,0,3
Nagaland,Dimapur,Blindness,60,80,1,0,1
Assam,Dima Hasao,Blindness,6,15,1,0,1
Assam,Dima Hasao,Blindness,15,35,10,5,15
Assam,Dima Hasao,Blindness,35,60,9,5,14
Assam,Dima Hasao,Blindness,60,80,2,2,4
Assam,Dibrugarh,Blindness,0,6,3,1,4
Assam,Dibrugarh,Blindness,6,15,19,13,32
Assam,Dibrugarh,Blindness,15,35,83,73,156
Assam,Dibrugarh,Blindness,35,60,97,63,160
Assam,Dibrugarh,Blindness,60,80,22,11,33
Arunachal Pradesh,Dibang Valley,Blindness,15,35,0,1,1
Maharashtra,Dhule,Blindness,0,6,8,2,10
Maharashtra,Dhule,Blindness,6,15,50,34,84
Maharashtra,Dhule,Blindness,15,35,306,156,462
Maharashtra,Dhule,Blindness,35,60,464,194,658
Maharashtra,Dhule,Blindness,60,80,236,70,306
Maharashtra,Dhule,Blindness,80,100,10,2,12
Assam,Dhubri,Blindness,0,6,2,1,3
Assam,Dhubri,Blindness,6,15,29,20,49
Assam,Dhubri,Blindness,15,35,98,85,183
Assam,Dhubri,Blindness,35,60,84,32,116
Assam,Dhubri,Blindness,60,80,21,5,26
Assam,Dhubri,Blindness,80,100,3,4,7
Rajasthan,Dholpur,Blindness,0,6,6,0,6
Rajasthan,Dholpur,Blindness,6,15,24,15,39
Rajasthan,Dholpur,Blindness,15,35,143,74,217
Rajasthan,Dholpur,Blindness,35,60,139,60,199
Rajasthan,Dholpur,Blindness,60,80,54,32,86
Rajasthan,Dholpur,Blindness,80,100,8,4,12
Odisha,Dhenkanal,Blindness,0,6,8,9,17
Odisha,Dhenkanal,Blindness,6,15,82,60,142
Odisha,Dhenkanal,Blindness,15,35,250,197,447
Odisha,Dhenkanal,Blindness,35,60,389,182,571
Odisha,Dhenkanal,Blindness,60,80,163,58,221
Odisha,Dhenkanal,Blindness,80,100,12,6,18
Assam,Dhemaji,Blindness,0,6,0,2,2
Assam,Dhemaji,Blindness,6,15,9,8,17
Assam,Dhemaji,Blindness,15,35,59,35,94
Assam,Dhemaji,Blindness,35,60,56,37,93
Assam,Dhemaji,Blindness,60,80,17,10,27
Assam,Dhemaji,Blindness,80,100,0,1,1
Karnataka,Dharwad,Blindness,0,6,9,6,15
Karnataka,Dharwad,Blindness,6,15,57,59,116
Karnataka,Dharwad,Blindness,15,35,248,209,457
Karnataka,Dharwad,Blindness,35,60,483,223,706
Karnataka,Dharwad,Blindness,60,80,148,55,203
Karnataka,Dharwad,Blindness,80,100,13,3,16
Tamil Nadu,Dharmapuri,Blindness,0,6,3,3,6
Tamil Nadu,Dharmapuri,Blindness,6,15,27,20,47
Tamil Nadu,Dharmapuri,Blindness,15,35,183,96,279
Tamil Nadu,Dharmapuri,Blindness,35,60,340,209,549
Tamil Nadu,Dharmapuri,Blindness,60,80,126,65,191
Tamil Nadu,Dharmapuri,Blindness,80,100,9,3,12
Madhya Pradesh,Dhar,Blindness,0,6,1,1,2
Madhya Pradesh,Dhar,Blindness,6,15,24,21,45
Madhya Pradesh,Dhar,Blindness,15,35,233,158,391
Madhya Pradesh,Dhar,Blindness,35,60,299,128,427
Madhya Pradesh,Dhar,Blindness,60,80,82,46,128
Madhya Pradesh,Dhar,Blindness,80,100,9,6,15
Jharkhand,Dhanbad,Blindness,0,6,1,0,1
Jharkhand,Dhanbad,Blindness,6,15,18,18,36
Jharkhand,Dhanbad,Blindness,15,35,135,102,237
Jharkhand,Dhanbad,Blindness,35,60,90,65,155
Jharkhand,Dhanbad,Blindness,60,80,25,16,41
Jharkhand,Dhanbad,Blindness,80,100,2,0,2
Chhattisgarh,Dhamtari,Blindness,0,6,2,1,3
Chhattisgarh,Dhamtari,Blindness,6,15,43,28,71
Chhattisgarh,Dhamtari,Blindness,15,35,182,122,304
Chhattisgarh,Dhamtari,Blindness,35,60,169,85,254
Chhattisgarh,Dhamtari,Blindness,60,80,54,20,74
Chhattisgarh,Dhamtari,Blindness,80,100,3,1,4
Tripura,Dhalai,Blindness,0,6,2,0,2
Tripura,Dhalai,Blindness,6,15,42,42,84
Tripura,Dhalai,Blindness,15,35,213,136,349
Tripura,Dhalai,Blindness,35,60,229,156,385
Tripura,Dhalai,Blindness,60,80,93,64,157
Tripura,Dhalai,Blindness,80,100,21,19,40
Madhya Pradesh,Dewas,Blindness,0,6,1,2,3
Madhya Pradesh,Dewas,Blindness,6,15,25,23,48
Madhya Pradesh,Dewas,Blindness,15,35,236,131,367
Madhya Pradesh,Dewas,Blindness,35,60,287,110,397
Madhya Pradesh,Dewas,Blindness,60,80,154,68,222
Madhya Pradesh,Dewas,Blindness,80,100,22,11,33
Gujarat,Devbhumi Dwarka,Blindness,0,6,2,3,5
Gujarat,Devbhumi Dwarka,Blindness,6,15,36,37,73
Gujarat,Devbhumi Dwarka,Blindness,15,35,147,75,222
Gujarat,Devbhumi Dwarka,Blindness,35,60,155,56,211
Gujarat,Devbhumi Dwarka,Blindness,60,80,140,62,202
Gujarat,Devbhumi Dwarka,Blindness,80,100,19,12,31
Uttar Pradesh,Deoria,Blindness,0,6,4,4,8
Uttar Pradesh,Deoria,Blindness,6,15,81,51,132
Uttar Pradesh,Deoria,Blindness,15,35,383,236,619
Uttar Pradesh,Deoria,Blindness,35,60,421,181,602
Uttar Pradesh,Deoria,Blindness,60,80,143,59,202
Uttar Pradesh,Deoria,Blindness,80,100,6,2,8
Jharkhand,Deoghar,Blindness,0,6,10,7,17
Jharkhand,Deoghar,Blindness,6,15,61,60,121
Jharkhand,Deoghar,Blindness,15,35,147,102,249
Jharkhand,Deoghar,Blindness,35,60,138,72,210
Jharkhand,Deoghar,Blindness,60,80,30,16,46
Jharkhand,Deoghar,Blindness,80,100,3,3,6
Odisha,Deogarh,Blindness,0,6,0,2,2
Odisha,Deogarh,Blindness,6,15,16,13,29
Odisha,Deogarh,Blindness,15,35,44,24,68
Odisha,Deogarh,Blindness,35,60,72,27,99
Odisha,Deogarh,Blindness,60,80,23,10,33
Odisha,Deogarh,Blindness,80,100,1,0,1
Uttarakhand,Dehradun,Blindness,0,6,1,5,6
Uttarakhand,Dehradun,Blindness,6,15,23,22,45
Uttarakhand,Dehradun,Blindness,15,35,141,109,250
Uttarakhand,Dehradun,Blindness,35,60,172,69,241
Uttarakhand,Dehradun,Blindness,60,80,54,22,76
Uttarakhand,Dehradun,Blindness,80,100,5,3,8
Karnataka,Davangere,Blindness,0,6,8,3,11
Karnataka,Davangere,Blindness,6,15,76,49,125
Karnataka,Davangere,Blindness,15,35,270,221,491
Karnataka,Davangere,Blindness,35,60,498,305,803
Karnataka,Davangere,Blindness,60,80,143,62,205
Karnataka,Davangere,Blindness,80,100,6,5,11
Rajasthan,Dausa,Blindness,0,6,2,1,3
Rajasthan,Dausa,Blindness,6,15,26,16,42
Rajasthan,Dausa,Blindness,15,35,157,73,230
Rajasthan,Dausa,Blindness,35,60,143,86,229
Rajasthan,Dausa,Blindness,60,80,69,23,92
Rajasthan,Dausa,Blindness,80,100,10,1,11
Madhya Pradesh,Datia,Blindness,0,6,8,2,10
Madhya Pradesh,Datia,Blindness,6,15,52,44,96
Madhya Pradesh,Datia,Blindness,15,35,193,124,317
Madhya Pradesh,Datia,Blindness,35,60,268,129,397
Madhya Pradesh,Datia,Blindness,60,80,136,74,210
Madhya Pradesh,Datia,Blindness,80,100,16,9,25
Assam,Darrang,Blindness,0,6,1,0,1
Assam,Darrang,Blindness,6,15,36,30,66
Assam,Darrang,Blindness,15,35,235,163,398
Assam,Darrang,Blindness,35,60,246,159,405
Assam,Darrang,Blindness,60,80,83,46,129
Assam,Darrang,Blindness,80,100,5,1,6
Bihar,Darbhanga,Blindness,0,6,7,2,9
Bihar,Darbhanga,Blindness,6,15,31,16,47
Bihar,Darbhanga,Blindness,15,35,216,111,327
Bihar,Darbhanga,Blindness,35,60,191,73,264
Bihar,Darbhanga,Blindness,60,80,57,24,81
Bihar,Darbhanga,Blindness,80,100,5,0,5
Chhattisgarh,Dantewada,Blindness,0,6,4,1,5
Chhattisgarh,Dantewada,Blindness,6,15,19,8,27
Chhattisgarh,Dantewada,Blindness,15,35,58,30,88
Chhattisgarh,Dantewada,Blindness,35,60,51,26,77
Chhattisgarh,Dantewada,Blindness,60,80,12,10,22
Chhattisgarh,Dantewada,Blindness,80,100,1,1,2
Gujarat,Dang,Blindness,0,6,0,1,1
Gujarat,Dang,Blindness,6,15,18,12,30
Gujarat,Dang,Blindness,15,35,70,44,114
Gujarat,Dang,Blindness,35,60,32,17,49
Gujarat,Dang,Blindness,60,80,9,9,18
Gujarat,Dang,Blindness,80,100,0,1,1
Madhya Pradesh,Damoh,Blindness,6,15,31,22,53
Madhya Pradesh,Damoh,Blindness,15,35,256,166,422
Madhya Pradesh,Damoh,Blindness,35,60,311,167,478
Madhya Pradesh,Damoh,Blindness,60,80,120,46,166
Madhya Pradesh,Damoh,Blindness,80,100,6,5,11
Dadra Nagar Haveli And Daman And Diu,Daman,Blindness,0,6,2,2,4
Dadra Nagar Haveli And Daman And Diu,Daman,Blindness,6,15,10,5,15
Dadra Nagar Haveli And Daman And Diu,Daman,Blindness,15,35,19,13,32
Dadra Nagar Haveli And Daman And Diu,Daman,Blindness,35,60,20,7,27
Dadra Nagar Haveli And Daman And Diu,Daman,Blindness,60,80,11,4,15
Karnataka,Dakshina Kannada,Blindness,0,6,2,1,3
Karnataka,Dakshina Kannada,Blindness,6,15,24,18,42
Karnataka,Dakshina Kannada,Blindness,15,35,126,64,190
Karnataka,Dakshina Kannada,Blindness,35,60,271,170,441
Karnataka,Dakshina Kannada,Blindness,60,80,128,78,206
Karnataka,Dakshina Kannada,Blindness,80,100,6,2,8
Dadra Nagar Haveli And Daman And Diu,Dadra And Nagar Haveli,Blindness,0,6,1,0,1
Dadra Nagar Haveli And Daman And Diu,Dadra And Nagar Haveli,Blindness,6,15,15,8,23
Dadra Nagar Haveli And Daman And Diu,Dadra And Nagar Haveli,Blindness,15,35,24,15,39
Dadra Nagar Haveli And Daman And Diu,Dadra And Nagar Haveli,Blindness,35,60,23,14,37
Dadra Nagar Haveli And Daman And Diu,Dadra And Nagar Haveli,Blindness,60,80,9,5,14
Odisha,Cuttack,Blindness,0,6,6,2,8
Odisha,Cuttack,Blindness,6,15,93,71,164
Odisha,Cuttack,Blindness,15,35,280,204,484
Odisha,Cuttack,Blindness,35,60,432,249,681
Odisha,Cuttack,Blindness,60,80,133,46,179
Odisha,Cuttack,Blindness,80,100,15,5,20
Tamil Nadu,Cuddalore,Blindness,0,6,0,1,1
Tamil Nadu,Cuddalore,Blindness,6,15,39,29,68
Tamil Nadu,Cuddalore,Blindness,15,35,238,157,395
Tamil Nadu,Cuddalore,Blindness,35,60,424,241,665
Tamil Nadu,Cuddalore,Blindness,60,80,165,72,237
Tamil Nadu,Cuddalore,Blindness,80,100,10,2,12
Tamil Nadu,Coimbatore,Blindness,0,6,1,3,4
Tamil Nadu,Coimbatore,Blindness,6,15,46,35,81
Tamil Nadu,Coimbatore,Blindness,15,35,168,139,307
Tamil Nadu,Coimbatore,Blindness,35,60,328,215,543
Tamil Nadu,Coimbatore,Blindness,60,80,143,54,197
Tamil Nadu,Coimbatore,Blindness,80,100,5,0,5
Rajasthan,Churu,Blindness,0,6,3,2,5
Rajasthan,Churu,Blindness,6,15,20,11,31
Rajasthan,Churu,Blindness,15,35,206,81,287
Rajasthan,Churu,Blindness,35,60,159,74,233
Rajasthan,Churu,Blindness,60,80,61,21,82
Rajasthan,Churu,Blindness,80,100,5,6,11
Manipur,Churachandpur,Blindness,0,6,1,1,2
Manipur,Churachandpur,Blindness,6,15,5,0,5
Manipur,Churachandpur,Blindness,15,35,14,15,29
Manipur,Churachandpur,Blindness,35,60,11,9,20
Manipur,Churachandpur,Blindness,60,80,2,8,10
Manipur,Churachandpur,Blindness,80,100,1,1,2
Rajasthan,Chittorgarh,Blindness,0,6,3,3,6
Rajasthan,Chittorgarh,Blindness,6,15,28,26,54
Rajasthan,Chittorgarh,Blindness,15,35,216,94,310
Rajasthan,Chittorgarh,Blindness,35,60,309,185,494
Rajasthan,Chittorgarh,Blindness,60,80,129,84,213
Rajasthan,Chittorgarh,Blindness,80,100,19,17,36
Andhra Pradesh,Chittoor,Blindness,0,6,7,6,13
Andhra Pradesh,Chittoor,Blindness,6,15,98,85,183
Andhra Pradesh,Chittoor,Blindness,15,35,551,207,758
Andhra Pradesh,Chittoor,Blindness,35,60,1478,71,1549
Andhra Pradesh,Chittoor,Blindness,60,80,579,18,597
Andhra Pradesh,Chittoor,Blindness,80,100,78,3,81
Uttar Pradesh,Chitrakoot,Blindness,0,6,4,3,7
Uttar Pradesh,Chitrakoot,Blindness,6,15,52,29,81
Uttar Pradesh,Chitrakoot,Blindness,15,35,214,96,310
Uttar Pradesh,Chitrakoot,Blindness,35,60,226,100,326
Uttar Pradesh,Chitrakoot,Blindness,60,80,72,30,102
Uttar Pradesh,Chitrakoot,Blindness,80,100,4,2,6
Karnataka,Chitradurga,Blindness,0,6,9,8,17
Karnataka,Chitradurga,Blindness,6,15,88,53,141
Karnataka,Chitradurga,Blindness,15,35,533,434,967
Karnataka,Chitradurga,Blindness,35,60,1162,956,2118
Karnataka,Chitradurga,Blindness,60,80,265,128,393
Karnataka,Chitradurga,Blindness,80,100,16,10,26
Assam,Chirang,Blindness,0,6,2,1,3
Assam,Chirang,Blindness,6,15,5,3,8
Assam,Chirang,Blindness,15,35,26,22,48
Assam,Chirang,Blindness,35,60,33,20,53
Assam,Chirang,Blindness,60,80,7,9,16
Karnataka,Chikkamagaluru,Blindness,0,6,4,6,10
Karnataka,Chikkamagaluru,Blindness,6,15,41,20,61
Karnataka,Chikkamagaluru,Blindness,15,35,219,153,372
Karnataka,Chikkamagaluru,Blindness,35,60,481,341,822
Karnataka,Chikkamagaluru,Blindness,60,80,186,98,284
Karnataka,Chikkamagaluru,Blindness,80,100,9,5,14
Karnataka,Chikkaballapura,Blindness,0,6,5,5,10
Karnataka,Chikkaballapura,Blindness,6,15,44,32,76
Karnataka,Chikkaballapura,Blindness,15,35,267,203,470
Karnataka,Chikkaballapura,Blindness,35,60,517,312,829
Karnataka,Chikkaballapura,Blindness,60,80,200,92,292
Karnataka,Chikkaballapura,Blindness,80,100,16,4,20
Gujarat,Chhotaudepur,Blindness,0,6,3,1,4
Gujarat,Chhotaudepur,Blindness,6,15,28,27,55
Gujarat,Chhotaudepur,Blindness,15,35,150,113,263
Gujarat,Chhotaudepur,Blindness,35,60,89,35,124
Gujarat,Chhotaudepur,Blindness,60,80,19,7,26
Gujarat,Chhotaudepur,Blindness,80,100,2,3,5
Madhya Pradesh,Chhindwara,Blindness,0,6,3,1,4
Madhya Pradesh,Chhindwara,Blindness,6,15,29,30,59
Madhya Pradesh,Chhindwara,Blindness,15,35,371,215,586
Madhya Pradesh,Chhindwara,Blindness,35,60,492,291,783
Madhya Pradesh,Chhindwara,Blindness,60,80,219,99,318
Madhya Pradesh,Chhindwara,Blindness,80,100,22,9,31
Madhya Pradesh,Chhatarpur,Blindness,0,6,23,14,37
Madhya Pradesh,Chhatarpur,Blindness,6,15,112,90,202
Madhya Pradesh,Chhatarpur,Blindness,15,35,649,357,1006
Madhya Pradesh,Chhatarpur,Blindness,35,60,664,341,1005
Madhya Pradesh,Chhatarpur,Blindness,60,80,312,120,432
Madhya Pradesh,Chhatarpur,Blindness,80,100,25,9,34
Tamil Nadu,Chennai,Blindness,0,6,5,5,10
Tamil Nadu,Chennai,Blindness,6,15,69,51,120
Tamil Nadu,Chennai,Blindness,15,35,267,221,488
Tamil Nadu,Chennai,Blindness,35,60,482,284,766
Tamil Nadu,Chennai,Blindness,60,80,186,83,269
Tamil Nadu,Chennai,Blindness,80,100,11,4,15
Tamil Nadu,Chengalpattu,Blindness,0,6,2,0,2
Tamil Nadu,Chengalpattu,Blindness,6,15,17,9,26
Tamil Nadu,Chengalpattu,Blindness,15,35,77,46,123
Tamil Nadu,Chengalpattu,Blindness,35,60,148,93,241
Tamil Nadu,Chengalpattu,Blindness,60,80,68,27,95
Tamil Nadu,Chengalpattu,Blindness,80,100,3,1,4
Jharkhand,Chatra,Blindness,0,6,2,0,2
Jharkhand,Chatra,Blindness,6,15,7,6,13
Jharkhand,Chatra,Blindness,15,35,14,7,21
Jharkhand,Chatra,Blindness,35,60,20,12,32
Jharkhand,Chatra,Blindness,60,80,0,3,3
Haryana,Charki Dadri,Blindness,0,6,2,1,3
Haryana,Charki Dadri,Blindness,6,15,7,6,13
Haryana,Charki Dadri,Blindness,15,35,32,16,48
Haryana,Charki Dadri,Blindness,35,60,61,27,88
Haryana,Charki Dadri,Blindness,60,80,21,6,27
Haryana,Charki Dadri,Blindness,80,100,4,3,7
Assam,Charaideo,Blindness,0,6,10,6,16
Assam,Charaideo,Blindness,6,15,20,19,39
Assam,Charaideo,Blindness,15,35,53,48,101
Assam,Charaideo,Blindness,35,60,60,39,99
Assam,Charaideo,Blindness,60,80,18,5,23
Arunachal Pradesh,Changlang,Blindness,0,6,1,0,1
Arunachal Pradesh,Changlang,Blindness,6,15,1,1,2
Arunachal Pradesh,Changlang,Blindness,15,35,3,5,8
Arunachal Pradesh,Changlang,Blindness,35,60,4,4,8
Arunachal Pradesh,Changlang,Blindness,60,80,3,2,5
Arunachal Pradesh,Changlang,Blindness,80,100,0,1,1
Maharashtra,Chandrapur,Blindness,0,6,8,10,18
Maharashtra,Chandrapur,Blindness,6,15,100,57,157
Maharashtra,Chandrapur,Blindness,15,35,350,214,564
Maharashtra,Chandrapur,Blindness,35,60,482,232,714
Maharashtra,Chandrapur,Blindness,60,80,116,44,160
Maharashtra,Chandrapur,Blindness,80,100,8,3,11
Chandigarh,Chandigarh,Blindness,0,6,1,1,2
Chandigarh,Chandigarh,Blindness,6,15,23,14,37
Chandigarh,Chandigarh,Blindness,15,35,116,48,164
Chandigarh,Chandigarh,Blindness,35,60,107,61,168
Chandigarh,Chandigarh,Blindness,60,80,36,16,52
Chandigarh,Chandigarh,Blindness,80,100,3,2,5
Manipur,Chandel,Blindness,6,15,1,1,2
Manipur,Chandel,Blindness,15,35,5,2,7
Manipur,Chandel,Blindness,35,60,3,1,4
Manipur,Chandel,Blindness,60,80,0,5,5
Manipur,Chandel,Blindness,80,100,1,1,2
Uttar Pradesh,Chandauli,Blindness,0,6,7,2,9
Uttar Pradesh,Chandauli,Blindness,6,15,32,37,69
Uttar Pradesh,Chandauli,Blindness,15,35,216,109,325
Uttar Pradesh,Chandauli,Blindness,35,60,176,93,269
Uttar Pradesh,Chandauli,Blindness,60,80,55,24,79
Uttar Pradesh,Chandauli,Blindness,80,100,1,0,1
Mizoram,Champhai,Blindness,6,15,1,0,1
Mizoram,Champhai,Blindness,15,35,4,4,8
Mizoram,Champhai,Blindness,35,60,2,0,2
Mizoram,Champhai,Blindness,60,80,1,0,1
Uttarakhand,Champawat,Blindness,0,6,0,1,1
Uttarakhand,Champawat,Blindness,6,15,10,9,19
Uttarakhand,Champawat,Blindness,15,35,81,35,116
Uttarakhand,Champawat,Blindness,35,60,133,64,197
Uttarakhand,Champawat,Blindness,60,80,20,31,51
Uttarakhand,Champawat,Blindness,80,100,1,0,1
Uttarakhand,Chamoli,Blindness,0,6,3,1,4
Uttarakhand,Chamoli,Blindness,6,15,13,6,19
Uttarakhand,Chamoli,Blindness,15,35,125,54,179
Uttarakhand,Chamoli,Blindness,35,60,166,80,246
Uttarakhand,Chamoli,Blindness,60,80,34,18,52
Uttarakhand,Chamoli,Blindness,80,100,3,2,5
Himachal Pradesh,Chamba,Blindness,0,6,0,1,1
Himachal Pradesh,Chamba,Blindness,6,15,11,8,19
Himachal Pradesh,Chamba,Blindness,15,35,60,33,93
Himachal Pradesh,Chamba,Blindness,35,60,102,38,140
Himachal Pradesh,Chamba,Blindness,60,80,18,5,23
Himachal Pradesh,Chamba,Blindness,80,100,2,0,2
Karnataka,Chamarajanagara,Blindness,0,6,6,4,10
Karnataka,Chamarajanagara,Blindness,6,15,83,49,132
Karnataka,Chamarajanagara,Blindness,15,35,331,286,617
Karnataka,Chamarajanagara,Blindness,35,60,771,480,1251
Karnataka,Chamarajanagara,Blindness,60,80,218,107,325
Karnataka,Chamarajanagara,Blindness,80,100,11,3,14
Delhi,Central,Blindness,0,6,1,3,4
Delhi,Central,Blindness,6,15,13,7,20
Delhi,Central,Blindness,15,35,54,27,81
Delhi,Central,Blindness,35,60,47,15,62
Delhi,Central,Blindness,60,80,12,6,18
Assam,Cachar,Blindness,0,6,7,9,16
Assam,Cachar,Blindness,6,15,55,51,106
Assam,Cachar,Blindness,15,35,176,160,336
Assam,Cachar,Blindness,35,60,174,108,282
Assam,Cachar,Blindness,60,80,38,20,58
Assam,Cachar,Blindness,80,100,4,3,7
Bihar,Buxar,Blindness,0,6,0,2,2
Bihar,Buxar,Blindness,6,15,23,19,42
Bihar,Buxar,Blindness,15,35,89,54,143
Bihar,Buxar,Blindness,35,60,89,40,129
Bihar,Buxar,Blindness,60,80,24,19,43
Bihar,Buxar,Blindness,80,100,1,1,2
Madhya Pradesh,Burhanpur,Blindness,0,6,1,2,3
Madhya Pradesh,Burhanpur,Blindness,6,15,24,18,42
Madhya Pradesh,Burhanpur,Blindness,15,35,161,119,280
Madhya Pradesh,Burhanpur,Blindness,35,60,149,63,212
Madhya Pradesh,Burhanpur,Blindness,60,80,46,16,62
Madhya Pradesh,Burhanpur,Blindness,80,100,5,2,7
Rajasthan,Bundi,Blindness,0,6,2,3,5
Rajasthan,Bundi,Blindness,6,15,40,23,63
Rajasthan,Bundi,Blindness,15,35,169,101,270
Rajasthan,Bundi,Blindness,35,60,235,115,350
Rajasthan,Bundi,Blindness,60,80,107,65,172
Rajasthan,Bundi,Blindness,80,100,16,12,28
Maharashtra,Buldhana,Blindness,0,6,12,9,21
Maharashtra,Buldhana,Blindness,6,15,125,84,209
Maharashtra,Buldhana,Blindness,15,35,489,305,794
Maharashtra,Buldhana,Blindness,35,60,803,398,1201
Maharashtra,Buldhana,Blindness,60,80,435,189,624
Maharashtra,Buldhana,Blindness,80,100,28,7,35
Uttar Pradesh,Bulandshahr,Blindness,0,6,4,2,6
Uttar Pradesh,Bulandshahr,Blindness,6,15,28,15,43
Uttar Pradesh,Bulandshahr,Blindness,15,35,156,61,217
Uttar Pradesh,Bulandshahr,Blindness,35,60,230,109,339
Uttar Pradesh,Bulandshahr,Blindness,60,80,160,53,213
Uttar Pradesh,Bulandshahr,Blindness,80,100,11,2,13
Jammu And Kashmir,Budgam,Blindness,0,6,6,0,6
Jammu And Kashmir,Budgam,Blindness,6,15,31,20,51
Jammu And Kashmir,Budgam,Blindness,15,35,109,97,206
Jammu And Kashmir,Budgam,Blindness,35,60,172,107,279
Jammu And Kashmir,Budgam,Blindness,60,80,41,23,64
Jammu And Kashmir,Budgam,Blindness,80,100,5,2,7
Uttar Pradesh,Budaun,Blindness,0,6,5,4,9
Uttar Pradesh,Budaun,Blindness,6,15,54,24,78
Uttar Pradesh,Budaun,Blindness,15,35,273,126,399
Uttar Pradesh,Budaun,Blindness,35,60,481,170,651
Uttar Pradesh,Budaun,Blindness,60,80,257,74,331
Uttar Pradesh,Budaun,Blindness,80,100,14,3,17
Odisha,Boudh,Blindness,0,6,4,6,10
Odisha,Boudh,Blindness,6,15,45,37,82
Odisha,Boudh,Blindness,15,35,91,49,140
Odisha,Boudh,Blindness,35,60,107,37,144
Odisha,Boudh,Blindness,60,80,27,9,36
Odisha,Boudh,Blindness,80,100,1,2,3
Gujarat,Botad,Blindness,0,6,3,0,3
Gujarat,Botad,Blindness,6,15,15,11,26
Gujarat,Botad,Blindness,15,35,67,34,101
Gujarat,Botad,Blindness,35,60,67,26,93
Gujarat,Botad,Blindness,60,80,37,15,52
Gujarat,Botad,Blindness,80,100,4,1,5
Assam,Bongaigaon,Blindness,0,6,7,9,16
Assam,Bongaigaon,Blindness,6,15,30,18,48
Assam,Bongaigaon,Blindness,15,35,124,87,211
Assam,Bongaigaon,Blindness,35,60,95,52,147
Assam,Bongaigaon,Blindness,60,80,31,10,41
Assam,Bongaigaon,Blindness,80,100,3,3,6
Jharkhand,Bokaro,Blindness,0,6,3,0,3
Jharkhand,Bokaro,Blindness,6,15,28,19,47
Jharkhand,Bokaro,Blindness,15,35,240,164,404
Jharkhand,Bokaro,Blindness,35,60,231,100,331
Jharkhand,Bokaro,Blindness,60,80,58,28,86
Jharkhand,Bokaro,Blindness,80,100,3,1,4
Assam,Biswanath,Blindness,6,15,8,4,12
Assam,Biswanath,Blindness,15,35,19,6,25
Assam,Biswanath,Blindness,35,60,15,6,21
Assam,Biswanath,Blindness,60,80,4,1,5
Manipur,Bishnupur,Blindness,6,15,9,6,15
Manipur,Bishnupur,Blindness,15,35,22,8,30
Manipur,Bishnupur,Blindness,35,60,21,15,36
Manipur,Bishnupur,Blindness,60,80,7,8,15
Manipur,Bishnupur,Blindness,80,100,0,1,1
West Bengal,Birbhum,Blindness,15,35,2,0,2
Chhattisgarh,Bilaspur,Blindness,0,6,3,2,5
Chhattisgarh,Bilaspur,Blindness,6,15,31,24,55
Chhattisgarh,Bilaspur,Blindness,15,35,160,130,290
Chhattisgarh,Bilaspur,Blindness,35,60,139,73,212
Chhattisgarh,Bilaspur,Blindness,60,80,43,24,67
Chhattisgarh,Bilaspur,Blindness,80,100,2,2,4
Himachal Pradesh,Bilaspur,Blindness,0,6,0,3,3
Himachal Pradesh,Bilaspur,Blindness,6,15,12,8,20
Himachal Pradesh,Bilaspur,Blindness,15,35,39,26,65
Himachal Pradesh,Bilaspur,Blindness,35,60,95,48,143
Himachal Pradesh,Bilaspur,Blindness,60,80,43,23,66
Himachal Pradesh,Bilaspur,Blindness,80,100,6,4,10
Rajasthan,Bikaner,Blindness,0,6,3,5,8
Rajasthan,Bikaner,Blindness,6,15,75,52,127
Rajasthan,Bikaner,Blindness,15,35,341,157,498
Rajasthan,Bikaner,Blindness,35,60,268,110,378
Rajasthan,Bikaner,Blindness,60,80,104,28,132
Rajasthan,Bikaner,Blindness,80,100,11,4,15
Uttar Pradesh,Bijnor,Blindness,0,6,4,5,9
Uttar Pradesh,Bijnor,Blindness,6,15,36,21,57
Uttar Pradesh,Bijnor,Blindness,15,35,217,101,318
Uttar Pradesh,Bijnor,Blindness,35,60,358,98,456
Uttar Pradesh,Bijnor,Blindness,60,80,236,55,291
Uttar Pradesh,Bijnor,Blindness,80,100,12,4,16
Chhattisgarh,Bijapur,Blindness,6,15,11,4,15
Chhattisgarh,Bijapur,Blindness,15,35,30,20,50
Chhattisgarh,Bijapur,Blindness,35,60,15,9,24
Chhattisgarh,Bijapur,Blindness,60,80,9,4,13
Chhattisgarh,Bijapur,Blindness,80,100,0,1,1
Karnataka,Bidar,Blindness,0,6,5,9,14
Karnataka,Bidar,Blindness,6,15,53,52,105
Karnataka,Bidar,Blindness,15,35,331,198,529
Karnataka,Bidar,Blindness,35,60,416,189,605
Karnataka,Bidar,Blindness,60,80,139,69,208
Karnataka,Bidar,Blindness,80,100,7,6,13
Madhya Pradesh,Bhopal,Blindness,0,6,3,5,8
Madhya Pradesh,Bhopal,Blindness,6,15,54,34,88
Madhya Pradesh,Bhopal,Blindness,15,35,317,170,487
Madhya Pradesh,Bhopal,Blindness,35,60,308,150,458
Madhya Pradesh,Bhopal,Blindness,60,80,99,35,134
Madhya Pradesh,Bhopal,Blindness,80,100,9,6,15
Bihar,Bhojpur,Blindness,0,6,6,3,9
Bihar,Bhojpur,Blindness,6,15,108,71,179
Bihar,Bhojpur,Blindness,15,35,346,180,526
Bihar,Bhojpur,Blindness,35,60,252,109,361
Bihar,Bhojpur,Blindness,60,80,66,32,98
Bihar,Bhojpur,Blindness,80,100,6,0,6
Haryana,Bhiwani,Blindness,0,6,3,1,4
Haryana,Bhiwani,Blindness,6,15,19,15,34
Haryana,Bhiwani,Blindness,15,35,105,62,167
Haryana,Bhiwani,Blindness,35,60,181,78,259
Haryana,Bhiwani,Blindness,60,80,71,30,101
Haryana,Bhiwani,Blindness,80,100,5,7,12
Madhya Pradesh,Bhind,Blindness,0,6,4,6,10
Madhya Pradesh,Bhind,Blindness,6,15,30,18,48
Madhya Pradesh,Bhind,Blindness,15,35,195,111,306
Madhya Pradesh,Bhind,Blindness,35,60,365,176,541
Madhya Pradesh,Bhind,Blindness,60,80,216,116,332
Madhya Pradesh,Bhind,Blindness,80,100,22,8,30
Rajasthan,Bhilwara,Blindness,0,6,8,2,10
Rajasthan,Bhilwara,Blindness,6,15,33,22,55
Rajasthan,Bhilwara,Blindness,15,35,193,86,279
Rajasthan,Bhilwara,Blindness,35,60,296,186,482
Rajasthan,Bhilwara,Blindness,60,80,260,184,444
Rajasthan,Bhilwara,Blindness,80,100,31,47,78
Gujarat,Bhavnagar,Blindness,0,6,2,3,5
Gujarat,Bhavnagar,Blindness,6,15,28,12,40
Gujarat,Bhavnagar,Blindness,15,35,116,66,182
Gujarat,Bhavnagar,Blindness,35,60,149,66,215
Gujarat,Bhavnagar,Blindness,60,80,90,19,109
Gujarat,Bhavnagar,Blindness,80,100,9,1,10
Gujarat,Bharuch,Blindness,0,6,8,3,11
Gujarat,Bharuch,Blindness,6,15,62,41,103
Gujarat,Bharuch,Blindness,15,35,219,95,314
Gujarat,Bharuch,Blindness,35,60,294,94,388
Gujarat,Bharuch,Blindness,60,80,112,31,143
Gujarat,Bharuch,Blindness,80,100,9,2,11
Rajasthan,Bharatpur,Blindness,0,6,3,0,3
Rajasthan,Bharatpur,Blindness,6,15,45,22,67
Rajasthan,Bharatpur,Blindness,15,35,260,149,409
Rajasthan,Bharatpur,Blindness,35,60,265,108,373
Rajasthan,Bharatpur,Blindness,60,80,127,78,205
Rajasthan,Bharatpur,Blindness,80,100,14,13,27
Maharashtra,Bhandara,Blindness,0,6,3,3,6
Maharashtra,Bhandara,Blindness,6,15,39,25,64
Maharashtra,Bhandara,Blindness,15,35,134,79,213
Maharashtra,Bhandara,Blindness,35,60,214,99,313
Maharashtra,Bhandara,Blindness,60,80,85,34,119
Maharashtra,Bhandara,Blindness,80,100,3,0,3
Bihar,Bhagalpur,Blindness,0,6,8,6,14
Bihar,Bhagalpur,Blindness,6,15,53,46,99
Bihar,Bhagalpur,Blindness,15,35,140,85,225
Bihar,Bhagalpur,Blindness,35,60,130,53,183
Bihar,Bhagalpur,Blindness,60,80,32,15,47
Odisha,Bhadrak,Blindness,0,6,7,6,13
Odisha,Bhadrak,Blindness,6,15,68,40,108
Odisha,Bhadrak,Blindness,15,35,251,169,420
Odisha,Bhadrak,Blindness,35,60,330,216,546
Odisha,Bhadrak,Blindness,60,80,141,62,203
Odisha,Bhadrak,Blindness,80,100,10,7,17
Uttar Pradesh,Bhadohi,Blindness,0,6,2,0,2
Uttar Pradesh,Bhadohi,Blindness,6,15,23,16,39
Uttar Pradesh,Bhadohi,Blindness,15,35,108,66,174
Uttar Pradesh,Bhadohi,Blindness,35,60,102,40,142
Uttar Pradesh,Bhadohi,Blindness,60,80,21,11,32
Uttar Pradesh,Bhadohi,Blindness,80,100,4,2,6
Madhya Pradesh,Betul,Blindness,0,6,6,5,11
Madhya Pradesh,Betul,Blindness,6,15,52,35,87
Madhya Pradesh,Betul,Blindness,15,35,307,210,517
Madhya Pradesh,Betul,Blindness,35,60,393,194,587
Madhya Pradesh,Betul,Blindness,60,80,132,53,185
Madhya Pradesh,Betul,Blindness,80,100,14,4,18
Karnataka,Bengaluru Urban,Blindness,0,6,6,7,13
Karnataka,Bengaluru Urban,Blindness,6,15,96,81,177
Karnataka,Bengaluru Urban,Blindness,15,35,463,309,772
Karnataka,Bengaluru Urban,Blindness,35,60,956,535,1491
Karnataka,Bengaluru Urban,Blindness,60,80,240,77,317
Karnataka,Bengaluru Urban,Blindness,80,100,19,3,22
Karnataka,Bengaluru Rural,Blindness,0,6,4,2,6
Karnataka,Bengaluru Rural,Blindness,6,15,26,27,53
Karnataka,Bengaluru Rural,Blindness,15,35,194,144,338
Karnataka,Bengaluru Rural,Blindness,35,60,403,241,644
Karnataka,Bengaluru Rural,Blindness,60,80,146,62,208
Karnataka,Bengaluru Rural,Blindness,80,100,13,3,16
Chhattisgarh,Bemetara,Blindness,0,6,3,0,3
Chhattisgarh,Bemetara,Blindness,6,15,6,16,22
Chhattisgarh,Bemetara,Blindness,15,35,49,27,76
Chhattisgarh,Bemetara,Blindness,35,60,47,17,64
Chhattisgarh,Bemetara,Blindness,60,80,24,9,33
Chhattisgarh,Bemetara,Blindness,80,100,4,2,6
Karnataka,Belagavi,Blindness,0,6,26,40,66
Karnataka,Belagavi,Blindness,6,15,391,233,624
Karnataka,Belagavi,Blindness,15,35,1408,928,2336
Karnataka,Belagavi,Blindness,35,60,2673,1902,4575
Karnataka,Belagavi,Blindness,60,80,614,219,833
Karnataka,Belagavi,Blindness,80,100,16,5,21
Bihar,Begusarai,Blindness,0,6,23,29,52
Bihar,Begusarai,Blindness,6,15,148,113,261
Bihar,Begusarai,Blindness,15,35,221,125,346
Bihar,Begusarai,Blindness,35,60,198,116,314
Bihar,Begusarai,Blindness,60,80,60,22,82
Bihar,Begusarai,Blindness,80,100,1,0,1
Maharashtra,Beed,Blindness,0,6,17,8,25
Maharashtra,Beed,Blindness,6,15,103,71,174
Maharashtra,Beed,Blindness,15,35,540,212,752
Maharashtra,Beed,Blindness,35,60,665,260,925
Maharashtra,Beed,Blindness,60,80,403,143,546
Maharashtra,Beed,Blindness,80,100,50,9,59
Punjab,Bathinda,Blindness,0,6,5,3,8
Punjab,Bathinda,Blindness,6,15,64,40,104
Punjab,Bathinda,Blindness,15,35,237,148,385
Punjab,Bathinda,Blindness,35,60,422,198,620
Punjab,Bathinda,Blindness,60,80,174,61,235
Punjab,Bathinda,Blindness,80,100,8,9,17
Uttar Pradesh,Basti,Blindness,0,6,3,6,9
Uttar Pradesh,Basti,Blindness,6,15,48,27,75
Uttar Pradesh,Basti,Blindness,15,35,211,94,305
Uttar Pradesh,Basti,Blindness,35,60,196,94,290
Uttar Pradesh,Basti,Blindness,60,80,66,33,99
Uttar Pradesh,Basti,Blindness,80,100,2,0,2
Chhattisgarh,Bastar,Blindness,0,6,9,5,14
Chhattisgarh,Bastar,Blindness,6,15,56,41,97
Chhattisgarh,Bastar,Blindness,15,35,148,111,259
Chhattisgarh,Bastar,Blindness,35,60,105,50,155
Chhattisgarh,Bastar,Blindness,60,80,34,15,49
Chhattisgarh,Bastar,Blindness,80,100,5,1,6
Madhya Pradesh,Barwani,Blindness,0,6,3,5,8
Madhya Pradesh,Barwani,Blindness,6,15,39,31,70
Madhya Pradesh,Barwani,Blindness,15,35,187,126,313
Madhya Pradesh,Barwani,Blindness,35,60,193,86,279
Madhya Pradesh,Barwani,Blindness,60,80,53,27,80
Madhya Pradesh,Barwani,Blindness,80,100,5,2,7
Assam,Barpeta,Blindness,0,6,11,4,15
Assam,Barpeta,Blindness,6,15,50,40,90
Assam,Barpeta,Blindness,15,35,217,143,360
Assam,Barpeta,Blindness,35,60,275,160,435
Assam,Barpeta,Blindness,60,80,55,40,95
Assam,Barpeta,Blindness,80,100,1,8,9
Punjab,Barnala,Blindness,0,6,6,3,9
Punjab,Barnala,Blindness,6,15,13,10,23
Punjab,Barnala,Blindness,15,35,69,33,102
Punjab,Barnala,Blindness,35,60,133,68,201
Punjab,Barnala,Blindness,60,80,65,18,83
Punjab,Barnala,Blindness,80,100,6,2,8
Rajasthan,Barmer,Blindness,0,6,2,0,2
Rajasthan,Barmer,Blindness,6,15,31,12,43
Rajasthan,Barmer,Blindness,15,35,175,61,236
Rajasthan,Barmer,Blindness,35,60,234,86,320
Rajasthan,Barmer,Blindness,60,80,83,43,126
Rajasthan,Barmer,Blindness,80,100,10,7,17
Odisha,Bargarh,Blindness,0,6,22,21,43
Odisha,Bargarh,Blindness,6,15,140,125,265
Odisha,Bargarh,Blindness,15,35,369,242,611
Odisha,Bargarh,Blindness,35,60,393,225,618
Odisha,Bargarh,Blindness,60,80,150,63,213
Odisha,Bargarh,Blindness,80,100,7,8,15
Uttar Pradesh,Bareilly,Blindness,0,6,10,6,16
Uttar Pradesh,Bareilly,Blindness,6,15,70,38,108
Uttar Pradesh,Bareilly,Blindness,15,35,303,162,465
Uttar Pradesh,Bareilly,Blindness,35,60,483,152,635
Uttar Pradesh,Bareilly,Blindness,60,80,194,64,258
Uttar Pradesh,Bareilly,Blindness,80,100,9,0,9
Rajasthan,Baran,Blindness,0,6,0,2,2
Rajasthan,Baran,Blindness,6,15,16,10,26
Rajasthan,Baran,Blindness,15,35,164,97,261
Rajasthan,Baran,Blindness,35,60,190,98,288
Rajasthan,Baran,Blindness,60,80,70,43,113
Rajasthan,Baran,Blindness,80,100,8,5,13
Jammu And Kashmir,Baramulla,Blindness,0,6,4,3,7
Jammu And Kashmir,Baramulla,Blindness,6,15,42,25,67
Jammu And Kashmir,Baramulla,Blindness,15,35,217,114,331
Jammu And Kashmir,Baramulla,Blindness,35,60,222,132,354
Jammu And Kashmir,Baramulla,Blindness,60,80,71,28,99
Jammu And Kashmir,Baramulla,Blindness,80,100,14,5,19
Uttar Pradesh,Barabanki,Blindness,0,6,8,8,16
Uttar Pradesh,Barabanki,Blindness,6,15,96,68,164
Uttar Pradesh,Barabanki,Blindness,15,35,437,258,695
Uttar Pradesh,Barabanki,Blindness,35,60,533,228,761
Uttar Pradesh,Barabanki,Blindness,60,80,249,91,340
Uttar Pradesh,Barabanki,Blindness,80,100,13,4,17
Rajasthan,Banswara,Blindness,0,6,3,2,5
Rajasthan,Banswara,Blindness,6,15,31,30,61
Rajasthan,Banswara,Blindness,15,35,220,119,339
Rajasthan,Banswara,Blindness,35,60,152,89,241
Rajasthan,Banswara,Blindness,60,80,49,26,75
Rajasthan,Banswara,Blindness,80,100,5,1,6
West Bengal,Bankura,Blindness,35,60,1,0,1
Bihar,Banka,Blindness,0,6,3,4,7
Bihar,Banka,Blindness,6,15,57,44,101
Bihar,Banka,Blindness,15,35,131,72,203
Bihar,Banka,Blindness,35,60,83,37,120
Bihar,Banka,Blindness,60,80,35,8,43
Bihar,Banka,Blindness,80,100,2,1,3
Jammu And Kashmir,Bandipora,Blindness,0,6,8,3,11
Jammu And Kashmir,Bandipora,Blindness,6,15,34,23,57
Jammu And Kashmir,Bandipora,Blindness,15,35,92,79,171
Jammu And Kashmir,Bandipora,Blindness,35,60,101,69,170
Jammu And Kashmir,Bandipora,Blindness,60,80,43,18,61
Jammu And Kashmir,Bandipora,Blindness,80,100,6,4,10
Uttar Pradesh,Banda,Blindness,0,6,2,0,2
Uttar Pradesh,Banda,Blindness,6,15,31,17,48
Uttar Pradesh,Banda,Blindness,15,35,289,101,390
Uttar Pradesh,Banda,Blindness,35,60,319,138,457
Uttar Pradesh,Banda,Blindness,60,80,148,40,188
Uttar Pradesh,Banda,Blindness,80,100,13,5,18
Gujarat,Banas Kantha,Blindness,0,6,12,9,21
Gujarat,Banas Kantha,Blindness,6,15,171,124,295
Gujarat,Banas Kantha,Blindness,15,35,604,235,839
Gujarat,Banas Kantha,Blindness,35,60,359,144,503
Gujarat,Banas Kantha,Blindness,60,80,198,43,241
Gujarat,Banas Kantha,Blindness,80,100,21,2,23
Chhattisgarh,Balrampur,Blindness,0,6,2,0,2
Chhattisgarh,Balrampur,Blindness,6,15,88,55,143
Chhattisgarh,Balrampur,Blindness,15,35,322,244,566
Chhattisgarh,Balrampur,Blindness,35,60,224,101,325
Chhattisgarh,Balrampur,Blindness,60,80,50,27,77
Chhattisgarh,Balrampur,Blindness,80,100,2,1,3
Uttar Pradesh,Balrampur,Blindness,0,6,1,2,3
Uttar Pradesh,Balrampur,Blindness,6,15,43,38,81
Uttar Pradesh,Balrampur,Blindness,15,35,189,94,283
Uttar Pradesh,Balrampur,Blindness,35,60,193,61,254
Uttar Pradesh,Balrampur,Blindness,60,80,78,24,102
Uttar Pradesh,Balrampur,Blindness,80,100,5,2,7
Chhattisgarh,Baloda Bazar,Blindness,0,6,0,2,2
Chhattisgarh,Baloda Bazar,Blindness,6,15,25,30,55
Chhattisgarh,Baloda Bazar,Blindness,15,35,98,73,171
Chhattisgarh,Baloda Bazar,Blindness,35,60,94,34,128
Chhattisgarh,Baloda Bazar,Blindness,60,80,35,9,44
Chhattisgarh,Baloda Bazar,Blindness,80,100,1,2,3
Chhattisgarh,Balod,Blindness,0,6,2,0,2
Chhattisgarh,Balod,Blindness,6,15,24,19,43
Chhattisgarh,Balod,Blindness,15,35,144,79,223
Chhattisgarh,Balod,Blindness,35,60,137,72,209
Chhattisgarh,Balod,Blindness,60,80,44,17,61
Chhattisgarh,Balod,Blindness,80,100,2,1,3
Uttar Pradesh,Ballia,Blindness,0,6,21,6,27
Uttar Pradesh,Ballia,Blindness,6,15,83,67,150
Uttar Pradesh,Ballia,Blindness,15,35,467,265,732
Uttar Pradesh,Ballia,Blindness,35,60,476,273,749
Uttar Pradesh,Ballia,Blindness,60,80,181,103,284
Uttar Pradesh,Ballia,Blindness,80,100,6,5,11
Karnataka,Ballari,Blindness,0,6,9,10,19
Karnataka,Ballari,Blindness,6,15,89,74,163
Karnataka,Ballari,Blindness,15,35,493,303,796
Karnataka,Ballari,Blindness,35,60,596,289,885
Karnataka,Ballari,Blindness,60,80,154,64,218
Karnataka,Ballari,Blindness,80,100,11,1,12
Odisha,Baleshwar,Blindness,0,6,8,4,12
Odisha,Baleshwar,Blindness,6,15,120,76,196
Odisha,Baleshwar,Blindness,15,35,404,271,675
Odisha,Baleshwar,Blindness,35,60,589,403,992
Odisha,Baleshwar,Blindness,60,80,293,131,424
Odisha,Baleshwar,Blindness,80,100,26,7,33
Odisha,Balangir,Blindness,0,6,28,25,53
Odisha,Balangir,Blindness,6,15,232,170,402
Odisha,Balangir,Blindness,15,35,427,258,685
Odisha,Balangir,Blindness,35,60,399,201,600
Odisha,Balangir,Blindness,60,80,141,49,190
Odisha,Balangir,Blindness,80,100,6,6,12
Madhya Pradesh,Balaghat,Blindness,0,6,2,2,4
Madhya Pradesh,Balaghat,Blindness,6,15,32,33,65
Madhya Pradesh,Balaghat,Blindness,15,35,351,242,593
Madhya Pradesh,Balaghat,Blindness,35,60,405,226,631
Madhya Pradesh,Balaghat,Blindness,60,80,118,62,180
Madhya Pradesh,Balaghat,Blindness,80,100,4,3,7
Assam,Baksa,Blindness,0,6,2,1,3
Assam,Baksa,Blindness,6,15,16,8,24
Assam,Baksa,Blindness,15,35,74,48,122
Assam,Baksa,Blindness,35,60,103,61,164
Assam,Baksa,Blindness,60,80,42,14,56
Assam,Baksa,Blindness,80,100,1,3,4
Assam,Bajali,Blindness,6,15,0,1,1
Assam,Bajali,Blindness,15,35,4,7,11
Assam,Bajali,Blindness,35,60,9,4,13
Assam,Bajali,Blindness,60,80,7,1,8
Uttar Pradesh,Bahraich,Blindness,0,6,9,8,17
Uttar Pradesh,Bahraich,Blindness,6,15,135,119,254
Uttar Pradesh,Bahraich,Blindness,15,35,407,234,641
Uttar Pradesh,Bahraich,Blindness,35,60,596,260,856
Uttar Pradesh,Bahraich,Blindness,60,80,221,105,326
Uttar Pradesh,Bahraich,Blindness,80,100,14,7,21
Uttar Pradesh,Baghpat,Blindness,0,6,1,1,2
Uttar Pradesh,Baghpat,Blindness,6,15,6,3,9
Uttar Pradesh,Baghpat,Blindness,15,35,66,21,87
Uttar Pradesh,Baghpat,Blindness,35,60,104,35,139
Uttar Pradesh,Baghpat,Blindness,60,80,49,17,66
Uttar Pradesh,Baghpat,Blindness,80,100,7,3,10
Uttarakhand,Bageshwar,Blindness,0,6,1,1,2
Uttarakhand,Bageshwar,Blindness,6,15,5,5,10
Uttarakhand,Bageshwar,Blindness,15,35,45,24,69
Uttarakhand,Bageshwar,Blindness,35,60,85,55,140
Uttarakhand,Bageshwar,Blindness,60,80,29,15,44
Uttarakhand,Bageshwar,Blindness,80,100,2,2,4
Karnataka,Bagalkote,Blindness,0,6,19,11,30
Karnataka,Bagalkote,Blindness,6,15,202,152,354
Karnataka,Bagalkote,Blindness,15,35,810,481,1291
Karnataka,Bagalkote,Blindness,35,60,962,522,1484
Karnataka,Bagalkote,Blindness,60,80,234,135,369
Karnataka,Bagalkote,Blindness,80,100,17,2,19
Uttar Pradesh,Azamgarh,Blindness,0,6,1,0,1
Uttar Pradesh,Azamgarh,Blindness,6,15,43,23,66
Uttar Pradesh,Azamgarh,Blindness,15,35,186,98,284
Uttar Pradesh,Azamgarh,Blindness,35,60,235,80,315
Uttar Pradesh,Azamgarh,Blindness,60,80,73,25,98
Uttar Pradesh,Azamgarh,Blindness,80,100,5,4,9
Uttar Pradesh,Ayodhya,Blindness,0,6,1,2,3
Uttar Pradesh,Ayodhya,Blindness,6,15,22,21,43
Uttar Pradesh,Ayodhya,Blindness,15,35,147,85,232
Uttar Pradesh,Ayodhya,Blindness,35,60,187,68,255
Uttar Pradesh,Ayodhya,Blindness,60,80,42,14,56
Uttar Pradesh,Ayodhya,Blindness,80,100,3,3,6
Bihar,Aurangabad,Blindness,0,6,0,2,2
Bihar,Aurangabad,Blindness,6,15,46,26,72
Bihar,Aurangabad,Blindness,15,35,124,57,181
Bihar,Aurangabad,Blindness,35,60,113,50,163
Bihar,Aurangabad,Blindness,60,80,24,15,39
Maharashtra,Aurangabad,Blindness,0,6,9,6,15
Maharashtra,Aurangabad,Blindness,6,15,90,56,146
Maharashtra,Aurangabad,Blindness,15,35,330,186,516
Maharashtra,Aurangabad,Blindness,35,60,382,171,553
Maharashtra,Aurangabad,Blindness,60,80,170,59,229
Maharashtra,Aurangabad,Blindness,80,100,14,5,19
Uttar Pradesh,Auraiya,Blindness,0,6,2,1,3
Uttar Pradesh,Auraiya,Blindness,6,15,23,16,39
Uttar Pradesh,Auraiya,Blindness,15,35,83,42,125
Uttar Pradesh,Auraiya,Blindness,35,60,178,71,249
Uttar Pradesh,Auraiya,Blindness,60,80,128,44,172
Uttar Pradesh,Auraiya,Blindness,80,100,9,5,14
Madhya Pradesh,Ashoknagar,Blindness,0,6,2,2,4
Madhya Pradesh,Ashoknagar,Blindness,6,15,30,17,47
Madhya Pradesh,Ashoknagar,Blindness,15,35,200,116,316
Madhya Pradesh,Ashoknagar,Blindness,35,60,223,129,352
Madhya Pradesh,Ashoknagar,Blindness,60,80,138,61,199
Madhya Pradesh,Ashoknagar,Blindness,80,100,12,3,15
Bihar,Arwal,Blindness,0,6,2,6,8
Bihar,Arwal,Blindness,6,15,34,24,58
Bihar,Arwal,Blindness,15,35,160,119,279
Bihar,Arwal,Blindness,35,60,257,312,569
Bihar,Arwal,Blindness,60,80,101,89,190
Bihar,Arwal,Blindness,80,100,9,2,11
Gujarat,Arvalli,Blindness,0,6,6,4,10
Gujarat,Arvalli,Blindness,6,15,39,37,76
Gujarat,Arvalli,Blindness,15,35,172,97,269
Gujarat,Arvalli,Blindness,35,60,146,68,214
Gujarat,Arvalli,Blindness,60,80,60,21,81
Gujarat,Arvalli,Blindness,80,100,4,1,5
Tamil Nadu,Ariyalur,Blindness,0,6,1,0,1
Tamil Nadu,Ariyalur,Blindness,6,15,17,15,32
Tamil Nadu,Ariyalur,Blindness,15,35,96,59,155
Tamil Nadu,Ariyalur,Blindness,35,60,178,90,268
Tamil Nadu,Ariyalur,Blindness,60,80,68,40,108
Tamil Nadu,Ariyalur,Blindness,80,100,7,3,10
Bihar,Araria,Blindness,0,6,5,0,5
Bihar,Araria,Blindness,6,15,28,16,44
Bihar,Araria,Blindness,15,35,77,29,106
Bihar,Araria,Blindness,35,60,56,16,72
Bihar,Araria,Blindness,60,80,15,3,18
Madhya Pradesh,Anuppur,Blindness,0,6,2,6,8
Madhya Pradesh,Anuppur,Blindness,6,15,38,25,63
Madhya Pradesh,Anuppur,Blindness,15,35,176,153,329
Madhya Pradesh,Anuppur,Blindness,35,60,230,122,352
Madhya Pradesh,Anuppur,Blindness,60,80,89,43,132
Madhya Pradesh,Anuppur,Blindness,80,100,6,3,9
Odisha,Anugul,Blindness,0,6,3,4,7
Odisha,Anugul,Blindness,6,15,44,28,72
Odisha,Anugul,Blindness,15,35,161,126,287
Odisha,Anugul,Blindness,35,60,249,166,415
Odisha,Anugul,Blindness,60,80,108,53,161
Odisha,Anugul,Blindness,80,100,6,7,13
Arunachal Pradesh,Anjaw,Blindness,15,35,2,1,3
Arunachal Pradesh,Anjaw,Blindness,35,60,1,0,1
Arunachal Pradesh,Anjaw,Blindness,60,80,0,1,1
Jammu And Kashmir,Anantnag,Blindness,0,6,2,3,5
Jammu And Kashmir,Anantnag,Blindness,6,15,9,12,21
Jammu And Kashmir,Anantnag,Blindness,15,35,44,38,82
Jammu And Kashmir,Anantnag,Blindness,35,60,65,58,123
Jammu And Kashmir,Anantnag,Blindness,60,80,43,12,55
Jammu And Kashmir,Anantnag,Blindness,80,100,8,3,11
Andhra Pradesh,Anantapur,Blindness,0,6,12,13,25
Andhra Pradesh,Anantapur,Blindness,6,15,131,84,215
Andhra Pradesh,Anantapur,Blindness,15,35,566,185,751
Andhra Pradesh,Anantapur,Blindness,35,60,1579,40,1619
Andhra Pradesh,Anantapur,Blindness,60,80,328,3,331
Andhra Pradesh,Anantapur,Blindness,80,100,24,0,24
Gujarat,Anand,Blindness,0,6,12,12,24
Gujarat,Anand,Blindness,6,15,98,89,187
Gujarat,Anand,Blindness,15,35,443,269,712
Gujarat,Anand,Blindness,35,60,417,183,600
Gujarat,Anand,Blindness,60,80,177,64,241
Gujarat,Anand,Blindness,80,100,16,7,23
Uttar Pradesh,Amroha,Blindness,0,6,1,1,2
Uttar Pradesh,Amroha,Blindness,6,15,13,9,22
Uttar Pradesh,Amroha,Blindness,15,35,99,52,151
Uttar Pradesh,Amroha,Blindness,35,60,117,47,164
Uttar Pradesh,Amroha,Blindness,60,80,74,24,98
Uttar Pradesh,Amroha,Blindness,80,100,6,4,10
Punjab,Amritsar,Blindness,0,6,6,6,12
Punjab,Amritsar,Blindness,6,15,42,29,71
Punjab,Amritsar,Blindness,15,35,225,115,340
Punjab,Amritsar,Blindness,35,60,296,120,416
Punjab,Amritsar,Blindness,60,80,158,34,192
Punjab,Amritsar,Blindness,80,100,26,7,33
Gujarat,Amreli,Blindness,0,6,0,1,1
Gujarat,Amreli,Blindness,6,15,62,63,125
Gujarat,Amreli,Blindness,15,35,327,160,487
Gujarat,Amreli,Blindness,35,60,309,117,426
Gujarat,Amreli,Blindness,60,80,237,56,293
Gujarat,Amreli,Blindness,80,100,23,5,28
Maharashtra,Amravati,Blindness,0,6,43,28,71
Maharashtra,Amravati,Blindness,6,15,296,213,509
Maharashtra,Amravati,Blindness,15,35,938,614,1552
Maharashtra,Amravati,Blindness,35,60,1375,670,2045
Maharashtra,Amravati,Blindness,60,80,568,224,792
Maharashtra,Amravati,Blindness,80,100,32,5,37
Uttar Pradesh,Amethi,Blindness,0,6,2,0,2
Uttar Pradesh,Amethi,Blindness,6,15,30,18,48
Uttar Pradesh,Amethi,Blindness,15,35,190,108,298
Uttar Pradesh,Amethi,Blindness,35,60,286,119,405
Uttar Pradesh,Amethi,Blindness,60,80,84,29,113
Uttar Pradesh,Amethi,Blindness,80,100,2,3,5
Uttar Pradesh,Ambedkar Nagar,Blindness,0,6,4,3,7
Uttar Pradesh,Ambedkar Nagar,Blindness,6,15,40,30,70
Uttar Pradesh,Ambedkar Nagar,Blindness,15,35,299,162,461
Uttar Pradesh,Ambedkar Nagar,Blindness,35,60,353,146,499
Uttar Pradesh,Ambedkar Nagar,Blindness,60,80,111,26,137
Uttar Pradesh,Ambedkar Nagar,Blindness,80,100,1,1,2
Haryana,Ambala,Blindness,0,6,1,2,3
Haryana,Ambala,Blindness,6,15,15,20,35
Haryana,Ambala,Blindness,15,35,94,53,147
Haryana,Ambala,Blindness,35,60,162,59,221
Haryana,Ambala,Blindness,60,80,49,21,70
Haryana,Ambala,Blindness,80,100,5,2,7
Rajasthan,Alwar,Blindness,0,6,8,3,11
Rajasthan,Alwar,Blindness,6,15,72,46,118
Rajasthan,Alwar,Blindness,15,35,302,146,448
Rajasthan,Alwar,Blindness,35,60,345,195,540
Rajasthan,Alwar,Blindness,60,80,208,153,361
Rajasthan,Alwar,Blindness,80,100,31,25,56
Uttarakhand,Almora,Blindness,6,15,15,22,37
Uttarakhand,Almora,Blindness,15,35,106,85,191
Uttarakhand,Almora,Blindness,35,60,309,149,458
Uttarakhand,Almora,Blindness,60,80,93,40,133
Uttarakhand,Almora,Blindness,80,100,5,2,7
Madhya Pradesh,Alirajpur,Blindness,0,6,1,2,3
Madhya Pradesh,Alirajpur,Blindness,6,15,19,19,38
Madhya Pradesh,Alirajpur,Blindness,15,35,143,80,223
Madhya Pradesh,Alirajpur,Blindness,35,60,95,52,147
Madhya Pradesh,Alirajpur,Blindness,60,80,33,10,43
Madhya Pradesh,Alirajpur,Blindness,80,100,1,1,2
Uttar Pradesh,Aligarh,Blindness,0,6,12,4,16
Uttar Pradesh,Aligarh,Blindness,6,15,69,31,100
Uttar Pradesh,Aligarh,Blindness,15,35,229,109,338
Uttar Pradesh,Aligarh,Blindness,35,60,288,120,408
Uttar Pradesh,Aligarh,Blindness,60,80,167,55,222
Uttar Pradesh,Aligarh,Blindness,80,100,16,4,20
Kerala,Alappuzha,Blindness,0,6,0,1,1
Kerala,Alappuzha,Blindness,6,15,7,12,19
Kerala,Alappuzha,Blindness,15,35,57,41,98
Kerala,Alappuzha,Blindness,35,60,175,100,275
Kerala,Alappuzha,Blindness,60,80,125,54,179
Kerala,Alappuzha,Blindness,80,100,11,6,17
Maharashtra,Akola,Blindness,0,6,9,3,12
Maharashtra,Akola,Blindness,6,15,28,29,57
Maharashtra,Akola,Blindness,15,35,225,112,337
Maharashtra,Akola,Blindness,35,60,328,181,509
Maharashtra,Akola,Blindness,60,80,209,61,270
Maharashtra,Akola,Blindness,80,100,16,4,20
Rajasthan,Ajmer,Blindness,0,6,8,5,13
Rajasthan,Ajmer,Blindness,6,15,66,35,101
Rajasthan,Ajmer,Blindness,15,35,210,120,330
Rajasthan,Ajmer,Blindness,35,60,298,128,426
Rajasthan,Ajmer,Blindness,60,80,96,51,147
Rajasthan,Ajmer,Blindness,80,100,9,10,19
Mizoram,Aizawl,Blindness,0,6,2,0,2
Mizoram,Aizawl,Blindness,6,15,3,4,7
Mizoram,Aizawl,Blindness,15,35,39,28,67
Mizoram,Aizawl,Blindness,35,60,40,14,54
Mizoram,Aizawl,Blindness,60,80,7,4,11
Mizoram,Aizawl,Blindness,80,100,1,0,1
Maharashtra,Ahmednagar,Blindness,0,6,28,8,36
Maharashtra,Ahmednagar,Blindness,6,15,139,89,228
Maharashtra,Ahmednagar,Blindness,15,35,496,231,727
Maharashtra,Ahmednagar,Blindness,35,60,699,304,1003
Maharashtra,Ahmednagar,Blindness,60,80,400,144,544
Maharashtra,Ahmednagar,Blindness,80,100,35,11,46
Gujarat,Ahmadabad,Blindness,0,6,14,15,29
Gujarat,Ahmadabad,Blindness,6,15,127,75,202
Gujarat,Ahmadabad,Blindness,15,35,565,366,931
Gujarat,Ahmadabad,Blindness,35,60,689,343,1032
Gujarat,Ahmadabad,Blindness,60,80,367,108,475
Gujarat,Ahmadabad,Blindness,80,100,37,11,48
Uttar Pradesh,Agra,Blindness,0,6,11,6,17
Uttar Pradesh,Agra,Blindness,6,15,92,46,138
Uttar Pradesh,Agra,Blindness,15,35,270,131,401
Uttar Pradesh,Agra,Blindness,35,60,336,118,454
Uttar Pradesh,Agra,Blindness,60,80,146,41,187
Uttar Pradesh,Agra,Blindness,80,100,14,1,15
Madhya Pradesh,Agar Malwa,Blindness,0,6,1,1,2
Madhya Pradesh,Agar Malwa,Blindness,6,15,4,6,10
Madhya Pradesh,Agar Malwa,Blindness,15,35,49,18,67
Madhya Pradesh,Agar Malwa,Blindness,35,60,82,44,126
Madhya Pradesh,Agar Malwa,Blindness,60,80,35,18,53
Madhya Pradesh,Agar Malwa,Blindness,80,100,4,4,8
West Bengal,24 Paraganas South,Blindness,15,35,1,0,1
West Bengal,24 Paraganas South,Blindness,35,60,1,0,1
West Bengal,24 Paraganas South,Blindness,60,80,1,0,1
Nagaland,Zunheboto,Cerebral Palsy,6,15,1,0,1
Nagaland,Zunheboto,Cerebral Palsy,15,35,1,1,2
Maharashtra,Yavatmal,Cerebral Palsy,0,6,2,2,4
Maharashtra,Yavatmal,Cerebral Palsy,6,15,22,7,29
Maharashtra,Yavatmal,Cerebral Palsy,15,35,17,7,24
Maharashtra,Yavatmal,Cerebral Palsy,35,60,7,2,9
Maharashtra,Yavatmal,Cerebral Palsy,60,80,2,0,2
Puducherry,Yanam,Cerebral Palsy,6,15,0,4,4
Puducherry,Yanam,Cerebral Palsy,15,35,20,6,26
Puducherry,Yanam,Cerebral Palsy,35,60,41,10,51
Puducherry,Yanam,Cerebral Palsy,60,80,8,8,16
Puducherry,Yanam,Cerebral Palsy,80,100,0,1,1
Haryana,Yamunanagar,Cerebral Palsy,0,6,3,2,5
Haryana,Yamunanagar,Cerebral Palsy,6,15,25,14,39
Haryana,Yamunanagar,Cerebral Palsy,15,35,31,17,48
Haryana,Yamunanagar,Cerebral Palsy,35,60,10,1,11
Haryana,Yamunanagar,Cerebral Palsy,60,80,0,1,1
Karnataka,Yadgir,Cerebral Palsy,0,6,6,4,10
Karnataka,Yadgir,Cerebral Palsy,6,15,13,6,19
Karnataka,Yadgir,Cerebral Palsy,15,35,2,7,9
Karnataka,Yadgir,Cerebral Palsy,35,60,3,0,3
Karnataka,Yadgir,Cerebral Palsy,60,80,1,0,1
Andhra Pradesh,Y.S.R.,Cerebral Palsy,15,35,1,0,1
Nagaland,Wokha,Cerebral Palsy,6,15,2,0,2
Nagaland,Wokha,Cerebral Palsy,15,35,4,3,7
Nagaland,Wokha,Cerebral Palsy,35,60,1,0,1
Nagaland,Wokha,Cerebral Palsy,60,80,1,0,1
Tripura,West Tripura,Cerebral Palsy,6,15,0,1,1
Tripura,West Tripura,Cerebral Palsy,15,35,0,1,1
Jharkhand,West Singhbhum,Cerebral Palsy,0,6,8,2,10
Jharkhand,West Singhbhum,Cerebral Palsy,6,15,37,32,69
Jharkhand,West Singhbhum,Cerebral Palsy,15,35,18,7,25
Jharkhand,West Singhbhum,Cerebral Palsy,35,60,10,6,16
Jharkhand,West Singhbhum,Cerebral Palsy,60,80,2,1,3
Arunachal Pradesh,West Siang,Cerebral Palsy,6,15,1,2,3
Arunachal Pradesh,West Siang,Cerebral Palsy,15,35,4,0,4
Meghalaya,West Khasi Hills,Cerebral Palsy,0,6,1,0,1
Meghalaya,West Khasi Hills,Cerebral Palsy,6,15,1,4,5
Meghalaya,West Khasi Hills,Cerebral Palsy,15,35,1,0,1
Assam,West Karbi Anglong,Cerebral Palsy,0,6,1,0,1
Assam,West Karbi Anglong,Cerebral Palsy,6,15,1,2,3
Assam,West Karbi Anglong,Cerebral Palsy,15,35,1,1,2
Assam,West Karbi Anglong,Cerebral Palsy,35,60,2,0,2
Arunachal Pradesh,West Kameng,Cerebral Palsy,15,35,0,1,1
Meghalaya,West Jaintia Hills,Cerebral Palsy,0,6,20,26,46
Meghalaya,West Jaintia Hills,Cerebral Palsy,6,15,46,54,100
Meghalaya,West Jaintia Hills,Cerebral Palsy,15,35,36,44,80
Meghalaya,West Jaintia Hills,Cerebral Palsy,35,60,0,4,4
Andhra Pradesh,West Godavari,Cerebral Palsy,15,35,2,0,2
Meghalaya,West Garo Hills,Cerebral Palsy,0,6,11,9,20
Meghalaya,West Garo Hills,Cerebral Palsy,6,15,49,38,87
Meghalaya,West Garo Hills,Cerebral Palsy,15,35,99,59,158
Meghalaya,West Garo Hills,Cerebral Palsy,35,60,10,9,19
Delhi,West,Cerebral Palsy,0,6,6,3,9
Delhi,West,Cerebral Palsy,6,15,36,32,68
Delhi,West,Cerebral Palsy,15,35,77,31,108
Delhi,West,Cerebral Palsy,35,60,17,8,25
Delhi,West,Cerebral Palsy,60,80,2,0,2
Kerala,Wayanad,Cerebral Palsy,0,6,5,7,12
Kerala,Wayanad,Cerebral Palsy,6,15,49,29,78
Kerala,Wayanad,Cerebral Palsy,15,35,105,82,187
Kerala,Wayanad,Cerebral Palsy,35,60,40,25,65
Kerala,Wayanad,Cerebral Palsy,60,80,3,1,4
Maharashtra,Washim,Cerebral Palsy,6,15,1,0,1
Maharashtra,Washim,Cerebral Palsy,35,60,3,0,3
Maharashtra,Washim,Cerebral Palsy,60,80,2,0,2
Maharashtra,Wardha,Cerebral Palsy,0,6,27,19,46
Maharashtra,Wardha,Cerebral Palsy,6,15,51,41,92
Maharashtra,Wardha,Cerebral Palsy,15,35,45,34,79
Maharashtra,Wardha,Cerebral Palsy,35,60,15,11,26
Maharashtra,Wardha,Cerebral Palsy,60,80,1,0,1
Andhra Pradesh,Vizianagaram,Cerebral Palsy,6,15,2,1,3
Andhra Pradesh,Vizianagaram,Cerebral Palsy,15,35,5,2,7
Andhra Pradesh,Visakhapatanam,Cerebral Palsy,6,15,3,2,5
Andhra Pradesh,Visakhapatanam,Cerebral Palsy,15,35,3,5,8
Andhra Pradesh,Visakhapatanam,Cerebral Palsy,35,60,5,0,5
Andhra Pradesh,Visakhapatanam,Cerebral Palsy,60,80,1,0,1
Tamil Nadu,Virudhunagar,Cerebral Palsy,0,6,11,10,21
Tamil Nadu,Virudhunagar,Cerebral Palsy,6,15,61,37,98
Tamil Nadu,Virudhunagar,Cerebral Palsy,15,35,87,67,154
Tamil Nadu,Virudhunagar,Cerebral Palsy,35,60,35,13,48
Tamil Nadu,Virudhunagar,Cerebral Palsy,60,80,3,0,3
Tamil Nadu,Virudhunagar,Cerebral Palsy,80,100,1,0,1
Tamil Nadu,Villupuram,Cerebral Palsy,0,6,12,9,21
Tamil Nadu,Villupuram,Cerebral Palsy,6,15,84,44,128
Tamil Nadu,Villupuram,Cerebral Palsy,15,35,102,53,155
Tamil Nadu,Villupuram,Cerebral Palsy,35,60,31,24,55
Tamil Nadu,Villupuram,Cerebral Palsy,60,80,3,1,4
Tamil Nadu,Villupuram,Cerebral Palsy,80,100,3,0,3
Karnataka,Vijayapura,Cerebral Palsy,0,6,77,40,117
Karnataka,Vijayapura,Cerebral Palsy,6,15,224,139,363
Karnataka,Vijayapura,Cerebral Palsy,15,35,147,69,216
Karnataka,Vijayapura,Cerebral Palsy,35,60,43,17,60
Karnataka,Vijayapura,Cerebral Palsy,60,80,3,1,4
Karnataka,Vijayanagar,Cerebral Palsy,35,60,1,0,1
Madhya Pradesh,Vidisha,Cerebral Palsy,0,6,20,12,32
Madhya Pradesh,Vidisha,Cerebral Palsy,6,15,130,60,190
Madhya Pradesh,Vidisha,Cerebral Palsy,15,35,144,85,229
Madhya Pradesh,Vidisha,Cerebral Palsy,35,60,68,29,97
Madhya Pradesh,Vidisha,Cerebral Palsy,60,80,14,9,23
Madhya Pradesh,Vidisha,Cerebral Palsy,80,100,2,0,2
Tamil Nadu,Vellore,Cerebral Palsy,0,6,20,13,33
Tamil Nadu,Vellore,Cerebral Palsy,6,15,71,37,108
Tamil Nadu,Vellore,Cerebral Palsy,15,35,92,48,140
Tamil Nadu,Vellore,Cerebral Palsy,35,60,33,16,49
Tamil Nadu,Vellore,Cerebral Palsy,60,80,1,3,4
Tamil Nadu,Vellore,Cerebral Palsy,80,100,1,1,2
Uttar Pradesh,Varanasi,Cerebral Palsy,0,6,42,22,64
Uttar Pradesh,Varanasi,Cerebral Palsy,6,15,311,168,479
Uttar Pradesh,Varanasi,Cerebral Palsy,15,35,403,171,574
Uttar Pradesh,Varanasi,Cerebral Palsy,35,60,86,26,112
Uttar Pradesh,Varanasi,Cerebral Palsy,60,80,9,2,11
Uttar Pradesh,Varanasi,Cerebral Palsy,80,100,1,0,1
Gujarat,Valsad,Cerebral Palsy,0,6,8,4,12
Gujarat,Valsad,Cerebral Palsy,6,15,28,12,40
Gujarat,Valsad,Cerebral Palsy,15,35,20,16,36
Gujarat,Valsad,Cerebral Palsy,35,60,5,5,10
Gujarat,Valsad,Cerebral Palsy,60,80,2,0,2
Bihar,Vaishali,Cerebral Palsy,0,6,69,38,107
Bihar,Vaishali,Cerebral Palsy,6,15,139,61,200
Bihar,Vaishali,Cerebral Palsy,15,35,73,35,108
Bihar,Vaishali,Cerebral Palsy,35,60,17,12,29
Bihar,Vaishali,Cerebral Palsy,60,80,3,0,3
Gujarat,Vadodara,Cerebral Palsy,0,6,10,8,18
Gujarat,Vadodara,Cerebral Palsy,6,15,30,12,42
Gujarat,Vadodara,Cerebral Palsy,15,35,15,7,22
Gujarat,Vadodara,Cerebral Palsy,35,60,6,3,9
Gujarat,Vadodara,Cerebral Palsy,60,80,3,1,4
Karnataka,Uttara Kannada,Cerebral Palsy,0,6,21,11,32
Karnataka,Uttara Kannada,Cerebral Palsy,6,15,44,32,76
Karnataka,Uttara Kannada,Cerebral Palsy,15,35,92,54,146
Karnataka,Uttara Kannada,Cerebral Palsy,35,60,55,26,81
Karnataka,Uttara Kannada,Cerebral Palsy,60,80,4,0,4
Karnataka,Uttara Kannada,Cerebral Palsy,80,100,0,1,1
Uttarakhand,Uttar Kashi,Cerebral Palsy,0,6,2,1,3
Uttarakhand,Uttar Kashi,Cerebral Palsy,6,15,5,10,15
Uttarakhand,Uttar Kashi,Cerebral Palsy,15,35,11,6,17
Uttarakhand,Uttar Kashi,Cerebral Palsy,35,60,4,1,5
Arunachal Pradesh,Upper Subansiri,Cerebral Palsy,6,15,2,1,3
Arunachal Pradesh,Upper Subansiri,Cerebral Palsy,15,35,1,0,1
Uttar Pradesh,Unnao,Cerebral Palsy,0,6,21,19,40
Uttar Pradesh,Unnao,Cerebral Palsy,6,15,101,74,175
Uttar Pradesh,Unnao,Cerebral Palsy,15,35,158,77,235
Uttar Pradesh,Unnao,Cerebral Palsy,35,60,49,18,67
Uttar Pradesh,Unnao,Cerebral Palsy,60,80,10,4,14
Tripura,Unakoti,Cerebral Palsy,0,6,4,3,7
Tripura,Unakoti,Cerebral Palsy,6,15,18,10,28
Tripura,Unakoti,Cerebral Palsy,15,35,7,6,13
Tripura,Unakoti,Cerebral Palsy,35,60,3,2,5
Tripura,Unakoti,Cerebral Palsy,60,80,0,1,1
Himachal Pradesh,Una,Cerebral Palsy,0,6,1,0,1
Himachal Pradesh,Una,Cerebral Palsy,6,15,7,2,9
Himachal Pradesh,Una,Cerebral Palsy,15,35,4,3,7
Himachal Pradesh,Una,Cerebral Palsy,35,60,6,5,11
Madhya Pradesh,Umaria,Cerebral Palsy,0,6,5,5,10
Madhya Pradesh,Umaria,Cerebral Palsy,6,15,66,47,113
Madhya Pradesh,Umaria,Cerebral Palsy,15,35,48,40,88
Madhya Pradesh,Umaria,Cerebral Palsy,35,60,7,5,12
Madhya Pradesh,Umaria,Cerebral Palsy,60,80,3,0,3
Manipur,Ukhrul,Cerebral Palsy,0,6,3,0,3
Manipur,Ukhrul,Cerebral Palsy,6,15,5,9,14
Manipur,Ukhrul,Cerebral Palsy,15,35,5,6,11
Manipur,Ukhrul,Cerebral Palsy,35,60,2,3,5
Manipur,Ukhrul,Cerebral Palsy,60,80,0,1,1
Madhya Pradesh,Ujjain,Cerebral Palsy,0,6,12,7,19
Madhya Pradesh,Ujjain,Cerebral Palsy,6,15,62,32,94
Madhya Pradesh,Ujjain,Cerebral Palsy,15,35,58,24,82
Madhya Pradesh,Ujjain,Cerebral Palsy,35,60,9,3,12
Karnataka,Udupi,Cerebral Palsy,0,6,6,6,12
Karnataka,Udupi,Cerebral Palsy,6,15,30,22,52
Karnataka,Udupi,Cerebral Palsy,15,35,72,40,112
Karnataka,Udupi,Cerebral Palsy,35,60,47,27,74
Karnataka,Udupi,Cerebral Palsy,60,80,7,3,10
Jammu And Kashmir,Udhampur,Cerebral Palsy,0,6,7,3,10
Jammu And Kashmir,Udhampur,Cerebral Palsy,6,15,42,27,69
Jammu And Kashmir,Udhampur,Cerebral Palsy,15,35,71,47,118
Jammu And Kashmir,Udhampur,Cerebral Palsy,35,60,16,5,21
Uttarakhand,Udam Singh Nagar,Cerebral Palsy,0,6,3,1,4
Uttarakhand,Udam Singh Nagar,Cerebral Palsy,6,15,54,17,71
Uttarakhand,Udam Singh Nagar,Cerebral Palsy,15,35,70,28,98
Uttarakhand,Udam Singh Nagar,Cerebral Palsy,35,60,15,3,18
Uttarakhand,Udam Singh Nagar,Cerebral Palsy,60,80,1,0,1
Assam,Udalguri,Cerebral Palsy,0,6,7,8,15
Assam,Udalguri,Cerebral Palsy,6,15,25,12,37
Assam,Udalguri,Cerebral Palsy,15,35,17,11,28
Assam,Udalguri,Cerebral Palsy,35,60,2,5,7
Rajasthan,Udaipur,Cerebral Palsy,0,6,13,4,17
Rajasthan,Udaipur,Cerebral Palsy,6,15,44,36,80
Rajasthan,Udaipur,Cerebral Palsy,15,35,39,29,68
Rajasthan,Udaipur,Cerebral Palsy,35,60,13,9,22
Tamil Nadu,Tuticorin,Cerebral Palsy,0,6,5,5,10
Tamil Nadu,Tuticorin,Cerebral Palsy,6,15,47,20,67
Tamil Nadu,Tuticorin,Cerebral Palsy,15,35,107,57,164
Tamil Nadu,Tuticorin,Cerebral Palsy,35,60,25,21,46
Tamil Nadu,Tuticorin,Cerebral Palsy,60,80,3,0,3
Karnataka,Tumakuru,Cerebral Palsy,0,6,28,28,56
Karnataka,Tumakuru,Cerebral Palsy,6,15,130,85,215
Karnataka,Tumakuru,Cerebral Palsy,15,35,128,66,194
Karnataka,Tumakuru,Cerebral Palsy,35,60,55,23,78
Karnataka,Tumakuru,Cerebral Palsy,60,80,11,2,13
Nagaland,Tuensang,Cerebral Palsy,15,35,2,0,2
Nagaland,Tuensang,Cerebral Palsy,35,60,0,1,1
Rajasthan,Tonk,Cerebral Palsy,0,6,17,14,31
Rajasthan,Tonk,Cerebral Palsy,6,15,57,43,100
Rajasthan,Tonk,Cerebral Palsy,15,35,43,27,70
Rajasthan,Tonk,Cerebral Palsy,35,60,14,3,17
Rajasthan,Tonk,Cerebral Palsy,60,80,2,0,2
Tamil Nadu,Tiruvannamalai,Cerebral Palsy,0,6,31,22,53
Tamil Nadu,Tiruvannamalai,Cerebral Palsy,6,15,52,44,96
Tamil Nadu,Tiruvannamalai,Cerebral Palsy,15,35,148,104,252
Tamil Nadu,Tiruvannamalai,Cerebral Palsy,35,60,87,47,134
Tamil Nadu,Tiruvannamalai,Cerebral Palsy,60,80,15,8,23
Tamil Nadu,Tiruppur,Cerebral Palsy,0,6,12,8,20
Tamil Nadu,Tiruppur,Cerebral Palsy,6,15,32,27,59
Tamil Nadu,Tiruppur,Cerebral Palsy,15,35,57,31,88
Tamil Nadu,Tiruppur,Cerebral Palsy,35,60,14,8,22
Tamil Nadu,Tiruppur,Cerebral Palsy,60,80,0,1,1
Tamil Nadu,Tirupathur,Cerebral Palsy,0,6,3,6,9
Tamil Nadu,Tirupathur,Cerebral Palsy,6,15,19,6,25
Tamil Nadu,Tirupathur,Cerebral Palsy,15,35,19,9,28
Tamil Nadu,Tirupathur,Cerebral Palsy,35,60,12,4,16
Tamil Nadu,Tirupathur,Cerebral Palsy,60,80,1,0,1
Tamil Nadu,Tirunelveli,Cerebral Palsy,0,6,23,14,37
Tamil Nadu,Tirunelveli,Cerebral Palsy,6,15,137,84,221
Tamil Nadu,Tirunelveli,Cerebral Palsy,15,35,338,230,568
Tamil Nadu,Tirunelveli,Cerebral Palsy,35,60,93,65,158
Tamil Nadu,Tirunelveli,Cerebral Palsy,60,80,4,4,8
Tamil Nadu,Tiruchirappalli,Cerebral Palsy,0,6,31,18,49
Tamil Nadu,Tiruchirappalli,Cerebral Palsy,6,15,93,72,165
Tamil Nadu,Tiruchirappalli,Cerebral Palsy,15,35,185,133,318
Tamil Nadu,Tiruchirappalli,Cerebral Palsy,35,60,56,46,102
Tamil Nadu,Tiruchirappalli,Cerebral Palsy,60,80,6,3,9
Arunachal Pradesh,Tirap,Cerebral Palsy,15,35,0,1,1
Assam,Tinsukia,Cerebral Palsy,0,6,1,3,4
Assam,Tinsukia,Cerebral Palsy,6,15,6,8,14
Assam,Tinsukia,Cerebral Palsy,15,35,10,5,15
Assam,Tinsukia,Cerebral Palsy,35,60,2,2,4
Madhya Pradesh,Tikamgarh,Cerebral Palsy,0,6,37,16,53
Madhya Pradesh,Tikamgarh,Cerebral Palsy,6,15,179,94,273
Madhya Pradesh,Tikamgarh,Cerebral Palsy,15,35,161,68,229
Madhya Pradesh,Tikamgarh,Cerebral Palsy,35,60,34,10,44
Madhya Pradesh,Tikamgarh,Cerebral Palsy,60,80,2,0,2
Kerala,Thrissur,Cerebral Palsy,0,6,14,9,23
Kerala,Thrissur,Cerebral Palsy,6,15,125,75,200
Kerala,Thrissur,Cerebral Palsy,15,35,252,158,410
Kerala,Thrissur,Cerebral Palsy,35,60,112,51,163
Kerala,Thrissur,Cerebral Palsy,60,80,15,12,27
Kerala,Thrissur,Cerebral Palsy,80,100,1,0,1
Manipur,Thoubal,Cerebral Palsy,0,6,0,1,1
Manipur,Thoubal,Cerebral Palsy,6,15,5,3,8
Manipur,Thoubal,Cerebral Palsy,15,35,13,10,23
Manipur,Thoubal,Cerebral Palsy,35,60,4,2,6
Tamil Nadu,Thiruvarur,Cerebral Palsy,0,6,3,9,12
Tamil Nadu,Thiruvarur,Cerebral Palsy,6,15,39,23,62
Tamil Nadu,Thiruvarur,Cerebral Palsy,15,35,95,62,157
Tamil Nadu,Thiruvarur,Cerebral Palsy,35,60,28,21,49
Tamil Nadu,Thiruvarur,Cerebral Palsy,60,80,2,2,4
Tamil Nadu,Thiruvarur,Cerebral Palsy,80,100,1,0,1
Kerala,Thiruvananthapuram,Cerebral Palsy,0,6,17,18,35
Kerala,Thiruvananthapuram,Cerebral Palsy,6,15,136,96,232
Kerala,Thiruvananthapuram,Cerebral Palsy,15,35,208,182,390
Kerala,Thiruvananthapuram,Cerebral Palsy,35,60,109,59,168
Kerala,Thiruvananthapuram,Cerebral Palsy,60,80,7,7,14
Tamil Nadu,Thiruvallur,Cerebral Palsy,0,6,17,10,27
Tamil Nadu,Thiruvallur,Cerebral Palsy,6,15,62,32,94
Tamil Nadu,Thiruvallur,Cerebral Palsy,15,35,132,92,224
Tamil Nadu,Thiruvallur,Cerebral Palsy,35,60,62,41,103
Tamil Nadu,Thiruvallur,Cerebral Palsy,60,80,16,3,19
Tamil Nadu,Thiruvallur,Cerebral Palsy,80,100,0,1,1
Tamil Nadu,Theni,Cerebral Palsy,0,6,5,8,13
Tamil Nadu,Theni,Cerebral Palsy,6,15,44,30,74
Tamil Nadu,Theni,Cerebral Palsy,15,35,93,39,132
Tamil Nadu,Theni,Cerebral Palsy,35,60,39,34,73
Tamil Nadu,Theni,Cerebral Palsy,60,80,3,5,8
Tamil Nadu,The Nilgiris,Cerebral Palsy,0,6,4,0,4
Tamil Nadu,The Nilgiris,Cerebral Palsy,6,15,16,9,25
Tamil Nadu,The Nilgiris,Cerebral Palsy,15,35,14,20,34
Tamil Nadu,The Nilgiris,Cerebral Palsy,35,60,7,3,10
Tamil Nadu,The Nilgiris,Cerebral Palsy,60,80,1,1,2
Tamil Nadu,Thanjavur,Cerebral Palsy,0,6,8,9,17
Tamil Nadu,Thanjavur,Cerebral Palsy,6,15,42,22,64
Tamil Nadu,Thanjavur,Cerebral Palsy,15,35,189,133,322
Tamil Nadu,Thanjavur,Cerebral Palsy,35,60,70,28,98
Tamil Nadu,Thanjavur,Cerebral Palsy,60,80,5,1,6
Maharashtra,Thane,Cerebral Palsy,0,6,25,7,32
Maharashtra,Thane,Cerebral Palsy,6,15,83,60,143
Maharashtra,Thane,Cerebral Palsy,15,35,207,123,330
Maharashtra,Thane,Cerebral Palsy,35,60,196,92,288
Maharashtra,Thane,Cerebral Palsy,60,80,22,6,28
Tamil Nadu,Tenkasi,Cerebral Palsy,0,6,36,29,65
Tamil Nadu,Tenkasi,Cerebral Palsy,6,15,65,41,106
Tamil Nadu,Tenkasi,Cerebral Palsy,15,35,51,20,71
Tamil Nadu,Tenkasi,Cerebral Palsy,35,60,7,8,15
Tamil Nadu,Tenkasi,Cerebral Palsy,60,80,1,0,1
Manipur,Tengnoupal,Cerebral Palsy,6,15,3,0,3
Manipur,Tengnoupal,Cerebral Palsy,15,35,3,0,3
Uttarakhand,Tehri Garhwal,Cerebral Palsy,0,6,10,1,11
Uttarakhand,Tehri Garhwal,Cerebral Palsy,6,15,36,23,59
Uttarakhand,Tehri Garhwal,Cerebral Palsy,15,35,157,66,223
Uttarakhand,Tehri Garhwal,Cerebral Palsy,35,60,213,82,295
Uttarakhand,Tehri Garhwal,Cerebral Palsy,60,80,46,13,59
Uttarakhand,Tehri Garhwal,Cerebral Palsy,80,100,4,1,5
Arunachal Pradesh,Tawang,Cerebral Palsy,6,15,0,2,2
Arunachal Pradesh,Tawang,Cerebral Palsy,15,35,1,1,2
Punjab,Tarn Taran,Cerebral Palsy,0,6,6,9,15
Punjab,Tarn Taran,Cerebral Palsy,6,15,33,13,46
Punjab,Tarn Taran,Cerebral Palsy,15,35,56,15,71
Punjab,Tarn Taran,Cerebral Palsy,35,60,22,9,31
Punjab,Tarn Taran,Cerebral Palsy,60,80,2,0,2
Punjab,Tarn Taran,Cerebral Palsy,80,100,0,1,1
Gujarat,Tapi,Cerebral Palsy,0,6,5,8,13
Gujarat,Tapi,Cerebral Palsy,6,15,16,13,29
Gujarat,Tapi,Cerebral Palsy,15,35,10,11,21
Gujarat,Tapi,Cerebral Palsy,35,60,1,1,2
Manipur,Tamenglong,Cerebral Palsy,0,6,1,1,2
Manipur,Tamenglong,Cerebral Palsy,6,15,1,4,5
Manipur,Tamenglong,Cerebral Palsy,15,35,7,4,11
Manipur,Tamenglong,Cerebral Palsy,35,60,0,6,6
Manipur,Tamenglong,Cerebral Palsy,60,80,1,2,3
Manipur,Tamenglong,Cerebral Palsy,80,100,1,0,1
Chhattisgarh,Surguja,Cerebral Palsy,0,6,11,8,19
Chhattisgarh,Surguja,Cerebral Palsy,6,15,62,45,107
Chhattisgarh,Surguja,Cerebral Palsy,15,35,81,45,126
Chhattisgarh,Surguja,Cerebral Palsy,35,60,10,8,18
Chhattisgarh,Surguja,Cerebral Palsy,60,80,1,0,1
Gujarat,Surendranagar,Cerebral Palsy,0,6,4,1,5
Gujarat,Surendranagar,Cerebral Palsy,6,15,20,11,31
Gujarat,Surendranagar,Cerebral Palsy,15,35,44,20,64
Gujarat,Surendranagar,Cerebral Palsy,35,60,8,6,14
Gujarat,Surendranagar,Cerebral Palsy,60,80,0,1,1
Gujarat,Surat,Cerebral Palsy,0,6,4,1,5
Gujarat,Surat,Cerebral Palsy,6,15,27,19,46
Gujarat,Surat,Cerebral Palsy,15,35,52,26,78
Gujarat,Surat,Cerebral Palsy,35,60,9,5,14
Gujarat,Surat,Cerebral Palsy,60,80,1,1,2
Chhattisgarh,Surajpur,Cerebral Palsy,0,6,7,3,10
Chhattisgarh,Surajpur,Cerebral Palsy,6,15,36,23,59
Chhattisgarh,Surajpur,Cerebral Palsy,15,35,32,27,59
Chhattisgarh,Surajpur,Cerebral Palsy,35,60,7,4,11
Chhattisgarh,Surajpur,Cerebral Palsy,60,80,1,0,1
Bihar,Supaul,Cerebral Palsy,0,6,105,55,160
Bihar,Supaul,Cerebral Palsy,6,15,325,163,488
Bihar,Supaul,Cerebral Palsy,15,35,126,47,173
Bihar,Supaul,Cerebral Palsy,35,60,17,8,25
Bihar,Supaul,Cerebral Palsy,60,80,1,0,1
Odisha,Sundargarh,Cerebral Palsy,0,6,93,60,153
Odisha,Sundargarh,Cerebral Palsy,6,15,278,202,480
Odisha,Sundargarh,Cerebral Palsy,15,35,244,171,415
Odisha,Sundargarh,Cerebral Palsy,35,60,75,54,129
Odisha,Sundargarh,Cerebral Palsy,60,80,9,5,14
Odisha,Sundargarh,Cerebral Palsy,80,100,1,1,2
Uttar Pradesh,Sultanpur,Cerebral Palsy,0,6,11,5,16
Uttar Pradesh,Sultanpur,Cerebral Palsy,6,15,169,76,245
Uttar Pradesh,Sultanpur,Cerebral Palsy,15,35,186,66,252
Uttar Pradesh,Sultanpur,Cerebral Palsy,35,60,52,16,68
Uttar Pradesh,Sultanpur,Cerebral Palsy,60,80,13,0,13
Chhattisgarh,Sukma,Cerebral Palsy,0,6,6,6,12
Chhattisgarh,Sukma,Cerebral Palsy,6,15,54,29,83
Chhattisgarh,Sukma,Cerebral Palsy,15,35,14,14,28
Chhattisgarh,Sukma,Cerebral Palsy,35,60,2,5,7
Chhattisgarh,Sukma,Cerebral Palsy,60,80,2,0,2
Jammu And Kashmir,Srinagar,Cerebral Palsy,0,6,2,1,3
Jammu And Kashmir,Srinagar,Cerebral Palsy,6,15,11,3,14
Jammu And Kashmir,Srinagar,Cerebral Palsy,15,35,8,4,12
Jammu And Kashmir,Srinagar,Cerebral Palsy,35,60,6,1,7
Andhra Pradesh,Srikakulam,Cerebral Palsy,6,15,1,2,3
Andhra Pradesh,Srikakulam,Cerebral Palsy,15,35,19,4,23
Andhra Pradesh,Srikakulam,Cerebral Palsy,35,60,2,3,5
Andhra Pradesh,Srikakulam,Cerebral Palsy,60,80,0,1,1
Punjab,Sri Muktsar Sahib,Cerebral Palsy,0,6,1,2,3
Punjab,Sri Muktsar Sahib,Cerebral Palsy,6,15,28,20,48
Punjab,Sri Muktsar Sahib,Cerebral Palsy,15,35,64,32,96
Punjab,Sri Muktsar Sahib,Cerebral Palsy,35,60,12,5,17
Punjab,Sri Muktsar Sahib,Cerebral Palsy,60,80,7,1,8
Andhra Pradesh,Spsr Nellore,Cerebral Palsy,6,15,12,7,19
Andhra Pradesh,Spsr Nellore,Cerebral Palsy,15,35,10,8,18
Andhra Pradesh,Spsr Nellore,Cerebral Palsy,35,60,3,2,5
Andhra Pradesh,Spsr Nellore,Cerebral Palsy,60,80,1,0,1
Meghalaya,South West Khasi Hills,Cerebral Palsy,0,6,6,1,7
Meghalaya,South West Khasi Hills,Cerebral Palsy,6,15,0,2,2
Meghalaya,South West Khasi Hills,Cerebral Palsy,15,35,4,2,6
Meghalaya,South West Garo Hills,Cerebral Palsy,0,6,2,7,9
Meghalaya,South West Garo Hills,Cerebral Palsy,6,15,24,11,35
Meghalaya,South West Garo Hills,Cerebral Palsy,15,35,22,13,35
Meghalaya,South West Garo Hills,Cerebral Palsy,35,60,4,0,4
Delhi,South West,Cerebral Palsy,0,6,7,4,11
Delhi,South West,Cerebral Palsy,6,15,32,10,42
Delhi,South West,Cerebral Palsy,15,35,46,14,60
Delhi,South West,Cerebral Palsy,35,60,11,4,15
Delhi,South West,Cerebral Palsy,60,80,2,0,2
Assam,South Salmara Mancachar,Cerebral Palsy,6,15,5,8,13
Assam,South Salmara Mancachar,Cerebral Palsy,15,35,3,2,5
Goa,South Goa,Cerebral Palsy,0,6,2,1,3
Goa,South Goa,Cerebral Palsy,6,15,9,4,13
Goa,South Goa,Cerebral Palsy,15,35,24,11,35
Goa,South Goa,Cerebral Palsy,35,60,10,7,17
Goa,South Goa,Cerebral Palsy,60,80,2,1,3
Meghalaya,South Garo Hills,Cerebral Palsy,0,6,2,0,2
Meghalaya,South Garo Hills,Cerebral Palsy,6,15,5,8,13
Meghalaya,South Garo Hills,Cerebral Palsy,15,35,10,5,15
Delhi,South East,Cerebral Palsy,0,6,1,1,2
Delhi,South East,Cerebral Palsy,6,15,3,4,7
Delhi,South East,Cerebral Palsy,15,35,8,3,11
Delhi,South East,Cerebral Palsy,35,60,0,2,2
Andaman And Nicobar Islands,South Andamans,Cerebral Palsy,0,6,3,1,4
Andaman And Nicobar Islands,South Andamans,Cerebral Palsy,6,15,13,8,21
Andaman And Nicobar Islands,South Andamans,Cerebral Palsy,15,35,38,29,67
Andaman And Nicobar Islands,South Andamans,Cerebral Palsy,35,60,33,22,55
Andaman And Nicobar Islands,South Andamans,Cerebral Palsy,60,80,8,2,10
Andaman And Nicobar Islands,South Andamans,Cerebral Palsy,80,100,1,0,1
Delhi,South,Cerebral Palsy,0,6,13,3,16
Delhi,South,Cerebral Palsy,6,15,24,22,46
Delhi,South,Cerebral Palsy,15,35,37,12,49
Delhi,South,Cerebral Palsy,35,60,7,2,9
Delhi,South,Cerebral Palsy,60,80,1,0,1
Assam,Sonitpur,Cerebral Palsy,0,6,91,52,143
Assam,Sonitpur,Cerebral Palsy,6,15,169,111,280
Assam,Sonitpur,Cerebral Palsy,15,35,88,82,170
Assam,Sonitpur,Cerebral Palsy,35,60,18,10,28
Assam,Sonitpur,Cerebral Palsy,60,80,1,1,2
Haryana,Sonipat,Cerebral Palsy,0,6,11,4,15
Haryana,Sonipat,Cerebral Palsy,6,15,61,23,84
Haryana,Sonipat,Cerebral Palsy,15,35,46,12,58
Haryana,Sonipat,Cerebral Palsy,35,60,3,5,8
Odisha,Sonepur,Cerebral Palsy,0,6,11,7,18
Odisha,Sonepur,Cerebral Palsy,6,15,35,26,61
Odisha,Sonepur,Cerebral Palsy,15,35,29,26,55
Odisha,Sonepur,Cerebral Palsy,35,60,10,7,17
Odisha,Sonepur,Cerebral Palsy,60,80,2,0,2
Uttar Pradesh,Sonbhadra,Cerebral Palsy,0,6,10,6,16
Uttar Pradesh,Sonbhadra,Cerebral Palsy,6,15,42,24,66
Uttar Pradesh,Sonbhadra,Cerebral Palsy,15,35,54,17,71
Uttar Pradesh,Sonbhadra,Cerebral Palsy,35,60,29,2,31
Uttar Pradesh,Sonbhadra,Cerebral Palsy,60,80,7,2,9
Uttar Pradesh,Sonbhadra,Cerebral Palsy,80,100,1,0,1
Maharashtra,Solapur,Cerebral Palsy,0,6,28,26,54
Maharashtra,Solapur,Cerebral Palsy,6,15,191,106,297
Maharashtra,Solapur,Cerebral Palsy,15,35,375,183,558
Maharashtra,Solapur,Cerebral Palsy,35,60,343,101,444
Maharashtra,Solapur,Cerebral Palsy,60,80,81,16,97
Maharashtra,Solapur,Cerebral Palsy,80,100,2,0,2
Himachal Pradesh,Solan,Cerebral Palsy,0,6,8,8,16
Himachal Pradesh,Solan,Cerebral Palsy,6,15,15,2,17
Himachal Pradesh,Solan,Cerebral Palsy,15,35,8,11,19
Himachal Pradesh,Solan,Cerebral Palsy,35,60,5,4,9
Himachal Pradesh,Solan,Cerebral Palsy,60,80,0,1,1
Bihar,Siwan,Cerebral Palsy,0,6,53,36,89
Bihar,Siwan,Cerebral Palsy,6,15,203,119,322
Bihar,Siwan,Cerebral Palsy,15,35,215,94,309
Bihar,Siwan,Cerebral Palsy,35,60,83,11,94
Bihar,Siwan,Cerebral Palsy,60,80,10,4,14
Bihar,Siwan,Cerebral Palsy,80,100,1,1,2
Assam,Sivasagar,Cerebral Palsy,0,6,3,3,6
Assam,Sivasagar,Cerebral Palsy,6,15,28,15,43
Assam,Sivasagar,Cerebral Palsy,15,35,31,20,51
Assam,Sivasagar,Cerebral Palsy,35,60,4,4,8
Assam,Sivasagar,Cerebral Palsy,60,80,1,0,1
Tamil Nadu,Sivaganga,Cerebral Palsy,0,6,24,13,37
Tamil Nadu,Sivaganga,Cerebral Palsy,6,15,64,40,104
Tamil Nadu,Sivaganga,Cerebral Palsy,15,35,150,85,235
Tamil Nadu,Sivaganga,Cerebral Palsy,35,60,43,26,69
Tamil Nadu,Sivaganga,Cerebral Palsy,60,80,5,2,7
Uttar Pradesh,Sitapur,Cerebral Palsy,0,6,14,8,22
Uttar Pradesh,Sitapur,Cerebral Palsy,6,15,239,139,378
Uttar Pradesh,Sitapur,Cerebral Palsy,15,35,227,66,293
Uttar Pradesh,Sitapur,Cerebral Palsy,35,60,44,16,60
Uttar Pradesh,Sitapur,Cerebral Palsy,60,80,1,2,3
Bihar,Sitamarhi,Cerebral Palsy,0,6,90,32,122
Bihar,Sitamarhi,Cerebral Palsy,6,15,180,68,248
Bihar,Sitamarhi,Cerebral Palsy,15,35,94,31,125
Bihar,Sitamarhi,Cerebral Palsy,35,60,7,3,10
Bihar,Sitamarhi,Cerebral Palsy,60,80,1,0,1
Haryana,Sirsa,Cerebral Palsy,0,6,7,9,16
Haryana,Sirsa,Cerebral Palsy,6,15,77,43,120
Haryana,Sirsa,Cerebral Palsy,15,35,189,73,262
Haryana,Sirsa,Cerebral Palsy,35,60,27,11,38
Haryana,Sirsa,Cerebral Palsy,60,80,3,1,4
Rajasthan,Sirohi,Cerebral Palsy,0,6,10,8,18
Rajasthan,Sirohi,Cerebral Palsy,6,15,45,28,73
Rajasthan,Sirohi,Cerebral Palsy,15,35,42,20,62
Rajasthan,Sirohi,Cerebral Palsy,35,60,9,0,9
Rajasthan,Sirohi,Cerebral Palsy,60,80,0,1,1
Himachal Pradesh,Sirmaur,Cerebral Palsy,0,6,1,3,4
Himachal Pradesh,Sirmaur,Cerebral Palsy,6,15,9,6,15
Himachal Pradesh,Sirmaur,Cerebral Palsy,15,35,16,4,20
Himachal Pradesh,Sirmaur,Cerebral Palsy,35,60,6,0,6
Himachal Pradesh,Sirmaur,Cerebral Palsy,60,80,2,1,3
Madhya Pradesh,Singrauli,Cerebral Palsy,0,6,5,6,11
Madhya Pradesh,Singrauli,Cerebral Palsy,6,15,44,28,72
Madhya Pradesh,Singrauli,Cerebral Palsy,15,35,48,18,66
Madhya Pradesh,Singrauli,Cerebral Palsy,35,60,11,8,19
Madhya Pradesh,Singrauli,Cerebral Palsy,60,80,2,1,3
Maharashtra,Sindhudurg,Cerebral Palsy,0,6,2,2,4
Maharashtra,Sindhudurg,Cerebral Palsy,6,15,6,7,13
Maharashtra,Sindhudurg,Cerebral Palsy,15,35,8,5,13
Maharashtra,Sindhudurg,Cerebral Palsy,35,60,9,5,14
Maharashtra,Sindhudurg,Cerebral Palsy,60,80,1,0,1
Jharkhand,Simdega,Cerebral Palsy,6,15,1,1,2
Jharkhand,Simdega,Cerebral Palsy,15,35,0,2,2
Rajasthan,Sikar,Cerebral Palsy,0,6,15,9,24
Rajasthan,Sikar,Cerebral Palsy,6,15,158,69,227
Rajasthan,Sikar,Cerebral Palsy,15,35,177,59,236
Rajasthan,Sikar,Cerebral Palsy,35,60,21,8,29
Madhya Pradesh,Sidhi,Cerebral Palsy,6,15,20,11,31
Madhya Pradesh,Sidhi,Cerebral Palsy,15,35,87,19,106
Madhya Pradesh,Sidhi,Cerebral Palsy,35,60,55,14,69
Madhya Pradesh,Sidhi,Cerebral Palsy,60,80,8,3,11
Uttar Pradesh,Siddharth Nagar,Cerebral Palsy,0,6,7,6,13
Uttar Pradesh,Siddharth Nagar,Cerebral Palsy,6,15,105,67,172
Uttar Pradesh,Siddharth Nagar,Cerebral Palsy,15,35,240,106,346
Uttar Pradesh,Siddharth Nagar,Cerebral Palsy,35,60,147,41,188
Uttar Pradesh,Siddharth Nagar,Cerebral Palsy,60,80,39,11,50
Uttar Pradesh,Shravasti,Cerebral Palsy,0,6,33,10,43
Uttar Pradesh,Shravasti,Cerebral Palsy,6,15,112,42,154
Uttar Pradesh,Shravasti,Cerebral Palsy,15,35,36,14,50
Uttar Pradesh,Shravasti,Cerebral Palsy,35,60,11,2,13
Uttar Pradesh,Shravasti,Cerebral Palsy,60,80,2,1,3
Jammu And Kashmir,Shopian,Cerebral Palsy,0,6,13,6,19
Jammu And Kashmir,Shopian,Cerebral Palsy,6,15,49,27,76
Jammu And Kashmir,Shopian,Cerebral Palsy,15,35,48,37,85
Jammu And Kashmir,Shopian,Cerebral Palsy,35,60,3,4,7
Madhya Pradesh,Shivpuri,Cerebral Palsy,0,6,2,6,8
Madhya Pradesh,Shivpuri,Cerebral Palsy,6,15,33,22,55
Madhya Pradesh,Shivpuri,Cerebral Palsy,15,35,76,33,109
Madhya Pradesh,Shivpuri,Cerebral Palsy,35,60,7,5,12
Madhya Pradesh,Shivpuri,Cerebral Palsy,60,80,1,2,3
Karnataka,Shivamogga,Cerebral Palsy,0,6,23,14,37
Karnataka,Shivamogga,Cerebral Palsy,6,15,46,26,72
Karnataka,Shivamogga,Cerebral Palsy,15,35,81,37,118
Karnataka,Shivamogga,Cerebral Palsy,35,60,38,7,45
Karnataka,Shivamogga,Cerebral Palsy,60,80,12,0,12
Himachal Pradesh,Shimla,Cerebral Palsy,0,6,1,0,1
Himachal Pradesh,Shimla,Cerebral Palsy,6,15,1,3,4
Himachal Pradesh,Shimla,Cerebral Palsy,15,35,5,3,8
Himachal Pradesh,Shimla,Cerebral Palsy,35,60,3,1,4
Arunachal Pradesh,Shi Yomi,Cerebral Palsy,6,15,1,0,1
Madhya Pradesh,Sheopur,Cerebral Palsy,0,6,10,7,17
Madhya Pradesh,Sheopur,Cerebral Palsy,6,15,18,7,25
Madhya Pradesh,Sheopur,Cerebral Palsy,15,35,27,13,40
Madhya Pradesh,Sheopur,Cerebral Palsy,35,60,3,0,3
Madhya Pradesh,Sheopur,Cerebral Palsy,60,80,0,1,1
Bihar,Sheohar,Cerebral Palsy,0,6,55,33,88
Bihar,Sheohar,Cerebral Palsy,6,15,98,54,152
Bihar,Sheohar,Cerebral Palsy,15,35,27,15,42
Bihar,Sheohar,Cerebral Palsy,35,60,3,1,4
Bihar,Sheohar,Cerebral Palsy,60,80,0,1,1
Bihar,Sheikhpura,Cerebral Palsy,0,6,13,7,20
Bihar,Sheikhpura,Cerebral Palsy,6,15,60,32,92
Bihar,Sheikhpura,Cerebral Palsy,15,35,37,14,51
Bihar,Sheikhpura,Cerebral Palsy,35,60,2,1,3
Uttar Pradesh,Shamli,Cerebral Palsy,0,6,25,10,35
Uttar Pradesh,Shamli,Cerebral Palsy,6,15,105,54,159
Uttar Pradesh,Shamli,Cerebral Palsy,15,35,171,52,223
Uttar Pradesh,Shamli,Cerebral Palsy,35,60,40,15,55
Uttar Pradesh,Shamli,Cerebral Palsy,60,80,6,3,9
Uttar Pradesh,Shamli,Cerebral Palsy,80,100,0,1,1
Madhya Pradesh,Shajapur,Cerebral Palsy,0,6,7,7,14
Madhya Pradesh,Shajapur,Cerebral Palsy,6,15,28,16,44
Madhya Pradesh,Shajapur,Cerebral Palsy,15,35,22,8,30
Madhya Pradesh,Shajapur,Cerebral Palsy,35,60,4,2,6
Madhya Pradesh,Shajapur,Cerebral Palsy,60,80,1,0,1
Uttar Pradesh,Shahjahanpur,Cerebral Palsy,0,6,11,6,17
Uttar Pradesh,Shahjahanpur,Cerebral Palsy,6,15,63,40,103
Uttar Pradesh,Shahjahanpur,Cerebral Palsy,15,35,150,41,191
Uttar Pradesh,Shahjahanpur,Cerebral Palsy,35,60,136,77,213
Uttar Pradesh,Shahjahanpur,Cerebral Palsy,60,80,25,6,31
Punjab,Shahid Bhagat Singh Nagar,Cerebral Palsy,0,6,9,11,20
Punjab,Shahid Bhagat Singh Nagar,Cerebral Palsy,6,15,30,27,57
Punjab,Shahid Bhagat Singh Nagar,Cerebral Palsy,15,35,99,56,155
Punjab,Shahid Bhagat Singh Nagar,Cerebral Palsy,35,60,70,43,113
Punjab,Shahid Bhagat Singh Nagar,Cerebral Palsy,60,80,15,7,22
Punjab,Shahid Bhagat Singh Nagar,Cerebral Palsy,80,100,1,1,2
Madhya Pradesh,Shahdol,Cerebral Palsy,0,6,1,3,4
Madhya Pradesh,Shahdol,Cerebral Palsy,6,15,20,11,31
Madhya Pradesh,Shahdol,Cerebral Palsy,15,35,28,14,42
Madhya Pradesh,Shahdol,Cerebral Palsy,35,60,14,13,27
Madhya Pradesh,Shahdol,Cerebral Palsy,60,80,6,0,6
Delhi,Shahdara,Cerebral Palsy,0,6,1,0,1
Delhi,Shahdara,Cerebral Palsy,6,15,5,5,10
Delhi,Shahdara,Cerebral Palsy,15,35,15,8,23
Delhi,Shahdara,Cerebral Palsy,35,60,2,1,3
Mizoram,Serchhip,Cerebral Palsy,0,6,1,0,1
Mizoram,Serchhip,Cerebral Palsy,6,15,2,2,4
Mizoram,Serchhip,Cerebral Palsy,15,35,1,1,2
Mizoram,Serchhip,Cerebral Palsy,35,60,2,1,3
Madhya Pradesh,Seoni,Cerebral Palsy,0,6,7,5,12
Madhya Pradesh,Seoni,Cerebral Palsy,6,15,40,17,57
Madhya Pradesh,Seoni,Cerebral Palsy,15,35,27,21,48
Madhya Pradesh,Seoni,Cerebral Palsy,35,60,41,15,56
Madhya Pradesh,Seoni,Cerebral Palsy,60,80,21,6,27
Manipur,Senapati,Cerebral Palsy,0,6,1,2,3
Manipur,Senapati,Cerebral Palsy,6,15,1,0,1
Manipur,Senapati,Cerebral Palsy,15,35,6,2,8
Madhya Pradesh,Sehore,Cerebral Palsy,0,6,1,1,2
Madhya Pradesh,Sehore,Cerebral Palsy,6,15,27,15,42
Madhya Pradesh,Sehore,Cerebral Palsy,15,35,43,17,60
Madhya Pradesh,Sehore,Cerebral Palsy,35,60,5,0,5
Rajasthan,Sawai Madhopur,Cerebral Palsy,0,6,1,0,1
Rajasthan,Sawai Madhopur,Cerebral Palsy,6,15,11,14,25
Rajasthan,Sawai Madhopur,Cerebral Palsy,15,35,11,6,17
Rajasthan,Sawai Madhopur,Cerebral Palsy,35,60,2,0,2
Madhya Pradesh,Satna,Cerebral Palsy,0,6,29,17,46
Madhya Pradesh,Satna,Cerebral Palsy,6,15,107,63,170
Madhya Pradesh,Satna,Cerebral Palsy,15,35,133,66,199
Madhya Pradesh,Satna,Cerebral Palsy,35,60,18,5,23
Madhya Pradesh,Satna,Cerebral Palsy,60,80,1,1,2
Maharashtra,Satara,Cerebral Palsy,0,6,2,0,2
Maharashtra,Satara,Cerebral Palsy,6,15,4,9,13
Maharashtra,Satara,Cerebral Palsy,15,35,23,11,34
Maharashtra,Satara,Cerebral Palsy,35,60,38,22,60
Maharashtra,Satara,Cerebral Palsy,60,80,11,1,12
Maharashtra,Satara,Cerebral Palsy,80,100,1,1,2
Bihar,Saran,Cerebral Palsy,0,6,24,11,35
Bihar,Saran,Cerebral Palsy,6,15,57,36,93
Bihar,Saran,Cerebral Palsy,15,35,52,19,71
Bihar,Saran,Cerebral Palsy,35,60,25,4,29
Bihar,Saran,Cerebral Palsy,60,80,4,2,6
Jharkhand,Saraikela Kharsawan,Cerebral Palsy,6,15,4,0,4
Jharkhand,Saraikela Kharsawan,Cerebral Palsy,15,35,5,4,9
Jharkhand,Saraikela Kharsawan,Cerebral Palsy,35,60,3,0,3
Uttar Pradesh,Sant Kabeer Nagar,Cerebral Palsy,0,6,31,19,50
Uttar Pradesh,Sant Kabeer Nagar,Cerebral Palsy,6,15,102,67,169
Uttar Pradesh,Sant Kabeer Nagar,Cerebral Palsy,15,35,127,62,189
Uttar Pradesh,Sant Kabeer Nagar,Cerebral Palsy,35,60,18,2,20
Uttar Pradesh,Sant Kabeer Nagar,Cerebral Palsy,60,80,2,0,2
Punjab,Sangrur,Cerebral Palsy,0,6,18,8,26
Punjab,Sangrur,Cerebral Palsy,6,15,74,49,123
Punjab,Sangrur,Cerebral Palsy,15,35,164,75,239
Punjab,Sangrur,Cerebral Palsy,35,60,54,24,78
Punjab,Sangrur,Cerebral Palsy,60,80,5,1,6
Maharashtra,Sangli,Cerebral Palsy,0,6,15,6,21
Maharashtra,Sangli,Cerebral Palsy,6,15,95,61,156
Maharashtra,Sangli,Cerebral Palsy,15,35,168,71,239
Maharashtra,Sangli,Cerebral Palsy,35,60,69,38,107
Maharashtra,Sangli,Cerebral Palsy,60,80,8,3,11
Uttar Pradesh,Sambhal,Cerebral Palsy,0,6,16,9,25
Uttar Pradesh,Sambhal,Cerebral Palsy,6,15,139,56,195
Uttar Pradesh,Sambhal,Cerebral Palsy,15,35,88,37,125
Uttar Pradesh,Sambhal,Cerebral Palsy,35,60,21,5,26
Uttar Pradesh,Sambhal,Cerebral Palsy,60,80,4,1,5
Odisha,Sambalpur,Cerebral Palsy,0,6,31,17,48
Odisha,Sambalpur,Cerebral Palsy,6,15,43,23,66
Odisha,Sambalpur,Cerebral Palsy,15,35,46,25,71
Odisha,Sambalpur,Cerebral Palsy,35,60,16,8,24
Odisha,Sambalpur,Cerebral Palsy,60,80,2,4,6
Odisha,Sambalpur,Cerebral Palsy,80,100,1,0,1
Jammu And Kashmir,Samba,Cerebral Palsy,0,6,4,1,5
Jammu And Kashmir,Samba,Cerebral Palsy,6,15,15,10,25
Jammu And Kashmir,Samba,Cerebral Palsy,15,35,27,18,45
Jammu And Kashmir,Samba,Cerebral Palsy,35,60,7,3,10
Jammu And Kashmir,Samba,Cerebral Palsy,60,80,2,0,2
Bihar,Samastipur,Cerebral Palsy,0,6,75,30,105
Bihar,Samastipur,Cerebral Palsy,6,15,88,48,136
Bihar,Samastipur,Cerebral Palsy,15,35,71,31,102
Bihar,Samastipur,Cerebral Palsy,35,60,15,5,20
Bihar,Samastipur,Cerebral Palsy,60,80,2,1,3
Tamil Nadu,Salem,Cerebral Palsy,0,6,13,14,27
Tamil Nadu,Salem,Cerebral Palsy,6,15,92,72,164
Tamil Nadu,Salem,Cerebral Palsy,15,35,160,73,233
Tamil Nadu,Salem,Cerebral Palsy,35,60,52,13,65
Tamil Nadu,Salem,Cerebral Palsy,60,80,5,1,6
Mizoram,Saiha,Cerebral Palsy,6,15,1,1,2
Mizoram,Saiha,Cerebral Palsy,15,35,2,0,2
Mizoram,Saiha,Cerebral Palsy,60,80,1,0,1
Jharkhand,Sahebganj,Cerebral Palsy,0,6,49,30,79
Jharkhand,Sahebganj,Cerebral Palsy,6,15,226,120,346
Jharkhand,Sahebganj,Cerebral Palsy,15,35,96,46,142
Jharkhand,Sahebganj,Cerebral Palsy,35,60,20,3,23
Jharkhand,Sahebganj,Cerebral Palsy,60,80,2,1,3
Bihar,Saharsa,Cerebral Palsy,0,6,37,15,52
Bihar,Saharsa,Cerebral Palsy,6,15,107,49,156
Bihar,Saharsa,Cerebral Palsy,15,35,82,23,105
Bihar,Saharsa,Cerebral Palsy,35,60,15,10,25
Bihar,Saharsa,Cerebral Palsy,60,80,7,1,8
Uttar Pradesh,Saharanpur,Cerebral Palsy,0,6,12,6,18
Uttar Pradesh,Saharanpur,Cerebral Palsy,6,15,99,55,154
Uttar Pradesh,Saharanpur,Cerebral Palsy,15,35,220,72,292
Uttar Pradesh,Saharanpur,Cerebral Palsy,35,60,121,38,159
Uttar Pradesh,Saharanpur,Cerebral Palsy,60,80,26,4,30
Madhya Pradesh,Sagar,Cerebral Palsy,0,6,4,2,6
Madhya Pradesh,Sagar,Cerebral Palsy,6,15,26,21,47
Madhya Pradesh,Sagar,Cerebral Palsy,15,35,87,46,133
Madhya Pradesh,Sagar,Cerebral Palsy,35,60,107,38,145
Madhya Pradesh,Sagar,Cerebral Palsy,60,80,22,11,33
Gujarat,Sabar Kantha,Cerebral Palsy,0,6,9,5,14
Gujarat,Sabar Kantha,Cerebral Palsy,6,15,62,33,95
Gujarat,Sabar Kantha,Cerebral Palsy,15,35,63,31,94
Gujarat,Sabar Kantha,Cerebral Palsy,35,60,7,8,15
Punjab,S.A.S Nagar,Cerebral Palsy,0,6,21,13,34
Punjab,S.A.S Nagar,Cerebral Palsy,6,15,51,36,87
Punjab,S.A.S Nagar,Cerebral Palsy,15,35,76,34,110
Punjab,S.A.S Nagar,Cerebral Palsy,35,60,38,13,51
Punjab,S.A.S Nagar,Cerebral Palsy,60,80,10,2,12
Punjab,S.A.S Nagar,Cerebral Palsy,80,100,1,0,1
Punjab,Rupnagar,Cerebral Palsy,0,6,5,5,10
Punjab,Rupnagar,Cerebral Palsy,6,15,17,9,26
Punjab,Rupnagar,Cerebral Palsy,15,35,72,52,124
Punjab,Rupnagar,Cerebral Palsy,35,60,52,34,86
Punjab,Rupnagar,Cerebral Palsy,60,80,13,2,15
Punjab,Rupnagar,Cerebral Palsy,80,100,1,0,1
Uttarakhand,Rudra Prayag,Cerebral Palsy,0,6,1,2,3
Uttarakhand,Rudra Prayag,Cerebral Palsy,6,15,4,9,13
Uttarakhand,Rudra Prayag,Cerebral Palsy,15,35,17,14,31
Uttarakhand,Rudra Prayag,Cerebral Palsy,35,60,14,3,17
Bihar,Rohtas,Cerebral Palsy,0,6,8,4,12
Bihar,Rohtas,Cerebral Palsy,6,15,79,35,114
Bihar,Rohtas,Cerebral Palsy,15,35,58,25,83
Bihar,Rohtas,Cerebral Palsy,35,60,25,9,34
Bihar,Rohtas,Cerebral Palsy,60,80,8,0,8
Bihar,Rohtas,Cerebral Palsy,80,100,1,0,1
Haryana,Rohtak,Cerebral Palsy,0,6,0,4,4
Haryana,Rohtak,Cerebral Palsy,6,15,32,18,50
Haryana,Rohtak,Cerebral Palsy,15,35,37,9,46
Haryana,Rohtak,Cerebral Palsy,35,60,17,6,23
Haryana,Rohtak,Cerebral Palsy,60,80,3,0,3
Haryana,Rohtak,Cerebral Palsy,80,100,1,0,1
Meghalaya,Ri Bhoi,Cerebral Palsy,0,6,11,14,25
Meghalaya,Ri Bhoi,Cerebral Palsy,6,15,24,28,52
Meghalaya,Ri Bhoi,Cerebral Palsy,15,35,45,28,73
Meghalaya,Ri Bhoi,Cerebral Palsy,35,60,3,3,6
Meghalaya,Ri Bhoi,Cerebral Palsy,60,80,1,0,1
Haryana,Rewari,Cerebral Palsy,0,6,5,1,6
Haryana,Rewari,Cerebral Palsy,6,15,33,15,48
Haryana,Rewari,Cerebral Palsy,15,35,58,11,69
Haryana,Rewari,Cerebral Palsy,35,60,9,3,12
Haryana,Rewari,Cerebral Palsy,60,80,1,1,2
Madhya Pradesh,Rewa,Cerebral Palsy,0,6,13,7,20
Madhya Pradesh,Rewa,Cerebral Palsy,6,15,49,21,70
Madhya Pradesh,Rewa,Cerebral Palsy,15,35,76,32,108
Madhya Pradesh,Rewa,Cerebral Palsy,35,60,7,2,9
Madhya Pradesh,Rewa,Cerebral Palsy,60,80,1,0,1
Jammu And Kashmir,Reasi,Cerebral Palsy,0,6,0,2,2
Jammu And Kashmir,Reasi,Cerebral Palsy,6,15,8,5,13
Jammu And Kashmir,Reasi,Cerebral Palsy,15,35,6,3,9
Jammu And Kashmir,Reasi,Cerebral Palsy,35,60,7,1,8
Jammu And Kashmir,Reasi,Cerebral Palsy,60,80,3,0,3
Odisha,Rayagada,Cerebral Palsy,0,6,62,57,119
Odisha,Rayagada,Cerebral Palsy,6,15,99,78,177
Odisha,Rayagada,Cerebral Palsy,15,35,70,40,110
Odisha,Rayagada,Cerebral Palsy,35,60,14,12,26
Odisha,Rayagada,Cerebral Palsy,60,80,2,0,2
Odisha,Rayagada,Cerebral Palsy,80,100,0,1,1
Maharashtra,Ratnagiri,Cerebral Palsy,0,6,6,11,17
Maharashtra,Ratnagiri,Cerebral Palsy,6,15,33,23,56
Maharashtra,Ratnagiri,Cerebral Palsy,15,35,57,45,102
Maharashtra,Ratnagiri,Cerebral Palsy,35,60,19,10,29
Maharashtra,Ratnagiri,Cerebral Palsy,60,80,3,3,6
Madhya Pradesh,Ratlam,Cerebral Palsy,0,6,27,16,43
Madhya Pradesh,Ratlam,Cerebral Palsy,6,15,130,98,228
Madhya Pradesh,Ratlam,Cerebral Palsy,15,35,124,74,198
Madhya Pradesh,Ratlam,Cerebral Palsy,35,60,56,31,87
Madhya Pradesh,Ratlam,Cerebral Palsy,60,80,15,5,20
Tamil Nadu,Ranipet,Cerebral Palsy,0,6,6,5,11
Tamil Nadu,Ranipet,Cerebral Palsy,6,15,16,19,35
Tamil Nadu,Ranipet,Cerebral Palsy,15,35,25,32,57
Tamil Nadu,Ranipet,Cerebral Palsy,35,60,4,7,11
Tamil Nadu,Ranipet,Cerebral Palsy,60,80,0,1,1
Jharkhand,Ranchi,Cerebral Palsy,0,6,19,15,34
Jharkhand,Ranchi,Cerebral Palsy,6,15,147,96,243
Jharkhand,Ranchi,Cerebral Palsy,15,35,73,47,120
Jharkhand,Ranchi,Cerebral Palsy,35,60,8,3,11
Jharkhand,Ranchi,Cerebral Palsy,60,80,1,0,1
Uttar Pradesh,Rampur,Cerebral Palsy,0,6,4,0,4
Uttar Pradesh,Rampur,Cerebral Palsy,6,15,41,29,70
Uttar Pradesh,Rampur,Cerebral Palsy,15,35,67,23,90
Uttar Pradesh,Rampur,Cerebral Palsy,35,60,23,5,28
Uttar Pradesh,Rampur,Cerebral Palsy,60,80,3,0,3
Jharkhand,Ramgarh,Cerebral Palsy,0,6,12,8,20
Jharkhand,Ramgarh,Cerebral Palsy,6,15,59,33,92
Jharkhand,Ramgarh,Cerebral Palsy,15,35,83,42,125
Jharkhand,Ramgarh,Cerebral Palsy,35,60,54,19,73
Jharkhand,Ramgarh,Cerebral Palsy,60,80,10,9,19
Jammu And Kashmir,Ramban,Cerebral Palsy,0,6,9,11,20
Jammu And Kashmir,Ramban,Cerebral Palsy,6,15,49,30,79
Jammu And Kashmir,Ramban,Cerebral Palsy,15,35,48,23,71
Jammu And Kashmir,Ramban,Cerebral Palsy,35,60,5,3,8
Jammu And Kashmir,Ramban,Cerebral Palsy,60,80,1,0,1
Tamil Nadu,Ramanathapuram,Cerebral Palsy,0,6,7,6,13
Tamil Nadu,Ramanathapuram,Cerebral Palsy,6,15,102,70,172
Tamil Nadu,Ramanathapuram,Cerebral Palsy,15,35,112,69,181
Tamil Nadu,Ramanathapuram,Cerebral Palsy,35,60,16,11,27
Tamil Nadu,Ramanathapuram,Cerebral Palsy,60,80,1,0,1
Karnataka,Ramanagara,Cerebral Palsy,0,6,7,2,9
Karnataka,Ramanagara,Cerebral Palsy,6,15,32,12,44
Karnataka,Ramanagara,Cerebral Palsy,15,35,44,36,80
Karnataka,Ramanagara,Cerebral Palsy,35,60,37,14,51
Karnataka,Ramanagara,Cerebral Palsy,60,80,8,1,9
Rajasthan,Rajsamand,Cerebral Palsy,0,6,5,3,8
Rajasthan,Rajsamand,Cerebral Palsy,6,15,29,9,38
Rajasthan,Rajsamand,Cerebral Palsy,15,35,40,29,69
Rajasthan,Rajsamand,Cerebral Palsy,35,60,26,13,39
Rajasthan,Rajsamand,Cerebral Palsy,60,80,2,7,9
Jammu And Kashmir,Rajouri,Cerebral Palsy,0,6,16,9,25
Jammu And Kashmir,Rajouri,Cerebral Palsy,6,15,81,34,115
Jammu And Kashmir,Rajouri,Cerebral Palsy,15,35,85,52,137
Jammu And Kashmir,Rajouri,Cerebral Palsy,35,60,17,10,27
Jammu And Kashmir,Rajouri,Cerebral Palsy,60,80,1,2,3
Chhattisgarh,Rajnandgaon,Cerebral Palsy,0,6,43,25,68
Chhattisgarh,Rajnandgaon,Cerebral Palsy,6,15,203,151,354
Chhattisgarh,Rajnandgaon,Cerebral Palsy,15,35,195,125,320
Chhattisgarh,Rajnandgaon,Cerebral Palsy,35,60,31,19,50
Chhattisgarh,Rajnandgaon,Cerebral Palsy,60,80,5,1,6
Gujarat,Rajkot,Cerebral Palsy,0,6,5,9,14
Gujarat,Rajkot,Cerebral Palsy,6,15,14,9,23
Gujarat,Rajkot,Cerebral Palsy,15,35,15,8,23
Gujarat,Rajkot,Cerebral Palsy,35,60,1,1,2
Gujarat,Rajkot,Cerebral Palsy,60,80,1,0,1
Madhya Pradesh,Rajgarh,Cerebral Palsy,0,6,7,7,14
Madhya Pradesh,Rajgarh,Cerebral Palsy,6,15,40,27,67
Madhya Pradesh,Rajgarh,Cerebral Palsy,15,35,30,14,44
Madhya Pradesh,Rajgarh,Cerebral Palsy,35,60,22,3,25
Madhya Pradesh,Rajgarh,Cerebral Palsy,60,80,3,3,6
Madhya Pradesh,Raisen,Cerebral Palsy,0,6,12,5,17
Madhya Pradesh,Raisen,Cerebral Palsy,6,15,54,17,71
Madhya Pradesh,Raisen,Cerebral Palsy,15,35,51,19,70
Madhya Pradesh,Raisen,Cerebral Palsy,35,60,16,2,18
Madhya Pradesh,Raisen,Cerebral Palsy,60,80,2,1,3
Chhattisgarh,Raipur,Cerebral Palsy,6,15,6,1,7
Chhattisgarh,Raipur,Cerebral Palsy,15,35,37,20,57
Chhattisgarh,Raipur,Cerebral Palsy,35,60,5,3,8
Chhattisgarh,Raipur,Cerebral Palsy,60,80,0,1,1
Chhattisgarh,Raigarh,Cerebral Palsy,0,6,47,30,77
Chhattisgarh,Raigarh,Cerebral Palsy,6,15,285,198,483
Chhattisgarh,Raigarh,Cerebral Palsy,15,35,280,148,428
Chhattisgarh,Raigarh,Cerebral Palsy,35,60,24,15,39
Chhattisgarh,Raigarh,Cerebral Palsy,60,80,7,0,7
Maharashtra,Raigad,Cerebral Palsy,0,6,15,2,17
Maharashtra,Raigad,Cerebral Palsy,6,15,69,33,102
Maharashtra,Raigad,Cerebral Palsy,15,35,109,76,185
Maharashtra,Raigad,Cerebral Palsy,35,60,94,41,135
Maharashtra,Raigad,Cerebral Palsy,60,80,5,5,10
Karnataka,Raichur,Cerebral Palsy,0,6,49,42,91
Karnataka,Raichur,Cerebral Palsy,6,15,190,116,306
Karnataka,Raichur,Cerebral Palsy,15,35,144,67,211
Karnataka,Raichur,Cerebral Palsy,35,60,27,15,42
Karnataka,Raichur,Cerebral Palsy,60,80,1,0,1
Uttar Pradesh,Rae Bareli,Cerebral Palsy,0,6,18,13,31
Uttar Pradesh,Rae Bareli,Cerebral Palsy,6,15,195,115,310
Uttar Pradesh,Rae Bareli,Cerebral Palsy,15,35,180,76,256
Uttar Pradesh,Rae Bareli,Cerebral Palsy,35,60,45,3,48
Uttar Pradesh,Rae Bareli,Cerebral Palsy,60,80,7,2,9
Uttar Pradesh,Rae Bareli,Cerebral Palsy,80,100,0,1,1
Bihar,Purnia,Cerebral Palsy,0,6,112,69,181
Bihar,Purnia,Cerebral Palsy,6,15,325,195,520
Bihar,Purnia,Cerebral Palsy,15,35,244,97,341
Bihar,Purnia,Cerebral Palsy,35,60,42,25,67
Bihar,Purnia,Cerebral Palsy,60,80,9,4,13
Odisha,Puri,Cerebral Palsy,0,6,5,3,8
Odisha,Puri,Cerebral Palsy,6,15,54,21,75
Odisha,Puri,Cerebral Palsy,15,35,86,33,119
Odisha,Puri,Cerebral Palsy,35,60,23,11,34
Odisha,Puri,Cerebral Palsy,60,80,16,5,21
Odisha,Puri,Cerebral Palsy,80,100,1,0,1
Bihar,Purbi Champaran,Cerebral Palsy,0,6,34,24,58
Bihar,Purbi Champaran,Cerebral Palsy,6,15,142,54,196
Bihar,Purbi Champaran,Cerebral Palsy,15,35,128,33,161
Bihar,Purbi Champaran,Cerebral Palsy,35,60,50,11,61
Bihar,Purbi Champaran,Cerebral Palsy,60,80,5,1,6
Maharashtra,Pune,Cerebral Palsy,0,6,37,27,64
Maharashtra,Pune,Cerebral Palsy,6,15,147,93,240
Maharashtra,Pune,Cerebral Palsy,15,35,233,119,352
Maharashtra,Pune,Cerebral Palsy,35,60,108,58,166
Maharashtra,Pune,Cerebral Palsy,60,80,22,2,24
Jammu And Kashmir,Pulwama,Cerebral Palsy,0,6,17,4,21
Jammu And Kashmir,Pulwama,Cerebral Palsy,6,15,70,64,134
Jammu And Kashmir,Pulwama,Cerebral Palsy,15,35,87,69,156
Jammu And Kashmir,Pulwama,Cerebral Palsy,35,60,25,18,43
Jammu And Kashmir,Pulwama,Cerebral Palsy,60,80,3,0,3
Tamil Nadu,Pudukkottai,Cerebral Palsy,0,6,5,10,15
Tamil Nadu,Pudukkottai,Cerebral Palsy,6,15,35,21,56
Tamil Nadu,Pudukkottai,Cerebral Palsy,15,35,122,62,184
Tamil Nadu,Pudukkottai,Cerebral Palsy,35,60,42,17,59
Tamil Nadu,Pudukkottai,Cerebral Palsy,60,80,1,4,5
Uttar Pradesh,Prayagraj,Cerebral Palsy,0,6,21,14,35
Uttar Pradesh,Prayagraj,Cerebral Palsy,6,15,144,77,221
Uttar Pradesh,Prayagraj,Cerebral Palsy,15,35,218,69,287
Uttar Pradesh,Prayagraj,Cerebral Palsy,35,60,45,10,55
Uttar Pradesh,Prayagraj,Cerebral Palsy,60,80,4,0,4
Rajasthan,Pratapgarh,Cerebral Palsy,0,6,0,1,1
Rajasthan,Pratapgarh,Cerebral Palsy,6,15,11,13,24
Rajasthan,Pratapgarh,Cerebral Palsy,15,35,50,51,101
Rajasthan,Pratapgarh,Cerebral Palsy,35,60,21,16,37
Rajasthan,Pratapgarh,Cerebral Palsy,60,80,2,2,4
Uttar Pradesh,Pratapgarh,Cerebral Palsy,0,6,11,8,19
Uttar Pradesh,Pratapgarh,Cerebral Palsy,6,15,92,46,138
Uttar Pradesh,Pratapgarh,Cerebral Palsy,15,35,367,162,529
Uttar Pradesh,Pratapgarh,Cerebral Palsy,35,60,285,246,531
Uttar Pradesh,Pratapgarh,Cerebral Palsy,60,80,67,26,93
Uttar Pradesh,Pratapgarh,Cerebral Palsy,80,100,2,0,2
Andhra Pradesh,Prakasam,Cerebral Palsy,6,15,6,0,6
Andhra Pradesh,Prakasam,Cerebral Palsy,15,35,15,3,18
Andhra Pradesh,Prakasam,Cerebral Palsy,35,60,3,1,4
Gujarat,Porbandar,Cerebral Palsy,6,15,6,6,12
Gujarat,Porbandar,Cerebral Palsy,15,35,14,8,22
Gujarat,Porbandar,Cerebral Palsy,35,60,3,3,6
Jammu And Kashmir,Poonch,Cerebral Palsy,0,6,8,4,12
Jammu And Kashmir,Poonch,Cerebral Palsy,6,15,23,16,39
Jammu And Kashmir,Poonch,Cerebral Palsy,15,35,21,16,37
Jammu And Kashmir,Poonch,Cerebral Palsy,35,60,19,6,25
Jammu And Kashmir,Poonch,Cerebral Palsy,60,80,1,1,2
Puducherry,Pondicherry,Cerebral Palsy,0,6,3,6,9
Puducherry,Pondicherry,Cerebral Palsy,6,15,50,25,75
Puducherry,Pondicherry,Cerebral Palsy,15,35,149,85,234
Puducherry,Pondicherry,Cerebral Palsy,35,60,38,30,68
Puducherry,Pondicherry,Cerebral Palsy,60,80,3,5,8
Uttarakhand,Pithoragarh,Cerebral Palsy,0,6,2,0,2
Uttarakhand,Pithoragarh,Cerebral Palsy,6,15,1,0,1
Uttarakhand,Pithoragarh,Cerebral Palsy,15,35,0,3,3
Uttarakhand,Pithoragarh,Cerebral Palsy,35,60,0,1,1
Uttar Pradesh,Pilibhit,Cerebral Palsy,0,6,2,3,5
Uttar Pradesh,Pilibhit,Cerebral Palsy,6,15,43,17,60
Uttar Pradesh,Pilibhit,Cerebral Palsy,15,35,83,32,115
Uttar Pradesh,Pilibhit,Cerebral Palsy,35,60,49,23,72
Uttar Pradesh,Pilibhit,Cerebral Palsy,60,80,6,3,9
Nagaland,Phek,Cerebral Palsy,0,6,1,0,1
Nagaland,Phek,Cerebral Palsy,15,35,3,2,5
Tamil Nadu,Perambalur,Cerebral Palsy,0,6,3,2,5
Tamil Nadu,Perambalur,Cerebral Palsy,6,15,7,6,13
Tamil Nadu,Perambalur,Cerebral Palsy,15,35,45,18,63
Tamil Nadu,Perambalur,Cerebral Palsy,35,60,12,6,18
Tamil Nadu,Perambalur,Cerebral Palsy,60,80,0,1,1
Tamil Nadu,Perambalur,Cerebral Palsy,80,100,1,0,1
Uttarakhand,Pauri Garhwal,Cerebral Palsy,0,6,4,2,6
Uttarakhand,Pauri Garhwal,Cerebral Palsy,6,15,23,11,34
Uttarakhand,Pauri Garhwal,Cerebral Palsy,15,35,34,18,52
Uttarakhand,Pauri Garhwal,Cerebral Palsy,35,60,21,8,29
Uttarakhand,Pauri Garhwal,Cerebral Palsy,60,80,1,0,1
Uttarakhand,Pauri Garhwal,Cerebral Palsy,80,100,3,0,3
Bihar,Patna,Cerebral Palsy,0,6,36,28,64
Bihar,Patna,Cerebral Palsy,6,15,178,92,270
Bihar,Patna,Cerebral Palsy,15,35,142,54,196
Bihar,Patna,Cerebral Palsy,35,60,36,8,44
Bihar,Patna,Cerebral Palsy,60,80,3,3,6
Punjab,Patiala,Cerebral Palsy,0,6,53,22,75
Punjab,Patiala,Cerebral Palsy,6,15,156,93,249
Punjab,Patiala,Cerebral Palsy,15,35,245,120,365
Punjab,Patiala,Cerebral Palsy,35,60,92,59,151
Punjab,Patiala,Cerebral Palsy,60,80,12,3,15
Punjab,Pathankot,Cerebral Palsy,0,6,14,3,17
Punjab,Pathankot,Cerebral Palsy,6,15,129,53,182
Punjab,Pathankot,Cerebral Palsy,15,35,102,50,152
Punjab,Pathankot,Cerebral Palsy,35,60,22,17,39
Punjab,Pathankot,Cerebral Palsy,60,80,1,1,2
Kerala,Pathanamthitta,Cerebral Palsy,0,6,6,0,6
Kerala,Pathanamthitta,Cerebral Palsy,6,15,43,41,84
Kerala,Pathanamthitta,Cerebral Palsy,15,35,127,79,206
Kerala,Pathanamthitta,Cerebral Palsy,35,60,69,50,119
Kerala,Pathanamthitta,Cerebral Palsy,60,80,8,2,10
Gujarat,Patan,Cerebral Palsy,0,6,1,1,2
Gujarat,Patan,Cerebral Palsy,6,15,39,15,54
Gujarat,Patan,Cerebral Palsy,15,35,19,8,27
Gujarat,Patan,Cerebral Palsy,35,60,4,3,7
Gujarat,Patan,Cerebral Palsy,60,80,1,1,2
Bihar,Pashchim Champaran,Cerebral Palsy,0,6,74,40,114
Bihar,Pashchim Champaran,Cerebral Palsy,6,15,189,97,286
Bihar,Pashchim Champaran,Cerebral Palsy,15,35,173,63,236
Bihar,Pashchim Champaran,Cerebral Palsy,35,60,43,14,57
Bihar,Pashchim Champaran,Cerebral Palsy,60,80,13,1,14
Maharashtra,Parbhani,Cerebral Palsy,0,6,15,7,22
Maharashtra,Parbhani,Cerebral Palsy,6,15,52,29,81
Maharashtra,Parbhani,Cerebral Palsy,15,35,26,15,41
Maharashtra,Parbhani,Cerebral Palsy,35,60,7,5,12
Maharashtra,Parbhani,Cerebral Palsy,60,80,1,0,1
Arunachal Pradesh,Papum Pare,Cerebral Palsy,6,15,3,2,5
Arunachal Pradesh,Papum Pare,Cerebral Palsy,15,35,8,2,10
Arunachal Pradesh,Papum Pare,Cerebral Palsy,35,60,4,0,4
Madhya Pradesh,Panna,Cerebral Palsy,0,6,1,3,4
Madhya Pradesh,Panna,Cerebral Palsy,6,15,20,10,30
Madhya Pradesh,Panna,Cerebral Palsy,15,35,31,21,52
Madhya Pradesh,Panna,Cerebral Palsy,35,60,11,6,17
Madhya Pradesh,Panna,Cerebral Palsy,60,80,2,0,2
Haryana,Panipat,Cerebral Palsy,0,6,3,0,3
Haryana,Panipat,Cerebral Palsy,6,15,24,3,27
Haryana,Panipat,Cerebral Palsy,15,35,32,13,45
Haryana,Panipat,Cerebral Palsy,35,60,11,3,14
Haryana,Panipat,Cerebral Palsy,60,80,1,0,1
Haryana,Panchkula,Cerebral Palsy,0,6,8,0,8
Haryana,Panchkula,Cerebral Palsy,6,15,42,24,66
Haryana,Panchkula,Cerebral Palsy,15,35,75,31,106
Haryana,Panchkula,Cerebral Palsy,35,60,22,9,31
Haryana,Panchkula,Cerebral Palsy,60,80,2,0,2
Gujarat,Panch Mahals,Cerebral Palsy,0,6,39,27,66
Gujarat,Panch Mahals,Cerebral Palsy,6,15,102,89,191
Gujarat,Panch Mahals,Cerebral Palsy,15,35,51,22,73
Gujarat,Panch Mahals,Cerebral Palsy,35,60,3,1,4
Haryana,Palwal,Cerebral Palsy,0,6,8,1,9
Haryana,Palwal,Cerebral Palsy,6,15,66,28,94
Haryana,Palwal,Cerebral Palsy,15,35,40,9,49
Haryana,Palwal,Cerebral Palsy,35,60,8,2,10
Haryana,Palwal,Cerebral Palsy,80,100,1,0,1
Rajasthan,Pali,Cerebral Palsy,0,6,1,0,1
Rajasthan,Pali,Cerebral Palsy,6,15,13,3,16
Rajasthan,Pali,Cerebral Palsy,15,35,10,5,15
Rajasthan,Pali,Cerebral Palsy,35,60,1,1,2
Maharashtra,Palghar,Cerebral Palsy,0,6,13,0,13
Maharashtra,Palghar,Cerebral Palsy,6,15,118,87,205
Maharashtra,Palghar,Cerebral Palsy,15,35,107,72,179
Maharashtra,Palghar,Cerebral Palsy,35,60,32,16,48
Maharashtra,Palghar,Cerebral Palsy,60,80,2,0,2
Jharkhand,Palamu,Cerebral Palsy,0,6,17,11,28
Jharkhand,Palamu,Cerebral Palsy,6,15,102,66,168
Jharkhand,Palamu,Cerebral Palsy,15,35,109,61,170
Jharkhand,Palamu,Cerebral Palsy,35,60,38,19,57
Jharkhand,Palamu,Cerebral Palsy,60,80,9,2,11
Jharkhand,Palamu,Cerebral Palsy,80,100,1,0,1
Kerala,Palakkad,Cerebral Palsy,0,6,14,9,23
Kerala,Palakkad,Cerebral Palsy,6,15,158,102,260
Kerala,Palakkad,Cerebral Palsy,15,35,437,270,707
Kerala,Palakkad,Cerebral Palsy,35,60,122,82,204
Kerala,Palakkad,Cerebral Palsy,60,80,17,9,26
Kerala,Palakkad,Cerebral Palsy,80,100,0,1,1
Jharkhand,Pakur,Cerebral Palsy,6,15,14,11,25
Jharkhand,Pakur,Cerebral Palsy,15,35,21,10,31
Jharkhand,Pakur,Cerebral Palsy,35,60,4,2,6
Maharashtra,Osmanabad,Cerebral Palsy,6,15,3,5,8
Maharashtra,Osmanabad,Cerebral Palsy,15,35,5,4,9
Maharashtra,Osmanabad,Cerebral Palsy,35,60,7,0,7
Maharashtra,Osmanabad,Cerebral Palsy,60,80,1,0,1
Haryana,Nuh,Cerebral Palsy,6,15,3,6,9
Haryana,Nuh,Cerebral Palsy,15,35,3,0,3
Haryana,Nuh,Cerebral Palsy,35,60,1,1,2
Odisha,Nuapada,Cerebral Palsy,0,6,35,31,66
Odisha,Nuapada,Cerebral Palsy,6,15,54,45,99
Odisha,Nuapada,Cerebral Palsy,15,35,22,17,39
Odisha,Nuapada,Cerebral Palsy,35,60,1,6,7
Odisha,Nuapada,Cerebral Palsy,60,80,1,1,2
Delhi,North West,Cerebral Palsy,0,6,2,3,5
Delhi,North West,Cerebral Palsy,6,15,55,34,89
Delhi,North West,Cerebral Palsy,15,35,48,28,76
Delhi,North West,Cerebral Palsy,35,60,9,5,14
Delhi,North West,Cerebral Palsy,60,80,1,0,1
Tripura,North Tripura,Cerebral Palsy,0,6,0,4,4
Tripura,North Tripura,Cerebral Palsy,6,15,16,8,24
Tripura,North Tripura,Cerebral Palsy,15,35,9,9,18
Tripura,North Tripura,Cerebral Palsy,35,60,6,2,8
Goa,North Goa,Cerebral Palsy,0,6,3,3,6
Goa,North Goa,Cerebral Palsy,6,15,17,11,28
Goa,North Goa,Cerebral Palsy,15,35,41,39,80
Goa,North Goa,Cerebral Palsy,35,60,32,15,47
Goa,North Goa,Cerebral Palsy,60,80,2,1,3
Meghalaya,North Garo Hills,Cerebral Palsy,0,6,5,1,6
Meghalaya,North Garo Hills,Cerebral Palsy,6,15,20,10,30
Meghalaya,North Garo Hills,Cerebral Palsy,15,35,25,19,44
Meghalaya,North Garo Hills,Cerebral Palsy,35,60,4,2,6
Delhi,North East,Cerebral Palsy,0,6,4,2,6
Delhi,North East,Cerebral Palsy,6,15,31,18,49
Delhi,North East,Cerebral Palsy,15,35,46,28,74
Delhi,North East,Cerebral Palsy,35,60,7,3,10
Andaman And Nicobar Islands,North And Middle Andaman,Cerebral Palsy,0,6,3,3,6
Andaman And Nicobar Islands,North And Middle Andaman,Cerebral Palsy,6,15,10,7,17
Andaman And Nicobar Islands,North And Middle Andaman,Cerebral Palsy,15,35,12,7,19
Andaman And Nicobar Islands,North And Middle Andaman,Cerebral Palsy,35,60,9,5,14
Andaman And Nicobar Islands,North And Middle Andaman,Cerebral Palsy,60,80,1,0,1
Delhi,North,Cerebral Palsy,0,6,2,0,2
Delhi,North,Cerebral Palsy,6,15,2,4,6
Delhi,North,Cerebral Palsy,15,35,6,6,12
Delhi,North,Cerebral Palsy,35,60,2,1,3
Manipur,Noney,Cerebral Palsy,0,6,2,0,2
Manipur,Noney,Cerebral Palsy,6,15,3,3,6
Manipur,Noney,Cerebral Palsy,15,35,1,3,4
Manipur,Noney,Cerebral Palsy,35,60,1,2,3
Madhya Pradesh,Niwari,Cerebral Palsy,0,6,0,1,1
Madhya Pradesh,Niwari,Cerebral Palsy,6,15,24,17,41
Madhya Pradesh,Niwari,Cerebral Palsy,15,35,26,7,33
Madhya Pradesh,Niwari,Cerebral Palsy,35,60,3,7,10
Andaman And Nicobar Islands,Nicobars,Cerebral Palsy,6,15,6,3,9
Andaman And Nicobar Islands,Nicobars,Cerebral Palsy,15,35,1,1,2
Andaman And Nicobar Islands,Nicobars,Cerebral Palsy,35,60,0,1,1
Andaman And Nicobar Islands,Nicobars,Cerebral Palsy,80,100,1,0,1
Delhi,New Delhi,Cerebral Palsy,6,15,2,1,3
Delhi,New Delhi,Cerebral Palsy,15,35,3,1,4
Delhi,New Delhi,Cerebral Palsy,35,60,1,0,1
Madhya Pradesh,Neemuch,Cerebral Palsy,6,15,3,1,4
Madhya Pradesh,Neemuch,Cerebral Palsy,15,35,14,13,27
Madhya Pradesh,Neemuch,Cerebral Palsy,35,60,15,9,24
Madhya Pradesh,Neemuch,Cerebral Palsy,60,80,3,3,6
Madhya Pradesh,Neemuch,Cerebral Palsy,80,100,0,2,2
Odisha,Nayagarh,Cerebral Palsy,0,6,6,6,12
Odisha,Nayagarh,Cerebral Palsy,6,15,47,29,76
Odisha,Nayagarh,Cerebral Palsy,15,35,57,35,92
Odisha,Nayagarh,Cerebral Palsy,35,60,34,16,50
Odisha,Nayagarh,Cerebral Palsy,60,80,22,9,31
Odisha,Nayagarh,Cerebral Palsy,80,100,3,1,4
Bihar,Nawada,Cerebral Palsy,0,6,12,21,33
Bihar,Nawada,Cerebral Palsy,6,15,87,56,143
Bihar,Nawada,Cerebral Palsy,15,35,83,42,125
Bihar,Nawada,Cerebral Palsy,35,60,15,2,17
Bihar,Nawada,Cerebral Palsy,60,80,3,1,4
Gujarat,Navsari,Cerebral Palsy,6,15,3,0,3
Gujarat,Navsari,Cerebral Palsy,15,35,2,3,5
Gujarat,Navsari,Cerebral Palsy,35,60,1,0,1
Maharashtra,Nashik,Cerebral Palsy,0,6,23,15,38
Maharashtra,Nashik,Cerebral Palsy,6,15,155,121,276
Maharashtra,Nashik,Cerebral Palsy,15,35,217,90,307
Maharashtra,Nashik,Cerebral Palsy,35,60,78,27,105
Maharashtra,Nashik,Cerebral Palsy,60,80,7,1,8
Madhya Pradesh,Narsinghpur,Cerebral Palsy,0,6,9,6,15
Madhya Pradesh,Narsinghpur,Cerebral Palsy,6,15,38,30,68
Madhya Pradesh,Narsinghpur,Cerebral Palsy,15,35,47,23,70
Madhya Pradesh,Narsinghpur,Cerebral Palsy,35,60,26,7,33
Madhya Pradesh,Narsinghpur,Cerebral Palsy,60,80,5,4,9
Madhya Pradesh,Narsinghpur,Cerebral Palsy,80,100,1,0,1
Madhya Pradesh,Narmadapuram,Cerebral Palsy,0,6,0,1,1
Madhya Pradesh,Narmadapuram,Cerebral Palsy,6,15,32,14,46
Madhya Pradesh,Narmadapuram,Cerebral Palsy,15,35,42,19,61
Madhya Pradesh,Narmadapuram,Cerebral Palsy,35,60,20,8,28
Madhya Pradesh,Narmadapuram,Cerebral Palsy,60,80,2,1,3
Gujarat,Narmada,Cerebral Palsy,0,6,2,2,4
Gujarat,Narmada,Cerebral Palsy,6,15,16,11,27
Gujarat,Narmada,Cerebral Palsy,15,35,26,19,45
Gujarat,Narmada,Cerebral Palsy,35,60,11,5,16
Gujarat,Narmada,Cerebral Palsy,60,80,1,0,1
Chhattisgarh,Narayanpur,Cerebral Palsy,0,6,0,1,1
Chhattisgarh,Narayanpur,Cerebral Palsy,6,15,1,1,2
Chhattisgarh,Narayanpur,Cerebral Palsy,15,35,1,0,1
Maharashtra,Nandurbar,Cerebral Palsy,0,6,21,15,36
Maharashtra,Nandurbar,Cerebral Palsy,6,15,63,54,117
Maharashtra,Nandurbar,Cerebral Palsy,15,35,48,23,71
Maharashtra,Nandurbar,Cerebral Palsy,35,60,11,4,15
Maharashtra,Nandurbar,Cerebral Palsy,60,80,2,0,2
Maharashtra,Nanded,Cerebral Palsy,0,6,8,5,13
Maharashtra,Nanded,Cerebral Palsy,6,15,68,32,100
Maharashtra,Nanded,Cerebral Palsy,15,35,35,18,53
Maharashtra,Nanded,Cerebral Palsy,35,60,18,12,30
Maharashtra,Nanded,Cerebral Palsy,60,80,6,1,7
Maharashtra,Nanded,Cerebral Palsy,80,100,2,0,2
Arunachal Pradesh,Namsai,Cerebral Palsy,6,15,2,1,3
Arunachal Pradesh,Namsai,Cerebral Palsy,15,35,1,1,2
Arunachal Pradesh,Namsai,Cerebral Palsy,35,60,1,0,1
Arunachal Pradesh,Namsai,Cerebral Palsy,80,100,1,0,1
Sikkim,Namchi,Cerebral Palsy,0,6,0,2,2
Sikkim,Namchi,Cerebral Palsy,6,15,13,17,30
Sikkim,Namchi,Cerebral Palsy,15,35,27,15,42
Sikkim,Namchi,Cerebral Palsy,35,60,9,9,18
Tamil Nadu,Namakkal,Cerebral Palsy,0,6,10,6,16
Tamil Nadu,Namakkal,Cerebral Palsy,6,15,65,52,117
Tamil Nadu,Namakkal,Cerebral Palsy,15,35,109,96,205
Tamil Nadu,Namakkal,Cerebral Palsy,35,60,60,41,101
Tamil Nadu,Namakkal,Cerebral Palsy,60,80,11,3,14
Assam,Nalbari,Cerebral Palsy,0,6,42,28,70
Assam,Nalbari,Cerebral Palsy,6,15,129,77,206
Assam,Nalbari,Cerebral Palsy,15,35,124,91,215
Assam,Nalbari,Cerebral Palsy,35,60,28,13,41
Assam,Nalbari,Cerebral Palsy,60,80,0,1,1
Bihar,Nalanda,Cerebral Palsy,0,6,90,52,142
Bihar,Nalanda,Cerebral Palsy,6,15,206,113,319
Bihar,Nalanda,Cerebral Palsy,15,35,160,68,228
Bihar,Nalanda,Cerebral Palsy,35,60,44,17,61
Bihar,Nalanda,Cerebral Palsy,60,80,5,3,8
Uttarakhand,Nainital,Cerebral Palsy,0,6,15,8,23
Uttarakhand,Nainital,Cerebral Palsy,6,15,57,42,99
Uttarakhand,Nainital,Cerebral Palsy,15,35,71,36,107
Uttarakhand,Nainital,Cerebral Palsy,35,60,25,11,36
Uttarakhand,Nainital,Cerebral Palsy,60,80,1,0,1
Maharashtra,Nagpur,Cerebral Palsy,0,6,64,47,111
Maharashtra,Nagpur,Cerebral Palsy,6,15,139,69,208
Maharashtra,Nagpur,Cerebral Palsy,15,35,53,22,75
Maharashtra,Nagpur,Cerebral Palsy,35,60,5,8,13
Maharashtra,Nagpur,Cerebral Palsy,60,80,1,0,1
Rajasthan,Nagaur,Cerebral Palsy,0,6,25,13,38
Rajasthan,Nagaur,Cerebral Palsy,6,15,136,102,238
Rajasthan,Nagaur,Cerebral Palsy,15,35,162,76,238
Rajasthan,Nagaur,Cerebral Palsy,35,60,52,11,63
Rajasthan,Nagaur,Cerebral Palsy,60,80,5,2,7
Rajasthan,Nagaur,Cerebral Palsy,80,100,1,1,2
Tamil Nadu,Nagapattinam,Cerebral Palsy,0,6,5,3,8
Tamil Nadu,Nagapattinam,Cerebral Palsy,6,15,46,39,85
Tamil Nadu,Nagapattinam,Cerebral Palsy,15,35,158,70,228
Tamil Nadu,Nagapattinam,Cerebral Palsy,35,60,50,22,72
Tamil Nadu,Nagapattinam,Cerebral Palsy,60,80,8,0,8
Assam,Nagaon,Cerebral Palsy,0,6,70,67,137
Assam,Nagaon,Cerebral Palsy,6,15,129,78,207
Assam,Nagaon,Cerebral Palsy,15,35,59,31,90
Assam,Nagaon,Cerebral Palsy,35,60,7,6,13
Odisha,Nabarangpur,Cerebral Palsy,0,6,7,6,13
Odisha,Nabarangpur,Cerebral Palsy,6,15,52,21,73
Odisha,Nabarangpur,Cerebral Palsy,15,35,23,11,34
Odisha,Nabarangpur,Cerebral Palsy,35,60,12,9,21
Odisha,Nabarangpur,Cerebral Palsy,60,80,4,2,6
Odisha,Nabarangpur,Cerebral Palsy,80,100,1,1,2
Karnataka,Mysuru,Cerebral Palsy,0,6,22,18,40
Karnataka,Mysuru,Cerebral Palsy,6,15,121,70,191
Karnataka,Mysuru,Cerebral Palsy,15,35,214,125,339
Karnataka,Mysuru,Cerebral Palsy,35,60,119,54,173
Karnataka,Mysuru,Cerebral Palsy,60,80,10,5,15
Karnataka,Mysuru,Cerebral Palsy,80,100,1,0,1
Bihar,Muzaffarpur,Cerebral Palsy,0,6,50,26,76
Bihar,Muzaffarpur,Cerebral Palsy,6,15,168,110,278
Bihar,Muzaffarpur,Cerebral Palsy,15,35,88,28,116
Bihar,Muzaffarpur,Cerebral Palsy,35,60,23,8,31
Bihar,Muzaffarpur,Cerebral Palsy,60,80,5,0,5
Uttar Pradesh,Muzaffarnagar,Cerebral Palsy,0,6,9,5,14
Uttar Pradesh,Muzaffarnagar,Cerebral Palsy,6,15,58,24,82
Uttar Pradesh,Muzaffarnagar,Cerebral Palsy,15,35,123,53,176
Uttar Pradesh,Muzaffarnagar,Cerebral Palsy,35,60,42,10,52
Uttar Pradesh,Muzaffarnagar,Cerebral Palsy,60,80,7,1,8
West Bengal,Murshidabad,Cerebral Palsy,35,60,1,0,1
Bihar,Munger,Cerebral Palsy,0,6,75,49,124
Bihar,Munger,Cerebral Palsy,6,15,214,112,326
Bihar,Munger,Cerebral Palsy,15,35,161,88,249
Bihar,Munger,Cerebral Palsy,35,60,24,8,32
Bihar,Munger,Cerebral Palsy,60,80,2,1,3
Chhattisgarh,Mungeli,Cerebral Palsy,0,6,6,5,11
Chhattisgarh,Mungeli,Cerebral Palsy,6,15,66,44,110
Chhattisgarh,Mungeli,Cerebral Palsy,15,35,87,50,137
Chhattisgarh,Mungeli,Cerebral Palsy,35,60,29,13,42
Chhattisgarh,Mungeli,Cerebral Palsy,60,80,4,1,5
Maharashtra,Mumbai Suburban,Cerebral Palsy,0,6,12,8,20
Maharashtra,Mumbai Suburban,Cerebral Palsy,6,15,62,37,99
Maharashtra,Mumbai Suburban,Cerebral Palsy,15,35,34,16,50
Maharashtra,Mumbai Suburban,Cerebral Palsy,35,60,3,6,9
Maharashtra,Mumbai Suburban,Cerebral Palsy,60,80,2,2,4
Maharashtra,Mumbai,Cerebral Palsy,0,6,10,2,12
Maharashtra,Mumbai,Cerebral Palsy,6,15,59,41,100
Maharashtra,Mumbai,Cerebral Palsy,15,35,104,54,158
Maharashtra,Mumbai,Cerebral Palsy,35,60,45,15,60
Maharashtra,Mumbai,Cerebral Palsy,60,80,6,3,9
Madhya Pradesh,Morena,Cerebral Palsy,0,6,38,36,74
Madhya Pradesh,Morena,Cerebral Palsy,6,15,237,82,319
Madhya Pradesh,Morena,Cerebral Palsy,15,35,201,57,258
Madhya Pradesh,Morena,Cerebral Palsy,35,60,66,12,78
Madhya Pradesh,Morena,Cerebral Palsy,60,80,12,3,15
Madhya Pradesh,Morena,Cerebral Palsy,80,100,0,1,1
Gujarat,Morbi,Cerebral Palsy,0,6,8,7,15
Gujarat,Morbi,Cerebral Palsy,6,15,19,7,26
Gujarat,Morbi,Cerebral Palsy,15,35,25,9,34
Gujarat,Morbi,Cerebral Palsy,35,60,4,1,5
Uttar Pradesh,Moradabad,Cerebral Palsy,0,6,3,1,4
Uttar Pradesh,Moradabad,Cerebral Palsy,6,15,29,11,40
Uttar Pradesh,Moradabad,Cerebral Palsy,15,35,42,19,61
Uttar Pradesh,Moradabad,Cerebral Palsy,35,60,5,5,10
Uttar Pradesh,Moradabad,Cerebral Palsy,60,80,2,0,2
Uttar Pradesh,Moradabad,Cerebral Palsy,80,100,1,0,1
Nagaland,Mon,Cerebral Palsy,6,15,2,1,3
Nagaland,Mon,Cerebral Palsy,15,35,5,2,7
Nagaland,Mokokchung,Cerebral Palsy,0,6,3,0,3
Nagaland,Mokokchung,Cerebral Palsy,6,15,9,7,16
Nagaland,Mokokchung,Cerebral Palsy,15,35,14,12,26
Nagaland,Mokokchung,Cerebral Palsy,35,60,5,3,8
Nagaland,Mokokchung,Cerebral Palsy,60,80,1,0,1
Punjab,Moga,Cerebral Palsy,0,6,3,3,6
Punjab,Moga,Cerebral Palsy,6,15,22,12,34
Punjab,Moga,Cerebral Palsy,15,35,30,21,51
Punjab,Moga,Cerebral Palsy,35,60,17,10,27
Punjab,Moga,Cerebral Palsy,60,80,4,1,5
Uttar Pradesh,Mirzapur,Cerebral Palsy,0,6,10,6,16
Uttar Pradesh,Mirzapur,Cerebral Palsy,6,15,90,36,126
Uttar Pradesh,Mirzapur,Cerebral Palsy,15,35,200,74,274
Uttar Pradesh,Mirzapur,Cerebral Palsy,35,60,70,25,95
Uttar Pradesh,Mirzapur,Cerebral Palsy,60,80,14,1,15
Uttar Pradesh,Meerut,Cerebral Palsy,0,6,6,2,8
Uttar Pradesh,Meerut,Cerebral Palsy,6,15,114,51,165
Uttar Pradesh,Meerut,Cerebral Palsy,15,35,221,83,304
Uttar Pradesh,Meerut,Cerebral Palsy,35,60,51,17,68
Uttar Pradesh,Meerut,Cerebral Palsy,60,80,12,1,13
Uttar Pradesh,Meerut,Cerebral Palsy,80,100,1,0,1
Odisha,Mayurbhanj,Cerebral Palsy,0,6,101,79,180
Odisha,Mayurbhanj,Cerebral Palsy,6,15,345,260,605
Odisha,Mayurbhanj,Cerebral Palsy,15,35,319,307,626
Odisha,Mayurbhanj,Cerebral Palsy,35,60,161,108,269
Odisha,Mayurbhanj,Cerebral Palsy,60,80,14,14,28
Odisha,Mayurbhanj,Cerebral Palsy,80,100,0,1,1
Tamil Nadu,Mayiladuthurai,Cerebral Palsy,0,6,6,4,10
Tamil Nadu,Mayiladuthurai,Cerebral Palsy,6,15,9,8,17
Tamil Nadu,Mayiladuthurai,Cerebral Palsy,15,35,16,9,25
Tamil Nadu,Mayiladuthurai,Cerebral Palsy,35,60,5,2,7
Tamil Nadu,Mayiladuthurai,Cerebral Palsy,60,80,1,0,1
Tamil Nadu,Mayiladuthurai,Cerebral Palsy,80,100,1,0,1
Uttar Pradesh,Mau,Cerebral Palsy,0,6,38,16,54
Uttar Pradesh,Mau,Cerebral Palsy,6,15,167,102,269
Uttar Pradesh,Mau,Cerebral Palsy,15,35,286,120,406
Uttar Pradesh,Mau,Cerebral Palsy,35,60,46,22,68
Uttar Pradesh,Mau,Cerebral Palsy,60,80,8,2,10
Uttar Pradesh,Mau,Cerebral Palsy,80,100,1,0,1
Uttar Pradesh,Mathura,Cerebral Palsy,0,6,20,9,29
Uttar Pradesh,Mathura,Cerebral Palsy,6,15,111,43,154
Uttar Pradesh,Mathura,Cerebral Palsy,15,35,137,51,188
Uttar Pradesh,Mathura,Cerebral Palsy,35,60,23,5,28
Uttar Pradesh,Mathura,Cerebral Palsy,60,80,3,0,3
Assam,Marigaon,Cerebral Palsy,0,6,30,28,58
Assam,Marigaon,Cerebral Palsy,6,15,84,43,127
Assam,Marigaon,Cerebral Palsy,15,35,77,33,110
Assam,Marigaon,Cerebral Palsy,35,60,5,10,15
Punjab,Mansa,Cerebral Palsy,0,6,13,9,22
Punjab,Mansa,Cerebral Palsy,6,15,59,24,83
Punjab,Mansa,Cerebral Palsy,15,35,75,42,117
Punjab,Mansa,Cerebral Palsy,35,60,26,17,43
Punjab,Mansa,Cerebral Palsy,60,80,2,1,3
Sikkim,Mangan,Cerebral Palsy,6,15,5,2,7
Sikkim,Mangan,Cerebral Palsy,15,35,2,0,2
Karnataka,Mandya,Cerebral Palsy,0,6,24,12,36
Karnataka,Mandya,Cerebral Palsy,6,15,63,54,117
Karnataka,Mandya,Cerebral Palsy,15,35,91,53,144
Karnataka,Mandya,Cerebral Palsy,35,60,42,17,59
Karnataka,Mandya,Cerebral Palsy,60,80,7,2,9
Madhya Pradesh,Mandsaur,Cerebral Palsy,0,6,2,1,3
Madhya Pradesh,Mandsaur,Cerebral Palsy,6,15,155,75,230
Madhya Pradesh,Mandsaur,Cerebral Palsy,15,35,184,110,294
Madhya Pradesh,Mandsaur,Cerebral Palsy,35,60,24,13,37
Madhya Pradesh,Mandsaur,Cerebral Palsy,60,80,0,1,1
Madhya Pradesh,Mandla,Cerebral Palsy,0,6,8,8,16
Madhya Pradesh,Mandla,Cerebral Palsy,6,15,113,74,187
Madhya Pradesh,Mandla,Cerebral Palsy,15,35,99,43,142
Madhya Pradesh,Mandla,Cerebral Palsy,35,60,21,14,35
Madhya Pradesh,Mandla,Cerebral Palsy,60,80,5,3,8
Himachal Pradesh,Mandi,Cerebral Palsy,0,6,27,22,49
Himachal Pradesh,Mandi,Cerebral Palsy,6,15,62,36,98
Himachal Pradesh,Mandi,Cerebral Palsy,15,35,69,27,96
Himachal Pradesh,Mandi,Cerebral Palsy,35,60,37,10,47
Himachal Pradesh,Mandi,Cerebral Palsy,60,80,1,2,3
Himachal Pradesh,Mandi,Cerebral Palsy,80,100,0,1,1
Mizoram,Mamit,Cerebral Palsy,0,6,2,1,3
Mizoram,Mamit,Cerebral Palsy,6,15,5,4,9
Mizoram,Mamit,Cerebral Palsy,15,35,1,3,4
Mizoram,Mamit,Cerebral Palsy,35,60,0,1,1
Odisha,Malkangiri,Cerebral Palsy,0,6,19,8,27
Odisha,Malkangiri,Cerebral Palsy,6,15,28,20,48
Odisha,Malkangiri,Cerebral Palsy,15,35,17,8,25
Odisha,Malkangiri,Cerebral Palsy,35,60,6,2,8
Odisha,Malkangiri,Cerebral Palsy,60,80,0,1,1
Punjab,Malerkotla,Cerebral Palsy,0,6,3,3,6
Punjab,Malerkotla,Cerebral Palsy,6,15,12,6,18
Punjab,Malerkotla,Cerebral Palsy,15,35,5,9,14
Punjab,Malerkotla,Cerebral Palsy,35,60,6,4,10
Punjab,Malerkotla,Cerebral Palsy,60,80,0,1,1
Kerala,Malappuram,Cerebral Palsy,0,6,46,37,83
Kerala,Malappuram,Cerebral Palsy,6,15,193,115,308
Kerala,Malappuram,Cerebral Palsy,15,35,260,175,435
Kerala,Malappuram,Cerebral Palsy,35,60,74,48,122
Kerala,Malappuram,Cerebral Palsy,60,80,13,6,19
Kerala,Malappuram,Cerebral Palsy,80,100,2,0,2
Assam,Majuli,Cerebral Palsy,6,15,12,4,16
Assam,Majuli,Cerebral Palsy,15,35,5,0,5
Assam,Majuli,Cerebral Palsy,35,60,4,2,6
Assam,Majuli,Cerebral Palsy,60,80,0,1,1
Uttar Pradesh,Mainpuri,Cerebral Palsy,0,6,23,9,32
Uttar Pradesh,Mainpuri,Cerebral Palsy,6,15,237,120,357
Uttar Pradesh,Mainpuri,Cerebral Palsy,15,35,162,69,231
Uttar Pradesh,Mainpuri,Cerebral Palsy,35,60,32,9,41
Uttar Pradesh,Mainpuri,Cerebral Palsy,60,80,4,2,6
Uttar Pradesh,Mahoba,Cerebral Palsy,0,6,3,0,3
Uttar Pradesh,Mahoba,Cerebral Palsy,6,15,18,7,25
Uttar Pradesh,Mahoba,Cerebral Palsy,15,35,32,15,47
Uttar Pradesh,Mahoba,Cerebral Palsy,35,60,22,8,30
Uttar Pradesh,Mahoba,Cerebral Palsy,60,80,3,1,4
Gujarat,Mahisagar,Cerebral Palsy,0,6,22,8,30
Gujarat,Mahisagar,Cerebral Palsy,6,15,90,62,152
Gujarat,Mahisagar,Cerebral Palsy,15,35,85,31,116
Gujarat,Mahisagar,Cerebral Palsy,35,60,24,9,33
Gujarat,Mahisagar,Cerebral Palsy,60,80,2,0,2
Gujarat,Mahesana,Cerebral Palsy,0,6,4,8,12
Gujarat,Mahesana,Cerebral Palsy,6,15,64,18,82
Gujarat,Mahesana,Cerebral Palsy,15,35,74,21,95
Gujarat,Mahesana,Cerebral Palsy,35,60,19,3,22
Haryana,Mahendragarh,Cerebral Palsy,0,6,1,1,2
Haryana,Mahendragarh,Cerebral Palsy,6,15,10,2,12
Haryana,Mahendragarh,Cerebral Palsy,15,35,25,6,31
Haryana,Mahendragarh,Cerebral Palsy,35,60,18,4,22
Haryana,Mahendragarh,Cerebral Palsy,60,80,2,1,3
Puducherry,Mahe,Cerebral Palsy,0,6,1,2,3
Puducherry,Mahe,Cerebral Palsy,6,15,0,1,1
Puducherry,Mahe,Cerebral Palsy,15,35,9,7,16
Puducherry,Mahe,Cerebral Palsy,35,60,1,2,3
Puducherry,Mahe,Cerebral Palsy,60,80,1,1,2
Chhattisgarh,Mahasamund,Cerebral Palsy,0,6,0,3,3
Chhattisgarh,Mahasamund,Cerebral Palsy,6,15,49,30,79
Chhattisgarh,Mahasamund,Cerebral Palsy,15,35,100,82,182
Chhattisgarh,Mahasamund,Cerebral Palsy,35,60,47,13,60
Chhattisgarh,Mahasamund,Cerebral Palsy,60,80,12,4,16
Chhattisgarh,Mahasamund,Cerebral Palsy,80,100,1,0,1
Uttar Pradesh,Maharajganj,Cerebral Palsy,0,6,31,8,39
Uttar Pradesh,Maharajganj,Cerebral Palsy,6,15,96,52,148
Uttar Pradesh,Maharajganj,Cerebral Palsy,15,35,147,80,227
Uttar Pradesh,Maharajganj,Cerebral Palsy,35,60,42,9,51
Uttar Pradesh,Maharajganj,Cerebral Palsy,60,80,8,1,9
Uttar Pradesh,Maharajganj,Cerebral Palsy,80,100,1,0,1
Tamil Nadu,Madurai,Cerebral Palsy,0,6,16,7,23
Tamil Nadu,Madurai,Cerebral Palsy,6,15,131,79,210
Tamil Nadu,Madurai,Cerebral Palsy,15,35,188,112,300
Tamil Nadu,Madurai,Cerebral Palsy,35,60,42,31,73
Tamil Nadu,Madurai,Cerebral Palsy,60,80,10,1,11
Bihar,Madhubani,Cerebral Palsy,0,6,5,4,9
Bihar,Madhubani,Cerebral Palsy,6,15,22,10,32
Bihar,Madhubani,Cerebral Palsy,15,35,32,17,49
Bihar,Madhubani,Cerebral Palsy,35,60,17,1,18
Bihar,Madhubani,Cerebral Palsy,60,80,0,2,2
Bihar,Madhepura,Cerebral Palsy,0,6,20,2,22
Bihar,Madhepura,Cerebral Palsy,6,15,50,32,82
Bihar,Madhepura,Cerebral Palsy,15,35,72,27,99
Bihar,Madhepura,Cerebral Palsy,35,60,42,14,56
Bihar,Madhepura,Cerebral Palsy,60,80,13,5,18
Mizoram,Lunglei,Cerebral Palsy,0,6,0,1,1
Mizoram,Lunglei,Cerebral Palsy,6,15,3,1,4
Mizoram,Lunglei,Cerebral Palsy,15,35,2,1,3
Punjab,Ludhiana,Cerebral Palsy,0,6,20,10,30
Punjab,Ludhiana,Cerebral Palsy,6,15,225,91,316
Punjab,Ludhiana,Cerebral Palsy,15,35,428,193,621
Punjab,Ludhiana,Cerebral Palsy,35,60,165,87,252
Punjab,Ludhiana,Cerebral Palsy,60,80,23,14,37
Punjab,Ludhiana,Cerebral Palsy,80,100,2,0,2
Uttar Pradesh,Lucknow,Cerebral Palsy,0,6,23,8,31
Uttar Pradesh,Lucknow,Cerebral Palsy,6,15,91,70,161
Uttar Pradesh,Lucknow,Cerebral Palsy,15,35,143,78,221
Uttar Pradesh,Lucknow,Cerebral Palsy,35,60,105,21,126
Uttar Pradesh,Lucknow,Cerebral Palsy,60,80,29,3,32
Arunachal Pradesh,Lower Dibang Valley,Cerebral Palsy,6,15,1,3,4
Arunachal Pradesh,Lower Dibang Valley,Cerebral Palsy,15,35,0,2,2
Arunachal Pradesh,Longding,Cerebral Palsy,6,15,2,1,3
Arunachal Pradesh,Longding,Cerebral Palsy,15,35,3,3,6
Jharkhand,Lohardaga,Cerebral Palsy,0,6,2,5,7
Jharkhand,Lohardaga,Cerebral Palsy,6,15,53,44,97
Jharkhand,Lohardaga,Cerebral Palsy,15,35,85,45,130
Jharkhand,Lohardaga,Cerebral Palsy,35,60,26,17,43
Jharkhand,Lohardaga,Cerebral Palsy,60,80,10,3,13
Jharkhand,Lohardaga,Cerebral Palsy,80,100,1,1,2
Ladakh,Leh Ladakh,Cerebral Palsy,0,6,0,2,2
Ladakh,Leh Ladakh,Cerebral Palsy,6,15,4,8,12
Ladakh,Leh Ladakh,Cerebral Palsy,15,35,6,3,9
Ladakh,Leh Ladakh,Cerebral Palsy,35,60,0,3,3
Mizoram,Lawngtlai,Cerebral Palsy,6,15,0,1,1
Mizoram,Lawngtlai,Cerebral Palsy,15,35,1,0,1
Mizoram,Lawngtlai,Cerebral Palsy,35,60,1,0,1
Maharashtra,Latur,Cerebral Palsy,0,6,34,24,58
Maharashtra,Latur,Cerebral Palsy,6,15,141,76,217
Maharashtra,Latur,Cerebral Palsy,15,35,92,67,159
Maharashtra,Latur,Cerebral Palsy,35,60,35,14,49
Maharashtra,Latur,Cerebral Palsy,60,80,12,2,14
Jharkhand,Latehar,Cerebral Palsy,0,6,8,4,12
Jharkhand,Latehar,Cerebral Palsy,6,15,24,10,34
Jharkhand,Latehar,Cerebral Palsy,15,35,15,12,27
Uttar Pradesh,Lalitpur,Cerebral Palsy,0,6,4,0,4
Uttar Pradesh,Lalitpur,Cerebral Palsy,6,15,35,16,51
Uttar Pradesh,Lalitpur,Cerebral Palsy,15,35,32,14,46
Uttar Pradesh,Lalitpur,Cerebral Palsy,35,60,20,5,25
Uttar Pradesh,Lalitpur,Cerebral Palsy,60,80,2,1,3
Lakshadweep,Lakshadweep District,Cerebral Palsy,6,15,1,0,1
Lakshadweep,Lakshadweep District,Cerebral Palsy,15,35,1,1,2
Lakshadweep,Lakshadweep District,Cerebral Palsy,35,60,2,0,2
Bihar,Lakhisarai,Cerebral Palsy,0,6,6,3,9
Bihar,Lakhisarai,Cerebral Palsy,6,15,51,26,77
Bihar,Lakhisarai,Cerebral Palsy,15,35,39,27,66
Bihar,Lakhisarai,Cerebral Palsy,35,60,19,3,22
Assam,Lakhimpur,Cerebral Palsy,0,6,84,72,156
Assam,Lakhimpur,Cerebral Palsy,6,15,147,79,226
Assam,Lakhimpur,Cerebral Palsy,15,35,56,41,97
Assam,Lakhimpur,Cerebral Palsy,35,60,11,6,17
Assam,Lakhimpur,Cerebral Palsy,60,80,2,1,3
Himachal Pradesh,Lahul And Spiti,Cerebral Palsy,6,15,4,2,6
Himachal Pradesh,Lahul And Spiti,Cerebral Palsy,15,35,0,5,5
Himachal Pradesh,Lahul And Spiti,Cerebral Palsy,35,60,2,1,3
Uttar Pradesh,Kushi Nagar,Cerebral Palsy,0,6,33,18,51
Uttar Pradesh,Kushi Nagar,Cerebral Palsy,6,15,130,64,194
Uttar Pradesh,Kushi Nagar,Cerebral Palsy,15,35,214,62,276
Uttar Pradesh,Kushi Nagar,Cerebral Palsy,35,60,68,22,90
Uttar Pradesh,Kushi Nagar,Cerebral Palsy,60,80,11,3,14
Haryana,Kurukshetra,Cerebral Palsy,0,6,12,10,22
Haryana,Kurukshetra,Cerebral Palsy,6,15,33,20,53
Haryana,Kurukshetra,Cerebral Palsy,15,35,57,23,80
Haryana,Kurukshetra,Cerebral Palsy,35,60,24,9,33
Haryana,Kurukshetra,Cerebral Palsy,60,80,0,1,1
Andhra Pradesh,Kurnool,Cerebral Palsy,0,6,5,3,8
Andhra Pradesh,Kurnool,Cerebral Palsy,6,15,5,2,7
Andhra Pradesh,Kurnool,Cerebral Palsy,15,35,10,4,14
Andhra Pradesh,Kurnool,Cerebral Palsy,35,60,12,3,15
Andhra Pradesh,Kurnool,Cerebral Palsy,60,80,2,0,2
Jammu And Kashmir,Kupwara,Cerebral Palsy,0,6,66,56,122
Jammu And Kashmir,Kupwara,Cerebral Palsy,6,15,161,115,276
Jammu And Kashmir,Kupwara,Cerebral Palsy,15,35,176,144,320
Jammu And Kashmir,Kupwara,Cerebral Palsy,35,60,32,20,52
Jammu And Kashmir,Kupwara,Cerebral Palsy,60,80,6,1,7
Himachal Pradesh,Kullu,Cerebral Palsy,0,6,3,1,4
Himachal Pradesh,Kullu,Cerebral Palsy,6,15,2,0,2
Himachal Pradesh,Kullu,Cerebral Palsy,15,35,1,3,4
Himachal Pradesh,Kullu,Cerebral Palsy,35,60,2,0,2
Himachal Pradesh,Kullu,Cerebral Palsy,60,80,0,1,1
Jammu And Kashmir,Kulgam,Cerebral Palsy,0,6,37,19,56
Jammu And Kashmir,Kulgam,Cerebral Palsy,6,15,89,45,134
Jammu And Kashmir,Kulgam,Cerebral Palsy,15,35,43,16,59
Jammu And Kashmir,Kulgam,Cerebral Palsy,35,60,6,2,8
Tamil Nadu,Krishnagiri,Cerebral Palsy,0,6,13,11,24
Tamil Nadu,Krishnagiri,Cerebral Palsy,6,15,110,76,186
Tamil Nadu,Krishnagiri,Cerebral Palsy,15,35,108,56,164
Tamil Nadu,Krishnagiri,Cerebral Palsy,35,60,30,9,39
Tamil Nadu,Krishnagiri,Cerebral Palsy,60,80,5,0,5
Tamil Nadu,Krishnagiri,Cerebral Palsy,80,100,2,1,3
Andhra Pradesh,Krishna,Cerebral Palsy,6,15,1,1,2
Andhra Pradesh,Krishna,Cerebral Palsy,15,35,2,1,3
Andhra Pradesh,Krishna,Cerebral Palsy,35,60,2,0,2
Kerala,Kozhikode,Cerebral Palsy,0,6,24,20,44
Kerala,Kozhikode,Cerebral Palsy,6,15,140,123,263
Kerala,Kozhikode,Cerebral Palsy,15,35,346,225,571
Kerala,Kozhikode,Cerebral Palsy,35,60,171,122,293
Kerala,Kozhikode,Cerebral Palsy,60,80,26,12,38
Kerala,Kozhikode,Cerebral Palsy,80,100,0,1,1
Kerala,Kottayam,Cerebral Palsy,0,6,5,5,10
Kerala,Kottayam,Cerebral Palsy,6,15,69,50,119
Kerala,Kottayam,Cerebral Palsy,15,35,212,149,361
Kerala,Kottayam,Cerebral Palsy,35,60,117,78,195
Kerala,Kottayam,Cerebral Palsy,60,80,10,4,14
Rajasthan,Kota,Cerebral Palsy,0,6,2,1,3
Rajasthan,Kota,Cerebral Palsy,6,15,9,1,10
Rajasthan,Kota,Cerebral Palsy,15,35,16,12,28
Rajasthan,Kota,Cerebral Palsy,35,60,13,1,14
Rajasthan,Kota,Cerebral Palsy,60,80,4,1,5
Rajasthan,Kota,Cerebral Palsy,80,100,1,0,1
Chhattisgarh,Korea,Cerebral Palsy,0,6,4,1,5
Chhattisgarh,Korea,Cerebral Palsy,6,15,41,24,65
Chhattisgarh,Korea,Cerebral Palsy,15,35,43,37,80
Chhattisgarh,Korea,Cerebral Palsy,35,60,4,5,9
Chhattisgarh,Korba,Cerebral Palsy,0,6,4,11,15
Chhattisgarh,Korba,Cerebral Palsy,6,15,70,39,109
Chhattisgarh,Korba,Cerebral Palsy,15,35,109,77,186
Chhattisgarh,Korba,Cerebral Palsy,35,60,19,17,36
Chhattisgarh,Korba,Cerebral Palsy,60,80,3,0,3
Chhattisgarh,Korba,Cerebral Palsy,80,100,0,1,1
Odisha,Koraput,Cerebral Palsy,0,6,2,1,3
Odisha,Koraput,Cerebral Palsy,6,15,3,5,8
Odisha,Koraput,Cerebral Palsy,15,35,3,3,6
Odisha,Koraput,Cerebral Palsy,35,60,6,3,9
Odisha,Koraput,Cerebral Palsy,60,80,1,0,1
Karnataka,Koppal,Cerebral Palsy,0,6,23,14,37
Karnataka,Koppal,Cerebral Palsy,6,15,73,46,119
Karnataka,Koppal,Cerebral Palsy,15,35,54,22,76
Karnataka,Koppal,Cerebral Palsy,35,60,22,4,26
Karnataka,Koppal,Cerebral Palsy,60,80,5,2,7
Chhattisgarh,Kondagaon,Cerebral Palsy,0,6,14,12,26
Chhattisgarh,Kondagaon,Cerebral Palsy,6,15,85,92,177
Chhattisgarh,Kondagaon,Cerebral Palsy,15,35,88,54,142
Chhattisgarh,Kondagaon,Cerebral Palsy,35,60,18,11,29
Chhattisgarh,Kondagaon,Cerebral Palsy,60,80,0,1,1
Chhattisgarh,Kondagaon,Cerebral Palsy,80,100,0,1,1
Kerala,Kollam,Cerebral Palsy,0,6,10,8,18
Kerala,Kollam,Cerebral Palsy,6,15,92,47,139
Kerala,Kollam,Cerebral Palsy,15,35,187,131,318
Kerala,Kollam,Cerebral Palsy,35,60,97,78,175
Kerala,Kollam,Cerebral Palsy,60,80,15,8,23
Kerala,Kollam,Cerebral Palsy,80,100,0,1,1
Maharashtra,Kolhapur,Cerebral Palsy,0,6,22,18,40
Maharashtra,Kolhapur,Cerebral Palsy,6,15,157,81,238
Maharashtra,Kolhapur,Cerebral Palsy,15,35,458,210,668
Maharashtra,Kolhapur,Cerebral Palsy,35,60,219,105,324
Maharashtra,Kolhapur,Cerebral Palsy,60,80,44,7,51
Maharashtra,Kolhapur,Cerebral Palsy,80,100,2,0,2
Mizoram,Kolasib,Cerebral Palsy,0,6,2,2,4
Mizoram,Kolasib,Cerebral Palsy,6,15,5,4,9
Mizoram,Kolasib,Cerebral Palsy,15,35,5,4,9
Mizoram,Kolasib,Cerebral Palsy,35,60,1,0,1
Karnataka,Kolar,Cerebral Palsy,0,6,26,17,43
Karnataka,Kolar,Cerebral Palsy,6,15,98,58,156
Karnataka,Kolar,Cerebral Palsy,15,35,175,109,284
Karnataka,Kolar,Cerebral Palsy,35,60,86,27,113
Karnataka,Kolar,Cerebral Palsy,60,80,17,7,24
Assam,Kokrajhar,Cerebral Palsy,0,6,62,36,98
Assam,Kokrajhar,Cerebral Palsy,6,15,167,107,274
Assam,Kokrajhar,Cerebral Palsy,15,35,161,107,268
Assam,Kokrajhar,Cerebral Palsy,35,60,30,18,48
Assam,Kokrajhar,Cerebral Palsy,60,80,2,3,5
Nagaland,Kohima,Cerebral Palsy,0,6,3,1,4
Nagaland,Kohima,Cerebral Palsy,6,15,9,6,15
Nagaland,Kohima,Cerebral Palsy,15,35,22,8,30
Nagaland,Kohima,Cerebral Palsy,35,60,5,1,6
Nagaland,Kohima,Cerebral Palsy,60,80,1,0,1
Jharkhand,Koderma,Cerebral Palsy,0,6,28,8,36
Jharkhand,Koderma,Cerebral Palsy,6,15,203,88,291
Jharkhand,Koderma,Cerebral Palsy,15,35,170,85,255
Jharkhand,Koderma,Cerebral Palsy,35,60,125,30,155
Jharkhand,Koderma,Cerebral Palsy,60,80,40,7,47
Jharkhand,Koderma,Cerebral Palsy,80,100,1,0,1
Karnataka,Kodagu,Cerebral Palsy,0,6,2,2,4
Karnataka,Kodagu,Cerebral Palsy,6,15,10,1,11
Karnataka,Kodagu,Cerebral Palsy,15,35,16,12,28
Karnataka,Kodagu,Cerebral Palsy,35,60,7,5,12
Jammu And Kashmir,Kishtwar,Cerebral Palsy,0,6,0,1,1
Jammu And Kashmir,Kishtwar,Cerebral Palsy,6,15,4,3,7
Jammu And Kashmir,Kishtwar,Cerebral Palsy,15,35,10,5,15
Jammu And Kashmir,Kishtwar,Cerebral Palsy,35,60,11,3,14
Jammu And Kashmir,Kishtwar,Cerebral Palsy,60,80,0,2,2
Bihar,Kishanganj,Cerebral Palsy,0,6,28,17,45
Bihar,Kishanganj,Cerebral Palsy,6,15,193,113,306
Bihar,Kishanganj,Cerebral Palsy,15,35,135,61,196
Bihar,Kishanganj,Cerebral Palsy,35,60,16,9,25
Bihar,Kishanganj,Cerebral Palsy,60,80,1,2,3
Himachal Pradesh,Kinnaur,Cerebral Palsy,6,15,0,1,1
Himachal Pradesh,Kinnaur,Cerebral Palsy,15,35,1,0,1
Jharkhand,Khunti,Cerebral Palsy,6,15,10,8,18
Jharkhand,Khunti,Cerebral Palsy,15,35,5,7,12
Jharkhand,Khunti,Cerebral Palsy,35,60,7,2,9
Jharkhand,Khunti,Cerebral Palsy,60,80,1,0,1
Odisha,Khordha,Cerebral Palsy,0,6,54,34,88
Odisha,Khordha,Cerebral Palsy,6,15,178,80,258
Odisha,Khordha,Cerebral Palsy,15,35,171,106,277
Odisha,Khordha,Cerebral Palsy,35,60,49,23,72
Odisha,Khordha,Cerebral Palsy,60,80,10,4,14
Uttar Pradesh,Kheri,Cerebral Palsy,0,6,35,28,63
Uttar Pradesh,Kheri,Cerebral Palsy,6,15,210,130,340
Uttar Pradesh,Kheri,Cerebral Palsy,15,35,117,45,162
Uttar Pradesh,Kheri,Cerebral Palsy,35,60,84,32,116
Uttar Pradesh,Kheri,Cerebral Palsy,60,80,22,6,28
Gujarat,Kheda,Cerebral Palsy,15,35,1,1,2
Mizoram,Khawzawl,Cerebral Palsy,6,15,2,2,4
Mizoram,Khawzawl,Cerebral Palsy,15,35,4,2,6
Mizoram,Khawzawl,Cerebral Palsy,35,60,3,1,4
Madhya Pradesh,Khargone,Cerebral Palsy,0,6,4,2,6
Madhya Pradesh,Khargone,Cerebral Palsy,6,15,56,38,94
Madhya Pradesh,Khargone,Cerebral Palsy,15,35,44,27,71
Madhya Pradesh,Khargone,Cerebral Palsy,35,60,22,5,27
Madhya Pradesh,Khargone,Cerebral Palsy,60,80,4,1,5
Bihar,Khagaria,Cerebral Palsy,0,6,29,10,39
Bihar,Khagaria,Cerebral Palsy,6,15,66,24,90
Bihar,Khagaria,Cerebral Palsy,15,35,33,14,47
Bihar,Khagaria,Cerebral Palsy,35,60,8,3,11
Bihar,Khagaria,Cerebral Palsy,60,80,1,0,1
Odisha,Kendujhar,Cerebral Palsy,0,6,68,38,106
Odisha,Kendujhar,Cerebral Palsy,6,15,240,164,404
Odisha,Kendujhar,Cerebral Palsy,15,35,135,80,215
Odisha,Kendujhar,Cerebral Palsy,35,60,12,10,22
Odisha,Kendujhar,Cerebral Palsy,60,80,0,1,1
Odisha,Kendrapara,Cerebral Palsy,0,6,41,20,61
Odisha,Kendrapara,Cerebral Palsy,6,15,113,53,166
Odisha,Kendrapara,Cerebral Palsy,15,35,41,25,66
Odisha,Kendrapara,Cerebral Palsy,35,60,10,5,15
Odisha,Kendrapara,Cerebral Palsy,60,80,1,0,1
Odisha,Kendrapara,Cerebral Palsy,80,100,0,1,1
Uttar Pradesh,Kaushambi,Cerebral Palsy,0,6,8,6,14
Uttar Pradesh,Kaushambi,Cerebral Palsy,6,15,81,47,128
Uttar Pradesh,Kaushambi,Cerebral Palsy,15,35,75,33,108
Uttar Pradesh,Kaushambi,Cerebral Palsy,35,60,33,6,39
Uttar Pradesh,Kaushambi,Cerebral Palsy,60,80,2,0,2
Madhya Pradesh,Katni,Cerebral Palsy,0,6,5,10,15
Madhya Pradesh,Katni,Cerebral Palsy,6,15,44,28,72
Madhya Pradesh,Katni,Cerebral Palsy,15,35,45,25,70
Madhya Pradesh,Katni,Cerebral Palsy,35,60,8,7,15
Madhya Pradesh,Katni,Cerebral Palsy,60,80,1,0,1
Bihar,Katihar,Cerebral Palsy,0,6,153,113,266
Bihar,Katihar,Cerebral Palsy,6,15,415,216,631
Bihar,Katihar,Cerebral Palsy,15,35,167,95,262
Bihar,Katihar,Cerebral Palsy,35,60,36,9,45
Bihar,Katihar,Cerebral Palsy,60,80,3,1,4
Jammu And Kashmir,Kathua,Cerebral Palsy,0,6,5,1,6
Jammu And Kashmir,Kathua,Cerebral Palsy,6,15,12,5,17
Jammu And Kashmir,Kathua,Cerebral Palsy,15,35,54,32,86
Jammu And Kashmir,Kathua,Cerebral Palsy,35,60,18,5,23
Jammu And Kashmir,Kathua,Cerebral Palsy,60,80,2,0,2
Uttar Pradesh,Kasganj,Cerebral Palsy,0,6,3,3,6
Uttar Pradesh,Kasganj,Cerebral Palsy,6,15,9,9,18
Uttar Pradesh,Kasganj,Cerebral Palsy,15,35,43,25,68
Uttar Pradesh,Kasganj,Cerebral Palsy,35,60,41,14,55
Uttar Pradesh,Kasganj,Cerebral Palsy,60,80,11,5,16
Uttar Pradesh,Kasganj,Cerebral Palsy,80,100,1,0,1
Kerala,Kasaragod,Cerebral Palsy,0,6,35,20,55
Kerala,Kasaragod,Cerebral Palsy,6,15,97,59,156
Kerala,Kasaragod,Cerebral Palsy,15,35,151,104,255
Kerala,Kasaragod,Cerebral Palsy,35,60,55,48,103
Kerala,Kasaragod,Cerebral Palsy,60,80,6,2,8
Tamil Nadu,Karur,Cerebral Palsy,0,6,12,5,17
Tamil Nadu,Karur,Cerebral Palsy,6,15,23,16,39
Tamil Nadu,Karur,Cerebral Palsy,15,35,83,35,118
Tamil Nadu,Karur,Cerebral Palsy,35,60,15,12,27
Tamil Nadu,Karur,Cerebral Palsy,60,80,0,1,1
Haryana,Karnal,Cerebral Palsy,0,6,46,32,78
Haryana,Karnal,Cerebral Palsy,6,15,159,81,240
Haryana,Karnal,Cerebral Palsy,15,35,149,60,209
Haryana,Karnal,Cerebral Palsy,35,60,22,13,35
Haryana,Karnal,Cerebral Palsy,60,80,0,1,1
Assam,Karimganj,Cerebral Palsy,0,6,83,61,144
Assam,Karimganj,Cerebral Palsy,6,15,198,145,343
Assam,Karimganj,Cerebral Palsy,15,35,152,101,253
Assam,Karimganj,Cerebral Palsy,35,60,25,9,34
Assam,Karimganj,Cerebral Palsy,60,80,1,3,4
Ladakh,Kargil,Cerebral Palsy,0,6,0,1,1
Ladakh,Kargil,Cerebral Palsy,6,15,1,0,1
Ladakh,Kargil,Cerebral Palsy,15,35,7,3,10
Ladakh,Kargil,Cerebral Palsy,35,60,1,2,3
Ladakh,Kargil,Cerebral Palsy,60,80,0,1,1
Assam,Karbi Anglong,Cerebral Palsy,0,6,19,9,28
Assam,Karbi Anglong,Cerebral Palsy,6,15,31,25,56
Assam,Karbi Anglong,Cerebral Palsy,15,35,31,9,40
Assam,Karbi Anglong,Cerebral Palsy,35,60,2,4,6
Assam,Karbi Anglong,Cerebral Palsy,60,80,0,2,2
Rajasthan,Karauli,Cerebral Palsy,0,6,3,2,5
Rajasthan,Karauli,Cerebral Palsy,6,15,5,1,6
Rajasthan,Karauli,Cerebral Palsy,15,35,2,2,4
Puducherry,Karaikal,Cerebral Palsy,15,35,1,0,1
Puducherry,Karaikal,Cerebral Palsy,35,60,0,1,1
Punjab,Kapurthala,Cerebral Palsy,0,6,20,11,31
Punjab,Kapurthala,Cerebral Palsy,6,15,96,59,155
Punjab,Kapurthala,Cerebral Palsy,15,35,186,83,269
Punjab,Kapurthala,Cerebral Palsy,35,60,42,17,59
Punjab,Kapurthala,Cerebral Palsy,60,80,4,2,6
Uttar Pradesh,Kanpur Nagar,Cerebral Palsy,0,6,62,34,96
Uttar Pradesh,Kanpur Nagar,Cerebral Palsy,6,15,223,112,335
Uttar Pradesh,Kanpur Nagar,Cerebral Palsy,15,35,299,140,439
Uttar Pradesh,Kanpur Nagar,Cerebral Palsy,35,60,71,20,91
Uttar Pradesh,Kanpur Nagar,Cerebral Palsy,60,80,8,1,9
Uttar Pradesh,Kanpur Dehat,Cerebral Palsy,0,6,23,16,39
Uttar Pradesh,Kanpur Dehat,Cerebral Palsy,6,15,161,83,244
Uttar Pradesh,Kanpur Dehat,Cerebral Palsy,15,35,116,33,149
Uttar Pradesh,Kanpur Dehat,Cerebral Palsy,35,60,28,7,35
Uttar Pradesh,Kanpur Dehat,Cerebral Palsy,60,80,2,0,2
Kerala,Kannur,Cerebral Palsy,0,6,33,15,48
Kerala,Kannur,Cerebral Palsy,6,15,154,100,254
Kerala,Kannur,Cerebral Palsy,15,35,343,250,593
Kerala,Kannur,Cerebral Palsy,35,60,121,67,188
Kerala,Kannur,Cerebral Palsy,60,80,3,2,5
Kerala,Kannur,Cerebral Palsy,80,100,0,1,1
Tamil Nadu,Kanniyakumari,Cerebral Palsy,0,6,6,10,16
Tamil Nadu,Kanniyakumari,Cerebral Palsy,6,15,51,34,85
Tamil Nadu,Kanniyakumari,Cerebral Palsy,15,35,124,83,207
Tamil Nadu,Kanniyakumari,Cerebral Palsy,35,60,53,29,82
Tamil Nadu,Kanniyakumari,Cerebral Palsy,60,80,14,2,16
Uttar Pradesh,Kannauj,Cerebral Palsy,0,6,7,11,18
Uttar Pradesh,Kannauj,Cerebral Palsy,6,15,104,58,162
Uttar Pradesh,Kannauj,Cerebral Palsy,15,35,114,47,161
Uttar Pradesh,Kannauj,Cerebral Palsy,35,60,18,2,20
Uttar Pradesh,Kannauj,Cerebral Palsy,60,80,2,1,3
Chhattisgarh,Kanker,Cerebral Palsy,0,6,3,7,10
Chhattisgarh,Kanker,Cerebral Palsy,6,15,59,32,91
Chhattisgarh,Kanker,Cerebral Palsy,15,35,92,78,170
Chhattisgarh,Kanker,Cerebral Palsy,35,60,53,34,87
Chhattisgarh,Kanker,Cerebral Palsy,60,80,16,3,19
Chhattisgarh,Kanker,Cerebral Palsy,80,100,4,1,5
Himachal Pradesh,Kangra,Cerebral Palsy,0,6,21,19,40
Himachal Pradesh,Kangra,Cerebral Palsy,6,15,57,42,99
Himachal Pradesh,Kangra,Cerebral Palsy,15,35,88,48,136
Himachal Pradesh,Kangra,Cerebral Palsy,35,60,20,11,31
Himachal Pradesh,Kangra,Cerebral Palsy,60,80,2,0,2
Manipur,Kangpokpi,Cerebral Palsy,6,15,3,1,4
Manipur,Kangpokpi,Cerebral Palsy,15,35,4,0,4
Manipur,Kangpokpi,Cerebral Palsy,35,60,2,0,2
Manipur,Kangpokpi,Cerebral Palsy,60,80,1,0,1
Odisha,Kandhamal,Cerebral Palsy,0,6,93,96,189
Odisha,Kandhamal,Cerebral Palsy,6,15,122,74,196
Odisha,Kandhamal,Cerebral Palsy,15,35,40,35,75
Odisha,Kandhamal,Cerebral Palsy,35,60,3,11,14
Odisha,Kandhamal,Cerebral Palsy,60,80,2,1,3
Tamil Nadu,Kanchipuram,Cerebral Palsy,0,6,3,6,9
Tamil Nadu,Kanchipuram,Cerebral Palsy,6,15,44,33,77
Tamil Nadu,Kanchipuram,Cerebral Palsy,15,35,65,47,112
Tamil Nadu,Kanchipuram,Cerebral Palsy,35,60,18,17,35
Tamil Nadu,Kanchipuram,Cerebral Palsy,60,80,1,0,1
Assam,Kamrup Metro,Cerebral Palsy,0,6,2,0,2
Assam,Kamrup Metro,Cerebral Palsy,6,15,6,3,9
Assam,Kamrup Metro,Cerebral Palsy,15,35,19,7,26
Assam,Kamrup Metro,Cerebral Palsy,35,60,4,0,4
Assam,Kamrup,Cerebral Palsy,0,6,7,2,9
Assam,Kamrup,Cerebral Palsy,6,15,12,7,19
Assam,Kamrup,Cerebral Palsy,15,35,7,6,13
Assam,Kamrup,Cerebral Palsy,35,60,5,2,7
Manipur,Kamjong,Cerebral Palsy,0,6,1,2,3
Manipur,Kamjong,Cerebral Palsy,6,15,1,0,1
Manipur,Kamjong,Cerebral Palsy,15,35,1,0,1
Manipur,Kamjong,Cerebral Palsy,35,60,1,1,2
Tamil Nadu,Kallakurichi,Cerebral Palsy,0,6,17,12,29
Tamil Nadu,Kallakurichi,Cerebral Palsy,6,15,34,16,50
Tamil Nadu,Kallakurichi,Cerebral Palsy,15,35,20,16,36
Tamil Nadu,Kallakurichi,Cerebral Palsy,35,60,7,3,10
Tamil Nadu,Kallakurichi,Cerebral Palsy,80,100,1,0,1
Odisha,Kalahandi,Cerebral Palsy,0,6,165,85,250
Odisha,Kalahandi,Cerebral Palsy,6,15,294,177,471
Odisha,Kalahandi,Cerebral Palsy,15,35,134,99,233
Odisha,Kalahandi,Cerebral Palsy,35,60,28,11,39
Odisha,Kalahandi,Cerebral Palsy,60,80,4,0,4
Karnataka,Kalaburagi,Cerebral Palsy,0,6,45,36,81
Karnataka,Kalaburagi,Cerebral Palsy,6,15,87,62,149
Karnataka,Kalaburagi,Cerebral Palsy,15,35,68,39,107
Karnataka,Kalaburagi,Cerebral Palsy,35,60,48,21,69
Karnataka,Kalaburagi,Cerebral Palsy,60,80,9,3,12
Manipur,Kakching,Cerebral Palsy,6,15,12,4,16
Manipur,Kakching,Cerebral Palsy,15,35,7,4,11
Manipur,Kakching,Cerebral Palsy,35,60,3,1,4
Haryana,Kaithal,Cerebral Palsy,0,6,4,0,4
Haryana,Kaithal,Cerebral Palsy,6,15,13,3,16
Haryana,Kaithal,Cerebral Palsy,15,35,23,8,31
Haryana,Kaithal,Cerebral Palsy,35,60,19,11,30
Haryana,Kaithal,Cerebral Palsy,60,80,3,0,3
Bihar,Kaimur (Bhabua),Cerebral Palsy,0,6,15,10,25
Bihar,Kaimur (Bhabua),Cerebral Palsy,6,15,36,9,45
Bihar,Kaimur (Bhabua),Cerebral Palsy,15,35,19,9,28
Bihar,Kaimur (Bhabua),Cerebral Palsy,35,60,7,3,10
Bihar,Kaimur (Bhabua),Cerebral Palsy,60,80,2,2,4
Gujarat,Kachchh,Cerebral Palsy,0,6,24,17,41
Gujarat,Kachchh,Cerebral Palsy,6,15,89,49,138
Gujarat,Kachchh,Cerebral Palsy,15,35,58,39,97
Gujarat,Kachchh,Cerebral Palsy,35,60,7,0,7
Chhattisgarh,Kabirdham,Cerebral Palsy,0,6,14,18,32
Chhattisgarh,Kabirdham,Cerebral Palsy,6,15,69,55,124
Chhattisgarh,Kabirdham,Cerebral Palsy,15,35,18,13,31
Chhattisgarh,Kabirdham,Cerebral Palsy,35,60,1,0,1
Gujarat,Junagadh,Cerebral Palsy,0,6,27,11,38
Gujarat,Junagadh,Cerebral Palsy,6,15,115,54,169
Gujarat,Junagadh,Cerebral Palsy,15,35,87,53,140
Gujarat,Junagadh,Cerebral Palsy,35,60,22,8,30
Gujarat,Junagadh,Cerebral Palsy,60,80,3,1,4
Assam,Jorhat,Cerebral Palsy,0,6,24,10,34
Assam,Jorhat,Cerebral Palsy,6,15,75,45,120
Assam,Jorhat,Cerebral Palsy,15,35,128,50,178
Assam,Jorhat,Cerebral Palsy,35,60,26,15,41
Assam,Jorhat,Cerebral Palsy,60,80,0,1,1
Rajasthan,Jodhpur,Cerebral Palsy,0,6,12,5,17
Rajasthan,Jodhpur,Cerebral Palsy,6,15,67,42,109
Rajasthan,Jodhpur,Cerebral Palsy,15,35,70,43,113
Rajasthan,Jodhpur,Cerebral Palsy,35,60,23,7,30
Rajasthan,Jodhpur,Cerebral Palsy,60,80,3,0,3
Manipur,Jiribam,Cerebral Palsy,6,15,3,2,5
Manipur,Jiribam,Cerebral Palsy,15,35,2,4,6
Haryana,Jind,Cerebral Palsy,0,6,25,11,36
Haryana,Jind,Cerebral Palsy,6,15,126,55,181
Haryana,Jind,Cerebral Palsy,15,35,181,56,237
Haryana,Jind,Cerebral Palsy,35,60,43,10,53
Haryana,Jind,Cerebral Palsy,60,80,2,1,3
Rajasthan,Jhunjhunu,Cerebral Palsy,0,6,2,5,7
Rajasthan,Jhunjhunu,Cerebral Palsy,6,15,27,10,37
Rajasthan,Jhunjhunu,Cerebral Palsy,15,35,31,16,47
Rajasthan,Jhunjhunu,Cerebral Palsy,35,60,9,2,11
Rajasthan,Jhunjhunu,Cerebral Palsy,60,80,1,1,2
Odisha,Jharsuguda,Cerebral Palsy,0,6,15,9,24
Odisha,Jharsuguda,Cerebral Palsy,6,15,31,17,48
Odisha,Jharsuguda,Cerebral Palsy,15,35,31,18,49
Odisha,Jharsuguda,Cerebral Palsy,35,60,16,13,29
Odisha,Jharsuguda,Cerebral Palsy,60,80,5,2,7
Uttar Pradesh,Jhansi,Cerebral Palsy,0,6,10,8,18
Uttar Pradesh,Jhansi,Cerebral Palsy,6,15,86,38,124
Uttar Pradesh,Jhansi,Cerebral Palsy,15,35,57,26,83
Uttar Pradesh,Jhansi,Cerebral Palsy,35,60,36,8,44
Uttar Pradesh,Jhansi,Cerebral Palsy,60,80,5,2,7
Rajasthan,Jhalawar,Cerebral Palsy,0,6,3,3,6
Rajasthan,Jhalawar,Cerebral Palsy,6,15,27,15,42
Rajasthan,Jhalawar,Cerebral Palsy,15,35,23,18,41
Rajasthan,Jhalawar,Cerebral Palsy,35,60,3,7,10
Rajasthan,Jhalawar,Cerebral Palsy,60,80,1,0,1
Rajasthan,Jhalawar,Cerebral Palsy,80,100,1,0,1
Haryana,Jhajjar,Cerebral Palsy,0,6,9,6,15
Haryana,Jhajjar,Cerebral Palsy,6,15,41,21,62
Haryana,Jhajjar,Cerebral Palsy,15,35,71,35,106
Haryana,Jhajjar,Cerebral Palsy,35,60,12,4,16
Haryana,Jhajjar,Cerebral Palsy,60,80,0,1,1
Madhya Pradesh,Jhabua,Cerebral Palsy,6,15,7,5,12
Madhya Pradesh,Jhabua,Cerebral Palsy,15,35,36,24,60
Madhya Pradesh,Jhabua,Cerebral Palsy,35,60,38,17,55
Madhya Pradesh,Jhabua,Cerebral Palsy,60,80,10,3,13
Madhya Pradesh,Jhabua,Cerebral Palsy,80,100,1,1,2
Bihar,Jehanabad,Cerebral Palsy,0,6,28,19,47
Bihar,Jehanabad,Cerebral Palsy,6,15,60,33,93
Bihar,Jehanabad,Cerebral Palsy,15,35,37,19,56
Bihar,Jehanabad,Cerebral Palsy,35,60,11,5,16
Bihar,Jehanabad,Cerebral Palsy,60,80,6,1,7
Uttar Pradesh,Jaunpur,Cerebral Palsy,0,6,17,8,25
Uttar Pradesh,Jaunpur,Cerebral Palsy,6,15,101,79,180
Uttar Pradesh,Jaunpur,Cerebral Palsy,15,35,153,69,222
Uttar Pradesh,Jaunpur,Cerebral Palsy,35,60,63,21,84
Uttar Pradesh,Jaunpur,Cerebral Palsy,60,80,16,5,21
Uttar Pradesh,Jaunpur,Cerebral Palsy,80,100,1,0,1
Chhattisgarh,Jashpur,Cerebral Palsy,0,6,35,22,57
Chhattisgarh,Jashpur,Cerebral Palsy,6,15,195,123,318
Chhattisgarh,Jashpur,Cerebral Palsy,15,35,213,170,383
Chhattisgarh,Jashpur,Cerebral Palsy,35,60,30,24,54
Chhattisgarh,Jashpur,Cerebral Palsy,60,80,10,2,12
Chhattisgarh,Janjgir-Champa,Cerebral Palsy,0,6,14,14,28
Chhattisgarh,Janjgir-Champa,Cerebral Palsy,6,15,115,65,180
Chhattisgarh,Janjgir-Champa,Cerebral Palsy,15,35,118,86,204
Chhattisgarh,Janjgir-Champa,Cerebral Palsy,35,60,28,13,41
Chhattisgarh,Janjgir-Champa,Cerebral Palsy,60,80,2,0,2
Bihar,Jamui,Cerebral Palsy,0,6,2,4,6
Bihar,Jamui,Cerebral Palsy,6,15,39,19,58
Bihar,Jamui,Cerebral Palsy,15,35,53,14,67
Bihar,Jamui,Cerebral Palsy,35,60,10,3,13
Bihar,Jamui,Cerebral Palsy,60,80,2,0,2
Jharkhand,Jamtara,Cerebral Palsy,0,6,22,13,35
Jharkhand,Jamtara,Cerebral Palsy,6,15,43,32,75
Jharkhand,Jamtara,Cerebral Palsy,15,35,7,4,11
Jharkhand,Jamtara,Cerebral Palsy,35,60,2,2,4
Jharkhand,Jamtara,Cerebral Palsy,60,80,1,0,1
Gujarat,Jamnagar,Cerebral Palsy,0,6,1,0,1
Gujarat,Jamnagar,Cerebral Palsy,6,15,6,5,11
Gujarat,Jamnagar,Cerebral Palsy,15,35,1,4,5
Gujarat,Jamnagar,Cerebral Palsy,35,60,1,0,1
Jammu And Kashmir,Jammu,Cerebral Palsy,0,6,13,5,18
Jammu And Kashmir,Jammu,Cerebral Palsy,6,15,60,36,96
Jammu And Kashmir,Jammu,Cerebral Palsy,15,35,141,88,229
Jammu And Kashmir,Jammu,Cerebral Palsy,35,60,58,24,82
Jammu And Kashmir,Jammu,Cerebral Palsy,60,80,7,3,10
Rajasthan,Jalore,Cerebral Palsy,0,6,9,2,11
Rajasthan,Jalore,Cerebral Palsy,6,15,34,18,52
Rajasthan,Jalore,Cerebral Palsy,15,35,43,11,54
Rajasthan,Jalore,Cerebral Palsy,35,60,16,5,21
Rajasthan,Jalore,Cerebral Palsy,60,80,4,0,4
Rajasthan,Jalore,Cerebral Palsy,80,100,0,1,1
Maharashtra,Jalna,Cerebral Palsy,6,15,9,4,13
Maharashtra,Jalna,Cerebral Palsy,15,35,8,8,16
Maharashtra,Jalna,Cerebral Palsy,35,60,4,2,6
Maharashtra,Jalna,Cerebral Palsy,60,80,0,1,1
Maharashtra,Jalgaon,Cerebral Palsy,0,6,45,27,72
Maharashtra,Jalgaon,Cerebral Palsy,6,15,153,61,214
Maharashtra,Jalgaon,Cerebral Palsy,15,35,98,47,145
Maharashtra,Jalgaon,Cerebral Palsy,35,60,33,17,50
Maharashtra,Jalgaon,Cerebral Palsy,60,80,4,0,4
Maharashtra,Jalgaon,Cerebral Palsy,80,100,0,1,1
Uttar Pradesh,Jalaun,Cerebral Palsy,0,6,5,1,6
Uttar Pradesh,Jalaun,Cerebral Palsy,6,15,39,20,59
Uttar Pradesh,Jalaun,Cerebral Palsy,15,35,231,81,312
Uttar Pradesh,Jalaun,Cerebral Palsy,35,60,341,117,458
Uttar Pradesh,Jalaun,Cerebral Palsy,60,80,60,9,69
Uttar Pradesh,Jalaun,Cerebral Palsy,80,100,4,0,4
Punjab,Jalandhar,Cerebral Palsy,0,6,16,12,28
Punjab,Jalandhar,Cerebral Palsy,6,15,120,62,182
Punjab,Jalandhar,Cerebral Palsy,15,35,201,89,290
Punjab,Jalandhar,Cerebral Palsy,35,60,69,28,97
Punjab,Jalandhar,Cerebral Palsy,60,80,9,1,10
Punjab,Jalandhar,Cerebral Palsy,80,100,2,1,3
Odisha,Jajapur,Cerebral Palsy,0,6,66,42,108
Odisha,Jajapur,Cerebral Palsy,6,15,236,107,343
Odisha,Jajapur,Cerebral Palsy,15,35,176,70,246
Odisha,Jajapur,Cerebral Palsy,35,60,17,10,27
Rajasthan,Jaisalmer,Cerebral Palsy,0,6,6,1,7
Rajasthan,Jaisalmer,Cerebral Palsy,6,15,68,32,100
Rajasthan,Jaisalmer,Cerebral Palsy,15,35,64,14,78
Rajasthan,Jaisalmer,Cerebral Palsy,35,60,1,2,3
Rajasthan,Jaipur,Cerebral Palsy,0,6,37,18,55
Rajasthan,Jaipur,Cerebral Palsy,6,15,235,141,376
Rajasthan,Jaipur,Cerebral Palsy,15,35,311,152,463
Rajasthan,Jaipur,Cerebral Palsy,35,60,55,22,77
Rajasthan,Jaipur,Cerebral Palsy,60,80,7,1,8
Rajasthan,Jaipur,Cerebral Palsy,80,100,1,1,2
Odisha,Jagatsinghapur,Cerebral Palsy,0,6,3,6,9
Odisha,Jagatsinghapur,Cerebral Palsy,6,15,32,14,46
Odisha,Jagatsinghapur,Cerebral Palsy,15,35,37,21,58
Odisha,Jagatsinghapur,Cerebral Palsy,35,60,9,0,9
Odisha,Jagatsinghapur,Cerebral Palsy,60,80,1,1,2
Madhya Pradesh,Jabalpur,Cerebral Palsy,0,6,3,2,5
Madhya Pradesh,Jabalpur,Cerebral Palsy,6,15,9,8,17
Madhya Pradesh,Jabalpur,Cerebral Palsy,15,35,40,22,62
Madhya Pradesh,Jabalpur,Cerebral Palsy,35,60,19,11,30
Madhya Pradesh,Jabalpur,Cerebral Palsy,60,80,5,1,6
Madhya Pradesh,Indore,Cerebral Palsy,0,6,20,10,30
Madhya Pradesh,Indore,Cerebral Palsy,6,15,75,41,116
Madhya Pradesh,Indore,Cerebral Palsy,15,35,122,73,195
Madhya Pradesh,Indore,Cerebral Palsy,35,60,30,21,51
Madhya Pradesh,Indore,Cerebral Palsy,60,80,8,1,9
Manipur,Imphal West,Cerebral Palsy,0,6,1,0,1
Manipur,Imphal West,Cerebral Palsy,6,15,22,15,37
Manipur,Imphal West,Cerebral Palsy,15,35,33,17,50
Manipur,Imphal West,Cerebral Palsy,35,60,15,5,20
Manipur,Imphal East,Cerebral Palsy,0,6,3,2,5
Manipur,Imphal East,Cerebral Palsy,6,15,20,10,30
Manipur,Imphal East,Cerebral Palsy,15,35,25,11,36
Manipur,Imphal East,Cerebral Palsy,35,60,12,10,22
Kerala,Idukki,Cerebral Palsy,0,6,3,1,4
Kerala,Idukki,Cerebral Palsy,6,15,33,43,76
Kerala,Idukki,Cerebral Palsy,15,35,110,83,193
Kerala,Idukki,Cerebral Palsy,35,60,32,28,60
Kerala,Idukki,Cerebral Palsy,60,80,12,5,17
West Bengal,Howrah,Cerebral Palsy,0,6,1,0,1
West Bengal,Howrah,Cerebral Palsy,15,35,1,0,1
West Bengal,Howrah,Cerebral Palsy,35,60,1,0,1
Punjab,Hoshiarpur,Cerebral Palsy,0,6,18,14,32
Punjab,Hoshiarpur,Cerebral Palsy,6,15,163,59,222
Punjab,Hoshiarpur,Cerebral Palsy,15,35,308,157,465
Punjab,Hoshiarpur,Cerebral Palsy,35,60,133,67,200
Punjab,Hoshiarpur,Cerebral Palsy,60,80,28,6,34
Punjab,Hoshiarpur,Cerebral Palsy,80,100,2,1,3
Assam,Hojai,Cerebral Palsy,0,6,38,24,62
Assam,Hojai,Cerebral Palsy,6,15,87,63,150
Assam,Hojai,Cerebral Palsy,15,35,29,20,49
Assam,Hojai,Cerebral Palsy,35,60,3,2,5
Assam,Hojai,Cerebral Palsy,60,80,1,0,1
Mizoram,Hnahthial,Cerebral Palsy,0,6,1,0,1
Mizoram,Hnahthial,Cerebral Palsy,35,60,0,1,1
Haryana,Hisar,Cerebral Palsy,0,6,4,4,8
Haryana,Hisar,Cerebral Palsy,6,15,59,24,83
Haryana,Hisar,Cerebral Palsy,15,35,76,35,111
Haryana,Hisar,Cerebral Palsy,35,60,18,4,22
Haryana,Hisar,Cerebral Palsy,60,80,1,0,1
Maharashtra,Hingoli,Cerebral Palsy,0,6,1,1,2
Maharashtra,Hingoli,Cerebral Palsy,6,15,35,18,53
Maharashtra,Hingoli,Cerebral Palsy,15,35,38,18,56
Maharashtra,Hingoli,Cerebral Palsy,35,60,5,2,7
Jharkhand,Hazaribagh,Cerebral Palsy,0,6,24,12,36
Jharkhand,Hazaribagh,Cerebral Palsy,6,15,62,36,98
Jharkhand,Hazaribagh,Cerebral Palsy,15,35,24,19,43
Jharkhand,Hazaribagh,Cerebral Palsy,35,60,16,4,20
Jharkhand,Hazaribagh,Cerebral Palsy,60,80,1,1,2
Jharkhand,Hazaribagh,Cerebral Palsy,80,100,1,0,1
Karnataka,Haveri,Cerebral Palsy,6,15,6,4,10
Karnataka,Haveri,Cerebral Palsy,15,35,11,4,15
Karnataka,Haveri,Cerebral Palsy,35,60,24,6,30
Karnataka,Haveri,Cerebral Palsy,60,80,11,4,15
Uttar Pradesh,Hathras,Cerebral Palsy,0,6,10,2,12
Uttar Pradesh,Hathras,Cerebral Palsy,6,15,13,7,20
Uttar Pradesh,Hathras,Cerebral Palsy,15,35,49,19,68
Uttar Pradesh,Hathras,Cerebral Palsy,35,60,40,12,52
Uttar Pradesh,Hathras,Cerebral Palsy,60,80,10,0,10
Karnataka,Hassan,Cerebral Palsy,0,6,16,5,21
Karnataka,Hassan,Cerebral Palsy,6,15,30,16,46
Karnataka,Hassan,Cerebral Palsy,15,35,39,20,59
Karnataka,Hassan,Cerebral Palsy,35,60,32,13,45
Karnataka,Hassan,Cerebral Palsy,60,80,6,3,9
Uttarakhand,Haridwar,Cerebral Palsy,0,6,8,5,13
Uttarakhand,Haridwar,Cerebral Palsy,6,15,85,29,114
Uttarakhand,Haridwar,Cerebral Palsy,15,35,254,94,348
Uttarakhand,Haridwar,Cerebral Palsy,35,60,116,62,178
Uttarakhand,Haridwar,Cerebral Palsy,60,80,15,7,22
Uttar Pradesh,Hardoi,Cerebral Palsy,0,6,26,19,45
Uttar Pradesh,Hardoi,Cerebral Palsy,6,15,250,119,369
Uttar Pradesh,Hardoi,Cerebral Palsy,15,35,553,178,731
Uttar Pradesh,Hardoi,Cerebral Palsy,35,60,630,146,776
Uttar Pradesh,Hardoi,Cerebral Palsy,60,80,200,28,228
Uttar Pradesh,Hardoi,Cerebral Palsy,80,100,9,2,11
Madhya Pradesh,Harda,Cerebral Palsy,0,6,2,1,3
Madhya Pradesh,Harda,Cerebral Palsy,6,15,19,12,31
Madhya Pradesh,Harda,Cerebral Palsy,15,35,29,9,38
Madhya Pradesh,Harda,Cerebral Palsy,35,60,3,0,3
Uttar Pradesh,Hapur,Cerebral Palsy,0,6,5,0,5
Uttar Pradesh,Hapur,Cerebral Palsy,6,15,43,13,56
Uttar Pradesh,Hapur,Cerebral Palsy,15,35,58,25,83
Uttar Pradesh,Hapur,Cerebral Palsy,35,60,17,8,25
Uttar Pradesh,Hapur,Cerebral Palsy,60,80,5,0,5
Rajasthan,Hanumangarh,Cerebral Palsy,0,6,34,18,52
Rajasthan,Hanumangarh,Cerebral Palsy,6,15,183,99,282
Rajasthan,Hanumangarh,Cerebral Palsy,15,35,113,66,179
Rajasthan,Hanumangarh,Cerebral Palsy,35,60,24,7,31
Rajasthan,Hanumangarh,Cerebral Palsy,60,80,2,1,3
Himachal Pradesh,Hamirpur,Cerebral Palsy,0,6,5,2,7
Himachal Pradesh,Hamirpur,Cerebral Palsy,6,15,18,10,28
Himachal Pradesh,Hamirpur,Cerebral Palsy,15,35,13,4,17
Himachal Pradesh,Hamirpur,Cerebral Palsy,35,60,8,3,11
Himachal Pradesh,Hamirpur,Cerebral Palsy,60,80,1,1,2
Uttar Pradesh,Hamirpur,Cerebral Palsy,0,6,2,0,2
Uttar Pradesh,Hamirpur,Cerebral Palsy,6,15,11,2,13
Uttar Pradesh,Hamirpur,Cerebral Palsy,15,35,32,21,53
Uttar Pradesh,Hamirpur,Cerebral Palsy,35,60,22,10,32
Uttar Pradesh,Hamirpur,Cerebral Palsy,60,80,6,2,8
Assam,Hailakandi,Cerebral Palsy,0,6,11,6,17
Assam,Hailakandi,Cerebral Palsy,6,15,14,9,23
Assam,Hailakandi,Cerebral Palsy,15,35,17,8,25
Assam,Hailakandi,Cerebral Palsy,35,60,1,5,6
Sikkim,Gyalshing,Cerebral Palsy,0,6,0,1,1
Sikkim,Gyalshing,Cerebral Palsy,6,15,10,10,20
Sikkim,Gyalshing,Cerebral Palsy,15,35,36,21,57
Sikkim,Gyalshing,Cerebral Palsy,35,60,5,6,11
Sikkim,Gyalshing,Cerebral Palsy,60,80,1,0,1
Madhya Pradesh,Gwalior,Cerebral Palsy,0,6,1,0,1
Madhya Pradesh,Gwalior,Cerebral Palsy,6,15,13,8,21
Madhya Pradesh,Gwalior,Cerebral Palsy,15,35,37,15,52
Madhya Pradesh,Gwalior,Cerebral Palsy,35,60,18,3,21
Madhya Pradesh,Gwalior,Cerebral Palsy,60,80,4,0,4
Haryana,Gurugram,Cerebral Palsy,0,6,11,9,20
Haryana,Gurugram,Cerebral Palsy,6,15,74,36,110
Haryana,Gurugram,Cerebral Palsy,15,35,45,23,68
Haryana,Gurugram,Cerebral Palsy,35,60,4,3,7
Punjab,Gurdaspur,Cerebral Palsy,0,6,7,6,13
Punjab,Gurdaspur,Cerebral Palsy,6,15,57,35,92
Punjab,Gurdaspur,Cerebral Palsy,15,35,153,64,217
Punjab,Gurdaspur,Cerebral Palsy,35,60,55,14,69
Punjab,Gurdaspur,Cerebral Palsy,60,80,4,7,11
Punjab,Gurdaspur,Cerebral Palsy,80,100,1,0,1
Andhra Pradesh,Guntur,Cerebral Palsy,0,6,1,1,2
Andhra Pradesh,Guntur,Cerebral Palsy,6,15,14,7,21
Andhra Pradesh,Guntur,Cerebral Palsy,15,35,18,7,25
Andhra Pradesh,Guntur,Cerebral Palsy,35,60,12,2,14
Andhra Pradesh,Guntur,Cerebral Palsy,60,80,2,0,2
Madhya Pradesh,Guna,Cerebral Palsy,0,6,15,1,16
Madhya Pradesh,Guna,Cerebral Palsy,6,15,28,15,43
Madhya Pradesh,Guna,Cerebral Palsy,15,35,24,16,40
Madhya Pradesh,Guna,Cerebral Palsy,80,100,0,1,1
Jharkhand,Gumla,Cerebral Palsy,0,6,5,3,8
Jharkhand,Gumla,Cerebral Palsy,6,15,20,16,36
Jharkhand,Gumla,Cerebral Palsy,15,35,67,50,117
Jharkhand,Gumla,Cerebral Palsy,35,60,36,29,65
Jharkhand,Gumla,Cerebral Palsy,60,80,12,0,12
Jharkhand,Gumla,Cerebral Palsy,80,100,1,0,1
Uttar Pradesh,Gorakhpur,Cerebral Palsy,0,6,54,29,83
Uttar Pradesh,Gorakhpur,Cerebral Palsy,6,15,226,115,341
Uttar Pradesh,Gorakhpur,Cerebral Palsy,15,35,320,159,479
Uttar Pradesh,Gorakhpur,Cerebral Palsy,35,60,122,36,158
Uttar Pradesh,Gorakhpur,Cerebral Palsy,60,80,31,3,34
Uttar Pradesh,Gorakhpur,Cerebral Palsy,80,100,1,0,1
Bihar,Gopalganj,Cerebral Palsy,0,6,173,93,266
Bihar,Gopalganj,Cerebral Palsy,6,15,372,211,583
Bihar,Gopalganj,Cerebral Palsy,15,35,145,61,206
Bihar,Gopalganj,Cerebral Palsy,35,60,13,4,17
Maharashtra,Gondia,Cerebral Palsy,0,6,42,27,69
Maharashtra,Gondia,Cerebral Palsy,6,15,40,36,76
Maharashtra,Gondia,Cerebral Palsy,15,35,5,2,7
Maharashtra,Gondia,Cerebral Palsy,35,60,1,1,2
Uttar Pradesh,Gonda,Cerebral Palsy,0,6,34,15,49
Uttar Pradesh,Gonda,Cerebral Palsy,6,15,163,82,245
Uttar Pradesh,Gonda,Cerebral Palsy,15,35,215,71,286
Uttar Pradesh,Gonda,Cerebral Palsy,35,60,101,21,122
Uttar Pradesh,Gonda,Cerebral Palsy,60,80,23,4,27
Assam,Golaghat,Cerebral Palsy,0,6,89,56,145
Assam,Golaghat,Cerebral Palsy,6,15,208,112,320
Assam,Golaghat,Cerebral Palsy,15,35,134,105,239
Assam,Golaghat,Cerebral Palsy,35,60,37,29,66
Assam,Golaghat,Cerebral Palsy,60,80,6,2,8
Jharkhand,Godda,Cerebral Palsy,0,6,42,23,65
Jharkhand,Godda,Cerebral Palsy,6,15,251,152,403
Jharkhand,Godda,Cerebral Palsy,15,35,394,205,599
Jharkhand,Godda,Cerebral Palsy,35,60,132,47,179
Jharkhand,Godda,Cerebral Palsy,60,80,42,24,66
Jharkhand,Godda,Cerebral Palsy,80,100,11,5,16
Assam,Goalpara,Cerebral Palsy,0,6,29,24,53
Assam,Goalpara,Cerebral Palsy,6,15,58,29,87
Assam,Goalpara,Cerebral Palsy,15,35,35,17,52
Assam,Goalpara,Cerebral Palsy,35,60,9,3,12
Assam,Goalpara,Cerebral Palsy,60,80,1,0,1
Jharkhand,Giridih,Cerebral Palsy,0,6,24,8,32
Jharkhand,Giridih,Cerebral Palsy,6,15,109,82,191
Jharkhand,Giridih,Cerebral Palsy,15,35,106,44,150
Jharkhand,Giridih,Cerebral Palsy,35,60,50,26,76
Jharkhand,Giridih,Cerebral Palsy,60,80,9,2,11
Jharkhand,Giridih,Cerebral Palsy,80,100,1,0,1
Gujarat,Gir Somnath,Cerebral Palsy,0,6,8,2,10
Gujarat,Gir Somnath,Cerebral Palsy,6,15,56,28,84
Gujarat,Gir Somnath,Cerebral Palsy,15,35,85,40,125
Gujarat,Gir Somnath,Cerebral Palsy,35,60,18,3,21
Gujarat,Gir Somnath,Cerebral Palsy,60,80,1,1,2
Gujarat,Gir Somnath,Cerebral Palsy,80,100,0,1,1
Uttar Pradesh,Ghazipur,Cerebral Palsy,0,6,51,31,82
Uttar Pradesh,Ghazipur,Cerebral Palsy,6,15,339,190,529
Uttar Pradesh,Ghazipur,Cerebral Palsy,15,35,365,162,527
Uttar Pradesh,Ghazipur,Cerebral Palsy,35,60,76,23,99
Uttar Pradesh,Ghazipur,Cerebral Palsy,60,80,9,7,16
Uttar Pradesh,Ghaziabad,Cerebral Palsy,0,6,13,10,23
Uttar Pradesh,Ghaziabad,Cerebral Palsy,6,15,132,72,204
Uttar Pradesh,Ghaziabad,Cerebral Palsy,15,35,228,75,303
Uttar Pradesh,Ghaziabad,Cerebral Palsy,35,60,36,13,49
Uttar Pradesh,Ghaziabad,Cerebral Palsy,60,80,5,0,5
Bihar,Gaya,Cerebral Palsy,0,6,103,65,168
Bihar,Gaya,Cerebral Palsy,6,15,353,195,548
Bihar,Gaya,Cerebral Palsy,15,35,239,95,334
Bihar,Gaya,Cerebral Palsy,35,60,40,7,47
Bihar,Gaya,Cerebral Palsy,60,80,2,1,3
Uttar Pradesh,Gautam Buddha Nagar,Cerebral Palsy,0,6,6,5,11
Uttar Pradesh,Gautam Buddha Nagar,Cerebral Palsy,6,15,50,14,64
Uttar Pradesh,Gautam Buddha Nagar,Cerebral Palsy,15,35,52,27,79
Uttar Pradesh,Gautam Buddha Nagar,Cerebral Palsy,35,60,14,2,16
Uttar Pradesh,Gautam Buddha Nagar,Cerebral Palsy,60,80,2,1,3
Chhattisgarh,Gaurella Pendra Marwahi,Cerebral Palsy,0,6,8,6,14
Chhattisgarh,Gaurella Pendra Marwahi,Cerebral Palsy,6,15,22,13,35
Chhattisgarh,Gaurella Pendra Marwahi,Cerebral Palsy,15,35,6,7,13
Chhattisgarh,Gaurella Pendra Marwahi,Cerebral Palsy,35,60,3,3,6
Chhattisgarh,Gariyaband,Cerebral Palsy,0,6,8,7,15
Chhattisgarh,Gariyaband,Cerebral Palsy,6,15,58,43,101
Chhattisgarh,Gariyaband,Cerebral Palsy,15,35,65,69,134
Chhattisgarh,Gariyaband,Cerebral Palsy,35,60,25,24,49
Chhattisgarh,Gariyaband,Cerebral Palsy,60,80,6,7,13
Jharkhand,Garhwa,Cerebral Palsy,0,6,11,8,19
Jharkhand,Garhwa,Cerebral Palsy,6,15,50,35,85
Jharkhand,Garhwa,Cerebral Palsy,15,35,33,17,50
Jharkhand,Garhwa,Cerebral Palsy,35,60,23,19,42
Jharkhand,Garhwa,Cerebral Palsy,60,80,3,2,5
Odisha,Ganjam,Cerebral Palsy,0,6,42,25,67
Odisha,Ganjam,Cerebral Palsy,6,15,54,31,85
Odisha,Ganjam,Cerebral Palsy,15,35,23,14,37
Odisha,Ganjam,Cerebral Palsy,35,60,2,0,2
Sikkim,Gangtok,Cerebral Palsy,0,6,3,1,4
Sikkim,Gangtok,Cerebral Palsy,6,15,26,9,35
Sikkim,Gangtok,Cerebral Palsy,15,35,37,19,56
Sikkim,Gangtok,Cerebral Palsy,35,60,8,7,15
Sikkim,Gangtok,Cerebral Palsy,60,80,1,0,1
Rajasthan,Ganganagar,Cerebral Palsy,0,6,17,9,26
Rajasthan,Ganganagar,Cerebral Palsy,6,15,104,73,177
Rajasthan,Ganganagar,Cerebral Palsy,15,35,166,67,233
Rajasthan,Ganganagar,Cerebral Palsy,35,60,24,20,44
Rajasthan,Ganganagar,Cerebral Palsy,60,80,1,0,1
Gujarat,Gandhinagar,Cerebral Palsy,0,6,2,1,3
Gujarat,Gandhinagar,Cerebral Palsy,6,15,10,13,23
Gujarat,Gandhinagar,Cerebral Palsy,15,35,24,15,39
Gujarat,Gandhinagar,Cerebral Palsy,35,60,8,7,15
Gujarat,Gandhinagar,Cerebral Palsy,60,80,2,0,2
Jammu And Kashmir,Ganderbal,Cerebral Palsy,0,6,10,6,16
Jammu And Kashmir,Ganderbal,Cerebral Palsy,6,15,31,19,50
Jammu And Kashmir,Ganderbal,Cerebral Palsy,15,35,52,20,72
Jammu And Kashmir,Ganderbal,Cerebral Palsy,35,60,10,10,20
Jammu And Kashmir,Ganderbal,Cerebral Palsy,60,80,2,1,3
Odisha,Gajapati,Cerebral Palsy,0,6,47,43,90
Odisha,Gajapati,Cerebral Palsy,6,15,68,40,108
Odisha,Gajapati,Cerebral Palsy,15,35,23,24,47
Odisha,Gajapati,Cerebral Palsy,60,80,1,1,2
Maharashtra,Gadchiroli,Cerebral Palsy,0,6,6,2,8
Maharashtra,Gadchiroli,Cerebral Palsy,6,15,12,4,16
Maharashtra,Gadchiroli,Cerebral Palsy,15,35,11,6,17
Maharashtra,Gadchiroli,Cerebral Palsy,35,60,19,3,22
Maharashtra,Gadchiroli,Cerebral Palsy,60,80,9,1,10
Maharashtra,Gadchiroli,Cerebral Palsy,80,100,1,0,1
Karnataka,Gadag,Cerebral Palsy,0,6,5,1,6
Karnataka,Gadag,Cerebral Palsy,6,15,1,3,4
Karnataka,Gadag,Cerebral Palsy,35,60,14,4,18
Karnataka,Gadag,Cerebral Palsy,60,80,6,1,7
Uttar Pradesh,Firozabad,Cerebral Palsy,0,6,60,34,94
Uttar Pradesh,Firozabad,Cerebral Palsy,6,15,324,210,534
Uttar Pradesh,Firozabad,Cerebral Palsy,15,35,136,51,187
Uttar Pradesh,Firozabad,Cerebral Palsy,35,60,49,8,57
Uttar Pradesh,Firozabad,Cerebral Palsy,60,80,5,2,7
Punjab,Ferozepur,Cerebral Palsy,0,6,18,10,28
Punjab,Ferozepur,Cerebral Palsy,6,15,78,44,122
Punjab,Ferozepur,Cerebral Palsy,15,35,123,51,174
Punjab,Ferozepur,Cerebral Palsy,35,60,21,11,32
Punjab,Ferozepur,Cerebral Palsy,60,80,0,1,1
Punjab,Fazilka,Cerebral Palsy,0,6,33,26,59
Punjab,Fazilka,Cerebral Palsy,6,15,159,90,249
Punjab,Fazilka,Cerebral Palsy,15,35,209,70,279
Punjab,Fazilka,Cerebral Palsy,35,60,19,13,32
Punjab,Fazilka,Cerebral Palsy,60,80,3,0,3
Uttar Pradesh,Fatehpur,Cerebral Palsy,0,6,16,8,24
Uttar Pradesh,Fatehpur,Cerebral Palsy,6,15,63,26,89
Uttar Pradesh,Fatehpur,Cerebral Palsy,15,35,81,36,117
Uttar Pradesh,Fatehpur,Cerebral Palsy,35,60,66,18,84
Uttar Pradesh,Fatehpur,Cerebral Palsy,60,80,20,4,24
Uttar Pradesh,Fatehpur,Cerebral Palsy,80,100,1,1,2
Punjab,Fatehgarh Sahib,Cerebral Palsy,0,6,21,15,36
Punjab,Fatehgarh Sahib,Cerebral Palsy,6,15,75,44,119
Punjab,Fatehgarh Sahib,Cerebral Palsy,15,35,68,36,104
Punjab,Fatehgarh Sahib,Cerebral Palsy,35,60,47,20,67
Punjab,Fatehgarh Sahib,Cerebral Palsy,60,80,15,4,19
Haryana,Fatehabad,Cerebral Palsy,0,6,8,4,12
Haryana,Fatehabad,Cerebral Palsy,6,15,20,16,36
Haryana,Fatehabad,Cerebral Palsy,15,35,20,8,28
Haryana,Fatehabad,Cerebral Palsy,35,60,6,3,9
Haryana,Fatehabad,Cerebral Palsy,60,80,1,0,1
Uttar Pradesh,Farrukhabad,Cerebral Palsy,0,6,11,12,23
Uttar Pradesh,Farrukhabad,Cerebral Palsy,6,15,171,97,268
Uttar Pradesh,Farrukhabad,Cerebral Palsy,15,35,136,72,208
Uttar Pradesh,Farrukhabad,Cerebral Palsy,35,60,56,17,73
Uttar Pradesh,Farrukhabad,Cerebral Palsy,60,80,11,1,12
Punjab,Faridkot,Cerebral Palsy,0,6,10,7,17
Punjab,Faridkot,Cerebral Palsy,6,15,39,29,68
Punjab,Faridkot,Cerebral Palsy,15,35,89,35,124
Punjab,Faridkot,Cerebral Palsy,35,60,43,9,52
Punjab,Faridkot,Cerebral Palsy,60,80,3,2,5
Haryana,Faridabad,Cerebral Palsy,0,6,1,8,9
Haryana,Faridabad,Cerebral Palsy,6,15,35,14,49
Haryana,Faridabad,Cerebral Palsy,15,35,46,14,60
Haryana,Faridabad,Cerebral Palsy,35,60,9,1,10
Uttar Pradesh,Etawah,Cerebral Palsy,0,6,10,7,17
Uttar Pradesh,Etawah,Cerebral Palsy,6,15,46,23,69
Uttar Pradesh,Etawah,Cerebral Palsy,15,35,73,39,112
Uttar Pradesh,Etawah,Cerebral Palsy,35,60,57,13,70
Uttar Pradesh,Etawah,Cerebral Palsy,60,80,12,2,14
Uttar Pradesh,Etawah,Cerebral Palsy,80,100,2,0,2
Uttar Pradesh,Etah,Cerebral Palsy,0,6,1,0,1
Uttar Pradesh,Etah,Cerebral Palsy,6,15,15,5,20
Uttar Pradesh,Etah,Cerebral Palsy,15,35,89,34,123
Uttar Pradesh,Etah,Cerebral Palsy,35,60,76,28,104
Uttar Pradesh,Etah,Cerebral Palsy,60,80,7,4,11
Uttar Pradesh,Etah,Cerebral Palsy,80,100,1,0,1
Tamil Nadu,Erode,Cerebral Palsy,0,6,5,1,6
Tamil Nadu,Erode,Cerebral Palsy,6,15,33,18,51
Tamil Nadu,Erode,Cerebral Palsy,15,35,122,79,201
Tamil Nadu,Erode,Cerebral Palsy,35,60,53,16,69
Tamil Nadu,Erode,Cerebral Palsy,60,80,6,0,6
Kerala,Ernakulam,Cerebral Palsy,0,6,17,8,25
Kerala,Ernakulam,Cerebral Palsy,6,15,107,56,163
Kerala,Ernakulam,Cerebral Palsy,15,35,243,204,447
Kerala,Ernakulam,Cerebral Palsy,35,60,116,63,179
Kerala,Ernakulam,Cerebral Palsy,60,80,11,1,12
Kerala,Ernakulam,Cerebral Palsy,80,100,1,0,1
Meghalaya,Eastern West Khasi Hills,Cerebral Palsy,0,6,0,1,1
Meghalaya,Eastern West Khasi Hills,Cerebral Palsy,15,35,3,1,4
Jharkhand,East Singhbum,Cerebral Palsy,0,6,0,1,1
Jharkhand,East Singhbum,Cerebral Palsy,6,15,4,5,9
Jharkhand,East Singhbum,Cerebral Palsy,15,35,33,10,43
Jharkhand,East Singhbum,Cerebral Palsy,35,60,29,14,43
Jharkhand,East Singhbum,Cerebral Palsy,60,80,11,7,18
Arunachal Pradesh,East Siang,Cerebral Palsy,0,6,0,3,3
Arunachal Pradesh,East Siang,Cerebral Palsy,6,15,3,3,6
Arunachal Pradesh,East Siang,Cerebral Palsy,15,35,3,1,4
Madhya Pradesh,East Nimar,Cerebral Palsy,6,15,1,5,6
Madhya Pradesh,East Nimar,Cerebral Palsy,15,35,16,6,22
Madhya Pradesh,East Nimar,Cerebral Palsy,35,60,4,1,5
Meghalaya,East Khasi Hills,Cerebral Palsy,0,6,13,8,21
Meghalaya,East Khasi Hills,Cerebral Palsy,6,15,86,41,127
Meghalaya,East Khasi Hills,Cerebral Palsy,15,35,73,48,121
Meghalaya,East Khasi Hills,Cerebral Palsy,35,60,8,9,17
Arunachal Pradesh,East Kameng,Cerebral Palsy,0,6,1,0,1
Arunachal Pradesh,East Kameng,Cerebral Palsy,6,15,1,0,1
Arunachal Pradesh,East Kameng,Cerebral Palsy,15,35,0,2,2
Arunachal Pradesh,East Kameng,Cerebral Palsy,35,60,2,0,2
Meghalaya,East Jaintia Hills,Cerebral Palsy,0,6,15,19,34
Meghalaya,East Jaintia Hills,Cerebral Palsy,6,15,37,29,66
Meghalaya,East Jaintia Hills,Cerebral Palsy,15,35,22,17,39
Meghalaya,East Jaintia Hills,Cerebral Palsy,35,60,4,4,8
Andhra Pradesh,East Godavari,Cerebral Palsy,15,35,7,4,11
Meghalaya,East Garo Hills,Cerebral Palsy,0,6,7,8,15
Meghalaya,East Garo Hills,Cerebral Palsy,6,15,15,15,30
Meghalaya,East Garo Hills,Cerebral Palsy,15,35,37,29,66
Meghalaya,East Garo Hills,Cerebral Palsy,35,60,3,1,4
Meghalaya,East Garo Hills,Cerebral Palsy,60,80,1,0,1
Delhi,East,Cerebral Palsy,0,6,9,8,17
Delhi,East,Cerebral Palsy,6,15,41,21,62
Delhi,East,Cerebral Palsy,15,35,31,24,55
Delhi,East,Cerebral Palsy,35,60,2,3,5
Chhattisgarh,Durg,Cerebral Palsy,0,6,0,1,1
Chhattisgarh,Durg,Cerebral Palsy,6,15,12,12,24
Chhattisgarh,Durg,Cerebral Palsy,15,35,30,22,52
Chhattisgarh,Durg,Cerebral Palsy,35,60,22,13,35
Chhattisgarh,Durg,Cerebral Palsy,60,80,5,0,5
Rajasthan,Dungarpur,Cerebral Palsy,0,6,3,0,3
Rajasthan,Dungarpur,Cerebral Palsy,6,15,13,4,17
Rajasthan,Dungarpur,Cerebral Palsy,15,35,15,13,28
Rajasthan,Dungarpur,Cerebral Palsy,35,60,7,4,11
Rajasthan,Dungarpur,Cerebral Palsy,60,80,1,0,1
Jharkhand,Dumka,Cerebral Palsy,0,6,7,10,17
Jharkhand,Dumka,Cerebral Palsy,6,15,86,33,119
Jharkhand,Dumka,Cerebral Palsy,15,35,31,16,47
Jharkhand,Dumka,Cerebral Palsy,35,60,15,7,22
Jharkhand,Dumka,Cerebral Palsy,60,80,5,0,5
Jharkhand,Dumka,Cerebral Palsy,80,100,1,0,1
Gujarat,Dohad,Cerebral Palsy,0,6,24,13,37
Gujarat,Dohad,Cerebral Palsy,6,15,100,60,160
Gujarat,Dohad,Cerebral Palsy,15,35,30,14,44
Gujarat,Dohad,Cerebral Palsy,35,60,7,1,8
Jammu And Kashmir,Doda,Cerebral Palsy,0,6,20,13,33
Jammu And Kashmir,Doda,Cerebral Palsy,6,15,63,31,94
Jammu And Kashmir,Doda,Cerebral Palsy,15,35,54,32,86
Jammu And Kashmir,Doda,Cerebral Palsy,35,60,12,7,19
Dadra Nagar Haveli And Daman And Diu,Diu,Cerebral Palsy,15,35,2,1,3
Dadra Nagar Haveli And Daman And Diu,Diu,Cerebral Palsy,35,60,1,0,1
Madhya Pradesh,Dindori,Cerebral Palsy,0,6,0,1,1
Madhya Pradesh,Dindori,Cerebral Palsy,6,15,11,13,24
Madhya Pradesh,Dindori,Cerebral Palsy,15,35,37,18,55
Madhya Pradesh,Dindori,Cerebral Palsy,35,60,9,3,12
Madhya Pradesh,Dindori,Cerebral Palsy,60,80,2,0,2
Tamil Nadu,Dindigul,Cerebral Palsy,0,6,6,3,9
Tamil Nadu,Dindigul,Cerebral Palsy,6,15,84,55,139
Tamil Nadu,Dindigul,Cerebral Palsy,15,35,268,158,426
Tamil Nadu,Dindigul,Cerebral Palsy,35,60,54,25,79
Tamil Nadu,Dindigul,Cerebral Palsy,60,80,4,0,4
West Bengal,Dinajpur Uttar,Cerebral Palsy,15,35,1,0,1
Nagaland,Dimapur,Cerebral Palsy,0,6,0,2,2
Nagaland,Dimapur,Cerebral Palsy,6,15,14,7,21
Nagaland,Dimapur,Cerebral Palsy,15,35,11,7,18
Nagaland,Dimapur,Cerebral Palsy,35,60,3,3,6
Assam,Dima Hasao,Cerebral Palsy,0,6,0,1,1
Assam,Dima Hasao,Cerebral Palsy,6,15,9,10,19
Assam,Dima Hasao,Cerebral Palsy,15,35,7,5,12
Assam,Dima Hasao,Cerebral Palsy,35,60,2,1,3
Assam,Dima Hasao,Cerebral Palsy,60,80,1,0,1
Assam,Dibrugarh,Cerebral Palsy,0,6,7,11,18
Assam,Dibrugarh,Cerebral Palsy,6,15,32,34,66
Assam,Dibrugarh,Cerebral Palsy,15,35,55,32,87
Assam,Dibrugarh,Cerebral Palsy,35,60,31,13,44
Assam,Dibrugarh,Cerebral Palsy,60,80,2,2,4
Maharashtra,Dhule,Cerebral Palsy,0,6,4,2,6
Maharashtra,Dhule,Cerebral Palsy,6,15,12,11,23
Maharashtra,Dhule,Cerebral Palsy,15,35,33,4,37
Maharashtra,Dhule,Cerebral Palsy,35,60,23,5,28
Maharashtra,Dhule,Cerebral Palsy,60,80,5,0,5
Assam,Dhubri,Cerebral Palsy,0,6,30,31,61
Assam,Dhubri,Cerebral Palsy,6,15,132,97,229
Assam,Dhubri,Cerebral Palsy,15,35,80,34,114
Assam,Dhubri,Cerebral Palsy,35,60,7,0,7
Assam,Dhubri,Cerebral Palsy,60,80,2,0,2
Rajasthan,Dholpur,Cerebral Palsy,6,15,5,2,7
Rajasthan,Dholpur,Cerebral Palsy,15,35,3,0,3
Odisha,Dhenkanal,Cerebral Palsy,0,6,32,21,53
Odisha,Dhenkanal,Cerebral Palsy,6,15,126,62,188
Odisha,Dhenkanal,Cerebral Palsy,15,35,77,52,129
Odisha,Dhenkanal,Cerebral Palsy,35,60,39,13,52
Odisha,Dhenkanal,Cerebral Palsy,60,80,9,6,15
Odisha,Dhenkanal,Cerebral Palsy,80,100,1,0,1
Assam,Dhemaji,Cerebral Palsy,0,6,21,8,29
Assam,Dhemaji,Cerebral Palsy,6,15,26,15,41
Assam,Dhemaji,Cerebral Palsy,15,35,16,8,24
Assam,Dhemaji,Cerebral Palsy,35,60,3,3,6
Karnataka,Dharwad,Cerebral Palsy,0,6,28,28,56
Karnataka,Dharwad,Cerebral Palsy,6,15,83,49,132
Karnataka,Dharwad,Cerebral Palsy,15,35,62,28,90
Karnataka,Dharwad,Cerebral Palsy,35,60,120,40,160
Karnataka,Dharwad,Cerebral Palsy,60,80,40,4,44
Tamil Nadu,Dharmapuri,Cerebral Palsy,0,6,8,10,18
Tamil Nadu,Dharmapuri,Cerebral Palsy,6,15,55,31,86
Tamil Nadu,Dharmapuri,Cerebral Palsy,15,35,140,93,233
Tamil Nadu,Dharmapuri,Cerebral Palsy,35,60,35,10,45
Tamil Nadu,Dharmapuri,Cerebral Palsy,60,80,2,2,4
Madhya Pradesh,Dhar,Cerebral Palsy,0,6,12,9,21
Madhya Pradesh,Dhar,Cerebral Palsy,6,15,31,29,60
Madhya Pradesh,Dhar,Cerebral Palsy,15,35,22,12,34
Madhya Pradesh,Dhar,Cerebral Palsy,35,60,10,4,14
Madhya Pradesh,Dhar,Cerebral Palsy,60,80,1,2,3
Jharkhand,Dhanbad,Cerebral Palsy,0,6,3,1,4
Jharkhand,Dhanbad,Cerebral Palsy,6,15,40,17,57
Jharkhand,Dhanbad,Cerebral Palsy,15,35,100,58,158
Jharkhand,Dhanbad,Cerebral Palsy,35,60,56,39,95
Jharkhand,Dhanbad,Cerebral Palsy,60,80,8,2,10
Jharkhand,Dhanbad,Cerebral Palsy,80,100,1,0,1
Chhattisgarh,Dhamtari,Cerebral Palsy,0,6,3,3,6
Chhattisgarh,Dhamtari,Cerebral Palsy,6,15,37,26,63
Chhattisgarh,Dhamtari,Cerebral Palsy,15,35,91,57,148
Chhattisgarh,Dhamtari,Cerebral Palsy,35,60,18,18,36
Chhattisgarh,Dhamtari,Cerebral Palsy,60,80,3,1,4
Tripura,Dhalai,Cerebral Palsy,6,15,8,2,10
Tripura,Dhalai,Cerebral Palsy,15,35,8,1,9
Tripura,Dhalai,Cerebral Palsy,35,60,1,1,2
Tripura,Dhalai,Cerebral Palsy,60,80,1,0,1
Madhya Pradesh,Dewas,Cerebral Palsy,0,6,3,0,3
Madhya Pradesh,Dewas,Cerebral Palsy,6,15,79,39,118
Madhya Pradesh,Dewas,Cerebral Palsy,15,35,142,64,206
Madhya Pradesh,Dewas,Cerebral Palsy,35,60,24,14,38
Madhya Pradesh,Dewas,Cerebral Palsy,60,80,4,1,5
Madhya Pradesh,Dewas,Cerebral Palsy,80,100,1,0,1
Gujarat,Devbhumi Dwarka,Cerebral Palsy,6,15,0,1,1
Gujarat,Devbhumi Dwarka,Cerebral Palsy,15,35,3,1,4
Gujarat,Devbhumi Dwarka,Cerebral Palsy,35,60,1,0,1
Uttar Pradesh,Deoria,Cerebral Palsy,0,6,7,6,13
Uttar Pradesh,Deoria,Cerebral Palsy,6,15,182,89,271
Uttar Pradesh,Deoria,Cerebral Palsy,15,35,193,70,263
Uttar Pradesh,Deoria,Cerebral Palsy,35,60,44,11,55
Uttar Pradesh,Deoria,Cerebral Palsy,60,80,15,2,17
Uttar Pradesh,Deoria,Cerebral Palsy,80,100,1,1,2
Jharkhand,Deoghar,Cerebral Palsy,0,6,12,5,17
Jharkhand,Deoghar,Cerebral Palsy,6,15,50,37,87
Jharkhand,Deoghar,Cerebral Palsy,15,35,36,26,62
Jharkhand,Deoghar,Cerebral Palsy,35,60,28,15,43
Jharkhand,Deoghar,Cerebral Palsy,60,80,6,1,7
Odisha,Deogarh,Cerebral Palsy,0,6,14,14,28
Odisha,Deogarh,Cerebral Palsy,6,15,30,16,46
Odisha,Deogarh,Cerebral Palsy,15,35,15,10,25
Odisha,Deogarh,Cerebral Palsy,35,60,2,3,5
Odisha,Deogarh,Cerebral Palsy,60,80,0,1,1
Uttarakhand,Dehradun,Cerebral Palsy,0,6,35,7,42
Uttarakhand,Dehradun,Cerebral Palsy,6,15,108,59,167
Uttarakhand,Dehradun,Cerebral Palsy,15,35,134,62,196
Uttarakhand,Dehradun,Cerebral Palsy,35,60,26,14,40
Uttarakhand,Dehradun,Cerebral Palsy,60,80,1,1,2
Karnataka,Davangere,Cerebral Palsy,0,6,23,19,42
Karnataka,Davangere,Cerebral Palsy,6,15,89,59,148
Karnataka,Davangere,Cerebral Palsy,15,35,81,58,139
Karnataka,Davangere,Cerebral Palsy,35,60,40,11,51
Karnataka,Davangere,Cerebral Palsy,60,80,3,2,5
Rajasthan,Dausa,Cerebral Palsy,0,6,21,9,30
Rajasthan,Dausa,Cerebral Palsy,6,15,131,70,201
Rajasthan,Dausa,Cerebral Palsy,15,35,130,58,188
Rajasthan,Dausa,Cerebral Palsy,35,60,17,8,25
Rajasthan,Dausa,Cerebral Palsy,60,80,0,1,1
Madhya Pradesh,Datia,Cerebral Palsy,0,6,17,11,28
Madhya Pradesh,Datia,Cerebral Palsy,6,15,64,28,92
Madhya Pradesh,Datia,Cerebral Palsy,15,35,63,27,90
Madhya Pradesh,Datia,Cerebral Palsy,35,60,12,3,15
Madhya Pradesh,Datia,Cerebral Palsy,60,80,1,0,1
Assam,Darrang,Cerebral Palsy,0,6,8,4,12
Assam,Darrang,Cerebral Palsy,6,15,32,24,56
Assam,Darrang,Cerebral Palsy,15,35,17,13,30
Assam,Darrang,Cerebral Palsy,35,60,2,2,4
Assam,Darrang,Cerebral Palsy,60,80,2,1,3
Bihar,Darbhanga,Cerebral Palsy,0,6,17,5,22
Bihar,Darbhanga,Cerebral Palsy,6,15,71,31,102
Bihar,Darbhanga,Cerebral Palsy,15,35,50,15,65
Bihar,Darbhanga,Cerebral Palsy,35,60,7,2,9
Bihar,Darbhanga,Cerebral Palsy,60,80,4,0,4
Chhattisgarh,Dantewada,Cerebral Palsy,0,6,0,2,2
Chhattisgarh,Dantewada,Cerebral Palsy,6,15,5,3,8
Chhattisgarh,Dantewada,Cerebral Palsy,15,35,5,4,9
Chhattisgarh,Dantewada,Cerebral Palsy,35,60,1,0,1
Chhattisgarh,Dantewada,Cerebral Palsy,60,80,0,1,1
Madhya Pradesh,Damoh,Cerebral Palsy,6,15,17,5,22
Madhya Pradesh,Damoh,Cerebral Palsy,15,35,40,21,61
Madhya Pradesh,Damoh,Cerebral Palsy,35,60,16,8,24
Madhya Pradesh,Damoh,Cerebral Palsy,60,80,3,5,8
Madhya Pradesh,Damoh,Cerebral Palsy,80,100,1,0,1
Dadra Nagar Haveli And Daman And Diu,Daman,Cerebral Palsy,0,6,1,0,1
Dadra Nagar Haveli And Daman And Diu,Daman,Cerebral Palsy,6,15,6,5,11
Dadra Nagar Haveli And Daman And Diu,Daman,Cerebral Palsy,15,35,4,1,5
Dadra Nagar Haveli And Daman And Diu,Daman,Cerebral Palsy,35,60,1,1,2
Karnataka,Dakshina Kannada,Cerebral Palsy,0,6,18,13,31
Karnataka,Dakshina Kannada,Cerebral Palsy,6,15,92,69,161
Karnataka,Dakshina Kannada,Cerebral Palsy,15,35,184,116,300
Karnataka,Dakshina Kannada,Cerebral Palsy,35,60,107,70,177
Karnataka,Dakshina Kannada,Cerebral Palsy,60,80,10,9,19
Dadra Nagar Haveli And Daman And Diu,Dadra And Nagar Haveli,Cerebral Palsy,0,6,0,1,1
Dadra Nagar Haveli And Daman And Diu,Dadra And Nagar Haveli,Cerebral Palsy,6,15,4,3,7
Dadra Nagar Haveli And Daman And Diu,Dadra And Nagar Haveli,Cerebral Palsy,15,35,1,2,3
Odisha,Cuttack,Cerebral Palsy,0,6,20,17,37
Odisha,Cuttack,Cerebral Palsy,6,15,145,68,213
Odisha,Cuttack,Cerebral Palsy,15,35,91,38,129
Odisha,Cuttack,Cerebral Palsy,35,60,50,27,77
Odisha,Cuttack,Cerebral Palsy,60,80,16,5,21
Tamil Nadu,Cuddalore,Cerebral Palsy,0,6,10,3,13
Tamil Nadu,Cuddalore,Cerebral Palsy,6,15,66,41,107
Tamil Nadu,Cuddalore,Cerebral Palsy,15,35,162,113,275
Tamil Nadu,Cuddalore,Cerebral Palsy,35,60,61,32,93
Tamil Nadu,Cuddalore,Cerebral Palsy,60,80,3,3,6
Tamil Nadu,Cuddalore,Cerebral Palsy,80,100,0,1,1
West Bengal,Coochbehar,Cerebral Palsy,15,35,1,0,1
Tamil Nadu,Coimbatore,Cerebral Palsy,0,6,14,11,25
Tamil Nadu,Coimbatore,Cerebral Palsy,6,15,53,32,85
Tamil Nadu,Coimbatore,Cerebral Palsy,15,35,74,52,126
Tamil Nadu,Coimbatore,Cerebral Palsy,35,60,15,10,25
Tamil Nadu,Coimbatore,Cerebral Palsy,60,80,2,0,2
Rajasthan,Churu,Cerebral Palsy,0,6,7,1,8
Rajasthan,Churu,Cerebral Palsy,6,15,45,23,68
Rajasthan,Churu,Cerebral Palsy,15,35,61,28,89
Rajasthan,Churu,Cerebral Palsy,35,60,13,6,19
Manipur,Churachandpur,Cerebral Palsy,0,6,6,9,15
Manipur,Churachandpur,Cerebral Palsy,6,15,15,7,22
Manipur,Churachandpur,Cerebral Palsy,15,35,18,8,26
Manipur,Churachandpur,Cerebral Palsy,35,60,5,3,8
Rajasthan,Chittorgarh,Cerebral Palsy,0,6,1,4,5
Rajasthan,Chittorgarh,Cerebral Palsy,6,15,24,20,44
Rajasthan,Chittorgarh,Cerebral Palsy,15,35,35,23,58
Rajasthan,Chittorgarh,Cerebral Palsy,35,60,12,9,21
Rajasthan,Chittorgarh,Cerebral Palsy,60,80,3,0,3
Andhra Pradesh,Chittoor,Cerebral Palsy,6,15,2,0,2
Andhra Pradesh,Chittoor,Cerebral Palsy,15,35,2,1,3
Uttar Pradesh,Chitrakoot,Cerebral Palsy,0,6,1,0,1
Uttar Pradesh,Chitrakoot,Cerebral Palsy,6,15,9,8,17
Uttar Pradesh,Chitrakoot,Cerebral Palsy,15,35,59,20,79
Uttar Pradesh,Chitrakoot,Cerebral Palsy,35,60,42,21,63
Uttar Pradesh,Chitrakoot,Cerebral Palsy,60,80,8,2,10
Karnataka,Chitradurga,Cerebral Palsy,0,6,13,18,31
Karnataka,Chitradurga,Cerebral Palsy,6,15,51,52,103
Karnataka,Chitradurga,Cerebral Palsy,15,35,68,41,109
Karnataka,Chitradurga,Cerebral Palsy,35,60,16,26,42
Karnataka,Chitradurga,Cerebral Palsy,60,80,8,1,9
Assam,Chirang,Cerebral Palsy,0,6,13,10,23
Assam,Chirang,Cerebral Palsy,6,15,44,25,69
Assam,Chirang,Cerebral Palsy,15,35,18,21,39
Assam,Chirang,Cerebral Palsy,35,60,5,2,7
Assam,Chirang,Cerebral Palsy,60,80,1,0,1
Karnataka,Chikkamagaluru,Cerebral Palsy,0,6,7,3,10
Karnataka,Chikkamagaluru,Cerebral Palsy,6,15,32,15,47
Karnataka,Chikkamagaluru,Cerebral Palsy,15,35,52,39,91
Karnataka,Chikkamagaluru,Cerebral Palsy,35,60,29,20,49
Karnataka,Chikkamagaluru,Cerebral Palsy,60,80,7,1,8
Karnataka,Chikkaballapura,Cerebral Palsy,0,6,7,2,9
Karnataka,Chikkaballapura,Cerebral Palsy,6,15,19,14,33
Karnataka,Chikkaballapura,Cerebral Palsy,15,35,32,11,43
Karnataka,Chikkaballapura,Cerebral Palsy,35,60,7,7,14
Karnataka,Chikkaballapura,Cerebral Palsy,60,80,5,1,6
Gujarat,Chhotaudepur,Cerebral Palsy,0,6,4,4,8
Gujarat,Chhotaudepur,Cerebral Palsy,6,15,23,6,29
Gujarat,Chhotaudepur,Cerebral Palsy,15,35,18,11,29
Gujarat,Chhotaudepur,Cerebral Palsy,35,60,8,1,9
Gujarat,Chhotaudepur,Cerebral Palsy,60,80,1,0,1
Madhya Pradesh,Chhindwara,Cerebral Palsy,0,6,6,2,8
Madhya Pradesh,Chhindwara,Cerebral Palsy,6,15,60,24,84
Madhya Pradesh,Chhindwara,Cerebral Palsy,15,35,96,75,171
Madhya Pradesh,Chhindwara,Cerebral Palsy,35,60,26,17,43
Madhya Pradesh,Chhindwara,Cerebral Palsy,60,80,5,3,8
Madhya Pradesh,Chhatarpur,Cerebral Palsy,0,6,28,12,40
Madhya Pradesh,Chhatarpur,Cerebral Palsy,6,15,122,47,169
Madhya Pradesh,Chhatarpur,Cerebral Palsy,15,35,173,72,245
Madhya Pradesh,Chhatarpur,Cerebral Palsy,35,60,10,9,19
Madhya Pradesh,Chhatarpur,Cerebral Palsy,60,80,3,0,3
Tamil Nadu,Chennai,Cerebral Palsy,0,6,13,7,20
Tamil Nadu,Chennai,Cerebral Palsy,6,15,87,70,157
Tamil Nadu,Chennai,Cerebral Palsy,15,35,227,126,353
Tamil Nadu,Chennai,Cerebral Palsy,35,60,108,61,169
Tamil Nadu,Chennai,Cerebral Palsy,60,80,7,5,12
Tamil Nadu,Chennai,Cerebral Palsy,80,100,1,0,1
Tamil Nadu,Chengalpattu,Cerebral Palsy,0,6,4,7,11
Tamil Nadu,Chengalpattu,Cerebral Palsy,6,15,20,18,38
Tamil Nadu,Chengalpattu,Cerebral Palsy,15,35,47,29,76
Tamil Nadu,Chengalpattu,Cerebral Palsy,35,60,21,10,31
Tamil Nadu,Chengalpattu,Cerebral Palsy,60,80,2,0,2
Jharkhand,Chatra,Cerebral Palsy,0,6,18,8,26
Jharkhand,Chatra,Cerebral Palsy,6,15,65,31,96
Jharkhand,Chatra,Cerebral Palsy,15,35,22,14,36
Jharkhand,Chatra,Cerebral Palsy,35,60,0,3,3
Jharkhand,Chatra,Cerebral Palsy,60,80,1,1,2
Haryana,Charki Dadri,Cerebral Palsy,0,6,4,4,8
Haryana,Charki Dadri,Cerebral Palsy,6,15,32,15,47
Haryana,Charki Dadri,Cerebral Palsy,15,35,35,13,48
Haryana,Charki Dadri,Cerebral Palsy,35,60,7,2,9
Haryana,Charki Dadri,Cerebral Palsy,60,80,0,1,1
Assam,Charaideo,Cerebral Palsy,0,6,21,12,33
Assam,Charaideo,Cerebral Palsy,6,15,34,27,61
Assam,Charaideo,Cerebral Palsy,15,35,19,16,35
Assam,Charaideo,Cerebral Palsy,35,60,2,1,3
Assam,Charaideo,Cerebral Palsy,60,80,1,0,1
Maharashtra,Chandrapur,Cerebral Palsy,0,6,16,13,29
Maharashtra,Chandrapur,Cerebral Palsy,6,15,104,68,172
Maharashtra,Chandrapur,Cerebral Palsy,15,35,77,27,104
Maharashtra,Chandrapur,Cerebral Palsy,35,60,21,9,30
Maharashtra,Chandrapur,Cerebral Palsy,60,80,1,2,3
Chandigarh,Chandigarh,Cerebral Palsy,0,6,2,4,6
Chandigarh,Chandigarh,Cerebral Palsy,6,15,24,10,34
Chandigarh,Chandigarh,Cerebral Palsy,15,35,60,34,94
Chandigarh,Chandigarh,Cerebral Palsy,35,60,20,15,35
Chandigarh,Chandigarh,Cerebral Palsy,60,80,0,1,1
Chandigarh,Chandigarh,Cerebral Palsy,80,100,1,0,1
Manipur,Chandel,Cerebral Palsy,15,35,3,2,5
Manipur,Chandel,Cerebral Palsy,35,60,0,1,1
Manipur,Chandel,Cerebral Palsy,60,80,1,0,1
Uttar Pradesh,Chandauli,Cerebral Palsy,0,6,13,7,20
Uttar Pradesh,Chandauli,Cerebral Palsy,6,15,78,40,118
Uttar Pradesh,Chandauli,Cerebral Palsy,15,35,131,51,182
Uttar Pradesh,Chandauli,Cerebral Palsy,35,60,26,9,35
Uttar Pradesh,Chandauli,Cerebral Palsy,80,100,1,0,1
Mizoram,Champhai,Cerebral Palsy,6,15,0,2,2
Mizoram,Champhai,Cerebral Palsy,15,35,1,0,1
Uttarakhand,Champawat,Cerebral Palsy,0,6,4,1,5
Uttarakhand,Champawat,Cerebral Palsy,6,15,20,13,33
Uttarakhand,Champawat,Cerebral Palsy,15,35,26,15,41
Uttarakhand,Champawat,Cerebral Palsy,35,60,14,9,23
Uttarakhand,Chamoli,Cerebral Palsy,6,15,4,2,6
Uttarakhand,Chamoli,Cerebral Palsy,15,35,21,8,29
Uttarakhand,Chamoli,Cerebral Palsy,35,60,15,11,26
Uttarakhand,Chamoli,Cerebral Palsy,60,80,2,0,2
Himachal Pradesh,Chamba,Cerebral Palsy,0,6,9,9,18
Himachal Pradesh,Chamba,Cerebral Palsy,6,15,17,12,29
Himachal Pradesh,Chamba,Cerebral Palsy,15,35,11,1,12
Himachal Pradesh,Chamba,Cerebral Palsy,35,60,2,1,3
Karnataka,Chamarajanagara,Cerebral Palsy,0,6,16,7,23
Karnataka,Chamarajanagara,Cerebral Palsy,6,15,50,29,79
Karnataka,Chamarajanagara,Cerebral Palsy,15,35,36,26,62
Karnataka,Chamarajanagara,Cerebral Palsy,35,60,10,1,11
Karnataka,Chamarajanagara,Cerebral Palsy,60,80,0,3,3
Delhi,Central,Cerebral Palsy,0,6,0,2,2
Delhi,Central,Cerebral Palsy,6,15,3,1,4
Delhi,Central,Cerebral Palsy,15,35,3,1,4
Delhi,Central,Cerebral Palsy,35,60,2,0,2
Delhi,Central,Cerebral Palsy,60,80,1,0,1
Assam,Cachar,Cerebral Palsy,0,6,1,0,1
Assam,Cachar,Cerebral Palsy,6,15,28,18,46
Assam,Cachar,Cerebral Palsy,15,35,83,47,130
Assam,Cachar,Cerebral Palsy,35,60,29,24,53
Assam,Cachar,Cerebral Palsy,60,80,5,1,6
Bihar,Buxar,Cerebral Palsy,0,6,45,16,61
Bihar,Buxar,Cerebral Palsy,6,15,188,100,288
Bihar,Buxar,Cerebral Palsy,15,35,250,103,353
Bihar,Buxar,Cerebral Palsy,35,60,44,20,64
Bihar,Buxar,Cerebral Palsy,60,80,6,2,8
Madhya Pradesh,Burhanpur,Cerebral Palsy,0,6,2,7,9
Madhya Pradesh,Burhanpur,Cerebral Palsy,6,15,26,11,37
Madhya Pradesh,Burhanpur,Cerebral Palsy,15,35,39,17,56
Madhya Pradesh,Burhanpur,Cerebral Palsy,35,60,12,6,18
Madhya Pradesh,Burhanpur,Cerebral Palsy,60,80,2,1,3
Rajasthan,Bundi,Cerebral Palsy,0,6,20,6,26
Rajasthan,Bundi,Cerebral Palsy,6,15,76,45,121
Rajasthan,Bundi,Cerebral Palsy,15,35,43,21,64
Rajasthan,Bundi,Cerebral Palsy,35,60,16,7,23
Rajasthan,Bundi,Cerebral Palsy,60,80,3,3,6
Maharashtra,Buldhana,Cerebral Palsy,0,6,6,6,12
Maharashtra,Buldhana,Cerebral Palsy,6,15,38,27,65
Maharashtra,Buldhana,Cerebral Palsy,15,35,9,6,15
Maharashtra,Buldhana,Cerebral Palsy,35,60,5,4,9
Maharashtra,Buldhana,Cerebral Palsy,60,80,0,1,1
Uttar Pradesh,Bulandshahr,Cerebral Palsy,0,6,31,18,49
Uttar Pradesh,Bulandshahr,Cerebral Palsy,6,15,175,67,242
Uttar Pradesh,Bulandshahr,Cerebral Palsy,15,35,125,46,171
Uttar Pradesh,Bulandshahr,Cerebral Palsy,35,60,47,17,64
Uttar Pradesh,Bulandshahr,Cerebral Palsy,60,80,11,2,13
Jammu And Kashmir,Budgam,Cerebral Palsy,0,6,11,11,22
Jammu And Kashmir,Budgam,Cerebral Palsy,6,15,92,70,162
Jammu And Kashmir,Budgam,Cerebral Palsy,15,35,100,74,174
Jammu And Kashmir,Budgam,Cerebral Palsy,35,60,31,20,51
Uttar Pradesh,Budaun,Cerebral Palsy,0,6,2,4,6
Uttar Pradesh,Budaun,Cerebral Palsy,6,15,22,5,27
Uttar Pradesh,Budaun,Cerebral Palsy,15,35,25,9,34
Uttar Pradesh,Budaun,Cerebral Palsy,35,60,10,5,15
Uttar Pradesh,Budaun,Cerebral Palsy,60,80,2,2,4
Odisha,Boudh,Cerebral Palsy,0,6,11,11,22
Odisha,Boudh,Cerebral Palsy,6,15,45,35,80
Odisha,Boudh,Cerebral Palsy,15,35,13,17,30
Odisha,Boudh,Cerebral Palsy,35,60,19,8,27
Odisha,Boudh,Cerebral Palsy,60,80,3,3,6
Gujarat,Botad,Cerebral Palsy,0,6,9,9,18
Gujarat,Botad,Cerebral Palsy,6,15,23,11,34
Gujarat,Botad,Cerebral Palsy,15,35,24,8,32
Gujarat,Botad,Cerebral Palsy,35,60,6,5,11
Assam,Bongaigaon,Cerebral Palsy,0,6,48,50,98
Assam,Bongaigaon,Cerebral Palsy,6,15,119,94,213
Assam,Bongaigaon,Cerebral Palsy,15,35,56,58,114
Assam,Bongaigaon,Cerebral Palsy,35,60,14,8,22
Assam,Bongaigaon,Cerebral Palsy,60,80,2,0,2
Jharkhand,Bokaro,Cerebral Palsy,0,6,12,7,19
Jharkhand,Bokaro,Cerebral Palsy,6,15,119,66,185
Jharkhand,Bokaro,Cerebral Palsy,15,35,222,113,335
Jharkhand,Bokaro,Cerebral Palsy,35,60,90,25,115
Jharkhand,Bokaro,Cerebral Palsy,60,80,8,4,12
Assam,Biswanath,Cerebral Palsy,0,6,28,15,43
Assam,Biswanath,Cerebral Palsy,6,15,45,27,72
Assam,Biswanath,Cerebral Palsy,15,35,23,16,39
Assam,Biswanath,Cerebral Palsy,35,60,5,3,8
Assam,Biswanath,Cerebral Palsy,60,80,0,1,1
Manipur,Bishnupur,Cerebral Palsy,0,6,4,3,7
Manipur,Bishnupur,Cerebral Palsy,6,15,13,6,19
Manipur,Bishnupur,Cerebral Palsy,15,35,16,13,29
Manipur,Bishnupur,Cerebral Palsy,35,60,6,2,8
Manipur,Bishnupur,Cerebral Palsy,60,80,2,1,3
Chhattisgarh,Bilaspur,Cerebral Palsy,0,6,24,13,37
Chhattisgarh,Bilaspur,Cerebral Palsy,6,15,169,145,314
Chhattisgarh,Bilaspur,Cerebral Palsy,15,35,211,158,369
Chhattisgarh,Bilaspur,Cerebral Palsy,35,60,35,16,51
Chhattisgarh,Bilaspur,Cerebral Palsy,60,80,2,1,3
Himachal Pradesh,Bilaspur,Cerebral Palsy,0,6,1,0,1
Himachal Pradesh,Bilaspur,Cerebral Palsy,6,15,4,3,7
Himachal Pradesh,Bilaspur,Cerebral Palsy,15,35,1,0,1
Himachal Pradesh,Bilaspur,Cerebral Palsy,35,60,2,1,3
Rajasthan,Bikaner,Cerebral Palsy,0,6,2,1,3
Rajasthan,Bikaner,Cerebral Palsy,6,15,31,16,47
Rajasthan,Bikaner,Cerebral Palsy,15,35,62,25,87
Rajasthan,Bikaner,Cerebral Palsy,35,60,14,9,23
Uttar Pradesh,Bijnor,Cerebral Palsy,0,6,22,6,28
Uttar Pradesh,Bijnor,Cerebral Palsy,6,15,160,90,250
Uttar Pradesh,Bijnor,Cerebral Palsy,15,35,190,60,250
Uttar Pradesh,Bijnor,Cerebral Palsy,35,60,43,17,60
Uttar Pradesh,Bijnor,Cerebral Palsy,60,80,13,2,15
Chhattisgarh,Bijapur,Cerebral Palsy,0,6,8,3,11
Chhattisgarh,Bijapur,Cerebral Palsy,6,15,11,14,25
Chhattisgarh,Bijapur,Cerebral Palsy,15,35,10,5,15
Chhattisgarh,Bijapur,Cerebral Palsy,35,60,3,2,5
Chhattisgarh,Bijapur,Cerebral Palsy,60,80,3,1,4
Chhattisgarh,Bijapur,Cerebral Palsy,80,100,0,1,1
Karnataka,Bidar,Cerebral Palsy,0,6,14,8,22
Karnataka,Bidar,Cerebral Palsy,6,15,36,11,47
Karnataka,Bidar,Cerebral Palsy,15,35,32,11,43
Karnataka,Bidar,Cerebral Palsy,35,60,81,19,100
Karnataka,Bidar,Cerebral Palsy,60,80,11,1,12
Karnataka,Bidar,Cerebral Palsy,80,100,1,0,1
Madhya Pradesh,Bhopal,Cerebral Palsy,0,6,16,8,24
Madhya Pradesh,Bhopal,Cerebral Palsy,6,15,42,39,81
Madhya Pradesh,Bhopal,Cerebral Palsy,15,35,99,52,151
Madhya Pradesh,Bhopal,Cerebral Palsy,35,60,38,11,49
Madhya Pradesh,Bhopal,Cerebral Palsy,60,80,3,3,6
Bihar,Bhojpur,Cerebral Palsy,0,6,26,20,46
Bihar,Bhojpur,Cerebral Palsy,6,15,110,68,178
Bihar,Bhojpur,Cerebral Palsy,15,35,73,35,108
Bihar,Bhojpur,Cerebral Palsy,35,60,38,6,44
Bihar,Bhojpur,Cerebral Palsy,60,80,2,1,3
Haryana,Bhiwani,Cerebral Palsy,0,6,49,32,81
Haryana,Bhiwani,Cerebral Palsy,6,15,158,81,239
Haryana,Bhiwani,Cerebral Palsy,15,35,107,34,141
Haryana,Bhiwani,Cerebral Palsy,35,60,32,12,44
Haryana,Bhiwani,Cerebral Palsy,60,80,3,1,4
Madhya Pradesh,Bhind,Cerebral Palsy,0,6,6,2,8
Madhya Pradesh,Bhind,Cerebral Palsy,6,15,43,17,60
Madhya Pradesh,Bhind,Cerebral Palsy,15,35,94,31,125
Madhya Pradesh,Bhind,Cerebral Palsy,35,60,15,9,24
Madhya Pradesh,Bhind,Cerebral Palsy,60,80,0,1,1
Rajasthan,Bhilwara,Cerebral Palsy,0,6,24,9,33
Rajasthan,Bhilwara,Cerebral Palsy,6,15,132,82,214
Rajasthan,Bhilwara,Cerebral Palsy,15,35,141,75,216
Rajasthan,Bhilwara,Cerebral Palsy,35,60,42,19,61
Rajasthan,Bhilwara,Cerebral Palsy,60,80,7,4,11
Rajasthan,Bhilwara,Cerebral Palsy,80,100,0,1,1
Gujarat,Bhavnagar,Cerebral Palsy,0,6,48,24,72
Gujarat,Bhavnagar,Cerebral Palsy,6,15,101,63,164
Gujarat,Bhavnagar,Cerebral Palsy,15,35,54,23,77
Gujarat,Bhavnagar,Cerebral Palsy,35,60,4,0,4
Gujarat,Bhavnagar,Cerebral Palsy,60,80,0,1,1
Gujarat,Bharuch,Cerebral Palsy,0,6,38,22,60
Gujarat,Bharuch,Cerebral Palsy,6,15,67,48,115
Gujarat,Bharuch,Cerebral Palsy,15,35,51,37,88
Gujarat,Bharuch,Cerebral Palsy,35,60,38,12,50
Gujarat,Bharuch,Cerebral Palsy,60,80,2,2,4
Rajasthan,Bharatpur,Cerebral Palsy,0,6,5,6,11
Rajasthan,Bharatpur,Cerebral Palsy,6,15,29,14,43
Rajasthan,Bharatpur,Cerebral Palsy,15,35,18,13,31
Rajasthan,Bharatpur,Cerebral Palsy,35,60,4,3,7
Rajasthan,Bharatpur,Cerebral Palsy,60,80,2,0,2
Maharashtra,Bhandara,Cerebral Palsy,0,6,24,15,39
Maharashtra,Bhandara,Cerebral Palsy,6,15,48,34,82
Maharashtra,Bhandara,Cerebral Palsy,15,35,31,19,50
Maharashtra,Bhandara,Cerebral Palsy,35,60,7,2,9
Bihar,Bhagalpur,Cerebral Palsy,0,6,112,83,195
Bihar,Bhagalpur,Cerebral Palsy,6,15,249,158,407
Bihar,Bhagalpur,Cerebral Palsy,15,35,123,55,178
Bihar,Bhagalpur,Cerebral Palsy,35,60,23,11,34
Bihar,Bhagalpur,Cerebral Palsy,60,80,13,5,18
Bihar,Bhagalpur,Cerebral Palsy,80,100,1,1,2
Odisha,Bhadrak,Cerebral Palsy,0,6,77,56,133
Odisha,Bhadrak,Cerebral Palsy,6,15,163,116,279
Odisha,Bhadrak,Cerebral Palsy,15,35,21,16,37
Odisha,Bhadrak,Cerebral Palsy,35,60,18,10,28
Odisha,Bhadrak,Cerebral Palsy,60,80,4,3,7
Uttar Pradesh,Bhadohi,Cerebral Palsy,0,6,10,3,13
Uttar Pradesh,Bhadohi,Cerebral Palsy,6,15,121,52,173
Uttar Pradesh,Bhadohi,Cerebral Palsy,15,35,118,27,145
Uttar Pradesh,Bhadohi,Cerebral Palsy,35,60,16,5,21
Madhya Pradesh,Betul,Cerebral Palsy,0,6,5,2,7
Madhya Pradesh,Betul,Cerebral Palsy,6,15,31,18,49
Madhya Pradesh,Betul,Cerebral Palsy,15,35,44,16,60
Madhya Pradesh,Betul,Cerebral Palsy,35,60,25,8,33
Madhya Pradesh,Betul,Cerebral Palsy,60,80,1,0,1
Karnataka,Bengaluru Urban,Cerebral Palsy,0,6,26,8,34
Karnataka,Bengaluru Urban,Cerebral Palsy,6,15,108,79,187
Karnataka,Bengaluru Urban,Cerebral Palsy,15,35,185,94,279
Karnataka,Bengaluru Urban,Cerebral Palsy,35,60,116,35,151
Karnataka,Bengaluru Urban,Cerebral Palsy,60,80,10,3,13
Karnataka,Bengaluru Rural,Cerebral Palsy,0,6,6,3,9
Karnataka,Bengaluru Rural,Cerebral Palsy,6,15,18,13,31
Karnataka,Bengaluru Rural,Cerebral Palsy,15,35,28,19,47
Karnataka,Bengaluru Rural,Cerebral Palsy,35,60,14,7,21
Karnataka,Bengaluru Rural,Cerebral Palsy,60,80,1,1,2
Chhattisgarh,Bemetara,Cerebral Palsy,0,6,6,8,14
Chhattisgarh,Bemetara,Cerebral Palsy,6,15,40,28,68
Chhattisgarh,Bemetara,Cerebral Palsy,15,35,39,22,61
Chhattisgarh,Bemetara,Cerebral Palsy,35,60,4,4,8
Karnataka,Belagavi,Cerebral Palsy,0,6,16,11,27
Karnataka,Belagavi,Cerebral Palsy,6,15,81,53,134
Karnataka,Belagavi,Cerebral Palsy,15,35,81,50,131
Karnataka,Belagavi,Cerebral Palsy,35,60,153,37,190
Karnataka,Belagavi,Cerebral Palsy,60,80,22,9,31
Bihar,Begusarai,Cerebral Palsy,0,6,125,98,223
Bihar,Begusarai,Cerebral Palsy,6,15,187,109,296
Bihar,Begusarai,Cerebral Palsy,15,35,54,21,75
Bihar,Begusarai,Cerebral Palsy,35,60,9,2,11
Bihar,Begusarai,Cerebral Palsy,60,80,1,1,2
Maharashtra,Beed,Cerebral Palsy,0,6,14,13,27
Maharashtra,Beed,Cerebral Palsy,6,15,96,40,136
Maharashtra,Beed,Cerebral Palsy,15,35,86,49,135
Maharashtra,Beed,Cerebral Palsy,35,60,28,14,42
Maharashtra,Beed,Cerebral Palsy,60,80,3,0,3
Maharashtra,Beed,Cerebral Palsy,80,100,1,0,1
Punjab,Bathinda,Cerebral Palsy,0,6,57,33,90
Punjab,Bathinda,Cerebral Palsy,6,15,156,88,244
Punjab,Bathinda,Cerebral Palsy,15,35,178,82,260
Punjab,Bathinda,Cerebral Palsy,35,60,30,10,40
Punjab,Bathinda,Cerebral Palsy,60,80,4,2,6
Uttar Pradesh,Basti,Cerebral Palsy,0,6,46,19,65
Uttar Pradesh,Basti,Cerebral Palsy,6,15,115,62,177
Uttar Pradesh,Basti,Cerebral Palsy,15,35,123,53,176
Uttar Pradesh,Basti,Cerebral Palsy,35,60,39,12,51
Uttar Pradesh,Basti,Cerebral Palsy,60,80,6,2,8
Chhattisgarh,Bastar,Cerebral Palsy,0,6,40,37,77
Chhattisgarh,Bastar,Cerebral Palsy,6,15,81,65,146
Chhattisgarh,Bastar,Cerebral Palsy,15,35,71,49,120
Chhattisgarh,Bastar,Cerebral Palsy,35,60,11,15,26
Chhattisgarh,Bastar,Cerebral Palsy,60,80,1,0,1
Madhya Pradesh,Barwani,Cerebral Palsy,0,6,18,14,32
Madhya Pradesh,Barwani,Cerebral Palsy,6,15,45,32,77
Madhya Pradesh,Barwani,Cerebral Palsy,15,35,39,33,72
Madhya Pradesh,Barwani,Cerebral Palsy,35,60,24,16,40
Madhya Pradesh,Barwani,Cerebral Palsy,60,80,6,0,6
Assam,Barpeta,Cerebral Palsy,0,6,141,107,248
Assam,Barpeta,Cerebral Palsy,6,15,217,117,334
Assam,Barpeta,Cerebral Palsy,15,35,145,90,235
Assam,Barpeta,Cerebral Palsy,35,60,22,8,30
Assam,Barpeta,Cerebral Palsy,60,80,4,0,4
Punjab,Barnala,Cerebral Palsy,0,6,15,9,24
Punjab,Barnala,Cerebral Palsy,6,15,90,40,130
Punjab,Barnala,Cerebral Palsy,15,35,129,62,191
Punjab,Barnala,Cerebral Palsy,35,60,49,19,68
Punjab,Barnala,Cerebral Palsy,60,80,7,2,9
Punjab,Barnala,Cerebral Palsy,80,100,1,0,1
Rajasthan,Barmer,Cerebral Palsy,0,6,43,24,67
Rajasthan,Barmer,Cerebral Palsy,6,15,192,117,309
Rajasthan,Barmer,Cerebral Palsy,15,35,139,79,218
Rajasthan,Barmer,Cerebral Palsy,35,60,37,26,63
Rajasthan,Barmer,Cerebral Palsy,60,80,7,1,8
Odisha,Bargarh,Cerebral Palsy,0,6,10,7,17
Odisha,Bargarh,Cerebral Palsy,6,15,24,20,44
Odisha,Bargarh,Cerebral Palsy,15,35,30,18,48
Odisha,Bargarh,Cerebral Palsy,35,60,27,12,39
Odisha,Bargarh,Cerebral Palsy,60,80,5,2,7
Uttar Pradesh,Bareilly,Cerebral Palsy,0,6,12,7,19
Uttar Pradesh,Bareilly,Cerebral Palsy,6,15,66,41,107
Uttar Pradesh,Bareilly,Cerebral Palsy,15,35,109,53,162
Uttar Pradesh,Bareilly,Cerebral Palsy,35,60,63,17,80
Uttar Pradesh,Bareilly,Cerebral Palsy,60,80,11,0,11
Rajasthan,Baran,Cerebral Palsy,0,6,7,6,13
Rajasthan,Baran,Cerebral Palsy,6,15,20,14,34
Rajasthan,Baran,Cerebral Palsy,15,35,20,4,24
Rajasthan,Baran,Cerebral Palsy,35,60,3,2,5
Jammu And Kashmir,Baramulla,Cerebral Palsy,0,6,54,39,93
Jammu And Kashmir,Baramulla,Cerebral Palsy,6,15,135,109,244
Jammu And Kashmir,Baramulla,Cerebral Palsy,15,35,112,85,197
Jammu And Kashmir,Baramulla,Cerebral Palsy,35,60,37,20,57
Jammu And Kashmir,Baramulla,Cerebral Palsy,60,80,4,2,6
Jammu And Kashmir,Baramulla,Cerebral Palsy,80,100,2,0,2
Uttar Pradesh,Barabanki,Cerebral Palsy,0,6,17,7,24
Uttar Pradesh,Barabanki,Cerebral Palsy,6,15,93,53,146
Uttar Pradesh,Barabanki,Cerebral Palsy,15,35,104,58,162
Uttar Pradesh,Barabanki,Cerebral Palsy,35,60,41,12,53
Uttar Pradesh,Barabanki,Cerebral Palsy,60,80,10,2,12
Rajasthan,Banswara,Cerebral Palsy,0,6,1,2,3
Rajasthan,Banswara,Cerebral Palsy,6,15,13,11,24
Rajasthan,Banswara,Cerebral Palsy,15,35,26,11,37
Rajasthan,Banswara,Cerebral Palsy,35,60,5,4,9
Rajasthan,Banswara,Cerebral Palsy,60,80,1,0,1
Bihar,Banka,Cerebral Palsy,0,6,76,42,118
Bihar,Banka,Cerebral Palsy,6,15,324,173,497
Bihar,Banka,Cerebral Palsy,15,35,175,81,256
Bihar,Banka,Cerebral Palsy,35,60,23,5,28
Bihar,Banka,Cerebral Palsy,60,80,8,0,8
Jammu And Kashmir,Bandipora,Cerebral Palsy,0,6,2,3,5
Jammu And Kashmir,Bandipora,Cerebral Palsy,6,15,38,31,69
Jammu And Kashmir,Bandipora,Cerebral Palsy,15,35,62,24,86
Jammu And Kashmir,Bandipora,Cerebral Palsy,35,60,20,23,43
Jammu And Kashmir,Bandipora,Cerebral Palsy,60,80,2,1,3
Jammu And Kashmir,Bandipora,Cerebral Palsy,80,100,0,1,1
Uttar Pradesh,Banda,Cerebral Palsy,0,6,4,0,4
Uttar Pradesh,Banda,Cerebral Palsy,6,15,31,18,49
Uttar Pradesh,Banda,Cerebral Palsy,15,35,299,86,385
Uttar Pradesh,Banda,Cerebral Palsy,35,60,518,89,607
Uttar Pradesh,Banda,Cerebral Palsy,60,80,166,19,185
Uttar Pradesh,Banda,Cerebral Palsy,80,100,13,2,15
Gujarat,Banas Kantha,Cerebral Palsy,0,6,1,0,1
Gujarat,Banas Kantha,Cerebral Palsy,6,15,2,1,3
Gujarat,Banas Kantha,Cerebral Palsy,15,35,0,1,1
Gujarat,Banas Kantha,Cerebral Palsy,35,60,1,0,1
Chhattisgarh,Balrampur,Cerebral Palsy,0,6,20,13,33
Chhattisgarh,Balrampur,Cerebral Palsy,6,15,76,49,125
Chhattisgarh,Balrampur,Cerebral Palsy,15,35,32,25,57
Chhattisgarh,Balrampur,Cerebral Palsy,35,60,2,3,5
Uttar Pradesh,Balrampur,Cerebral Palsy,0,6,17,9,26
Uttar Pradesh,Balrampur,Cerebral Palsy,6,15,137,65,202
Uttar Pradesh,Balrampur,Cerebral Palsy,15,35,136,52,188
Uttar Pradesh,Balrampur,Cerebral Palsy,35,60,33,12,45
Uttar Pradesh,Balrampur,Cerebral Palsy,60,80,4,2,6
Uttar Pradesh,Balrampur,Cerebral Palsy,80,100,1,0,1
Chhattisgarh,Baloda Bazar,Cerebral Palsy,0,6,19,8,27
Chhattisgarh,Baloda Bazar,Cerebral Palsy,6,15,209,144,353
Chhattisgarh,Baloda Bazar,Cerebral Palsy,15,35,323,283,606
Chhattisgarh,Baloda Bazar,Cerebral Palsy,35,60,151,75,226
Chhattisgarh,Baloda Bazar,Cerebral Palsy,60,80,19,8,27
Chhattisgarh,Balod,Cerebral Palsy,0,6,5,2,7
Chhattisgarh,Balod,Cerebral Palsy,6,15,47,19,66
Chhattisgarh,Balod,Cerebral Palsy,15,35,26,21,47
Chhattisgarh,Balod,Cerebral Palsy,35,60,4,3,7
Uttar Pradesh,Ballia,Cerebral Palsy,0,6,6,3,9
Uttar Pradesh,Ballia,Cerebral Palsy,6,15,41,18,59
Uttar Pradesh,Ballia,Cerebral Palsy,15,35,137,60,197
Uttar Pradesh,Ballia,Cerebral Palsy,35,60,80,32,112
Uttar Pradesh,Ballia,Cerebral Palsy,60,80,12,3,15
Uttar Pradesh,Ballia,Cerebral Palsy,80,100,1,0,1
Karnataka,Ballari,Cerebral Palsy,0,6,22,17,39
Karnataka,Ballari,Cerebral Palsy,6,15,100,54,154
Karnataka,Ballari,Cerebral Palsy,15,35,91,77,168
Karnataka,Ballari,Cerebral Palsy,35,60,91,29,120
Karnataka,Ballari,Cerebral Palsy,60,80,30,2,32
Odisha,Baleshwar,Cerebral Palsy,0,6,9,10,19
Odisha,Baleshwar,Cerebral Palsy,6,15,49,35,84
Odisha,Baleshwar,Cerebral Palsy,15,35,58,39,97
Odisha,Baleshwar,Cerebral Palsy,35,60,57,34,91
Odisha,Baleshwar,Cerebral Palsy,60,80,19,9,28
Odisha,Baleshwar,Cerebral Palsy,80,100,0,1,1
Odisha,Balangir,Cerebral Palsy,0,6,17,14,31
Odisha,Balangir,Cerebral Palsy,6,15,60,28,88
Odisha,Balangir,Cerebral Palsy,15,35,40,25,65
Odisha,Balangir,Cerebral Palsy,35,60,36,12,48
Odisha,Balangir,Cerebral Palsy,60,80,10,1,11
Madhya Pradesh,Balaghat,Cerebral Palsy,0,6,6,4,10
Madhya Pradesh,Balaghat,Cerebral Palsy,6,15,11,18,29
Madhya Pradesh,Balaghat,Cerebral Palsy,15,35,11,5,16
Madhya Pradesh,Balaghat,Cerebral Palsy,35,60,7,2,9
Madhya Pradesh,Balaghat,Cerebral Palsy,60,80,1,2,3
Assam,Baksa,Cerebral Palsy,0,6,19,6,25
Assam,Baksa,Cerebral Palsy,6,15,64,48,112
Assam,Baksa,Cerebral Palsy,15,35,53,25,78
Assam,Baksa,Cerebral Palsy,35,60,6,1,7
Assam,Bajali,Cerebral Palsy,0,6,4,5,9
Assam,Bajali,Cerebral Palsy,6,15,3,0,3
Assam,Bajali,Cerebral Palsy,15,35,0,2,2
Assam,Bajali,Cerebral Palsy,35,60,1,2,3
Uttar Pradesh,Bahraich,Cerebral Palsy,0,6,55,23,78
Uttar Pradesh,Bahraich,Cerebral Palsy,6,15,323,146,469
Uttar Pradesh,Bahraich,Cerebral Palsy,15,35,326,106,432
Uttar Pradesh,Bahraich,Cerebral Palsy,35,60,57,8,65
Uttar Pradesh,Bahraich,Cerebral Palsy,60,80,11,3,14
Uttar Pradesh,Bahraich,Cerebral Palsy,80,100,1,0,1
Uttar Pradesh,Baghpat,Cerebral Palsy,0,6,4,1,5
Uttar Pradesh,Baghpat,Cerebral Palsy,6,15,34,15,49
Uttar Pradesh,Baghpat,Cerebral Palsy,15,35,97,34,131
Uttar Pradesh,Baghpat,Cerebral Palsy,35,60,42,14,56
Uttar Pradesh,Baghpat,Cerebral Palsy,60,80,11,1,12
Uttarakhand,Bageshwar,Cerebral Palsy,0,6,7,0,7
Uttarakhand,Bageshwar,Cerebral Palsy,6,15,27,26,53
Uttarakhand,Bageshwar,Cerebral Palsy,15,35,71,34,105
Uttarakhand,Bageshwar,Cerebral Palsy,35,60,45,17,62
Uttarakhand,Bageshwar,Cerebral Palsy,60,80,4,0,4
Karnataka,Bagalkote,Cerebral Palsy,0,6,10,7,17
Karnataka,Bagalkote,Cerebral Palsy,6,15,48,24,72
Karnataka,Bagalkote,Cerebral Palsy,15,35,49,35,84
Karnataka,Bagalkote,Cerebral Palsy,35,60,16,8,24
Karnataka,Bagalkote,Cerebral Palsy,60,80,1,0,1
Uttar Pradesh,Azamgarh,Cerebral Palsy,0,6,47,17,64
Uttar Pradesh,Azamgarh,Cerebral Palsy,6,15,336,179,515
Uttar Pradesh,Azamgarh,Cerebral Palsy,15,35,286,112,398
Uttar Pradesh,Azamgarh,Cerebral Palsy,35,60,53,28,81
Uttar Pradesh,Azamgarh,Cerebral Palsy,60,80,20,7,27
Uttar Pradesh,Ayodhya,Cerebral Palsy,0,6,3,2,5
Uttar Pradesh,Ayodhya,Cerebral Palsy,6,15,24,8,32
Uttar Pradesh,Ayodhya,Cerebral Palsy,15,35,55,30,85
Uttar Pradesh,Ayodhya,Cerebral Palsy,35,60,27,6,33
Uttar Pradesh,Ayodhya,Cerebral Palsy,60,80,3,1,4
Bihar,Aurangabad,Cerebral Palsy,0,6,7,3,10
Bihar,Aurangabad,Cerebral Palsy,6,15,26,21,47
Bihar,Aurangabad,Cerebral Palsy,15,35,54,16,70
Bihar,Aurangabad,Cerebral Palsy,35,60,12,6,18
Bihar,Aurangabad,Cerebral Palsy,60,80,4,1,5
Maharashtra,Aurangabad,Cerebral Palsy,0,6,8,6,14
Maharashtra,Aurangabad,Cerebral Palsy,6,15,46,35,81
Maharashtra,Aurangabad,Cerebral Palsy,15,35,111,50,161
Maharashtra,Aurangabad,Cerebral Palsy,35,60,54,18,72
Maharashtra,Aurangabad,Cerebral Palsy,60,80,3,1,4
Uttar Pradesh,Auraiya,Cerebral Palsy,0,6,20,5,25
Uttar Pradesh,Auraiya,Cerebral Palsy,6,15,65,34,99
Uttar Pradesh,Auraiya,Cerebral Palsy,15,35,37,23,60
Uttar Pradesh,Auraiya,Cerebral Palsy,35,60,25,5,30
Uttar Pradesh,Auraiya,Cerebral Palsy,60,80,3,0,3
Madhya Pradesh,Ashoknagar,Cerebral Palsy,6,15,2,0,2
Madhya Pradesh,Ashoknagar,Cerebral Palsy,15,35,1,0,1
Bihar,Arwal,Cerebral Palsy,0,6,11,1,12
Bihar,Arwal,Cerebral Palsy,6,15,41,15,56
Bihar,Arwal,Cerebral Palsy,15,35,16,10,26
Bihar,Arwal,Cerebral Palsy,35,60,4,0,4
Bihar,Arwal,Cerebral Palsy,60,80,1,1,2
Gujarat,Arvalli,Cerebral Palsy,0,6,6,2,8
Gujarat,Arvalli,Cerebral Palsy,6,15,49,33,82
Gujarat,Arvalli,Cerebral Palsy,15,35,33,9,42
Gujarat,Arvalli,Cerebral Palsy,35,60,5,1,6
Tamil Nadu,Ariyalur,Cerebral Palsy,0,6,7,5,12
Tamil Nadu,Ariyalur,Cerebral Palsy,6,15,29,16,45
Tamil Nadu,Ariyalur,Cerebral Palsy,15,35,66,30,96
Tamil Nadu,Ariyalur,Cerebral Palsy,35,60,15,6,21
Tamil Nadu,Ariyalur,Cerebral Palsy,60,80,1,0,1
Bihar,Araria,Cerebral Palsy,0,6,55,36,91
Bihar,Araria,Cerebral Palsy,6,15,198,106,304
Bihar,Araria,Cerebral Palsy,15,35,199,107,306
Bihar,Araria,Cerebral Palsy,35,60,58,29,87
Bihar,Araria,Cerebral Palsy,60,80,12,4,16
Madhya Pradesh,Anuppur,Cerebral Palsy,0,6,2,1,3
Madhya Pradesh,Anuppur,Cerebral Palsy,6,15,40,20,60
Madhya Pradesh,Anuppur,Cerebral Palsy,15,35,73,43,116
Madhya Pradesh,Anuppur,Cerebral Palsy,35,60,8,7,15
Madhya Pradesh,Anuppur,Cerebral Palsy,60,80,1,0,1
Madhya Pradesh,Anuppur,Cerebral Palsy,80,100,1,1,2
Odisha,Anugul,Cerebral Palsy,0,6,69,43,112
Odisha,Anugul,Cerebral Palsy,6,15,199,143,342
Odisha,Anugul,Cerebral Palsy,15,35,97,56,153
Odisha,Anugul,Cerebral Palsy,35,60,26,12,38
Odisha,Anugul,Cerebral Palsy,60,80,9,0,9
Odisha,Anugul,Cerebral Palsy,80,100,1,1,2
Jammu And Kashmir,Anantnag,Cerebral Palsy,0,6,59,32,91
Jammu And Kashmir,Anantnag,Cerebral Palsy,6,15,193,135,328
Jammu And Kashmir,Anantnag,Cerebral Palsy,15,35,162,101,263
Jammu And Kashmir,Anantnag,Cerebral Palsy,35,60,19,20,39
Jammu And Kashmir,Anantnag,Cerebral Palsy,60,80,1,0,1
Jammu And Kashmir,Anantnag,Cerebral Palsy,80,100,1,0,1
Andhra Pradesh,Anantapur,Cerebral Palsy,0,6,1,0,1
Andhra Pradesh,Anantapur,Cerebral Palsy,6,15,6,1,7
Andhra Pradesh,Anantapur,Cerebral Palsy,15,35,7,1,8
Andhra Pradesh,Anantapur,Cerebral Palsy,35,60,2,1,3
Gujarat,Anand,Cerebral Palsy,0,6,25,12,37
Gujarat,Anand,Cerebral Palsy,6,15,64,42,106
Gujarat,Anand,Cerebral Palsy,15,35,96,47,143
Gujarat,Anand,Cerebral Palsy,35,60,23,9,32
Gujarat,Anand,Cerebral Palsy,60,80,4,2,6
Uttar Pradesh,Amroha,Cerebral Palsy,0,6,11,1,12
Uttar Pradesh,Amroha,Cerebral Palsy,6,15,47,23,70
Uttar Pradesh,Amroha,Cerebral Palsy,15,35,92,35,127
Uttar Pradesh,Amroha,Cerebral Palsy,35,60,43,20,63
Uttar Pradesh,Amroha,Cerebral Palsy,60,80,5,1,6
Punjab,Amritsar,Cerebral Palsy,0,6,65,29,94
Punjab,Amritsar,Cerebral Palsy,6,15,173,97,270
Punjab,Amritsar,Cerebral Palsy,15,35,265,112,377
Punjab,Amritsar,Cerebral Palsy,35,60,53,17,70
Punjab,Amritsar,Cerebral Palsy,60,80,3,1,4
Gujarat,Amreli,Cerebral Palsy,0,6,18,7,25
Gujarat,Amreli,Cerebral Palsy,6,15,77,53,130
Gujarat,Amreli,Cerebral Palsy,15,35,61,27,88
Gujarat,Amreli,Cerebral Palsy,35,60,11,9,20
Gujarat,Amreli,Cerebral Palsy,60,80,2,2,4
Gujarat,Amreli,Cerebral Palsy,80,100,1,0,1
Maharashtra,Amravati,Cerebral Palsy,6,15,0,2,2
Maharashtra,Amravati,Cerebral Palsy,15,35,7,5,12
Maharashtra,Amravati,Cerebral Palsy,35,60,12,7,19
Maharashtra,Amravati,Cerebral Palsy,60,80,15,3,18
Uttar Pradesh,Amethi,Cerebral Palsy,0,6,11,9,20
Uttar Pradesh,Amethi,Cerebral Palsy,6,15,79,47,126
Uttar Pradesh,Amethi,Cerebral Palsy,15,35,105,45,150
Uttar Pradesh,Amethi,Cerebral Palsy,35,60,31,6,37
Uttar Pradesh,Amethi,Cerebral Palsy,60,80,6,1,7
Uttar Pradesh,Ambedkar Nagar,Cerebral Palsy,0,6,23,13,36
Uttar Pradesh,Ambedkar Nagar,Cerebral Palsy,6,15,182,98,280
Uttar Pradesh,Ambedkar Nagar,Cerebral Palsy,15,35,129,66,195
Uttar Pradesh,Ambedkar Nagar,Cerebral Palsy,35,60,27,7,34
Uttar Pradesh,Ambedkar Nagar,Cerebral Palsy,60,80,2,1,3
Haryana,Ambala,Cerebral Palsy,0,6,8,5,13
Haryana,Ambala,Cerebral Palsy,6,15,43,13,56
Haryana,Ambala,Cerebral Palsy,15,35,70,24,94
Haryana,Ambala,Cerebral Palsy,35,60,20,13,33
Haryana,Ambala,Cerebral Palsy,60,80,2,0,2
Rajasthan,Alwar,Cerebral Palsy,0,6,35,18,53
Rajasthan,Alwar,Cerebral Palsy,6,15,147,77,224
Rajasthan,Alwar,Cerebral Palsy,15,35,165,80,245
Rajasthan,Alwar,Cerebral Palsy,35,60,41,17,58
Rajasthan,Alwar,Cerebral Palsy,60,80,2,3,5
Rajasthan,Alwar,Cerebral Palsy,80,100,2,0,2
Uttarakhand,Almora,Cerebral Palsy,0,6,1,1,2
Uttarakhand,Almora,Cerebral Palsy,6,15,17,9,26
Uttarakhand,Almora,Cerebral Palsy,15,35,62,33,95
Uttarakhand,Almora,Cerebral Palsy,35,60,41,13,54
Uttarakhand,Almora,Cerebral Palsy,60,80,3,1,4
Madhya Pradesh,Alirajpur,Cerebral Palsy,6,15,1,1,2
Madhya Pradesh,Alirajpur,Cerebral Palsy,15,35,3,0,3
Madhya Pradesh,Alirajpur,Cerebral Palsy,35,60,12,1,13
Uttar Pradesh,Aligarh,Cerebral Palsy,0,6,18,12,30
Uttar Pradesh,Aligarh,Cerebral Palsy,6,15,190,69,259
Uttar Pradesh,Aligarh,Cerebral Palsy,15,35,213,79,292
Uttar Pradesh,Aligarh,Cerebral Palsy,35,60,49,23,72
Uttar Pradesh,Aligarh,Cerebral Palsy,60,80,4,4,8
Uttar Pradesh,Aligarh,Cerebral Palsy,80,100,1,0,1
Kerala,Alappuzha,Cerebral Palsy,0,6,9,3,12
Kerala,Alappuzha,Cerebral Palsy,6,15,58,36,94
Kerala,Alappuzha,Cerebral Palsy,15,35,119,84,203
Kerala,Alappuzha,Cerebral Palsy,35,60,72,27,99
Kerala,Alappuzha,Cerebral Palsy,60,80,8,4,12
Maharashtra,Akola,Cerebral Palsy,0,6,35,21,56
Maharashtra,Akola,Cerebral Palsy,6,15,67,43,110
Maharashtra,Akola,Cerebral Palsy,15,35,51,29,80
Maharashtra,Akola,Cerebral Palsy,35,60,16,9,25
Maharashtra,Akola,Cerebral Palsy,60,80,1,0,1
Rajasthan,Ajmer,Cerebral Palsy,0,6,9,5,14
Rajasthan,Ajmer,Cerebral Palsy,6,15,44,26,70
Rajasthan,Ajmer,Cerebral Palsy,15,35,54,32,86
Rajasthan,Ajmer,Cerebral Palsy,35,60,10,5,15
Rajasthan,Ajmer,Cerebral Palsy,60,80,1,1,2
Mizoram,Aizawl,Cerebral Palsy,0,6,6,6,12
Mizoram,Aizawl,Cerebral Palsy,6,15,18,17,35
Mizoram,Aizawl,Cerebral Palsy,15,35,22,10,32
Mizoram,Aizawl,Cerebral Palsy,35,60,6,4,10
Mizoram,Aizawl,Cerebral Palsy,60,80,0,1,1
Mizoram,Aizawl,Cerebral Palsy,80,100,0,1,1
Maharashtra,Ahmednagar,Cerebral Palsy,0,6,0,1,1
Maharashtra,Ahmednagar,Cerebral Palsy,6,15,3,4,7
Maharashtra,Ahmednagar,Cerebral Palsy,15,35,24,5,29
Maharashtra,Ahmednagar,Cerebral Palsy,35,60,15,5,20
Maharashtra,Ahmednagar,Cerebral Palsy,60,80,6,1,7
Gujarat,Ahmadabad,Cerebral Palsy,0,6,2,0,2
Gujarat,Ahmadabad,Cerebral Palsy,6,15,77,30,107
Gujarat,Ahmadabad,Cerebral Palsy,15,35,93,37,130
Gujarat,Ahmadabad,Cerebral Palsy,35,60,30,16,46
Uttar Pradesh,Agra,Cerebral Palsy,0,6,69,23,92
Uttar Pradesh,Agra,Cerebral Palsy,6,15,239,102,341
Uttar Pradesh,Agra,Cerebral Palsy,15,35,181,68,249
Uttar Pradesh,Agra,Cerebral Palsy,35,60,17,2,19
Uttar Pradesh,Agra,Cerebral Palsy,60,80,3,0,3
Madhya Pradesh,Agar Malwa,Cerebral Palsy,0,6,11,2,13
Madhya Pradesh,Agar Malwa,Cerebral Palsy,6,15,25,12,37
Madhya Pradesh,Agar Malwa,Cerebral Palsy,15,35,8,2,10
Madhya Pradesh,Agar Malwa,Cerebral Palsy,35,60,1,1,2
Maharashtra,Yavatmal,Chronic Neurological Conditions,6,15,4,1,5
Maharashtra,Yavatmal,Chronic Neurological Conditions,35,60,3,0,3
Puducherry,Yanam,Chronic Neurological Conditions,6,15,5,2,7
Puducherry,Yanam,Chronic Neurological Conditions,15,35,3,9,12
Puducherry,Yanam,Chronic Neurological Conditions,35,60,14,6,20
Puducherry,Yanam,Chronic Neurological Conditions,60,80,5,2,7
Haryana,Yamunanagar,Chronic Neurological Conditions,0,6,7,2,9
Haryana,Yamunanagar,Chronic Neurological Conditions,6,15,2,1,3
Haryana,Yamunanagar,Chronic Neurological Conditions,15,35,15,6,21
Haryana,Yamunanagar,Chronic Neurological Conditions,35,60,69,25,94
Haryana,Yamunanagar,Chronic Neurological Conditions,60,80,14,5,19
Karnataka,Yadgir,Chronic Neurological Conditions,0,6,1,1,2
Karnataka,Yadgir,Chronic Neurological Conditions,6,15,4,0,4
Karnataka,Yadgir,Chronic Neurological Conditions,35,60,3,2,5
Karnataka,Yadgir,Chronic Neurological Conditions,60,80,1,0,1
Jharkhand,West Singhbhum,Chronic Neurological Conditions,6,15,3,2,5
Jharkhand,West Singhbhum,Chronic Neurological Conditions,15,35,3,4,7
Jharkhand,West Singhbhum,Chronic Neurological Conditions,35,60,4,2,6
Jharkhand,West Singhbhum,Chronic Neurological Conditions,60,80,1,0,1
Assam,West Karbi Anglong,Chronic Neurological Conditions,35,60,0,1,1
Meghalaya,West Jaintia Hills,Chronic Neurological Conditions,6,15,4,8,12
Meghalaya,West Jaintia Hills,Chronic Neurological Conditions,15,35,7,10,17
Meghalaya,West Jaintia Hills,Chronic Neurological Conditions,35,60,0,3,3
Meghalaya,West Garo Hills,Chronic Neurological Conditions,6,15,1,2,3
Meghalaya,West Garo Hills,Chronic Neurological Conditions,15,35,3,1,4
Delhi,West,Chronic Neurological Conditions,0,6,1,2,3
Delhi,West,Chronic Neurological Conditions,6,15,18,13,31
Delhi,West,Chronic Neurological Conditions,15,35,89,45,134
Delhi,West,Chronic Neurological Conditions,35,60,235,47,282
Delhi,West,Chronic Neurological Conditions,60,80,64,12,76
Kerala,Wayanad,Chronic Neurological Conditions,0,6,1,0,1
Kerala,Wayanad,Chronic Neurological Conditions,6,15,3,4,7
Kerala,Wayanad,Chronic Neurological Conditions,15,35,5,1,6
Kerala,Wayanad,Chronic Neurological Conditions,35,60,25,10,35
Kerala,Wayanad,Chronic Neurological Conditions,60,80,17,3,20
Maharashtra,Washim,Chronic Neurological Conditions,35,60,0,1,1
Maharashtra,Wardha,Chronic Neurological Conditions,35,60,4,0,4
Maharashtra,Wardha,Chronic Neurological Conditions,60,80,0,1,1
Andhra Pradesh,Vizianagaram,Chronic Neurological Conditions,15,35,1,0,1
Andhra Pradesh,Vizianagaram,Chronic Neurological Conditions,35,60,1,0,1
Andhra Pradesh,Visakhapatanam,Chronic Neurological Conditions,6,15,1,0,1
Tamil Nadu,Virudhunagar,Chronic Neurological Conditions,0,6,3,2,5
Tamil Nadu,Virudhunagar,Chronic Neurological Conditions,6,15,2,2,4
Tamil Nadu,Virudhunagar,Chronic Neurological Conditions,15,35,21,11,32
Tamil Nadu,Virudhunagar,Chronic Neurological Conditions,35,60,103,34,137
Tamil Nadu,Virudhunagar,Chronic Neurological Conditions,60,80,15,9,24
Tamil Nadu,Villupuram,Chronic Neurological Conditions,0,6,1,0,1
Tamil Nadu,Villupuram,Chronic Neurological Conditions,6,15,2,0,2
Tamil Nadu,Villupuram,Chronic Neurological Conditions,15,35,8,1,9
Tamil Nadu,Villupuram,Chronic Neurological Conditions,35,60,9,7,16
Tamil Nadu,Villupuram,Chronic Neurological Conditions,60,80,7,0,7
Karnataka,Vijayapura,Chronic Neurological Conditions,6,15,0,1,1
Karnataka,Vijayapura,Chronic Neurological Conditions,15,35,9,2,11
Karnataka,Vijayapura,Chronic Neurological Conditions,35,60,10,5,15
Karnataka,Vijayapura,Chronic Neurological Conditions,60,80,2,1,3
Madhya Pradesh,Vidisha,Chronic Neurological Conditions,6,15,4,3,7
Madhya Pradesh,Vidisha,Chronic Neurological Conditions,15,35,17,7,24
Madhya Pradesh,Vidisha,Chronic Neurological Conditions,35,60,23,7,30
Madhya Pradesh,Vidisha,Chronic Neurological Conditions,60,80,8,3,11
Tamil Nadu,Vellore,Chronic Neurological Conditions,6,15,5,2,7
Tamil Nadu,Vellore,Chronic Neurological Conditions,15,35,10,7,17
Tamil Nadu,Vellore,Chronic Neurological Conditions,35,60,12,11,23
Tamil Nadu,Vellore,Chronic Neurological Conditions,60,80,7,5,12
Tamil Nadu,Vellore,Chronic Neurological Conditions,80,100,1,0,1
Uttar Pradesh,Varanasi,Chronic Neurological Conditions,0,6,0,1,1
Uttar Pradesh,Varanasi,Chronic Neurological Conditions,15,35,8,2,10
Uttar Pradesh,Varanasi,Chronic Neurological Conditions,35,60,10,2,12
Uttar Pradesh,Varanasi,Chronic Neurological Conditions,80,100,1,0,1
Bihar,Vaishali,Chronic Neurological Conditions,0,6,0,1,1
Bihar,Vaishali,Chronic Neurological Conditions,6,15,2,2,4
Bihar,Vaishali,Chronic Neurological Conditions,15,35,15,5,20
Bihar,Vaishali,Chronic Neurological Conditions,35,60,10,3,13
Bihar,Vaishali,Chronic Neurological Conditions,60,80,3,0,3
Gujarat,Vadodara,Chronic Neurological Conditions,0,6,1,1,2
Gujarat,Vadodara,Chronic Neurological Conditions,6,15,1,4,5
Gujarat,Vadodara,Chronic Neurological Conditions,15,35,48,15,63
Gujarat,Vadodara,Chronic Neurological Conditions,35,60,99,18,117
Gujarat,Vadodara,Chronic Neurological Conditions,60,80,54,5,59
Gujarat,Vadodara,Chronic Neurological Conditions,80,100,4,0,4
Karnataka,Uttara Kannada,Chronic Neurological Conditions,0,6,3,2,5
Karnataka,Uttara Kannada,Chronic Neurological Conditions,6,15,3,2,5
Karnataka,Uttara Kannada,Chronic Neurological Conditions,15,35,31,15,46
Karnataka,Uttara Kannada,Chronic Neurological Conditions,35,60,228,49,277
Karnataka,Uttara Kannada,Chronic Neurological Conditions,60,80,85,17,102
Karnataka,Uttara Kannada,Chronic Neurological Conditions,80,100,2,0,2
Uttarakhand,Uttar Kashi,Chronic Neurological Conditions,0,6,1,0,1
Uttarakhand,Uttar Kashi,Chronic Neurological Conditions,6,15,2,2,4
Uttarakhand,Uttar Kashi,Chronic Neurological Conditions,15,35,29,15,44
Uttarakhand,Uttar Kashi,Chronic Neurological Conditions,35,60,32,25,57
Uttarakhand,Uttar Kashi,Chronic Neurological Conditions,60,80,5,1,6
Uttar Pradesh,Unnao,Chronic Neurological Conditions,6,15,1,0,1
Uttar Pradesh,Unnao,Chronic Neurological Conditions,15,35,10,2,12
Uttar Pradesh,Unnao,Chronic Neurological Conditions,35,60,11,4,15
Uttar Pradesh,Unnao,Chronic Neurological Conditions,60,80,1,0,1
Himachal Pradesh,Una,Chronic Neurological Conditions,6,15,0,1,1
Himachal Pradesh,Una,Chronic Neurological Conditions,15,35,1,0,1
Himachal Pradesh,Una,Chronic Neurological Conditions,35,60,3,1,4
Himachal Pradesh,Una,Chronic Neurological Conditions,60,80,3,0,3
Madhya Pradesh,Umaria,Chronic Neurological Conditions,15,35,1,0,1
Manipur,Ukhrul,Chronic Neurological Conditions,60,80,1,0,1
Madhya Pradesh,Ujjain,Chronic Neurological Conditions,0,6,1,2,3
Madhya Pradesh,Ujjain,Chronic Neurological Conditions,6,15,2,6,8
Madhya Pradesh,Ujjain,Chronic Neurological Conditions,15,35,2,2,4
Madhya Pradesh,Ujjain,Chronic Neurological Conditions,35,60,4,1,5
Madhya Pradesh,Ujjain,Chronic Neurological Conditions,60,80,3,0,3
Karnataka,Udupi,Chronic Neurological Conditions,0,6,1,2,3
Karnataka,Udupi,Chronic Neurological Conditions,15,35,3,3,6
Karnataka,Udupi,Chronic Neurological Conditions,35,60,13,4,17
Karnataka,Udupi,Chronic Neurological Conditions,60,80,4,0,4
Jammu And Kashmir,Udhampur,Chronic Neurological Conditions,0,6,0,1,1
Jammu And Kashmir,Udhampur,Chronic Neurological Conditions,6,15,9,4,13
Jammu And Kashmir,Udhampur,Chronic Neurological Conditions,15,35,39,28,67
Jammu And Kashmir,Udhampur,Chronic Neurological Conditions,35,60,72,31,103
Jammu And Kashmir,Udhampur,Chronic Neurological Conditions,60,80,14,3,17
Uttarakhand,Udam Singh Nagar,Chronic Neurological Conditions,15,35,4,2,6
Uttarakhand,Udam Singh Nagar,Chronic Neurological Conditions,35,60,0,3,3
Assam,Udalguri,Chronic Neurological Conditions,6,15,2,0,2
Assam,Udalguri,Chronic Neurological Conditions,15,35,0,1,1
Assam,Udalguri,Chronic Neurological Conditions,35,60,2,0,2
Rajasthan,Udaipur,Chronic Neurological Conditions,6,15,3,1,4
Rajasthan,Udaipur,Chronic Neurological Conditions,15,35,8,4,12
Rajasthan,Udaipur,Chronic Neurological Conditions,35,60,13,2,15
Rajasthan,Udaipur,Chronic Neurological Conditions,60,80,2,1,3
Tamil Nadu,Tuticorin,Chronic Neurological Conditions,15,35,3,2,5
Tamil Nadu,Tuticorin,Chronic Neurological Conditions,35,60,10,3,13
Tamil Nadu,Tuticorin,Chronic Neurological Conditions,60,80,5,1,6
Karnataka,Tumakuru,Chronic Neurological Conditions,0,6,2,3,5
Karnataka,Tumakuru,Chronic Neurological Conditions,6,15,9,6,15
Karnataka,Tumakuru,Chronic Neurological Conditions,15,35,20,19,39
Karnataka,Tumakuru,Chronic Neurological Conditions,35,60,69,29,98
Karnataka,Tumakuru,Chronic Neurological Conditions,60,80,21,2,23
Karnataka,Tumakuru,Chronic Neurological Conditions,80,100,1,0,1
Nagaland,Tuensang,Chronic Neurological Conditions,15,35,2,0,2
Rajasthan,Tonk,Chronic Neurological Conditions,15,35,4,1,5
Rajasthan,Tonk,Chronic Neurological Conditions,35,60,4,0,4
Tamil Nadu,Tiruvannamalai,Chronic Neurological Conditions,0,6,2,4,6
Tamil Nadu,Tiruvannamalai,Chronic Neurological Conditions,6,15,6,2,8
Tamil Nadu,Tiruvannamalai,Chronic Neurological Conditions,15,35,6,3,9
Tamil Nadu,Tiruvannamalai,Chronic Neurological Conditions,35,60,5,7,12
Tamil Nadu,Tiruvannamalai,Chronic Neurological Conditions,60,80,2,1,3
Tamil Nadu,Tiruppur,Chronic Neurological Conditions,0,6,2,2,4
Tamil Nadu,Tiruppur,Chronic Neurological Conditions,6,15,6,3,9
Tamil Nadu,Tiruppur,Chronic Neurological Conditions,15,35,6,3,9
Tamil Nadu,Tiruppur,Chronic Neurological Conditions,35,60,11,4,15
Tamil Nadu,Tiruppur,Chronic Neurological Conditions,60,80,4,0,4
Tamil Nadu,Tirupathur,Chronic Neurological Conditions,6,15,0,1,1
Tamil Nadu,Tirupathur,Chronic Neurological Conditions,15,35,3,1,4
Tamil Nadu,Tirupathur,Chronic Neurological Conditions,35,60,2,0,2
Tamil Nadu,Tirunelveli,Chronic Neurological Conditions,6,15,1,0,1
Tamil Nadu,Tirunelveli,Chronic Neurological Conditions,15,35,6,1,7
Tamil Nadu,Tirunelveli,Chronic Neurological Conditions,35,60,5,3,8
Tamil Nadu,Tirunelveli,Chronic Neurological Conditions,60,80,1,1,2
Tamil Nadu,Tiruchirappalli,Chronic Neurological Conditions,0,6,1,0,1
Tamil Nadu,Tiruchirappalli,Chronic Neurological Conditions,15,35,4,8,12
Tamil Nadu,Tiruchirappalli,Chronic Neurological Conditions,35,60,17,6,23
Tamil Nadu,Tiruchirappalli,Chronic Neurological Conditions,60,80,1,0,1
Assam,Tinsukia,Chronic Neurological Conditions,15,35,0,1,1
Assam,Tinsukia,Chronic Neurological Conditions,35,60,1,1,2
Madhya Pradesh,Tikamgarh,Chronic Neurological Conditions,0,6,2,2,4
Madhya Pradesh,Tikamgarh,Chronic Neurological Conditions,6,15,16,6,22
Madhya Pradesh,Tikamgarh,Chronic Neurological Conditions,15,35,75,37,112
Madhya Pradesh,Tikamgarh,Chronic Neurological Conditions,35,60,216,82,298
Madhya Pradesh,Tikamgarh,Chronic Neurological Conditions,60,80,114,36,150
Madhya Pradesh,Tikamgarh,Chronic Neurological Conditions,80,100,6,0,6
Kerala,Thrissur,Chronic Neurological Conditions,0,6,2,1,3
Kerala,Thrissur,Chronic Neurological Conditions,6,15,7,9,16
Kerala,Thrissur,Chronic Neurological Conditions,15,35,15,12,27
Kerala,Thrissur,Chronic Neurological Conditions,35,60,79,19,98
Kerala,Thrissur,Chronic Neurological Conditions,60,80,26,7,33
Kerala,Thrissur,Chronic Neurological Conditions,80,100,0,1,1
Tamil Nadu,Thiruvarur,Chronic Neurological Conditions,6,15,3,1,4
Tamil Nadu,Thiruvarur,Chronic Neurological Conditions,15,35,9,3,12
Tamil Nadu,Thiruvarur,Chronic Neurological Conditions,35,60,19,4,23
Tamil Nadu,Thiruvarur,Chronic Neurological Conditions,60,80,11,3,14
Kerala,Thiruvananthapuram,Chronic Neurological Conditions,0,6,3,2,5
Kerala,Thiruvananthapuram,Chronic Neurological Conditions,6,15,6,9,15
Kerala,Thiruvananthapuram,Chronic Neurological Conditions,15,35,15,18,33
Kerala,Thiruvananthapuram,Chronic Neurological Conditions,35,60,46,19,65
Kerala,Thiruvananthapuram,Chronic Neurological Conditions,60,80,13,5,18
Kerala,Thiruvananthapuram,Chronic Neurological Conditions,80,100,0,3,3
Tamil Nadu,Thiruvallur,Chronic Neurological Conditions,0,6,5,4,9
Tamil Nadu,Thiruvallur,Chronic Neurological Conditions,6,15,13,12,25
Tamil Nadu,Thiruvallur,Chronic Neurological Conditions,15,35,32,14,46
Tamil Nadu,Thiruvallur,Chronic Neurological Conditions,35,60,107,25,132
Tamil Nadu,Thiruvallur,Chronic Neurological Conditions,60,80,34,11,45
Tamil Nadu,Thiruvallur,Chronic Neurological Conditions,80,100,1,0,1
Tamil Nadu,Theni,Chronic Neurological Conditions,6,15,0,1,1
Tamil Nadu,Theni,Chronic Neurological Conditions,15,35,2,0,2
Tamil Nadu,Theni,Chronic Neurological Conditions,35,60,0,2,2
Tamil Nadu,The Nilgiris,Chronic Neurological Conditions,15,35,2,0,2
Tamil Nadu,The Nilgiris,Chronic Neurological Conditions,35,60,15,2,17
Tamil Nadu,The Nilgiris,Chronic Neurological Conditions,60,80,5,0,5
Tamil Nadu,The Nilgiris,Chronic Neurological Conditions,80,100,1,0,1
Tamil Nadu,Thanjavur,Chronic Neurological Conditions,0,6,1,1,2
Tamil Nadu,Thanjavur,Chronic Neurological Conditions,6,15,0,1,1
Tamil Nadu,Thanjavur,Chronic Neurological Conditions,15,35,1,2,3
Tamil Nadu,Thanjavur,Chronic Neurological Conditions,35,60,11,7,18
Tamil Nadu,Thanjavur,Chronic Neurological Conditions,60,80,3,0,3
Maharashtra,Thane,Chronic Neurological Conditions,0,6,1,0,1
Maharashtra,Thane,Chronic Neurological Conditions,6,15,2,3,5
Maharashtra,Thane,Chronic Neurological Conditions,15,35,16,6,22
Maharashtra,Thane,Chronic Neurological Conditions,35,60,32,9,41
Maharashtra,Thane,Chronic Neurological Conditions,60,80,15,2,17
Tamil Nadu,Tenkasi,Chronic Neurological Conditions,15,35,1,1,2
Tamil Nadu,Tenkasi,Chronic Neurological Conditions,35,60,2,0,2
Uttarakhand,Tehri Garhwal,Chronic Neurological Conditions,0,6,1,0,1
Uttarakhand,Tehri Garhwal,Chronic Neurological Conditions,6,15,1,0,1
Uttarakhand,Tehri Garhwal,Chronic Neurological Conditions,15,35,5,2,7
Uttarakhand,Tehri Garhwal,Chronic Neurological Conditions,35,60,6,3,9
Uttarakhand,Tehri Garhwal,Chronic Neurological Conditions,60,80,0,1,1
Punjab,Tarn Taran,Chronic Neurological Conditions,0,6,1,0,1
Punjab,Tarn Taran,Chronic Neurological Conditions,6,15,4,2,6
Punjab,Tarn Taran,Chronic Neurological Conditions,15,35,23,10,33
Punjab,Tarn Taran,Chronic Neurological Conditions,35,60,65,16,81
Punjab,Tarn Taran,Chronic Neurological Conditions,60,80,16,2,18
Punjab,Tarn Taran,Chronic Neurological Conditions,80,100,2,1,3
Gujarat,Tapi,Chronic Neurological Conditions,6,15,0,1,1
Gujarat,Tapi,Chronic Neurological Conditions,15,35,4,1,5
Gujarat,Tapi,Chronic Neurological Conditions,35,60,4,1,5
Gujarat,Tapi,Chronic Neurological Conditions,60,80,1,0,1
Manipur,Tamenglong,Chronic Neurological Conditions,35,60,1,2,3
Manipur,Tamenglong,Chronic Neurological Conditions,60,80,1,0,1
Chhattisgarh,Surguja,Chronic Neurological Conditions,35,60,1,0,1
Chhattisgarh,Surguja,Chronic Neurological Conditions,60,80,1,1,2
Gujarat,Surat,Chronic Neurological Conditions,15,35,4,3,7
Gujarat,Surat,Chronic Neurological Conditions,35,60,2,1,3
Chhattisgarh,Surajpur,Chronic Neurological Conditions,6,15,1,0,1
Chhattisgarh,Surajpur,Chronic Neurological Conditions,15,35,1,3,4
Chhattisgarh,Surajpur,Chronic Neurological Conditions,35,60,1,1,2
Bihar,Supaul,Chronic Neurological Conditions,15,35,3,0,3
Bihar,Supaul,Chronic Neurological Conditions,60,80,1,0,1
Odisha,Sundargarh,Chronic Neurological Conditions,0,6,5,3,8
Odisha,Sundargarh,Chronic Neurological Conditions,6,15,9,9,18
Odisha,Sundargarh,Chronic Neurological Conditions,15,35,25,15,40
Odisha,Sundargarh,Chronic Neurological Conditions,35,60,59,21,80
Odisha,Sundargarh,Chronic Neurological Conditions,60,80,18,8,26
Uttar Pradesh,Sultanpur,Chronic Neurological Conditions,0,6,1,0,1
Uttar Pradesh,Sultanpur,Chronic Neurological Conditions,6,15,1,0,1
Uttar Pradesh,Sultanpur,Chronic Neurological Conditions,15,35,13,6,19
Uttar Pradesh,Sultanpur,Chronic Neurological Conditions,35,60,22,0,22
Uttar Pradesh,Sultanpur,Chronic Neurological Conditions,60,80,4,2,6
Chhattisgarh,Sukma,Chronic Neurological Conditions,6,15,0,2,2
Chhattisgarh,Sukma,Chronic Neurological Conditions,15,35,4,3,7
Chhattisgarh,Sukma,Chronic Neurological Conditions,35,60,2,0,2
Jammu And Kashmir,Srinagar,Chronic Neurological Conditions,0,6,1,1,2
Jammu And Kashmir,Srinagar,Chronic Neurological Conditions,6,15,10,7,17
Jammu And Kashmir,Srinagar,Chronic Neurological Conditions,15,35,20,13,33
Jammu And Kashmir,Srinagar,Chronic Neurological Conditions,35,60,21,12,33
Jammu And Kashmir,Srinagar,Chronic Neurological Conditions,60,80,5,1,6
Andhra Pradesh,Srikakulam,Chronic Neurological Conditions,15,35,0,1,1
Punjab,Sri Muktsar Sahib,Chronic Neurological Conditions,0,6,0,1,1
Punjab,Sri Muktsar Sahib,Chronic Neurological Conditions,6,15,1,1,2
Punjab,Sri Muktsar Sahib,Chronic Neurological Conditions,15,35,6,0,6
Punjab,Sri Muktsar Sahib,Chronic Neurological Conditions,35,60,4,2,6
Punjab,Sri Muktsar Sahib,Chronic Neurological Conditions,60,80,1,1,2
Andhra Pradesh,Spsr Nellore,Chronic Neurological Conditions,15,35,2,0,2
Andhra Pradesh,Spsr Nellore,Chronic Neurological Conditions,35,60,0,1,1
Andhra Pradesh,Spsr Nellore,Chronic Neurological Conditions,60,80,1,0,1
Meghalaya,South West Khasi Hills,Chronic Neurological Conditions,15,35,1,0,1
Meghalaya,South West Khasi Hills,Chronic Neurological Conditions,35,60,1,0,1
Meghalaya,South West Garo Hills,Chronic Neurological Conditions,15,35,0,1,1
Delhi,South West,Chronic Neurological Conditions,0,6,1,1,2
Delhi,South West,Chronic Neurological Conditions,6,15,6,11,17
Delhi,South West,Chronic Neurological Conditions,15,35,28,7,35
Delhi,South West,Chronic Neurological Conditions,35,60,57,15,72
Delhi,South West,Chronic Neurological Conditions,60,80,13,2,15
Goa,South Goa,Chronic Neurological Conditions,15,35,7,1,8
Goa,South Goa,Chronic Neurological Conditions,35,60,30,9,39
Goa,South Goa,Chronic Neurological Conditions,60,80,12,2,14
Meghalaya,South Garo Hills,Chronic Neurological Conditions,15,35,0,1,1
Delhi,South East,Chronic Neurological Conditions,6,15,6,0,6
Delhi,South East,Chronic Neurological Conditions,15,35,4,3,7
Delhi,South East,Chronic Neurological Conditions,35,60,16,2,18
Delhi,South East,Chronic Neurological Conditions,60,80,3,0,3
Delhi,South East,Chronic Neurological Conditions,80,100,1,0,1
Andaman And Nicobar Islands,South Andamans,Chronic Neurological Conditions,15,35,7,2,9
Andaman And Nicobar Islands,South Andamans,Chronic Neurological Conditions,35,60,6,7,13
Andaman And Nicobar Islands,South Andamans,Chronic Neurological Conditions,60,80,4,2,6
Delhi,South,Chronic Neurological Conditions,6,15,0,2,2
Delhi,South,Chronic Neurological Conditions,15,35,14,3,17
Delhi,South,Chronic Neurological Conditions,35,60,16,5,21
Delhi,South,Chronic Neurological Conditions,60,80,3,0,3
Assam,Sonitpur,Chronic Neurological Conditions,15,35,4,1,5
Assam,Sonitpur,Chronic Neurological Conditions,35,60,3,0,3
Assam,Sonitpur,Chronic Neurological Conditions,60,80,2,1,3
Haryana,Sonipat,Chronic Neurological Conditions,0,6,1,1,2
Haryana,Sonipat,Chronic Neurological Conditions,6,15,5,6,11
Haryana,Sonipat,Chronic Neurological Conditions,15,35,59,17,76
Haryana,Sonipat,Chronic Neurological Conditions,35,60,176,38,214
Haryana,Sonipat,Chronic Neurological Conditions,60,80,27,4,31
Haryana,Sonipat,Chronic Neurological Conditions,80,100,1,0,1
Odisha,Sonepur,Chronic Neurological Conditions,6,15,0,1,1
Odisha,Sonepur,Chronic Neurological Conditions,15,35,1,0,1
Odisha,Sonepur,Chronic Neurological Conditions,35,60,0,1,1
Uttar Pradesh,Sonbhadra,Chronic Neurological Conditions,6,15,3,0,3
Uttar Pradesh,Sonbhadra,Chronic Neurological Conditions,15,35,7,3,10
Uttar Pradesh,Sonbhadra,Chronic Neurological Conditions,35,60,10,0,10
Uttar Pradesh,Sonbhadra,Chronic Neurological Conditions,60,80,1,0,1
Maharashtra,Solapur,Chronic Neurological Conditions,6,15,13,3,16
Maharashtra,Solapur,Chronic Neurological Conditions,15,35,12,5,17
Maharashtra,Solapur,Chronic Neurological Conditions,35,60,17,0,17
Maharashtra,Solapur,Chronic Neurological Conditions,60,80,1,0,1
Himachal Pradesh,Solan,Chronic Neurological Conditions,0,6,1,0,1
Himachal Pradesh,Solan,Chronic Neurological Conditions,6,15,1,0,1
Himachal Pradesh,Solan,Chronic Neurological Conditions,15,35,0,1,1
Himachal Pradesh,Solan,Chronic Neurological Conditions,35,60,3,1,4
Himachal Pradesh,Solan,Chronic Neurological Conditions,60,80,1,0,1
Bihar,Siwan,Chronic Neurological Conditions,0,6,0,1,1
Bihar,Siwan,Chronic Neurological Conditions,6,15,1,0,1
Bihar,Siwan,Chronic Neurological Conditions,15,35,1,0,1
Bihar,Siwan,Chronic Neurological Conditions,35,60,1,2,3
Assam,Sivasagar,Chronic Neurological Conditions,6,15,0,1,1
Assam,Sivasagar,Chronic Neurological Conditions,15,35,2,0,2
Assam,Sivasagar,Chronic Neurological Conditions,35,60,2,0,2
Tamil Nadu,Sivaganga,Chronic Neurological Conditions,0,6,2,0,2
Tamil Nadu,Sivaganga,Chronic Neurological Conditions,6,15,4,0,4
Tamil Nadu,Sivaganga,Chronic Neurological Conditions,15,35,5,0,5
Tamil Nadu,Sivaganga,Chronic Neurological Conditions,35,60,9,2,11
Tamil Nadu,Sivaganga,Chronic Neurological Conditions,60,80,3,1,4
Uttar Pradesh,Sitapur,Chronic Neurological Conditions,6,15,1,1,2
Uttar Pradesh,Sitapur,Chronic Neurological Conditions,15,35,14,2,16
Uttar Pradesh,Sitapur,Chronic Neurological Conditions,35,60,15,6,21
Uttar Pradesh,Sitapur,Chronic Neurological Conditions,60,80,2,0,2
Bihar,Sitamarhi,Chronic Neurological Conditions,6,15,0,1,1
Bihar,Sitamarhi,Chronic Neurological Conditions,15,35,1,0,1
Bihar,Sitamarhi,Chronic Neurological Conditions,35,60,1,0,1
Bihar,Sitamarhi,Chronic Neurological Conditions,60,80,1,1,2
Haryana,Sirsa,Chronic Neurological Conditions,6,15,2,0,2
Haryana,Sirsa,Chronic Neurological Conditions,15,35,9,2,11
Haryana,Sirsa,Chronic Neurological Conditions,35,60,26,8,34
Haryana,Sirsa,Chronic Neurological Conditions,60,80,2,0,2
Rajasthan,Sirohi,Chronic Neurological Conditions,15,35,1,2,3
Rajasthan,Sirohi,Chronic Neurological Conditions,35,60,4,0,4
Rajasthan,Sirohi,Chronic Neurological Conditions,60,80,0,1,1
Himachal Pradesh,Sirmaur,Chronic Neurological Conditions,6,15,3,0,3
Himachal Pradesh,Sirmaur,Chronic Neurological Conditions,15,35,4,0,4
Himachal Pradesh,Sirmaur,Chronic Neurological Conditions,35,60,4,6,10
Himachal Pradesh,Sirmaur,Chronic Neurological Conditions,60,80,1,0,1
Madhya Pradesh,Singrauli,Chronic Neurological Conditions,6,15,1,0,1
Madhya Pradesh,Singrauli,Chronic Neurological Conditions,15,35,3,1,4
Madhya Pradesh,Singrauli,Chronic Neurological Conditions,35,60,3,2,5
Maharashtra,Sindhudurg,Chronic Neurological Conditions,15,35,2,0,2
Maharashtra,Sindhudurg,Chronic Neurological Conditions,35,60,2,2,4
Maharashtra,Sindhudurg,Chronic Neurological Conditions,60,80,1,0,1
Jharkhand,Simdega,Chronic Neurological Conditions,15,35,1,1,2
Jharkhand,Simdega,Chronic Neurological Conditions,35,60,1,0,1
Rajasthan,Sikar,Chronic Neurological Conditions,6,15,0,1,1
Rajasthan,Sikar,Chronic Neurological Conditions,15,35,3,1,4
Rajasthan,Sikar,Chronic Neurological Conditions,35,60,5,1,6
Rajasthan,Sikar,Chronic Neurological Conditions,60,80,1,0,1
Madhya Pradesh,Sidhi,Chronic Neurological Conditions,6,15,23,5,28
Madhya Pradesh,Sidhi,Chronic Neurological Conditions,15,35,53,16,69
Madhya Pradesh,Sidhi,Chronic Neurological Conditions,35,60,85,29,114
Madhya Pradesh,Sidhi,Chronic Neurological Conditions,60,80,29,6,35
Madhya Pradesh,Sidhi,Chronic Neurological Conditions,80,100,2,0,2
Uttar Pradesh,Siddharth Nagar,Chronic Neurological Conditions,6,15,3,4,7
Uttar Pradesh,Siddharth Nagar,Chronic Neurological Conditions,15,35,32,9,41
Uttar Pradesh,Siddharth Nagar,Chronic Neurological Conditions,35,60,43,15,58
Uttar Pradesh,Siddharth Nagar,Chronic Neurological Conditions,60,80,12,2,14
Uttar Pradesh,Siddharth Nagar,Chronic Neurological Conditions,80,100,1,1,2
Uttar Pradesh,Shravasti,Chronic Neurological Conditions,15,35,4,1,5
Uttar Pradesh,Shravasti,Chronic Neurological Conditions,35,60,2,1,3
Uttar Pradesh,Shravasti,Chronic Neurological Conditions,60,80,4,0,4
Jammu And Kashmir,Shopian,Chronic Neurological Conditions,0,6,14,7,21
Jammu And Kashmir,Shopian,Chronic Neurological Conditions,6,15,38,21,59
Jammu And Kashmir,Shopian,Chronic Neurological Conditions,15,35,53,45,98
Jammu And Kashmir,Shopian,Chronic Neurological Conditions,35,60,66,43,109
Jammu And Kashmir,Shopian,Chronic Neurological Conditions,60,80,21,6,27
Jammu And Kashmir,Shopian,Chronic Neurological Conditions,80,100,1,0,1
Madhya Pradesh,Shivpuri,Chronic Neurological Conditions,35,60,2,0,2
Karnataka,Shivamogga,Chronic Neurological Conditions,0,6,13,7,20
Karnataka,Shivamogga,Chronic Neurological Conditions,6,15,61,32,93
Karnataka,Shivamogga,Chronic Neurological Conditions,15,35,171,95,266
Karnataka,Shivamogga,Chronic Neurological Conditions,35,60,499,228,727
Karnataka,Shivamogga,Chronic Neurological Conditions,60,80,144,38,182
Karnataka,Shivamogga,Chronic Neurological Conditions,80,100,1,1,2
Himachal Pradesh,Shimla,Chronic Neurological Conditions,6,15,0,2,2
Himachal Pradesh,Shimla,Chronic Neurological Conditions,15,35,21,14,35
Himachal Pradesh,Shimla,Chronic Neurological Conditions,35,60,35,7,42
Himachal Pradesh,Shimla,Chronic Neurological Conditions,60,80,7,6,13
Himachal Pradesh,Shimla,Chronic Neurological Conditions,80,100,1,0,1
Bihar,Sheohar,Chronic Neurological Conditions,6,15,1,3,4
Bihar,Sheohar,Chronic Neurological Conditions,15,35,0,1,1
Bihar,Sheohar,Chronic Neurological Conditions,35,60,1,0,1
Bihar,Sheohar,Chronic Neurological Conditions,60,80,0,1,1
Bihar,Sheikhpura,Chronic Neurological Conditions,6,15,1,0,1
Bihar,Sheikhpura,Chronic Neurological Conditions,15,35,0,1,1
Bihar,Sheikhpura,Chronic Neurological Conditions,35,60,1,0,1
Uttar Pradesh,Shamli,Chronic Neurological Conditions,6,15,1,0,1
Uttar Pradesh,Shamli,Chronic Neurological Conditions,15,35,5,3,8
Uttar Pradesh,Shamli,Chronic Neurological Conditions,35,60,5,2,7
Madhya Pradesh,Shajapur,Chronic Neurological Conditions,15,35,3,0,3
Madhya Pradesh,Shajapur,Chronic Neurological Conditions,35,60,7,1,8
Madhya Pradesh,Shajapur,Chronic Neurological Conditions,60,80,2,0,2
Uttar Pradesh,Shahjahanpur,Chronic Neurological Conditions,0,6,1,0,1
Uttar Pradesh,Shahjahanpur,Chronic Neurological Conditions,6,15,5,1,6
Uttar Pradesh,Shahjahanpur,Chronic Neurological Conditions,15,35,39,11,50
Uttar Pradesh,Shahjahanpur,Chronic Neurological Conditions,35,60,26,9,35
Uttar Pradesh,Shahjahanpur,Chronic Neurological Conditions,60,80,15,1,16
Uttar Pradesh,Shahjahanpur,Chronic Neurological Conditions,80,100,2,0,2
Punjab,Shahid Bhagat Singh Nagar,Chronic Neurological Conditions,0,6,0,2,2
Punjab,Shahid Bhagat Singh Nagar,Chronic Neurological Conditions,6,15,5,3,8
Punjab,Shahid Bhagat Singh Nagar,Chronic Neurological Conditions,15,35,18,5,23
Punjab,Shahid Bhagat Singh Nagar,Chronic Neurological Conditions,35,60,73,18,91
Punjab,Shahid Bhagat Singh Nagar,Chronic Neurological Conditions,60,80,27,5,32
Punjab,Shahid Bhagat Singh Nagar,Chronic Neurological Conditions,80,100,1,1,2
Madhya Pradesh,Shahdol,Chronic Neurological Conditions,0,6,0,1,1
Madhya Pradesh,Shahdol,Chronic Neurological Conditions,6,15,1,0,1
Madhya Pradesh,Shahdol,Chronic Neurological Conditions,15,35,3,2,5
Madhya Pradesh,Shahdol,Chronic Neurological Conditions,35,60,1,0,1
Madhya Pradesh,Shahdol,Chronic Neurological Conditions,60,80,1,1,2
Delhi,Shahdara,Chronic Neurological Conditions,6,15,1,0,1
Delhi,Shahdara,Chronic Neurological Conditions,15,35,2,3,5
Delhi,Shahdara,Chronic Neurological Conditions,35,60,8,0,8
Delhi,Shahdara,Chronic Neurological Conditions,60,80,0,1,1
Mizoram,Serchhip,Chronic Neurological Conditions,15,35,1,0,1
Mizoram,Serchhip,Chronic Neurological Conditions,35,60,2,1,3
Madhya Pradesh,Seoni,Chronic Neurological Conditions,6,15,0,1,1
Madhya Pradesh,Seoni,Chronic Neurological Conditions,15,35,4,2,6
Madhya Pradesh,Seoni,Chronic Neurological Conditions,35,60,13,3,16
Madhya Pradesh,Seoni,Chronic Neurological Conditions,60,80,2,0,2
Manipur,Senapati,Chronic Neurological Conditions,6,15,1,0,1
Manipur,Senapati,Chronic Neurological Conditions,15,35,1,0,1
Madhya Pradesh,Sehore,Chronic Neurological Conditions,6,15,1,0,1
Rajasthan,Sawai Madhopur,Chronic Neurological Conditions,6,15,0,2,2
Rajasthan,Sawai Madhopur,Chronic Neurological Conditions,15,35,1,0,1
Rajasthan,Sawai Madhopur,Chronic Neurological Conditions,35,60,1,0,1
Madhya Pradesh,Satna,Chronic Neurological Conditions,6,15,1,2,3
Madhya Pradesh,Satna,Chronic Neurological Conditions,15,35,2,0,2
Madhya Pradesh,Satna,Chronic Neurological Conditions,35,60,2,1,3
Madhya Pradesh,Satna,Chronic Neurological Conditions,60,80,1,0,1
Maharashtra,Satara,Chronic Neurological Conditions,15,35,2,0,2
Maharashtra,Satara,Chronic Neurological Conditions,35,60,5,5,10
Maharashtra,Satara,Chronic Neurological Conditions,60,80,1,0,1
Bihar,Saran,Chronic Neurological Conditions,6,15,3,2,5
Bihar,Saran,Chronic Neurological Conditions,15,35,10,3,13
Bihar,Saran,Chronic Neurological Conditions,35,60,8,1,9
Bihar,Saran,Chronic Neurological Conditions,60,80,1,0,1
Jharkhand,Saraikela Kharsawan,Chronic Neurological Conditions,6,15,0,1,1
Jharkhand,Saraikela Kharsawan,Chronic Neurological Conditions,15,35,0,2,2
Jharkhand,Saraikela Kharsawan,Chronic Neurological Conditions,35,60,2,0,2
Uttar Pradesh,Sant Kabeer Nagar,Chronic Neurological Conditions,0,6,1,0,1
Uttar Pradesh,Sant Kabeer Nagar,Chronic Neurological Conditions,6,15,17,10,27
Uttar Pradesh,Sant Kabeer Nagar,Chronic Neurological Conditions,15,35,69,33,102
Uttar Pradesh,Sant Kabeer Nagar,Chronic Neurological Conditions,35,60,138,29,167
Uttar Pradesh,Sant Kabeer Nagar,Chronic Neurological Conditions,60,80,34,6,40
Uttar Pradesh,Sant Kabeer Nagar,Chronic Neurological Conditions,80,100,1,0,1
Punjab,Sangrur,Chronic Neurological Conditions,0,6,2,2,4
Punjab,Sangrur,Chronic Neurological Conditions,6,15,9,6,15
Punjab,Sangrur,Chronic Neurological Conditions,15,35,20,11,31
Punjab,Sangrur,Chronic Neurological Conditions,35,60,91,40,131
Punjab,Sangrur,Chronic Neurological Conditions,60,80,27,8,35
Punjab,Sangrur,Chronic Neurological Conditions,80,100,0,2,2
Maharashtra,Sangli,Chronic Neurological Conditions,0,6,1,0,1
Maharashtra,Sangli,Chronic Neurological Conditions,6,15,6,3,9
Maharashtra,Sangli,Chronic Neurological Conditions,15,35,18,4,22
Maharashtra,Sangli,Chronic Neurological Conditions,35,60,24,4,28
Maharashtra,Sangli,Chronic Neurological Conditions,60,80,6,1,7
Uttar Pradesh,Sambhal,Chronic Neurological Conditions,15,35,4,0,4
Uttar Pradesh,Sambhal,Chronic Neurological Conditions,35,60,1,0,1
Odisha,Sambalpur,Chronic Neurological Conditions,6,15,1,0,1
Odisha,Sambalpur,Chronic Neurological Conditions,15,35,4,4,8
Odisha,Sambalpur,Chronic Neurological Conditions,35,60,9,4,13
Odisha,Sambalpur,Chronic Neurological Conditions,60,80,3,0,3
Jammu And Kashmir,Samba,Chronic Neurological Conditions,0,6,2,3,5
Jammu And Kashmir,Samba,Chronic Neurological Conditions,6,15,5,3,8
Jammu And Kashmir,Samba,Chronic Neurological Conditions,15,35,14,4,18
Jammu And Kashmir,Samba,Chronic Neurological Conditions,35,60,18,3,21
Jammu And Kashmir,Samba,Chronic Neurological Conditions,60,80,3,1,4
Bihar,Samastipur,Chronic Neurological Conditions,0,6,1,0,1
Bihar,Samastipur,Chronic Neurological Conditions,6,15,4,2,6
Bihar,Samastipur,Chronic Neurological Conditions,15,35,11,5,16
Bihar,Samastipur,Chronic Neurological Conditions,35,60,19,2,21
Bihar,Samastipur,Chronic Neurological Conditions,60,80,4,2,6
Tamil Nadu,Salem,Chronic Neurological Conditions,0,6,1,1,2
Tamil Nadu,Salem,Chronic Neurological Conditions,6,15,7,12,19
Tamil Nadu,Salem,Chronic Neurological Conditions,15,35,24,9,33
Tamil Nadu,Salem,Chronic Neurological Conditions,35,60,86,28,114
Tamil Nadu,Salem,Chronic Neurological Conditions,60,80,23,3,26
Tamil Nadu,Salem,Chronic Neurological Conditions,80,100,0,2,2
Mizoram,Saiha,Chronic Neurological Conditions,6,15,0,1,1
Mizoram,Saiha,Chronic Neurological Conditions,15,35,0,1,1
Mizoram,Saiha,Chronic Neurological Conditions,35,60,0,1,1
Jharkhand,Sahebganj,Chronic Neurological Conditions,6,15,1,0,1
Jharkhand,Sahebganj,Chronic Neurological Conditions,35,60,5,1,6
Jharkhand,Sahebganj,Chronic Neurological Conditions,60,80,1,0,1
Bihar,Saharsa,Chronic Neurological Conditions,0,6,0,1,1
Bihar,Saharsa,Chronic Neurological Conditions,6,15,0,1,1
Bihar,Saharsa,Chronic Neurological Conditions,15,35,3,3,6
Bihar,Saharsa,Chronic Neurological Conditions,35,60,1,0,1
Bihar,Saharsa,Chronic Neurological Conditions,80,100,1,0,1
Uttar Pradesh,Saharanpur,Chronic Neurological Conditions,0,6,1,0,1
Uttar Pradesh,Saharanpur,Chronic Neurological Conditions,6,15,1,1,2
Uttar Pradesh,Saharanpur,Chronic Neurological Conditions,15,35,11,5,16
Uttar Pradesh,Saharanpur,Chronic Neurological Conditions,35,60,16,4,20
Uttar Pradesh,Saharanpur,Chronic Neurological Conditions,60,80,2,0,2
Uttar Pradesh,Saharanpur,Chronic Neurological Conditions,80,100,1,0,1
Madhya Pradesh,Sagar,Chronic Neurological Conditions,15,35,8,2,10
Madhya Pradesh,Sagar,Chronic Neurological Conditions,35,60,8,2,10
Madhya Pradesh,Sagar,Chronic Neurological Conditions,60,80,2,0,2
Gujarat,Sabar Kantha,Chronic Neurological Conditions,6,15,0,2,2
Gujarat,Sabar Kantha,Chronic Neurological Conditions,15,35,1,0,1
Gujarat,Sabar Kantha,Chronic Neurological Conditions,35,60,1,1,2
Gujarat,Sabar Kantha,Chronic Neurological Conditions,80,100,1,0,1
Punjab,S.A.S Nagar,Chronic Neurological Conditions,0,6,1,1,2
Punjab,S.A.S Nagar,Chronic Neurological Conditions,6,15,5,3,8
Punjab,S.A.S Nagar,Chronic Neurological Conditions,15,35,20,9,29
Punjab,S.A.S Nagar,Chronic Neurological Conditions,35,60,45,10,55
Punjab,S.A.S Nagar,Chronic Neurological Conditions,60,80,17,1,18
Punjab,S.A.S Nagar,Chronic Neurological Conditions,80,100,0,1,1
Punjab,Rupnagar,Chronic Neurological Conditions,0,6,1,0,1
Punjab,Rupnagar,Chronic Neurological Conditions,6,15,1,2,3
Punjab,Rupnagar,Chronic Neurological Conditions,15,35,33,17,50
Punjab,Rupnagar,Chronic Neurological Conditions,35,60,156,38,194
Punjab,Rupnagar,Chronic Neurological Conditions,60,80,71,8,79
Punjab,Rupnagar,Chronic Neurological Conditions,80,100,1,0,1
Uttarakhand,Rudra Prayag,Chronic Neurological Conditions,15,35,6,4,10
Uttarakhand,Rudra Prayag,Chronic Neurological Conditions,35,60,10,7,17
Uttarakhand,Rudra Prayag,Chronic Neurological Conditions,60,80,3,2,5
Bihar,Rohtas,Chronic Neurological Conditions,6,15,22,14,36
Bihar,Rohtas,Chronic Neurological Conditions,15,35,224,72,296
Bihar,Rohtas,Chronic Neurological Conditions,35,60,175,75,250
Bihar,Rohtas,Chronic Neurological Conditions,60,80,39,8,47
Bihar,Rohtas,Chronic Neurological Conditions,80,100,2,0,2
Haryana,Rohtak,Chronic Neurological Conditions,6,15,11,4,15
Haryana,Rohtak,Chronic Neurological Conditions,15,35,77,26,103
Haryana,Rohtak,Chronic Neurological Conditions,35,60,292,68,360
Haryana,Rohtak,Chronic Neurological Conditions,60,80,53,12,65
Haryana,Rohtak,Chronic Neurological Conditions,80,100,0,2,2
Haryana,Rewari,Chronic Neurological Conditions,0,6,1,0,1
Haryana,Rewari,Chronic Neurological Conditions,6,15,0,1,1
Haryana,Rewari,Chronic Neurological Conditions,15,35,9,10,19
Haryana,Rewari,Chronic Neurological Conditions,35,60,32,7,39
Madhya Pradesh,Rewa,Chronic Neurological Conditions,15,35,6,1,7
Madhya Pradesh,Rewa,Chronic Neurological Conditions,35,60,12,2,14
Madhya Pradesh,Rewa,Chronic Neurological Conditions,60,80,7,0,7
Jammu And Kashmir,Reasi,Chronic Neurological Conditions,6,15,2,1,3
Jammu And Kashmir,Reasi,Chronic Neurological Conditions,15,35,11,7,18
Jammu And Kashmir,Reasi,Chronic Neurological Conditions,35,60,11,4,15
Jammu And Kashmir,Reasi,Chronic Neurological Conditions,60,80,3,0,3
Odisha,Rayagada,Chronic Neurological Conditions,0,6,1,0,1
Odisha,Rayagada,Chronic Neurological Conditions,6,15,3,1,4
Odisha,Rayagada,Chronic Neurological Conditions,15,35,11,7,18
Odisha,Rayagada,Chronic Neurological Conditions,35,60,35,6,41
Odisha,Rayagada,Chronic Neurological Conditions,60,80,5,4,9
Odisha,Rayagada,Chronic Neurological Conditions,80,100,0,1,1
Maharashtra,Ratnagiri,Chronic Neurological Conditions,35,60,2,1,3
Madhya Pradesh,Ratlam,Chronic Neurological Conditions,15,35,1,0,1
Madhya Pradesh,Ratlam,Chronic Neurological Conditions,35,60,0,1,1
Tamil Nadu,Ranipet,Chronic Neurological Conditions,0,6,1,0,1
Tamil Nadu,Ranipet,Chronic Neurological Conditions,6,15,1,2,3
Tamil Nadu,Ranipet,Chronic Neurological Conditions,15,35,0,1,1
Tamil Nadu,Ranipet,Chronic Neurological Conditions,35,60,3,5,8
Jharkhand,Ranchi,Chronic Neurological Conditions,15,35,1,0,1
Jharkhand,Ranchi,Chronic Neurological Conditions,35,60,4,0,4
Uttar Pradesh,Rampur,Chronic Neurological Conditions,6,15,2,0,2
Uttar Pradesh,Rampur,Chronic Neurological Conditions,15,35,11,5,16
Uttar Pradesh,Rampur,Chronic Neurological Conditions,35,60,4,1,5
Jharkhand,Ramgarh,Chronic Neurological Conditions,6,15,2,7,9
Jharkhand,Ramgarh,Chronic Neurological Conditions,15,35,4,6,10
Jharkhand,Ramgarh,Chronic Neurological Conditions,35,60,15,4,19
Jharkhand,Ramgarh,Chronic Neurological Conditions,60,80,2,1,3
Jammu And Kashmir,Ramban,Chronic Neurological Conditions,15,35,2,0,2
Jammu And Kashmir,Ramban,Chronic Neurological Conditions,35,60,3,0,3
Tamil Nadu,Ramanathapuram,Chronic Neurological Conditions,0,6,0,1,1
Tamil Nadu,Ramanathapuram,Chronic Neurological Conditions,6,15,1,1,2
Tamil Nadu,Ramanathapuram,Chronic Neurological Conditions,35,60,1,0,1
Karnataka,Ramanagara,Chronic Neurological Conditions,6,15,0,1,1
Karnataka,Ramanagara,Chronic Neurological Conditions,15,35,3,3,6
Karnataka,Ramanagara,Chronic Neurological Conditions,35,60,20,2,22
Karnataka,Ramanagara,Chronic Neurological Conditions,60,80,11,1,12
Rajasthan,Rajsamand,Chronic Neurological Conditions,15,35,2,0,2
Rajasthan,Rajsamand,Chronic Neurological Conditions,35,60,6,1,7
Rajasthan,Rajsamand,Chronic Neurological Conditions,60,80,0,1,1
Jammu And Kashmir,Rajouri,Chronic Neurological Conditions,0,6,3,0,3
Jammu And Kashmir,Rajouri,Chronic Neurological Conditions,6,15,9,5,14
Jammu And Kashmir,Rajouri,Chronic Neurological Conditions,15,35,19,19,38
Jammu And Kashmir,Rajouri,Chronic Neurological Conditions,35,60,44,27,71
Jammu And Kashmir,Rajouri,Chronic Neurological Conditions,60,80,6,4,10
Jammu And Kashmir,Rajouri,Chronic Neurological Conditions,80,100,1,0,1
Chhattisgarh,Rajnandgaon,Chronic Neurological Conditions,0,6,3,1,4
Chhattisgarh,Rajnandgaon,Chronic Neurological Conditions,6,15,10,3,13
Chhattisgarh,Rajnandgaon,Chronic Neurological Conditions,15,35,41,20,61
Chhattisgarh,Rajnandgaon,Chronic Neurological Conditions,35,60,77,29,106
Chhattisgarh,Rajnandgaon,Chronic Neurological Conditions,60,80,18,7,25
Gujarat,Rajkot,Chronic Neurological Conditions,60,80,1,0,1
Madhya Pradesh,Rajgarh,Chronic Neurological Conditions,6,15,2,1,3
Madhya Pradesh,Rajgarh,Chronic Neurological Conditions,15,35,2,2,4
Madhya Pradesh,Rajgarh,Chronic Neurological Conditions,35,60,5,3,8
Madhya Pradesh,Rajgarh,Chronic Neurological Conditions,60,80,1,1,2
Madhya Pradesh,Raisen,Chronic Neurological Conditions,6,15,1,0,1
Madhya Pradesh,Raisen,Chronic Neurological Conditions,15,35,1,0,1
Madhya Pradesh,Raisen,Chronic Neurological Conditions,35,60,6,1,7
Madhya Pradesh,Raisen,Chronic Neurological Conditions,60,80,3,1,4
Madhya Pradesh,Raisen,Chronic Neurological Conditions,80,100,0,1,1
Chhattisgarh,Raipur,Chronic Neurological Conditions,15,35,4,9,13
Chhattisgarh,Raipur,Chronic Neurological Conditions,35,60,26,3,29
Chhattisgarh,Raipur,Chronic Neurological Conditions,60,80,11,0,11
Chhattisgarh,Raipur,Chronic Neurological Conditions,80,100,1,0,1
Chhattisgarh,Raigarh,Chronic Neurological Conditions,15,35,1,0,1
Chhattisgarh,Raigarh,Chronic Neurological Conditions,35,60,3,1,4
Chhattisgarh,Raigarh,Chronic Neurological Conditions,60,80,0,1,1
Maharashtra,Raigad,Chronic Neurological Conditions,0,6,3,2,5
Maharashtra,Raigad,Chronic Neurological Conditions,6,15,12,9,21
Maharashtra,Raigad,Chronic Neurological Conditions,15,35,97,55,152
Maharashtra,Raigad,Chronic Neurological Conditions,35,60,498,108,606
Maharashtra,Raigad,Chronic Neurological Conditions,60,80,255,48,303
Maharashtra,Raigad,Chronic Neurological Conditions,80,100,5,0,5
Karnataka,Raichur,Chronic Neurological Conditions,0,6,1,0,1
Karnataka,Raichur,Chronic Neurological Conditions,6,15,0,2,2
Karnataka,Raichur,Chronic Neurological Conditions,15,35,1,3,4
Karnataka,Raichur,Chronic Neurological Conditions,35,60,6,2,8
Uttar Pradesh,Rae Bareli,Chronic Neurological Conditions,35,60,1,0,1
Bihar,Purnia,Chronic Neurological Conditions,15,35,1,0,1
Bihar,Purnia,Chronic Neurological Conditions,35,60,1,1,2
Bihar,Purnia,Chronic Neurological Conditions,60,80,1,0,1
Odisha,Puri,Chronic Neurological Conditions,0,6,0,1,1
Odisha,Puri,Chronic Neurological Conditions,6,15,4,4,8
Odisha,Puri,Chronic Neurological Conditions,15,35,10,7,17
Odisha,Puri,Chronic Neurological Conditions,35,60,25,11,36
Odisha,Puri,Chronic Neurological Conditions,60,80,10,5,15
Bihar,Purbi Champaran,Chronic Neurological Conditions,0,6,1,1,2
Bihar,Purbi Champaran,Chronic Neurological Conditions,6,15,4,0,4
Bihar,Purbi Champaran,Chronic Neurological Conditions,15,35,10,4,14
Bihar,Purbi Champaran,Chronic Neurological Conditions,35,60,7,1,8
Bihar,Purbi Champaran,Chronic Neurological Conditions,60,80,3,1,4
Maharashtra,Pune,Chronic Neurological Conditions,0,6,6,4,10
Maharashtra,Pune,Chronic Neurological Conditions,6,15,36,18,54
Maharashtra,Pune,Chronic Neurological Conditions,15,35,163,63,226
Maharashtra,Pune,Chronic Neurological Conditions,35,60,576,109,685
Maharashtra,Pune,Chronic Neurological Conditions,60,80,177,35,212
Maharashtra,Pune,Chronic Neurological Conditions,80,100,9,2,11
Jammu And Kashmir,Pulwama,Chronic Neurological Conditions,0,6,27,9,36
Jammu And Kashmir,Pulwama,Chronic Neurological Conditions,6,15,69,41,110
Jammu And Kashmir,Pulwama,Chronic Neurological Conditions,15,35,132,104,236
Jammu And Kashmir,Pulwama,Chronic Neurological Conditions,35,60,126,103,229
Jammu And Kashmir,Pulwama,Chronic Neurological Conditions,60,80,21,16,37
Tamil Nadu,Pudukkottai,Chronic Neurological Conditions,0,6,1,0,1
Tamil Nadu,Pudukkottai,Chronic Neurological Conditions,6,15,3,1,4
Tamil Nadu,Pudukkottai,Chronic Neurological Conditions,15,35,6,5,11
Tamil Nadu,Pudukkottai,Chronic Neurological Conditions,35,60,14,4,18
Tamil Nadu,Pudukkottai,Chronic Neurological Conditions,60,80,3,1,4
Uttar Pradesh,Prayagraj,Chronic Neurological Conditions,6,15,1,1,2
Uttar Pradesh,Prayagraj,Chronic Neurological Conditions,15,35,8,2,10
Uttar Pradesh,Prayagraj,Chronic Neurological Conditions,35,60,6,1,7
Uttar Pradesh,Prayagraj,Chronic Neurological Conditions,60,80,1,1,2
Rajasthan,Pratapgarh,Chronic Neurological Conditions,6,15,1,2,3
Rajasthan,Pratapgarh,Chronic Neurological Conditions,15,35,3,2,5
Rajasthan,Pratapgarh,Chronic Neurological Conditions,35,60,6,1,7
Rajasthan,Pratapgarh,Chronic Neurological Conditions,60,80,8,2,10
Rajasthan,Pratapgarh,Chronic Neurological Conditions,80,100,1,1,2
Uttar Pradesh,Pratapgarh,Chronic Neurological Conditions,6,15,1,0,1
Uttar Pradesh,Pratapgarh,Chronic Neurological Conditions,15,35,4,1,5
Uttar Pradesh,Pratapgarh,Chronic Neurological Conditions,35,60,13,5,18
Uttar Pradesh,Pratapgarh,Chronic Neurological Conditions,60,80,1,0,1
Uttar Pradesh,Pratapgarh,Chronic Neurological Conditions,80,100,1,0,1
Andhra Pradesh,Prakasam,Chronic Neurological Conditions,35,60,1,0,1
Gujarat,Porbandar,Chronic Neurological Conditions,15,35,0,1,1
Jammu And Kashmir,Poonch,Chronic Neurological Conditions,0,6,2,2,4
Jammu And Kashmir,Poonch,Chronic Neurological Conditions,6,15,12,15,27
Jammu And Kashmir,Poonch,Chronic Neurological Conditions,15,35,39,38,77
Jammu And Kashmir,Poonch,Chronic Neurological Conditions,35,60,62,41,103
Jammu And Kashmir,Poonch,Chronic Neurological Conditions,60,80,9,6,15
Jammu And Kashmir,Poonch,Chronic Neurological Conditions,80,100,4,0,4
Puducherry,Pondicherry,Chronic Neurological Conditions,0,6,1,0,1
Puducherry,Pondicherry,Chronic Neurological Conditions,6,15,25,24,49
Puducherry,Pondicherry,Chronic Neurological Conditions,15,35,141,61,202
Puducherry,Pondicherry,Chronic Neurological Conditions,35,60,411,148,559
Puducherry,Pondicherry,Chronic Neurological Conditions,60,80,120,23,143
Puducherry,Pondicherry,Chronic Neurological Conditions,80,100,3,5,8
Uttarakhand,Pithoragarh,Chronic Neurological Conditions,15,35,0,1,1
Uttarakhand,Pithoragarh,Chronic Neurological Conditions,35,60,1,0,1
Uttar Pradesh,Pilibhit,Chronic Neurological Conditions,6,15,2,1,3
Uttar Pradesh,Pilibhit,Chronic Neurological Conditions,15,35,22,3,25
Uttar Pradesh,Pilibhit,Chronic Neurological Conditions,35,60,15,6,21
Uttar Pradesh,Pilibhit,Chronic Neurological Conditions,60,80,1,0,1
Nagaland,Phek,Chronic Neurological Conditions,15,35,1,0,1
Nagaland,Phek,Chronic Neurological Conditions,35,60,1,0,1
Tamil Nadu,Perambalur,Chronic Neurological Conditions,35,60,2,0,2
Tamil Nadu,Perambalur,Chronic Neurological Conditions,60,80,1,0,1
Uttarakhand,Pauri Garhwal,Chronic Neurological Conditions,6,15,1,0,1
Uttarakhand,Pauri Garhwal,Chronic Neurological Conditions,15,35,5,1,6
Uttarakhand,Pauri Garhwal,Chronic Neurological Conditions,35,60,6,4,10
Uttarakhand,Pauri Garhwal,Chronic Neurological Conditions,60,80,2,0,2
Bihar,Patna,Chronic Neurological Conditions,0,6,0,1,1
Bihar,Patna,Chronic Neurological Conditions,6,15,4,1,5
Bihar,Patna,Chronic Neurological Conditions,15,35,10,2,12
Bihar,Patna,Chronic Neurological Conditions,35,60,9,1,10
Bihar,Patna,Chronic Neurological Conditions,60,80,3,0,3
Bihar,Patna,Chronic Neurological Conditions,80,100,2,0,2
Punjab,Patiala,Chronic Neurological Conditions,0,6,3,3,6
Punjab,Patiala,Chronic Neurological Conditions,6,15,16,15,31
Punjab,Patiala,Chronic Neurological Conditions,15,35,49,29,78
Punjab,Patiala,Chronic Neurological Conditions,35,60,152,57,209
Punjab,Patiala,Chronic Neurological Conditions,60,80,48,10,58
Punjab,Patiala,Chronic Neurological Conditions,80,100,3,0,3
Punjab,Pathankot,Chronic Neurological Conditions,0,6,0,1,1
Punjab,Pathankot,Chronic Neurological Conditions,6,15,2,1,3
Punjab,Pathankot,Chronic Neurological Conditions,15,35,7,9,16
Punjab,Pathankot,Chronic Neurological Conditions,35,60,16,3,19
Punjab,Pathankot,Chronic Neurological Conditions,60,80,8,2,10
Kerala,Pathanamthitta,Chronic Neurological Conditions,0,6,2,1,3
Kerala,Pathanamthitta,Chronic Neurological Conditions,6,15,4,1,5
Kerala,Pathanamthitta,Chronic Neurological Conditions,15,35,4,7,11
Kerala,Pathanamthitta,Chronic Neurological Conditions,35,60,24,8,32
Kerala,Pathanamthitta,Chronic Neurological Conditions,60,80,7,4,11
Kerala,Pathanamthitta,Chronic Neurological Conditions,80,100,1,0,1
Bihar,Pashchim Champaran,Chronic Neurological Conditions,6,15,4,1,5
Bihar,Pashchim Champaran,Chronic Neurological Conditions,15,35,7,3,10
Bihar,Pashchim Champaran,Chronic Neurological Conditions,35,60,5,5,10
Maharashtra,Parbhani,Chronic Neurological Conditions,6,15,1,0,1
Maharashtra,Parbhani,Chronic Neurological Conditions,15,35,3,1,4
Maharashtra,Parbhani,Chronic Neurological Conditions,35,60,4,1,5
Maharashtra,Parbhani,Chronic Neurological Conditions,60,80,5,2,7
Arunachal Pradesh,Papum Pare,Chronic Neurological Conditions,15,35,3,4,7
Arunachal Pradesh,Papum Pare,Chronic Neurological Conditions,35,60,1,1,2
Arunachal Pradesh,Papum Pare,Chronic Neurological Conditions,80,100,1,0,1
Madhya Pradesh,Panna,Chronic Neurological Conditions,15,35,1,1,2
Madhya Pradesh,Panna,Chronic Neurological Conditions,35,60,0,1,1
Haryana,Panipat,Chronic Neurological Conditions,15,35,2,0,2
Haryana,Panipat,Chronic Neurological Conditions,35,60,6,2,8
Haryana,Panipat,Chronic Neurological Conditions,60,80,0,1,1
Haryana,Panchkula,Chronic Neurological Conditions,6,15,0,1,1
Haryana,Panchkula,Chronic Neurological Conditions,15,35,4,1,5
Haryana,Panchkula,Chronic Neurological Conditions,35,60,4,0,4
Haryana,Panchkula,Chronic Neurological Conditions,60,80,1,4,5
Gujarat,Panch Mahals,Chronic Neurological Conditions,60,80,1,0,1
Haryana,Palwal,Chronic Neurological Conditions,15,35,1,0,1
Rajasthan,Pali,Chronic Neurological Conditions,15,35,1,2,3
Rajasthan,Pali,Chronic Neurological Conditions,35,60,2,1,3
Rajasthan,Pali,Chronic Neurological Conditions,60,80,1,0,1
Maharashtra,Palghar,Chronic Neurological Conditions,6,15,1,1,2
Maharashtra,Palghar,Chronic Neurological Conditions,15,35,4,2,6
Maharashtra,Palghar,Chronic Neurological Conditions,35,60,20,1,21
Maharashtra,Palghar,Chronic Neurological Conditions,60,80,11,4,15
Maharashtra,Palghar,Chronic Neurological Conditions,80,100,1,0,1
Jharkhand,Palamu,Chronic Neurological Conditions,15,35,3,0,3
Jharkhand,Palamu,Chronic Neurological Conditions,35,60,1,0,1
Jharkhand,Palamu,Chronic Neurological Conditions,60,80,0,1,1
Kerala,Palakkad,Chronic Neurological Conditions,0,6,2,1,3
Kerala,Palakkad,Chronic Neurological Conditions,6,15,6,1,7
Kerala,Palakkad,Chronic Neurological Conditions,15,35,39,19,58
Kerala,Palakkad,Chronic Neurological Conditions,35,60,54,21,75
Kerala,Palakkad,Chronic Neurological Conditions,60,80,19,8,27
Jharkhand,Pakur,Chronic Neurological Conditions,6,15,1,0,1
Jharkhand,Pakur,Chronic Neurological Conditions,15,35,3,8,11
Jharkhand,Pakur,Chronic Neurological Conditions,35,60,5,0,5
Jharkhand,Pakur,Chronic Neurological Conditions,60,80,1,1,2
Maharashtra,Osmanabad,Chronic Neurological Conditions,6,15,0,3,3
Maharashtra,Osmanabad,Chronic Neurological Conditions,15,35,6,0,6
Maharashtra,Osmanabad,Chronic Neurological Conditions,35,60,4,0,4
Haryana,Nuh,Chronic Neurological Conditions,0,6,1,0,1
Haryana,Nuh,Chronic Neurological Conditions,15,35,0,1,1
Haryana,Nuh,Chronic Neurological Conditions,35,60,0,1,1
Odisha,Nuapada,Chronic Neurological Conditions,0,6,1,1,2
Odisha,Nuapada,Chronic Neurological Conditions,6,15,1,0,1
Odisha,Nuapada,Chronic Neurological Conditions,15,35,2,0,2
Odisha,Nuapada,Chronic Neurological Conditions,35,60,2,0,2
Odisha,Nuapada,Chronic Neurological Conditions,60,80,2,2,4
Delhi,North West,Chronic Neurological Conditions,6,15,7,4,11
Delhi,North West,Chronic Neurological Conditions,15,35,15,13,28
Delhi,North West,Chronic Neurological Conditions,35,60,32,10,42
Delhi,North West,Chronic Neurological Conditions,60,80,11,2,13
Delhi,North West,Chronic Neurological Conditions,80,100,0,1,1
Goa,North Goa,Chronic Neurological Conditions,15,35,5,5,10
Goa,North Goa,Chronic Neurological Conditions,35,60,14,9,23
Goa,North Goa,Chronic Neurological Conditions,60,80,2,0,2
Delhi,North East,Chronic Neurological Conditions,6,15,3,7,10
Delhi,North East,Chronic Neurological Conditions,15,35,18,5,23
Delhi,North East,Chronic Neurological Conditions,35,60,52,5,57
Delhi,North East,Chronic Neurological Conditions,60,80,9,1,10
Andaman And Nicobar Islands,North And Middle Andaman,Chronic Neurological Conditions,15,35,2,1,3
Andaman And Nicobar Islands,North And Middle Andaman,Chronic Neurological Conditions,35,60,4,3,7
Andaman And Nicobar Islands,North And Middle Andaman,Chronic Neurological Conditions,60,80,3,0,3
Delhi,North,Chronic Neurological Conditions,6,15,1,0,1
Delhi,North,Chronic Neurological Conditions,15,35,9,2,11
Delhi,North,Chronic Neurological Conditions,35,60,15,2,17
Delhi,North,Chronic Neurological Conditions,60,80,3,0,3
Madhya Pradesh,Niwari,Chronic Neurological Conditions,6,15,1,0,1
Madhya Pradesh,Niwari,Chronic Neurological Conditions,15,35,11,6,17
Madhya Pradesh,Niwari,Chronic Neurological Conditions,35,60,41,4,45
Madhya Pradesh,Niwari,Chronic Neurological Conditions,60,80,10,4,14
Madhya Pradesh,Niwari,Chronic Neurological Conditions,80,100,1,0,1
Delhi,New Delhi,Chronic Neurological Conditions,15,35,2,1,3
Delhi,New Delhi,Chronic Neurological Conditions,35,60,2,1,3
Delhi,New Delhi,Chronic Neurological Conditions,60,80,0,1,1
Madhya Pradesh,Neemuch,Chronic Neurological Conditions,35,60,1,0,1
Odisha,Nayagarh,Chronic Neurological Conditions,0,6,2,0,2
Odisha,Nayagarh,Chronic Neurological Conditions,6,15,7,1,8
Odisha,Nayagarh,Chronic Neurological Conditions,15,35,17,4,21
Odisha,Nayagarh,Chronic Neurological Conditions,35,60,15,11,26
Odisha,Nayagarh,Chronic Neurological Conditions,60,80,7,4,11
Odisha,Nayagarh,Chronic Neurological Conditions,80,100,1,2,3
Bihar,Nawada,Chronic Neurological Conditions,15,35,1,1,2
Bihar,Nawada,Chronic Neurological Conditions,60,80,1,0,1
Gujarat,Navsari,Chronic Neurological Conditions,15,35,0,1,1
Gujarat,Navsari,Chronic Neurological Conditions,35,60,1,1,2
Maharashtra,Nashik,Chronic Neurological Conditions,6,15,2,2,4
Maharashtra,Nashik,Chronic Neurological Conditions,15,35,125,49,174
Maharashtra,Nashik,Chronic Neurological Conditions,35,60,385,74,459
Maharashtra,Nashik,Chronic Neurological Conditions,60,80,134,16,150
Maharashtra,Nashik,Chronic Neurological Conditions,80,100,5,0,5
Madhya Pradesh,Narsinghpur,Chronic Neurological Conditions,6,15,1,0,1
Madhya Pradesh,Narsinghpur,Chronic Neurological Conditions,15,35,22,9,31
Madhya Pradesh,Narsinghpur,Chronic Neurological Conditions,35,60,28,6,34
Madhya Pradesh,Narsinghpur,Chronic Neurological Conditions,60,80,6,3,9
Madhya Pradesh,Narmadapuram,Chronic Neurological Conditions,6,15,0,1,1
Madhya Pradesh,Narmadapuram,Chronic Neurological Conditions,15,35,1,1,2
Madhya Pradesh,Narmadapuram,Chronic Neurological Conditions,35,60,1,1,2
Gujarat,Narmada,Chronic Neurological Conditions,15,35,1,0,1
Maharashtra,Nandurbar,Chronic Neurological Conditions,6,15,1,0,1
Maharashtra,Nandurbar,Chronic Neurological Conditions,15,35,1,1,2
Maharashtra,Nandurbar,Chronic Neurological Conditions,35,60,5,1,6
Maharashtra,Nanded,Chronic Neurological Conditions,6,15,1,1,2
Maharashtra,Nanded,Chronic Neurological Conditions,15,35,6,0,6
Maharashtra,Nanded,Chronic Neurological Conditions,35,60,9,2,11
Maharashtra,Nanded,Chronic Neurological Conditions,60,80,2,0,2
Arunachal Pradesh,Namsai,Chronic Neurological Conditions,35,60,0,1,1
Sikkim,Namchi,Chronic Neurological Conditions,15,35,1,1,2
Sikkim,Namchi,Chronic Neurological Conditions,35,60,1,0,1
Sikkim,Namchi,Chronic Neurological Conditions,80,100,1,0,1
Tamil Nadu,Namakkal,Chronic Neurological Conditions,0,6,1,0,1
Tamil Nadu,Namakkal,Chronic Neurological Conditions,6,15,0,1,1
Tamil Nadu,Namakkal,Chronic Neurological Conditions,15,35,4,2,6
Tamil Nadu,Namakkal,Chronic Neurological Conditions,35,60,8,4,12
Tamil Nadu,Namakkal,Chronic Neurological Conditions,60,80,3,0,3
Assam,Nalbari,Chronic Neurological Conditions,0,6,1,1,2
Assam,Nalbari,Chronic Neurological Conditions,6,15,1,7,8
Assam,Nalbari,Chronic Neurological Conditions,15,35,13,4,17
Assam,Nalbari,Chronic Neurological Conditions,35,60,10,7,17
Assam,Nalbari,Chronic Neurological Conditions,60,80,5,2,7
Bihar,Nalanda,Chronic Neurological Conditions,0,6,2,2,4
Bihar,Nalanda,Chronic Neurological Conditions,6,15,8,5,13
Bihar,Nalanda,Chronic Neurological Conditions,15,35,18,5,23
Bihar,Nalanda,Chronic Neurological Conditions,35,60,13,10,23
Bihar,Nalanda,Chronic Neurological Conditions,60,80,2,1,3
Uttarakhand,Nainital,Chronic Neurological Conditions,6,15,6,6,12
Uttarakhand,Nainital,Chronic Neurological Conditions,15,35,68,30,98
Uttarakhand,Nainital,Chronic Neurological Conditions,35,60,137,32,169
Uttarakhand,Nainital,Chronic Neurological Conditions,60,80,34,8,42
Uttarakhand,Nainital,Chronic Neurological Conditions,80,100,1,1,2
Maharashtra,Nagpur,Chronic Neurological Conditions,35,60,7,2,9
Maharashtra,Nagpur,Chronic Neurological Conditions,60,80,3,2,5
Rajasthan,Nagaur,Chronic Neurological Conditions,0,6,1,0,1
Rajasthan,Nagaur,Chronic Neurological Conditions,6,15,10,12,22
Rajasthan,Nagaur,Chronic Neurological Conditions,15,35,9,8,17
Rajasthan,Nagaur,Chronic Neurological Conditions,35,60,6,2,8
Rajasthan,Nagaur,Chronic Neurological Conditions,80,100,1,1,2
Tamil Nadu,Nagapattinam,Chronic Neurological Conditions,6,15,2,0,2
Tamil Nadu,Nagapattinam,Chronic Neurological Conditions,15,35,6,2,8
Tamil Nadu,Nagapattinam,Chronic Neurological Conditions,35,60,4,5,9
Tamil Nadu,Nagapattinam,Chronic Neurological Conditions,60,80,2,0,2
Assam,Nagaon,Chronic Neurological Conditions,0,6,1,0,1
Assam,Nagaon,Chronic Neurological Conditions,15,35,3,3,6
Assam,Nagaon,Chronic Neurological Conditions,35,60,11,1,12
Odisha,Nabarangpur,Chronic Neurological Conditions,6,15,1,0,1
Odisha,Nabarangpur,Chronic Neurological Conditions,15,35,1,1,2
Odisha,Nabarangpur,Chronic Neurological Conditions,35,60,2,0,2
Karnataka,Mysuru,Chronic Neurological Conditions,0,6,2,2,4
Karnataka,Mysuru,Chronic Neurological Conditions,6,15,11,9,20
Karnataka,Mysuru,Chronic Neurological Conditions,15,35,78,40,118
Karnataka,Mysuru,Chronic Neurological Conditions,35,60,288,109,397
Karnataka,Mysuru,Chronic Neurological Conditions,60,80,74,13,87
Karnataka,Mysuru,Chronic Neurological Conditions,80,100,1,1,2
Bihar,Muzaffarpur,Chronic Neurological Conditions,15,35,8,3,11
Bihar,Muzaffarpur,Chronic Neurological Conditions,35,60,5,1,6
Bihar,Muzaffarpur,Chronic Neurological Conditions,60,80,2,0,2
Uttar Pradesh,Muzaffarnagar,Chronic Neurological Conditions,15,35,5,4,9
Uttar Pradesh,Muzaffarnagar,Chronic Neurological Conditions,35,60,8,2,10
Uttar Pradesh,Muzaffarnagar,Chronic Neurological Conditions,60,80,2,0,2
West Bengal,Murshidabad,Chronic Neurological Conditions,35,60,1,0,1
Bihar,Munger,Chronic Neurological Conditions,6,15,3,0,3
Bihar,Munger,Chronic Neurological Conditions,15,35,5,3,8
Bihar,Munger,Chronic Neurological Conditions,35,60,5,3,8
Chhattisgarh,Mungeli,Chronic Neurological Conditions,15,35,0,1,1
Chhattisgarh,Mungeli,Chronic Neurological Conditions,60,80,0,1,1
Maharashtra,Mumbai Suburban,Chronic Neurological Conditions,0,6,1,0,1
Maharashtra,Mumbai Suburban,Chronic Neurological Conditions,6,15,2,1,3
Maharashtra,Mumbai Suburban,Chronic Neurological Conditions,15,35,5,4,9
Maharashtra,Mumbai Suburban,Chronic Neurological Conditions,35,60,9,3,12
Maharashtra,Mumbai Suburban,Chronic Neurological Conditions,60,80,2,0,2
Maharashtra,Mumbai,Chronic Neurological Conditions,0,6,0,1,1
Maharashtra,Mumbai,Chronic Neurological Conditions,6,15,12,8,20
Maharashtra,Mumbai,Chronic Neurological Conditions,15,35,76,35,111
Maharashtra,Mumbai,Chronic Neurological Conditions,35,60,221,50,271
Maharashtra,Mumbai,Chronic Neurological Conditions,60,80,76,9,85
Maharashtra,Mumbai,Chronic Neurological Conditions,80,100,5,2,7
Madhya Pradesh,Morena,Chronic Neurological Conditions,6,15,3,2,5
Madhya Pradesh,Morena,Chronic Neurological Conditions,15,35,21,3,24
Madhya Pradesh,Morena,Chronic Neurological Conditions,35,60,16,5,21
Madhya Pradesh,Morena,Chronic Neurological Conditions,60,80,3,0,3
Uttar Pradesh,Moradabad,Chronic Neurological Conditions,6,15,1,0,1
Uttar Pradesh,Moradabad,Chronic Neurological Conditions,15,35,3,1,4
Nagaland,Mokokchung,Chronic Neurological Conditions,6,15,0,1,1
Nagaland,Mokokchung,Chronic Neurological Conditions,60,80,0,1,1
Nagaland,Mokokchung,Chronic Neurological Conditions,80,100,0,1,1
Punjab,Moga,Chronic Neurological Conditions,6,15,1,2,3
Punjab,Moga,Chronic Neurological Conditions,15,35,2,2,4
Punjab,Moga,Chronic Neurological Conditions,35,60,19,4,23
Punjab,Moga,Chronic Neurological Conditions,60,80,6,0,6
Uttar Pradesh,Mirzapur,Chronic Neurological Conditions,6,15,0,2,2
Uttar Pradesh,Mirzapur,Chronic Neurological Conditions,15,35,3,2,5
Uttar Pradesh,Mirzapur,Chronic Neurological Conditions,35,60,9,3,12
Uttar Pradesh,Meerut,Chronic Neurological Conditions,6,15,0,1,1
Uttar Pradesh,Meerut,Chronic Neurological Conditions,15,35,2,2,4
Uttar Pradesh,Meerut,Chronic Neurological Conditions,35,60,8,1,9
Odisha,Mayurbhanj,Chronic Neurological Conditions,0,6,5,3,8
Odisha,Mayurbhanj,Chronic Neurological Conditions,6,15,26,27,53
Odisha,Mayurbhanj,Chronic Neurological Conditions,15,35,138,60,198
Odisha,Mayurbhanj,Chronic Neurological Conditions,35,60,668,288,956
Odisha,Mayurbhanj,Chronic Neurological Conditions,60,80,279,115,394
Odisha,Mayurbhanj,Chronic Neurological Conditions,80,100,15,4,19
Tamil Nadu,Mayiladuthurai,Chronic Neurological Conditions,0,6,1,0,1
Tamil Nadu,Mayiladuthurai,Chronic Neurological Conditions,6,15,1,1,2
Tamil Nadu,Mayiladuthurai,Chronic Neurological Conditions,15,35,0,1,1
Tamil Nadu,Mayiladuthurai,Chronic Neurological Conditions,35,60,2,2,4
Uttar Pradesh,Mau,Chronic Neurological Conditions,15,35,13,5,18
Uttar Pradesh,Mau,Chronic Neurological Conditions,35,60,30,8,38
Uttar Pradesh,Mau,Chronic Neurological Conditions,60,80,5,2,7
Uttar Pradesh,Mathura,Chronic Neurological Conditions,15,35,2,0,2
Uttar Pradesh,Mathura,Chronic Neurological Conditions,35,60,1,0,1
Uttar Pradesh,Mathura,Chronic Neurological Conditions,60,80,1,0,1
Assam,Marigaon,Chronic Neurological Conditions,0,6,1,0,1
Assam,Marigaon,Chronic Neurological Conditions,6,15,5,0,5
Assam,Marigaon,Chronic Neurological Conditions,15,35,7,5,12
Assam,Marigaon,Chronic Neurological Conditions,35,60,13,6,19
Assam,Marigaon,Chronic Neurological Conditions,60,80,2,1,3
Punjab,Mansa,Chronic Neurological Conditions,0,6,2,0,2
Punjab,Mansa,Chronic Neurological Conditions,6,15,3,1,4
Punjab,Mansa,Chronic Neurological Conditions,15,35,36,8,44
Punjab,Mansa,Chronic Neurological Conditions,35,60,102,34,136
Punjab,Mansa,Chronic Neurological Conditions,60,80,37,3,40
Punjab,Mansa,Chronic Neurological Conditions,80,100,0,1,1
Karnataka,Mandya,Chronic Neurological Conditions,0,6,5,0,5
Karnataka,Mandya,Chronic Neurological Conditions,6,15,34,21,55
Karnataka,Mandya,Chronic Neurological Conditions,15,35,143,97,240
Karnataka,Mandya,Chronic Neurological Conditions,35,60,544,177,721
Karnataka,Mandya,Chronic Neurological Conditions,60,80,219,32,251
Karnataka,Mandya,Chronic Neurological Conditions,80,100,6,0,6
Madhya Pradesh,Mandla,Chronic Neurological Conditions,6,15,0,1,1
Madhya Pradesh,Mandla,Chronic Neurological Conditions,15,35,3,1,4
Madhya Pradesh,Mandla,Chronic Neurological Conditions,35,60,1,1,2
Madhya Pradesh,Mandla,Chronic Neurological Conditions,60,80,2,0,2
Madhya Pradesh,Mandla,Chronic Neurological Conditions,80,100,0,1,1
Himachal Pradesh,Mandi,Chronic Neurological Conditions,0,6,3,4,7
Himachal Pradesh,Mandi,Chronic Neurological Conditions,6,15,14,7,21
Himachal Pradesh,Mandi,Chronic Neurological Conditions,15,35,34,13,47
Himachal Pradesh,Mandi,Chronic Neurological Conditions,35,60,68,30,98
Himachal Pradesh,Mandi,Chronic Neurological Conditions,60,80,29,11,40
Himachal Pradesh,Mandi,Chronic Neurological Conditions,80,100,5,2,7
Mizoram,Mamit,Chronic Neurological Conditions,6,15,0,1,1
Mizoram,Mamit,Chronic Neurological Conditions,15,35,2,0,2
Mizoram,Mamit,Chronic Neurological Conditions,35,60,1,0,1
Mizoram,Mamit,Chronic Neurological Conditions,60,80,0,1,1
Odisha,Malkangiri,Chronic Neurological Conditions,6,15,0,1,1
Odisha,Malkangiri,Chronic Neurological Conditions,15,35,4,4,8
Odisha,Malkangiri,Chronic Neurological Conditions,35,60,14,5,19
Punjab,Malerkotla,Chronic Neurological Conditions,6,15,2,2,4
Punjab,Malerkotla,Chronic Neurological Conditions,15,35,4,0,4
Punjab,Malerkotla,Chronic Neurological Conditions,35,60,12,6,18
Punjab,Malerkotla,Chronic Neurological Conditions,60,80,3,0,3
Kerala,Malappuram,Chronic Neurological Conditions,0,6,10,9,19
Kerala,Malappuram,Chronic Neurological Conditions,6,15,12,14,26
Kerala,Malappuram,Chronic Neurological Conditions,15,35,30,16,46
Kerala,Malappuram,Chronic Neurological Conditions,35,60,86,31,117
Kerala,Malappuram,Chronic Neurological Conditions,60,80,22,4,26
Kerala,Malappuram,Chronic Neurological Conditions,80,100,1,0,1
Assam,Majuli,Chronic Neurological Conditions,15,35,1,1,2
Assam,Majuli,Chronic Neurological Conditions,35,60,2,3,5
Uttar Pradesh,Mainpuri,Chronic Neurological Conditions,6,15,3,2,5
Uttar Pradesh,Mainpuri,Chronic Neurological Conditions,15,35,5,2,7
Uttar Pradesh,Mainpuri,Chronic Neurological Conditions,35,60,7,1,8
Uttar Pradesh,Mainpuri,Chronic Neurological Conditions,60,80,1,1,2
Uttar Pradesh,Mahoba,Chronic Neurological Conditions,6,15,1,0,1
Uttar Pradesh,Mahoba,Chronic Neurological Conditions,15,35,4,4,8
Uttar Pradesh,Mahoba,Chronic Neurological Conditions,35,60,10,5,15
Uttar Pradesh,Mahoba,Chronic Neurological Conditions,60,80,8,0,8
Gujarat,Mahesana,Chronic Neurological Conditions,15,35,1,0,1
Gujarat,Mahesana,Chronic Neurological Conditions,35,60,6,0,6
Haryana,Mahendragarh,Chronic Neurological Conditions,6,15,1,0,1
Haryana,Mahendragarh,Chronic Neurological Conditions,15,35,7,1,8
Haryana,Mahendragarh,Chronic Neurological Conditions,35,60,6,1,7
Haryana,Mahendragarh,Chronic Neurological Conditions,60,80,2,0,2
Puducherry,Mahe,Chronic Neurological Conditions,6,15,0,1,1
Chhattisgarh,Mahasamund,Chronic Neurological Conditions,35,60,1,0,1
Uttar Pradesh,Maharajganj,Chronic Neurological Conditions,15,35,5,0,5
Uttar Pradesh,Maharajganj,Chronic Neurological Conditions,35,60,3,2,5
Uttar Pradesh,Maharajganj,Chronic Neurological Conditions,60,80,2,1,3
Tamil Nadu,Madurai,Chronic Neurological Conditions,0,6,0,3,3
Tamil Nadu,Madurai,Chronic Neurological Conditions,6,15,4,4,8
Tamil Nadu,Madurai,Chronic Neurological Conditions,15,35,12,6,18
Tamil Nadu,Madurai,Chronic Neurological Conditions,35,60,31,8,39
Tamil Nadu,Madurai,Chronic Neurological Conditions,60,80,9,1,10
Tamil Nadu,Madurai,Chronic Neurological Conditions,80,100,1,0,1
Bihar,Madhubani,Chronic Neurological Conditions,6,15,1,0,1
Bihar,Madhubani,Chronic Neurological Conditions,15,35,10,3,13
Bihar,Madhubani,Chronic Neurological Conditions,35,60,7,3,10
Bihar,Madhubani,Chronic Neurological Conditions,60,80,1,1,2
Bihar,Madhepura,Chronic Neurological Conditions,0,6,0,1,1
Bihar,Madhepura,Chronic Neurological Conditions,6,15,0,3,3
Bihar,Madhepura,Chronic Neurological Conditions,15,35,6,2,8
Bihar,Madhepura,Chronic Neurological Conditions,35,60,4,3,7
Bihar,Madhepura,Chronic Neurological Conditions,60,80,2,3,5
Mizoram,Lunglei,Chronic Neurological Conditions,15,35,2,1,3
Mizoram,Lunglei,Chronic Neurological Conditions,35,60,1,1,2
Punjab,Ludhiana,Chronic Neurological Conditions,0,6,0,2,2
Punjab,Ludhiana,Chronic Neurological Conditions,6,15,14,6,20
Punjab,Ludhiana,Chronic Neurological Conditions,15,35,158,85,243
Punjab,Ludhiana,Chronic Neurological Conditions,35,60,546,137,683
Punjab,Ludhiana,Chronic Neurological Conditions,60,80,213,25,238
Punjab,Ludhiana,Chronic Neurological Conditions,80,100,7,5,12
Uttar Pradesh,Lucknow,Chronic Neurological Conditions,6,15,1,2,3
Uttar Pradesh,Lucknow,Chronic Neurological Conditions,15,35,37,16,53
Uttar Pradesh,Lucknow,Chronic Neurological Conditions,35,60,45,18,63
Uttar Pradesh,Lucknow,Chronic Neurological Conditions,60,80,14,1,15
Arunachal Pradesh,Lower Dibang Valley,Chronic Neurological Conditions,15,35,1,0,1
Arunachal Pradesh,Lower Dibang Valley,Chronic Neurological Conditions,35,60,0,4,4
Arunachal Pradesh,Lower Dibang Valley,Chronic Neurological Conditions,60,80,2,1,3
Arunachal Pradesh,Lower Dibang Valley,Chronic Neurological Conditions,80,100,0,1,1
Jharkhand,Lohardaga,Chronic Neurological Conditions,6,15,1,1,2
Jharkhand,Lohardaga,Chronic Neurological Conditions,15,35,6,1,7
Jharkhand,Lohardaga,Chronic Neurological Conditions,35,60,6,2,8
Jharkhand,Lohardaga,Chronic Neurological Conditions,60,80,3,0,3
Ladakh,Leh Ladakh,Chronic Neurological Conditions,15,35,4,4,8
Ladakh,Leh Ladakh,Chronic Neurological Conditions,35,60,8,1,9
Ladakh,Leh Ladakh,Chronic Neurological Conditions,60,80,0,1,1
Maharashtra,Latur,Chronic Neurological Conditions,6,15,1,1,2
Maharashtra,Latur,Chronic Neurological Conditions,15,35,9,12,21
Maharashtra,Latur,Chronic Neurological Conditions,35,60,36,10,46
Maharashtra,Latur,Chronic Neurological Conditions,60,80,11,3,14
Jharkhand,Latehar,Chronic Neurological Conditions,6,15,0,2,2
Jharkhand,Latehar,Chronic Neurological Conditions,60,80,2,0,2
Uttar Pradesh,Lalitpur,Chronic Neurological Conditions,15,35,8,1,9
Uttar Pradesh,Lalitpur,Chronic Neurological Conditions,35,60,4,0,4
Uttar Pradesh,Lalitpur,Chronic Neurological Conditions,60,80,1,0,1
Lakshadweep,Lakshadweep District,Chronic Neurological Conditions,6,15,1,0,1
Lakshadweep,Lakshadweep District,Chronic Neurological Conditions,60,80,0,1,1
Bihar,Lakhisarai,Chronic Neurological Conditions,0,6,0,1,1
Bihar,Lakhisarai,Chronic Neurological Conditions,6,15,2,0,2
Bihar,Lakhisarai,Chronic Neurological Conditions,15,35,2,3,5
Bihar,Lakhisarai,Chronic Neurological Conditions,35,60,8,0,8
Bihar,Lakhisarai,Chronic Neurological Conditions,60,80,1,0,1
Assam,Lakhimpur,Chronic Neurological Conditions,6,15,1,0,1
Assam,Lakhimpur,Chronic Neurological Conditions,15,35,3,0,3
Assam,Lakhimpur,Chronic Neurological Conditions,35,60,4,1,5
Assam,Lakhimpur,Chronic Neurological Conditions,60,80,1,0,1
Uttar Pradesh,Kushi Nagar,Chronic Neurological Conditions,6,15,4,3,7
Uttar Pradesh,Kushi Nagar,Chronic Neurological Conditions,15,35,34,15,49
Uttar Pradesh,Kushi Nagar,Chronic Neurological Conditions,35,60,77,13,90
Uttar Pradesh,Kushi Nagar,Chronic Neurological Conditions,60,80,27,3,30
Haryana,Kurukshetra,Chronic Neurological Conditions,15,35,0,1,1
Haryana,Kurukshetra,Chronic Neurological Conditions,35,60,4,0,4
Andhra Pradesh,Kurnool,Chronic Neurological Conditions,15,35,3,0,3
Andhra Pradesh,Kurnool,Chronic Neurological Conditions,35,60,2,1,3
Andhra Pradesh,Kurnool,Chronic Neurological Conditions,60,80,1,0,1
Jammu And Kashmir,Kupwara,Chronic Neurological Conditions,0,6,17,15,32
Jammu And Kashmir,Kupwara,Chronic Neurological Conditions,6,15,47,33,80
Jammu And Kashmir,Kupwara,Chronic Neurological Conditions,15,35,85,101,186
Jammu And Kashmir,Kupwara,Chronic Neurological Conditions,35,60,90,122,212
Jammu And Kashmir,Kupwara,Chronic Neurological Conditions,60,80,15,14,29
Jammu And Kashmir,Kupwara,Chronic Neurological Conditions,80,100,4,2,6
Himachal Pradesh,Kullu,Chronic Neurological Conditions,6,15,2,0,2
Himachal Pradesh,Kullu,Chronic Neurological Conditions,15,35,1,1,2
Himachal Pradesh,Kullu,Chronic Neurological Conditions,35,60,1,0,1
Jammu And Kashmir,Kulgam,Chronic Neurological Conditions,0,6,11,4,15
Jammu And Kashmir,Kulgam,Chronic Neurological Conditions,6,15,40,26,66
Jammu And Kashmir,Kulgam,Chronic Neurological Conditions,15,35,102,77,179
Jammu And Kashmir,Kulgam,Chronic Neurological Conditions,35,60,88,44,132
Jammu And Kashmir,Kulgam,Chronic Neurological Conditions,60,80,20,13,33
Jammu And Kashmir,Kulgam,Chronic Neurological Conditions,80,100,1,2,3
Tamil Nadu,Krishnagiri,Chronic Neurological Conditions,6,15,3,0,3
Tamil Nadu,Krishnagiri,Chronic Neurological Conditions,15,35,9,2,11
Tamil Nadu,Krishnagiri,Chronic Neurological Conditions,35,60,10,1,11
Tamil Nadu,Krishnagiri,Chronic Neurological Conditions,60,80,6,0,6
Tamil Nadu,Krishnagiri,Chronic Neurological Conditions,80,100,0,1,1
Kerala,Kozhikode,Chronic Neurological Conditions,0,6,2,2,4
Kerala,Kozhikode,Chronic Neurological Conditions,6,15,11,11,22
Kerala,Kozhikode,Chronic Neurological Conditions,15,35,35,13,48
Kerala,Kozhikode,Chronic Neurological Conditions,35,60,97,34,131
Kerala,Kozhikode,Chronic Neurological Conditions,60,80,41,14,55
Kerala,Kozhikode,Chronic Neurological Conditions,80,100,2,1,3
Kerala,Kottayam,Chronic Neurological Conditions,0,6,2,2,4
Kerala,Kottayam,Chronic Neurological Conditions,6,15,2,2,4
Kerala,Kottayam,Chronic Neurological Conditions,15,35,15,8,23
Kerala,Kottayam,Chronic Neurological Conditions,35,60,23,10,33
Kerala,Kottayam,Chronic Neurological Conditions,60,80,10,2,12
Rajasthan,Kota,Chronic Neurological Conditions,6,15,12,1,13
Rajasthan,Kota,Chronic Neurological Conditions,15,35,32,13,45
Rajasthan,Kota,Chronic Neurological Conditions,35,60,43,16,59
Rajasthan,Kota,Chronic Neurological Conditions,60,80,14,6,20
Rajasthan,Kota,Chronic Neurological Conditions,80,100,0,1,1
Chhattisgarh,Korba,Chronic Neurological Conditions,15,35,1,0,1
Chhattisgarh,Korba,Chronic Neurological Conditions,35,60,1,1,2
Odisha,Koraput,Chronic Neurological Conditions,15,35,1,0,1
Odisha,Koraput,Chronic Neurological Conditions,35,60,5,1,6
Karnataka,Koppal,Chronic Neurological Conditions,6,15,0,1,1
Karnataka,Koppal,Chronic Neurological Conditions,15,35,2,1,3
Karnataka,Koppal,Chronic Neurological Conditions,35,60,3,1,4
Karnataka,Koppal,Chronic Neurological Conditions,60,80,2,0,2
Chhattisgarh,Kondagaon,Chronic Neurological Conditions,15,35,1,0,1
Kerala,Kollam,Chronic Neurological Conditions,0,6,0,2,2
Kerala,Kollam,Chronic Neurological Conditions,6,15,6,7,13
Kerala,Kollam,Chronic Neurological Conditions,15,35,27,14,41
Kerala,Kollam,Chronic Neurological Conditions,35,60,43,26,69
Kerala,Kollam,Chronic Neurological Conditions,60,80,8,10,18
Kerala,Kollam,Chronic Neurological Conditions,80,100,2,0,2
Maharashtra,Kolhapur,Chronic Neurological Conditions,6,15,2,1,3
Maharashtra,Kolhapur,Chronic Neurological Conditions,15,35,2,3,5
Maharashtra,Kolhapur,Chronic Neurological Conditions,35,60,7,1,8
Mizoram,Kolasib,Chronic Neurological Conditions,6,15,0,4,4
Mizoram,Kolasib,Chronic Neurological Conditions,15,35,3,0,3
Mizoram,Kolasib,Chronic Neurological Conditions,35,60,5,1,6
Mizoram,Kolasib,Chronic Neurological Conditions,60,80,1,0,1
Karnataka,Kolar,Chronic Neurological Conditions,0,6,2,2,4
Karnataka,Kolar,Chronic Neurological Conditions,6,15,18,11,29
Karnataka,Kolar,Chronic Neurological Conditions,15,35,78,54,132
Karnataka,Kolar,Chronic Neurological Conditions,35,60,265,95,360
Karnataka,Kolar,Chronic Neurological Conditions,60,80,107,10,117
Karnataka,Kolar,Chronic Neurological Conditions,80,100,4,0,4
Assam,Kokrajhar,Chronic Neurological Conditions,15,35,2,0,2
Nagaland,Kohima,Chronic Neurological Conditions,6,15,0,1,1
Nagaland,Kohima,Chronic Neurological Conditions,15,35,0,5,5
Nagaland,Kohima,Chronic Neurological Conditions,35,60,3,1,4
Nagaland,Kohima,Chronic Neurological Conditions,60,80,1,0,1
Jharkhand,Koderma,Chronic Neurological Conditions,6,15,2,0,2
Jharkhand,Koderma,Chronic Neurological Conditions,15,35,8,3,11
Jharkhand,Koderma,Chronic Neurological Conditions,35,60,6,3,9
Jharkhand,Koderma,Chronic Neurological Conditions,60,80,1,0,1
Karnataka,Kodagu,Chronic Neurological Conditions,6,15,1,0,1
Karnataka,Kodagu,Chronic Neurological Conditions,15,35,0,1,1
Karnataka,Kodagu,Chronic Neurological Conditions,35,60,10,1,11
Karnataka,Kodagu,Chronic Neurological Conditions,60,80,2,0,2
Jammu And Kashmir,Kishtwar,Chronic Neurological Conditions,0,6,2,0,2
Jammu And Kashmir,Kishtwar,Chronic Neurological Conditions,6,15,3,1,4
Jammu And Kashmir,Kishtwar,Chronic Neurological Conditions,15,35,6,3,9
Jammu And Kashmir,Kishtwar,Chronic Neurological Conditions,35,60,3,1,4
Bihar,Kishanganj,Chronic Neurological Conditions,6,15,3,0,3
Bihar,Kishanganj,Chronic Neurological Conditions,15,35,9,1,10
Bihar,Kishanganj,Chronic Neurological Conditions,35,60,4,2,6
Himachal Pradesh,Kinnaur,Chronic Neurological Conditions,15,35,2,0,2
Himachal Pradesh,Kinnaur,Chronic Neurological Conditions,35,60,1,0,1
Jharkhand,Khunti,Chronic Neurological Conditions,6,15,1,0,1
Jharkhand,Khunti,Chronic Neurological Conditions,15,35,5,4,9
Jharkhand,Khunti,Chronic Neurological Conditions,35,60,1,4,5
Jharkhand,Khunti,Chronic Neurological Conditions,60,80,1,0,1
Odisha,Khordha,Chronic Neurological Conditions,6,15,1,2,3
Odisha,Khordha,Chronic Neurological Conditions,15,35,10,5,15
Odisha,Khordha,Chronic Neurological Conditions,35,60,38,8,46
Odisha,Khordha,Chronic Neurological Conditions,60,80,12,2,14
Odisha,Khordha,Chronic Neurological Conditions,80,100,2,2,4
Uttar Pradesh,Kheri,Chronic Neurological Conditions,6,15,1,2,3
Uttar Pradesh,Kheri,Chronic Neurological Conditions,15,35,20,7,27
Uttar Pradesh,Kheri,Chronic Neurological Conditions,35,60,33,6,39
Uttar Pradesh,Kheri,Chronic Neurological Conditions,60,80,9,2,11
Gujarat,Kheda,Chronic Neurological Conditions,35,60,1,0,1
Gujarat,Kheda,Chronic Neurological Conditions,60,80,1,0,1
Mizoram,Khawzawl,Chronic Neurological Conditions,35,60,0,1,1
Madhya Pradesh,Khargone,Chronic Neurological Conditions,0,6,1,0,1
Madhya Pradesh,Khargone,Chronic Neurological Conditions,6,15,4,2,6
Madhya Pradesh,Khargone,Chronic Neurological Conditions,15,35,6,3,9
Madhya Pradesh,Khargone,Chronic Neurological Conditions,35,60,2,0,2
Madhya Pradesh,Khargone,Chronic Neurological Conditions,60,80,1,0,1
Bihar,Khagaria,Chronic Neurological Conditions,6,15,0,1,1
Bihar,Khagaria,Chronic Neurological Conditions,15,35,2,1,3
Bihar,Khagaria,Chronic Neurological Conditions,35,60,1,0,1
Bihar,Khagaria,Chronic Neurological Conditions,60,80,1,0,1
Odisha,Kendujhar,Chronic Neurological Conditions,0,6,2,0,2
Odisha,Kendujhar,Chronic Neurological Conditions,15,35,1,0,1
Odisha,Kendujhar,Chronic Neurological Conditions,35,60,0,1,1
Odisha,Kendujhar,Chronic Neurological Conditions,60,80,1,0,1
Odisha,Kendrapara,Chronic Neurological Conditions,0,6,0,1,1
Odisha,Kendrapara,Chronic Neurological Conditions,6,15,5,2,7
Odisha,Kendrapara,Chronic Neurological Conditions,15,35,9,10,19
Odisha,Kendrapara,Chronic Neurological Conditions,35,60,18,6,24
Odisha,Kendrapara,Chronic Neurological Conditions,60,80,10,8,18
Odisha,Kendrapara,Chronic Neurological Conditions,80,100,1,0,1
Uttar Pradesh,Kaushambi,Chronic Neurological Conditions,15,35,7,1,8
Uttar Pradesh,Kaushambi,Chronic Neurological Conditions,35,60,7,1,8
Uttar Pradesh,Kaushambi,Chronic Neurological Conditions,60,80,4,1,5
Madhya Pradesh,Katni,Chronic Neurological Conditions,0,6,1,2,3
Madhya Pradesh,Katni,Chronic Neurological Conditions,6,15,3,5,8
Madhya Pradesh,Katni,Chronic Neurological Conditions,15,35,73,26,99
Madhya Pradesh,Katni,Chronic Neurological Conditions,35,60,331,98,429
Madhya Pradesh,Katni,Chronic Neurological Conditions,60,80,153,28,181
Madhya Pradesh,Katni,Chronic Neurological Conditions,80,100,3,0,3
Bihar,Katihar,Chronic Neurological Conditions,15,35,3,0,3
Bihar,Katihar,Chronic Neurological Conditions,35,60,4,2,6
Jammu And Kashmir,Kathua,Chronic Neurological Conditions,0,6,1,0,1
Jammu And Kashmir,Kathua,Chronic Neurological Conditions,6,15,2,3,5
Jammu And Kashmir,Kathua,Chronic Neurological Conditions,15,35,13,6,19
Jammu And Kashmir,Kathua,Chronic Neurological Conditions,35,60,34,4,38
Jammu And Kashmir,Kathua,Chronic Neurological Conditions,60,80,9,1,10
Jammu And Kashmir,Kathua,Chronic Neurological Conditions,80,100,1,0,1
Uttar Pradesh,Kasganj,Chronic Neurological Conditions,6,15,1,0,1
Uttar Pradesh,Kasganj,Chronic Neurological Conditions,15,35,4,1,5
Uttar Pradesh,Kasganj,Chronic Neurological Conditions,35,60,7,2,9
Uttar Pradesh,Kasganj,Chronic Neurological Conditions,60,80,3,0,3
Kerala,Kasaragod,Chronic Neurological Conditions,0,6,9,7,16
Kerala,Kasaragod,Chronic Neurological Conditions,6,15,11,5,16
Kerala,Kasaragod,Chronic Neurological Conditions,15,35,6,5,11
Kerala,Kasaragod,Chronic Neurological Conditions,35,60,46,18,64
Kerala,Kasaragod,Chronic Neurological Conditions,60,80,9,3,12
Kerala,Kasaragod,Chronic Neurological Conditions,80,100,1,0,1
Tamil Nadu,Karur,Chronic Neurological Conditions,0,6,1,0,1
Tamil Nadu,Karur,Chronic Neurological Conditions,6,15,1,4,5
Tamil Nadu,Karur,Chronic Neurological Conditions,15,35,3,7,10
Tamil Nadu,Karur,Chronic Neurological Conditions,35,60,27,14,41
Tamil Nadu,Karur,Chronic Neurological Conditions,60,80,14,2,16
Haryana,Karnal,Chronic Neurological Conditions,0,6,1,0,1
Haryana,Karnal,Chronic Neurological Conditions,6,15,1,3,4
Haryana,Karnal,Chronic Neurological Conditions,15,35,11,3,14
Haryana,Karnal,Chronic Neurological Conditions,35,60,10,4,14
Haryana,Karnal,Chronic Neurological Conditions,60,80,5,1,6
Assam,Karimganj,Chronic Neurological Conditions,6,15,0,2,2
Assam,Karimganj,Chronic Neurological Conditions,15,35,3,5,8
Assam,Karimganj,Chronic Neurological Conditions,35,60,16,2,18
Assam,Karimganj,Chronic Neurological Conditions,60,80,6,0,6
Assam,Karbi Anglong,Chronic Neurological Conditions,6,15,0,1,1
Assam,Karbi Anglong,Chronic Neurological Conditions,15,35,1,0,1
Rajasthan,Karauli,Chronic Neurological Conditions,15,35,0,1,1
Puducherry,Karaikal,Chronic Neurological Conditions,6,15,0,1,1
Puducherry,Karaikal,Chronic Neurological Conditions,15,35,1,0,1
Puducherry,Karaikal,Chronic Neurological Conditions,35,60,1,0,1
Puducherry,Karaikal,Chronic Neurological Conditions,60,80,3,0,3
Punjab,Kapurthala,Chronic Neurological Conditions,6,15,3,2,5
Punjab,Kapurthala,Chronic Neurological Conditions,15,35,20,9,29
Punjab,Kapurthala,Chronic Neurological Conditions,35,60,59,14,73
Punjab,Kapurthala,Chronic Neurological Conditions,60,80,30,2,32
Uttar Pradesh,Kanpur Nagar,Chronic Neurological Conditions,6,15,1,1,2
Uttar Pradesh,Kanpur Nagar,Chronic Neurological Conditions,15,35,4,2,6
Uttar Pradesh,Kanpur Nagar,Chronic Neurological Conditions,35,60,18,3,21
Uttar Pradesh,Kanpur Nagar,Chronic Neurological Conditions,60,80,6,1,7
Uttar Pradesh,Kanpur Dehat,Chronic Neurological Conditions,15,35,4,1,5
Uttar Pradesh,Kanpur Dehat,Chronic Neurological Conditions,35,60,5,0,5
Kerala,Kannur,Chronic Neurological Conditions,0,6,2,2,4
Kerala,Kannur,Chronic Neurological Conditions,6,15,28,11,39
Kerala,Kannur,Chronic Neurological Conditions,15,35,46,29,75
Kerala,Kannur,Chronic Neurological Conditions,35,60,96,60,156
Kerala,Kannur,Chronic Neurological Conditions,60,80,53,25,78
Kerala,Kannur,Chronic Neurological Conditions,80,100,3,0,3
Tamil Nadu,Kanniyakumari,Chronic Neurological Conditions,6,15,2,0,2
Tamil Nadu,Kanniyakumari,Chronic Neurological Conditions,15,35,4,1,5
Tamil Nadu,Kanniyakumari,Chronic Neurological Conditions,35,60,11,2,13
Tamil Nadu,Kanniyakumari,Chronic Neurological Conditions,80,100,0,1,1
Uttar Pradesh,Kannauj,Chronic Neurological Conditions,6,15,1,0,1
Uttar Pradesh,Kannauj,Chronic Neurological Conditions,15,35,1,1,2
Uttar Pradesh,Kannauj,Chronic Neurological Conditions,35,60,0,2,2
Uttar Pradesh,Kannauj,Chronic Neurological Conditions,60,80,1,0,1
Chhattisgarh,Kanker,Chronic Neurological Conditions,6,15,2,0,2
Chhattisgarh,Kanker,Chronic Neurological Conditions,15,35,11,4,15
Chhattisgarh,Kanker,Chronic Neurological Conditions,35,60,7,10,17
Chhattisgarh,Kanker,Chronic Neurological Conditions,60,80,1,1,2
Himachal Pradesh,Kangra,Chronic Neurological Conditions,0,6,2,0,2
Himachal Pradesh,Kangra,Chronic Neurological Conditions,6,15,5,5,10
Himachal Pradesh,Kangra,Chronic Neurological Conditions,15,35,18,2,20
Himachal Pradesh,Kangra,Chronic Neurological Conditions,35,60,65,16,81
Himachal Pradesh,Kangra,Chronic Neurological Conditions,60,80,39,14,53
Himachal Pradesh,Kangra,Chronic Neurological Conditions,80,100,3,2,5
Manipur,Kangpokpi,Chronic Neurological Conditions,6,15,1,0,1
Manipur,Kangpokpi,Chronic Neurological Conditions,15,35,1,0,1
Manipur,Kangpokpi,Chronic Neurological Conditions,35,60,1,2,3
Manipur,Kangpokpi,Chronic Neurological Conditions,60,80,0,1,1
Odisha,Kandhamal,Chronic Neurological Conditions,0,6,1,0,1
Odisha,Kandhamal,Chronic Neurological Conditions,6,15,4,0,4
Odisha,Kandhamal,Chronic Neurological Conditions,15,35,0,3,3
Odisha,Kandhamal,Chronic Neurological Conditions,35,60,2,1,3
Odisha,Kandhamal,Chronic Neurological Conditions,60,80,2,1,3
Tamil Nadu,Kanchipuram,Chronic Neurological Conditions,0,6,0,1,1
Tamil Nadu,Kanchipuram,Chronic Neurological Conditions,6,15,2,0,2
Tamil Nadu,Kanchipuram,Chronic Neurological Conditions,15,35,0,1,1
Tamil Nadu,Kanchipuram,Chronic Neurological Conditions,35,60,12,4,16
Tamil Nadu,Kanchipuram,Chronic Neurological Conditions,60,80,7,1,8
Assam,Kamrup Metro,Chronic Neurological Conditions,0,6,0,1,1
Assam,Kamrup Metro,Chronic Neurological Conditions,15,35,4,2,6
Assam,Kamrup Metro,Chronic Neurological Conditions,35,60,4,0,4
Assam,Kamrup,Chronic Neurological Conditions,6,15,0,1,1
Assam,Kamrup,Chronic Neurological Conditions,15,35,3,1,4
Assam,Kamrup,Chronic Neurological Conditions,35,60,2,0,2
Tamil Nadu,Kallakurichi,Chronic Neurological Conditions,6,15,1,0,1
Tamil Nadu,Kallakurichi,Chronic Neurological Conditions,15,35,1,0,1
Tamil Nadu,Kallakurichi,Chronic Neurological Conditions,35,60,5,1,6
Tamil Nadu,Kallakurichi,Chronic Neurological Conditions,60,80,2,0,2
Odisha,Kalahandi,Chronic Neurological Conditions,15,35,1,0,1
Odisha,Kalahandi,Chronic Neurological Conditions,35,60,0,3,3
Odisha,Kalahandi,Chronic Neurological Conditions,60,80,0,1,1
Karnataka,Kalaburagi,Chronic Neurological Conditions,0,6,1,0,1
Karnataka,Kalaburagi,Chronic Neurological Conditions,6,15,4,1,5
Karnataka,Kalaburagi,Chronic Neurological Conditions,15,35,96,32,128
Karnataka,Kalaburagi,Chronic Neurological Conditions,35,60,305,51,356
Karnataka,Kalaburagi,Chronic Neurological Conditions,60,80,79,4,83
Karnataka,Kalaburagi,Chronic Neurological Conditions,80,100,2,0,2
Manipur,Kakching,Chronic Neurological Conditions,60,80,1,0,1
Haryana,Kaithal,Chronic Neurological Conditions,0,6,0,2,2
Haryana,Kaithal,Chronic Neurological Conditions,6,15,5,1,6
Haryana,Kaithal,Chronic Neurological Conditions,15,35,33,11,44
Haryana,Kaithal,Chronic Neurological Conditions,35,60,123,33,156
Haryana,Kaithal,Chronic Neurological Conditions,60,80,15,3,18
Haryana,Kaithal,Chronic Neurological Conditions,80,100,1,0,1
Bihar,Kaimur (Bhabua),Chronic Neurological Conditions,6,15,1,0,1
Bihar,Kaimur (Bhabua),Chronic Neurological Conditions,15,35,15,4,19
Bihar,Kaimur (Bhabua),Chronic Neurological Conditions,35,60,17,7,24
Bihar,Kaimur (Bhabua),Chronic Neurological Conditions,60,80,3,0,3
Gujarat,Kachchh,Chronic Neurological Conditions,15,35,2,0,2
Gujarat,Kachchh,Chronic Neurological Conditions,35,60,3,0,3
Chhattisgarh,Kabirdham,Chronic Neurological Conditions,15,35,1,0,1
Gujarat,Junagadh,Chronic Neurological Conditions,15,35,1,0,1
Assam,Jorhat,Chronic Neurological Conditions,0,6,1,0,1
Assam,Jorhat,Chronic Neurological Conditions,6,15,1,1,2
Assam,Jorhat,Chronic Neurological Conditions,15,35,13,9,22
Assam,Jorhat,Chronic Neurological Conditions,35,60,16,4,20
Assam,Jorhat,Chronic Neurological Conditions,60,80,2,0,2
Assam,Jorhat,Chronic Neurological Conditions,80,100,1,0,1
Rajasthan,Jodhpur,Chronic Neurological Conditions,6,15,1,0,1
Rajasthan,Jodhpur,Chronic Neurological Conditions,15,35,6,3,9
Rajasthan,Jodhpur,Chronic Neurological Conditions,35,60,16,1,17
Rajasthan,Jodhpur,Chronic Neurological Conditions,60,80,0,1,1
Haryana,Jind,Chronic Neurological Conditions,6,15,1,1,2
Haryana,Jind,Chronic Neurological Conditions,15,35,179,95,274
Haryana,Jind,Chronic Neurological Conditions,35,60,572,274,846
Haryana,Jind,Chronic Neurological Conditions,60,80,29,13,42
Haryana,Jind,Chronic Neurological Conditions,80,100,1,1,2
Rajasthan,Jhunjhunu,Chronic Neurological Conditions,6,15,1,2,3
Rajasthan,Jhunjhunu,Chronic Neurological Conditions,15,35,2,3,5
Rajasthan,Jhunjhunu,Chronic Neurological Conditions,35,60,8,1,9
Odisha,Jharsuguda,Chronic Neurological Conditions,0,6,0,1,1
Odisha,Jharsuguda,Chronic Neurological Conditions,6,15,1,0,1
Odisha,Jharsuguda,Chronic Neurological Conditions,15,35,0,1,1
Odisha,Jharsuguda,Chronic Neurological Conditions,35,60,6,1,7
Odisha,Jharsuguda,Chronic Neurological Conditions,60,80,1,0,1
Odisha,Jharsuguda,Chronic Neurological Conditions,80,100,1,0,1
Uttar Pradesh,Jhansi,Chronic Neurological Conditions,6,15,1,0,1
Uttar Pradesh,Jhansi,Chronic Neurological Conditions,15,35,3,1,4
Uttar Pradesh,Jhansi,Chronic Neurological Conditions,35,60,7,2,9
Uttar Pradesh,Jhansi,Chronic Neurological Conditions,60,80,5,0,5
Rajasthan,Jhalawar,Chronic Neurological Conditions,15,35,2,0,2
Rajasthan,Jhalawar,Chronic Neurological Conditions,35,60,2,0,2
Haryana,Jhajjar,Chronic Neurological Conditions,0,6,0,2,2
Haryana,Jhajjar,Chronic Neurological Conditions,6,15,1,4,5
Haryana,Jhajjar,Chronic Neurological Conditions,15,35,29,16,45
Haryana,Jhajjar,Chronic Neurological Conditions,35,60,83,15,98
Haryana,Jhajjar,Chronic Neurological Conditions,60,80,12,8,20
Madhya Pradesh,Jhabua,Chronic Neurological Conditions,6,15,1,0,1
Madhya Pradesh,Jhabua,Chronic Neurological Conditions,15,35,5,4,9
Madhya Pradesh,Jhabua,Chronic Neurological Conditions,35,60,3,3,6
Madhya Pradesh,Jhabua,Chronic Neurological Conditions,60,80,3,0,3
Bihar,Jehanabad,Chronic Neurological Conditions,15,35,5,2,7
Bihar,Jehanabad,Chronic Neurological Conditions,35,60,3,4,7
Uttar Pradesh,Jaunpur,Chronic Neurological Conditions,6,15,3,4,7
Uttar Pradesh,Jaunpur,Chronic Neurological Conditions,15,35,20,3,23
Uttar Pradesh,Jaunpur,Chronic Neurological Conditions,35,60,14,2,16
Uttar Pradesh,Jaunpur,Chronic Neurological Conditions,60,80,2,0,2
Chhattisgarh,Jashpur,Chronic Neurological Conditions,6,15,0,1,1
Chhattisgarh,Jashpur,Chronic Neurological Conditions,15,35,2,0,2
Chhattisgarh,Jashpur,Chronic Neurological Conditions,60,80,2,0,2
Chhattisgarh,Janjgir-Champa,Chronic Neurological Conditions,15,35,4,0,4
Chhattisgarh,Janjgir-Champa,Chronic Neurological Conditions,35,60,2,0,2
Bihar,Jamui,Chronic Neurological Conditions,6,15,2,2,4
Bihar,Jamui,Chronic Neurological Conditions,15,35,3,4,7
Bihar,Jamui,Chronic Neurological Conditions,35,60,8,0,8
Jharkhand,Jamtara,Chronic Neurological Conditions,35,60,1,1,2
Gujarat,Jamnagar,Chronic Neurological Conditions,60,80,1,0,1
Jammu And Kashmir,Jammu,Chronic Neurological Conditions,0,6,7,2,9
Jammu And Kashmir,Jammu,Chronic Neurological Conditions,6,15,30,9,39
Jammu And Kashmir,Jammu,Chronic Neurological Conditions,15,35,50,27,77
Jammu And Kashmir,Jammu,Chronic Neurological Conditions,35,60,60,22,82
Jammu And Kashmir,Jammu,Chronic Neurological Conditions,60,80,15,4,19
Rajasthan,Jalore,Chronic Neurological Conditions,6,15,2,3,5
Rajasthan,Jalore,Chronic Neurological Conditions,15,35,6,3,9
Rajasthan,Jalore,Chronic Neurological Conditions,35,60,6,5,11
Rajasthan,Jalore,Chronic Neurological Conditions,60,80,3,2,5
Maharashtra,Jalgaon,Chronic Neurological Conditions,0,6,1,1,2
Maharashtra,Jalgaon,Chronic Neurological Conditions,6,15,21,12,33
Maharashtra,Jalgaon,Chronic Neurological Conditions,15,35,95,41,136
Maharashtra,Jalgaon,Chronic Neurological Conditions,35,60,181,35,216
Maharashtra,Jalgaon,Chronic Neurological Conditions,60,80,59,17,76
Maharashtra,Jalgaon,Chronic Neurological Conditions,80,100,1,0,1
Uttar Pradesh,Jalaun,Chronic Neurological Conditions,6,15,2,0,2
Uttar Pradesh,Jalaun,Chronic Neurological Conditions,15,35,20,14,34
Uttar Pradesh,Jalaun,Chronic Neurological Conditions,35,60,44,14,58
Uttar Pradesh,Jalaun,Chronic Neurological Conditions,60,80,14,3,17
Uttar Pradesh,Jalaun,Chronic Neurological Conditions,80,100,2,0,2
Punjab,Jalandhar,Chronic Neurological Conditions,6,15,1,0,1
Punjab,Jalandhar,Chronic Neurological Conditions,15,35,4,4,8
Punjab,Jalandhar,Chronic Neurological Conditions,35,60,22,2,24
Punjab,Jalandhar,Chronic Neurological Conditions,60,80,8,1,9
Odisha,Jajapur,Chronic Neurological Conditions,15,35,8,1,9
Odisha,Jajapur,Chronic Neurological Conditions,35,60,10,2,12
Odisha,Jajapur,Chronic Neurological Conditions,60,80,3,0,3
Rajasthan,Jaisalmer,Chronic Neurological Conditions,15,35,1,0,1
Rajasthan,Jaisalmer,Chronic Neurological Conditions,35,60,3,0,3
Rajasthan,Jaipur,Chronic Neurological Conditions,6,15,6,1,7
Rajasthan,Jaipur,Chronic Neurological Conditions,15,35,18,12,30
Rajasthan,Jaipur,Chronic Neurological Conditions,35,60,25,3,28
Rajasthan,Jaipur,Chronic Neurological Conditions,60,80,2,1,3
Rajasthan,Jaipur,Chronic Neurological Conditions,80,100,1,0,1
Odisha,Jagatsinghapur,Chronic Neurological Conditions,0,6,4,4,8
Odisha,Jagatsinghapur,Chronic Neurological Conditions,6,15,16,9,25
Odisha,Jagatsinghapur,Chronic Neurological Conditions,15,35,29,13,42
Odisha,Jagatsinghapur,Chronic Neurological Conditions,35,60,87,33,120
Odisha,Jagatsinghapur,Chronic Neurological Conditions,60,80,28,8,36
Odisha,Jagatsinghapur,Chronic Neurological Conditions,80,100,0,2,2
Madhya Pradesh,Jabalpur,Chronic Neurological Conditions,0,6,0,1,1
Madhya Pradesh,Jabalpur,Chronic Neurological Conditions,6,15,3,1,4
Madhya Pradesh,Jabalpur,Chronic Neurological Conditions,15,35,54,20,74
Madhya Pradesh,Jabalpur,Chronic Neurological Conditions,35,60,285,57,342
Madhya Pradesh,Jabalpur,Chronic Neurological Conditions,60,80,61,23,84
Madhya Pradesh,Jabalpur,Chronic Neurological Conditions,80,100,1,2,3
Madhya Pradesh,Indore,Chronic Neurological Conditions,15,35,12,3,15
Madhya Pradesh,Indore,Chronic Neurological Conditions,35,60,30,6,36
Madhya Pradesh,Indore,Chronic Neurological Conditions,60,80,23,3,26
Manipur,Imphal West,Chronic Neurological Conditions,15,35,2,0,2
Manipur,Imphal West,Chronic Neurological Conditions,35,60,4,1,5
Manipur,Imphal West,Chronic Neurological Conditions,60,80,3,2,5
Manipur,Imphal West,Chronic Neurological Conditions,80,100,1,1,2
Manipur,Imphal East,Chronic Neurological Conditions,35,60,4,0,4
Manipur,Imphal East,Chronic Neurological Conditions,60,80,1,1,2
Manipur,Imphal East,Chronic Neurological Conditions,80,100,0,1,1
Kerala,Idukki,Chronic Neurological Conditions,0,6,0,1,1
Kerala,Idukki,Chronic Neurological Conditions,6,15,3,5,8
Kerala,Idukki,Chronic Neurological Conditions,15,35,5,4,9
Kerala,Idukki,Chronic Neurological Conditions,35,60,15,8,23
Kerala,Idukki,Chronic Neurological Conditions,60,80,5,2,7
Kerala,Idukki,Chronic Neurological Conditions,80,100,0,1,1
Punjab,Hoshiarpur,Chronic Neurological Conditions,0,6,4,0,4
Punjab,Hoshiarpur,Chronic Neurological Conditions,6,15,8,11,19
Punjab,Hoshiarpur,Chronic Neurological Conditions,15,35,62,34,96
Punjab,Hoshiarpur,Chronic Neurological Conditions,35,60,235,70,305
Punjab,Hoshiarpur,Chronic Neurological Conditions,60,80,107,22,129
Punjab,Hoshiarpur,Chronic Neurological Conditions,80,100,3,0,3
Assam,Hojai,Chronic Neurological Conditions,15,35,2,1,3
Assam,Hojai,Chronic Neurological Conditions,35,60,2,3,5
Haryana,Hisar,Chronic Neurological Conditions,0,6,3,2,5
Haryana,Hisar,Chronic Neurological Conditions,6,15,4,1,5
Haryana,Hisar,Chronic Neurological Conditions,15,35,57,24,81
Haryana,Hisar,Chronic Neurological Conditions,35,60,209,46,255
Haryana,Hisar,Chronic Neurological Conditions,60,80,28,8,36
Haryana,Hisar,Chronic Neurological Conditions,80,100,0,1,1
Maharashtra,Hingoli,Chronic Neurological Conditions,15,35,1,0,1
Jharkhand,Hazaribagh,Chronic Neurological Conditions,6,15,2,2,4
Jharkhand,Hazaribagh,Chronic Neurological Conditions,15,35,3,3,6
Jharkhand,Hazaribagh,Chronic Neurological Conditions,35,60,8,1,9
Jharkhand,Hazaribagh,Chronic Neurological Conditions,60,80,1,0,1
Karnataka,Haveri,Chronic Neurological Conditions,0,6,1,1,2
Karnataka,Haveri,Chronic Neurological Conditions,6,15,1,1,2
Karnataka,Haveri,Chronic Neurological Conditions,15,35,1,2,3
Karnataka,Haveri,Chronic Neurological Conditions,35,60,12,4,16
Karnataka,Haveri,Chronic Neurological Conditions,60,80,1,0,1
Uttar Pradesh,Hathras,Chronic Neurological Conditions,15,35,2,0,2
Uttar Pradesh,Hathras,Chronic Neurological Conditions,35,60,1,0,1
Karnataka,Hassan,Chronic Neurological Conditions,0,6,0,3,3
Karnataka,Hassan,Chronic Neurological Conditions,6,15,8,6,14
Karnataka,Hassan,Chronic Neurological Conditions,15,35,69,44,113
Karnataka,Hassan,Chronic Neurological Conditions,35,60,359,89,448
Karnataka,Hassan,Chronic Neurological Conditions,60,80,112,25,137
Karnataka,Hassan,Chronic Neurological Conditions,80,100,5,1,6
Uttarakhand,Haridwar,Chronic Neurological Conditions,6,15,2,0,2
Uttarakhand,Haridwar,Chronic Neurological Conditions,15,35,1,2,3
Uttarakhand,Haridwar,Chronic Neurological Conditions,35,60,7,0,7
Uttarakhand,Haridwar,Chronic Neurological Conditions,60,80,1,0,1
Uttar Pradesh,Hardoi,Chronic Neurological Conditions,6,15,1,0,1
Uttar Pradesh,Hardoi,Chronic Neurological Conditions,15,35,16,5,21
Uttar Pradesh,Hardoi,Chronic Neurological Conditions,35,60,23,7,30
Uttar Pradesh,Hardoi,Chronic Neurological Conditions,60,80,16,4,20
Uttar Pradesh,Hardoi,Chronic Neurological Conditions,80,100,2,0,2
Madhya Pradesh,Harda,Chronic Neurological Conditions,15,35,1,1,2
Uttar Pradesh,Hapur,Chronic Neurological Conditions,15,35,2,0,2
Uttar Pradesh,Hapur,Chronic Neurological Conditions,35,60,3,1,4
Uttar Pradesh,Hapur,Chronic Neurological Conditions,60,80,1,0,1
Rajasthan,Hanumangarh,Chronic Neurological Conditions,15,35,1,0,1
Rajasthan,Hanumangarh,Chronic Neurological Conditions,35,60,5,0,5
Himachal Pradesh,Hamirpur,Chronic Neurological Conditions,6,15,1,0,1
Himachal Pradesh,Hamirpur,Chronic Neurological Conditions,15,35,4,2,6
Himachal Pradesh,Hamirpur,Chronic Neurological Conditions,35,60,5,6,11
Himachal Pradesh,Hamirpur,Chronic Neurological Conditions,60,80,8,1,9
Himachal Pradesh,Hamirpur,Chronic Neurological Conditions,80,100,0,1,1
Uttar Pradesh,Hamirpur,Chronic Neurological Conditions,6,15,3,0,3
Uttar Pradesh,Hamirpur,Chronic Neurological Conditions,15,35,3,3,6
Uttar Pradesh,Hamirpur,Chronic Neurological Conditions,35,60,7,3,10
Uttar Pradesh,Hamirpur,Chronic Neurological Conditions,60,80,4,0,4
Assam,Hailakandi,Chronic Neurological Conditions,15,35,1,0,1
Assam,Hailakandi,Chronic Neurological Conditions,35,60,6,0,6
Sikkim,Gyalshing,Chronic Neurological Conditions,6,15,0,1,1
Sikkim,Gyalshing,Chronic Neurological Conditions,15,35,2,0,2
Sikkim,Gyalshing,Chronic Neurological Conditions,35,60,1,0,1
Madhya Pradesh,Gwalior,Chronic Neurological Conditions,0,6,15,6,21
Madhya Pradesh,Gwalior,Chronic Neurological Conditions,6,15,73,45,118
Madhya Pradesh,Gwalior,Chronic Neurological Conditions,15,35,176,80,256
Madhya Pradesh,Gwalior,Chronic Neurological Conditions,35,60,199,62,261
Madhya Pradesh,Gwalior,Chronic Neurological Conditions,60,80,37,10,47
Haryana,Gurugram,Chronic Neurological Conditions,6,15,1,0,1
Haryana,Gurugram,Chronic Neurological Conditions,15,35,15,10,25
Haryana,Gurugram,Chronic Neurological Conditions,35,60,72,18,90
Haryana,Gurugram,Chronic Neurological Conditions,60,80,17,2,19
Punjab,Gurdaspur,Chronic Neurological Conditions,0,6,0,1,1
Punjab,Gurdaspur,Chronic Neurological Conditions,6,15,0,3,3
Punjab,Gurdaspur,Chronic Neurological Conditions,15,35,1,0,1
Punjab,Gurdaspur,Chronic Neurological Conditions,35,60,23,4,27
Punjab,Gurdaspur,Chronic Neurological Conditions,60,80,4,0,4
Andhra Pradesh,Guntur,Chronic Neurological Conditions,6,15,1,0,1
Andhra Pradesh,Guntur,Chronic Neurological Conditions,15,35,1,0,1
Andhra Pradesh,Guntur,Chronic Neurological Conditions,35,60,1,0,1
Madhya Pradesh,Guna,Chronic Neurological Conditions,35,60,1,0,1
Jharkhand,Gumla,Chronic Neurological Conditions,6,15,4,3,7
Jharkhand,Gumla,Chronic Neurological Conditions,15,35,30,21,51
Jharkhand,Gumla,Chronic Neurological Conditions,35,60,34,18,52
Jharkhand,Gumla,Chronic Neurological Conditions,60,80,6,5,11
Jharkhand,Gumla,Chronic Neurological Conditions,80,100,1,0,1
Uttar Pradesh,Gorakhpur,Chronic Neurological Conditions,0,6,1,1,2
Uttar Pradesh,Gorakhpur,Chronic Neurological Conditions,6,15,6,7,13
Uttar Pradesh,Gorakhpur,Chronic Neurological Conditions,15,35,41,16,57
Uttar Pradesh,Gorakhpur,Chronic Neurological Conditions,35,60,71,23,94
Uttar Pradesh,Gorakhpur,Chronic Neurological Conditions,60,80,22,6,28
Bihar,Gopalganj,Chronic Neurological Conditions,0,6,0,1,1
Bihar,Gopalganj,Chronic Neurological Conditions,6,15,2,0,2
Bihar,Gopalganj,Chronic Neurological Conditions,35,60,2,2,4
Maharashtra,Gondia,Chronic Neurological Conditions,0,6,4,4,8
Maharashtra,Gondia,Chronic Neurological Conditions,6,15,10,9,19
Maharashtra,Gondia,Chronic Neurological Conditions,15,35,83,27,110
Maharashtra,Gondia,Chronic Neurological Conditions,35,60,283,90,373
Maharashtra,Gondia,Chronic Neurological Conditions,60,80,90,25,115
Maharashtra,Gondia,Chronic Neurological Conditions,80,100,2,0,2
Uttar Pradesh,Gonda,Chronic Neurological Conditions,0,6,1,0,1
Uttar Pradesh,Gonda,Chronic Neurological Conditions,6,15,2,1,3
Uttar Pradesh,Gonda,Chronic Neurological Conditions,15,35,23,5,28
Uttar Pradesh,Gonda,Chronic Neurological Conditions,35,60,31,5,36
Uttar Pradesh,Gonda,Chronic Neurological Conditions,60,80,3,2,5
Assam,Golaghat,Chronic Neurological Conditions,0,6,2,7,9
Assam,Golaghat,Chronic Neurological Conditions,6,15,10,8,18
Assam,Golaghat,Chronic Neurological Conditions,15,35,11,7,18
Assam,Golaghat,Chronic Neurological Conditions,35,60,27,15,42
Assam,Golaghat,Chronic Neurological Conditions,60,80,14,3,17
Jharkhand,Godda,Chronic Neurological Conditions,0,6,1,0,1
Jharkhand,Godda,Chronic Neurological Conditions,6,15,4,0,4
Jharkhand,Godda,Chronic Neurological Conditions,15,35,13,9,22
Jharkhand,Godda,Chronic Neurological Conditions,35,60,5,2,7
Jharkhand,Godda,Chronic Neurological Conditions,60,80,4,7,11
Assam,Goalpara,Chronic Neurological Conditions,6,15,2,0,2
Assam,Goalpara,Chronic Neurological Conditions,15,35,1,0,1
Assam,Goalpara,Chronic Neurological Conditions,35,60,5,1,6
Jharkhand,Giridih,Chronic Neurological Conditions,6,15,0,2,2
Jharkhand,Giridih,Chronic Neurological Conditions,15,35,5,1,6
Jharkhand,Giridih,Chronic Neurological Conditions,35,60,7,2,9
Jharkhand,Giridih,Chronic Neurological Conditions,60,80,1,0,1
Gujarat,Gir Somnath,Chronic Neurological Conditions,6,15,1,0,1
Gujarat,Gir Somnath,Chronic Neurological Conditions,15,35,1,0,1
Uttar Pradesh,Ghazipur,Chronic Neurological Conditions,15,35,5,0,5
Uttar Pradesh,Ghazipur,Chronic Neurological Conditions,35,60,2,0,2
Uttar Pradesh,Ghazipur,Chronic Neurological Conditions,60,80,2,0,2
Uttar Pradesh,Ghaziabad,Chronic Neurological Conditions,6,15,3,0,3
Uttar Pradesh,Ghaziabad,Chronic Neurological Conditions,15,35,8,2,10
Uttar Pradesh,Ghaziabad,Chronic Neurological Conditions,35,60,5,0,5
Uttar Pradesh,Ghaziabad,Chronic Neurological Conditions,60,80,2,1,3
Bihar,Gaya,Chronic Neurological Conditions,0,6,1,0,1
Bihar,Gaya,Chronic Neurological Conditions,6,15,2,0,2
Bihar,Gaya,Chronic Neurological Conditions,15,35,3,3,6
Bihar,Gaya,Chronic Neurological Conditions,35,60,4,2,6
Bihar,Gaya,Chronic Neurological Conditions,80,100,1,0,1
Uttar Pradesh,Gautam Buddha Nagar,Chronic Neurological Conditions,15,35,6,0,6
Uttar Pradesh,Gautam Buddha Nagar,Chronic Neurological Conditions,35,60,8,2,10
Uttar Pradesh,Gautam Buddha Nagar,Chronic Neurological Conditions,60,80,1,0,1
Chhattisgarh,Gaurella Pendra Marwahi,Chronic Neurological Conditions,35,60,1,0,1
Chhattisgarh,Gariyaband,Chronic Neurological Conditions,0,6,0,1,1
Chhattisgarh,Gariyaband,Chronic Neurological Conditions,15,35,1,0,1
Chhattisgarh,Gariyaband,Chronic Neurological Conditions,35,60,1,0,1
Jharkhand,Garhwa,Chronic Neurological Conditions,6,15,5,2,7
Jharkhand,Garhwa,Chronic Neurological Conditions,15,35,5,5,10
Jharkhand,Garhwa,Chronic Neurological Conditions,35,60,8,0,8
Jharkhand,Garhwa,Chronic Neurological Conditions,60,80,1,0,1
Odisha,Ganjam,Chronic Neurological Conditions,15,35,14,5,19
Odisha,Ganjam,Chronic Neurological Conditions,35,60,42,13,55
Odisha,Ganjam,Chronic Neurological Conditions,60,80,5,2,7
Sikkim,Gangtok,Chronic Neurological Conditions,15,35,2,0,2
Rajasthan,Ganganagar,Chronic Neurological Conditions,6,15,0,1,1
Rajasthan,Ganganagar,Chronic Neurological Conditions,35,60,1,0,1
Rajasthan,Ganganagar,Chronic Neurological Conditions,60,80,1,0,1
Gujarat,Gandhinagar,Chronic Neurological Conditions,15,35,1,0,1
Gujarat,Gandhinagar,Chronic Neurological Conditions,35,60,2,1,3
Gujarat,Gandhinagar,Chronic Neurological Conditions,60,80,1,1,2
Jammu And Kashmir,Ganderbal,Chronic Neurological Conditions,0,6,7,8,15
Jammu And Kashmir,Ganderbal,Chronic Neurological Conditions,6,15,15,16,31
Jammu And Kashmir,Ganderbal,Chronic Neurological Conditions,15,35,30,22,52
Jammu And Kashmir,Ganderbal,Chronic Neurological Conditions,35,60,36,32,68
Jammu And Kashmir,Ganderbal,Chronic Neurological Conditions,60,80,5,7,12
Jammu And Kashmir,Ganderbal,Chronic Neurological Conditions,80,100,0,1,1
Odisha,Gajapati,Chronic Neurological Conditions,0,6,1,0,1
Odisha,Gajapati,Chronic Neurological Conditions,15,35,0,2,2
Odisha,Gajapati,Chronic Neurological Conditions,35,60,1,1,2
Odisha,Gajapati,Chronic Neurological Conditions,60,80,2,0,2
Maharashtra,Gadchiroli,Chronic Neurological Conditions,6,15,0,1,1
Maharashtra,Gadchiroli,Chronic Neurological Conditions,15,35,6,6,12
Maharashtra,Gadchiroli,Chronic Neurological Conditions,35,60,34,10,44
Maharashtra,Gadchiroli,Chronic Neurological Conditions,60,80,15,2,17
Karnataka,Gadag,Chronic Neurological Conditions,0,6,1,0,1
Karnataka,Gadag,Chronic Neurological Conditions,6,15,2,1,3
Karnataka,Gadag,Chronic Neurological Conditions,15,35,2,2,4
Karnataka,Gadag,Chronic Neurological Conditions,35,60,9,3,12
Karnataka,Gadag,Chronic Neurological Conditions,60,80,2,1,3
Karnataka,Gadag,Chronic Neurological Conditions,80,100,1,0,1
Uttar Pradesh,Firozabad,Chronic Neurological Conditions,15,35,4,3,7
Uttar Pradesh,Firozabad,Chronic Neurological Conditions,35,60,3,2,5
Uttar Pradesh,Firozabad,Chronic Neurological Conditions,60,80,1,0,1
Punjab,Ferozepur,Chronic Neurological Conditions,15,35,1,0,1
Punjab,Ferozepur,Chronic Neurological Conditions,35,60,1,2,3
Punjab,Ferozepur,Chronic Neurological Conditions,60,80,1,0,1
Punjab,Fazilka,Chronic Neurological Conditions,0,6,0,1,1
Punjab,Fazilka,Chronic Neurological Conditions,6,15,1,0,1
Punjab,Fazilka,Chronic Neurological Conditions,15,35,5,3,8
Punjab,Fazilka,Chronic Neurological Conditions,35,60,16,3,19
Punjab,Fazilka,Chronic Neurological Conditions,60,80,5,1,6
Punjab,Fazilka,Chronic Neurological Conditions,80,100,1,0,1
Uttar Pradesh,Fatehpur,Chronic Neurological Conditions,0,6,1,0,1
Uttar Pradesh,Fatehpur,Chronic Neurological Conditions,6,15,1,3,4
Uttar Pradesh,Fatehpur,Chronic Neurological Conditions,15,35,17,10,27
Uttar Pradesh,Fatehpur,Chronic Neurological Conditions,35,60,25,9,34
Uttar Pradesh,Fatehpur,Chronic Neurological Conditions,60,80,15,1,16
Uttar Pradesh,Fatehpur,Chronic Neurological Conditions,80,100,1,0,1
Punjab,Fatehgarh Sahib,Chronic Neurological Conditions,0,6,1,0,1
Punjab,Fatehgarh Sahib,Chronic Neurological Conditions,15,35,6,4,10
Punjab,Fatehgarh Sahib,Chronic Neurological Conditions,35,60,31,8,39
Punjab,Fatehgarh Sahib,Chronic Neurological Conditions,60,80,17,1,18
Punjab,Fatehgarh Sahib,Chronic Neurological Conditions,80,100,2,0,2
Haryana,Fatehabad,Chronic Neurological Conditions,0,6,1,0,1
Haryana,Fatehabad,Chronic Neurological Conditions,6,15,2,0,2
Haryana,Fatehabad,Chronic Neurological Conditions,15,35,3,3,6
Haryana,Fatehabad,Chronic Neurological Conditions,35,60,8,3,11
Haryana,Fatehabad,Chronic Neurological Conditions,60,80,1,2,3
Uttar Pradesh,Farrukhabad,Chronic Neurological Conditions,6,15,4,1,5
Uttar Pradesh,Farrukhabad,Chronic Neurological Conditions,15,35,15,6,21
Uttar Pradesh,Farrukhabad,Chronic Neurological Conditions,35,60,12,5,17
Uttar Pradesh,Farrukhabad,Chronic Neurological Conditions,60,80,7,0,7
Punjab,Faridkot,Chronic Neurological Conditions,6,15,4,4,8
Punjab,Faridkot,Chronic Neurological Conditions,15,35,13,6,19
Punjab,Faridkot,Chronic Neurological Conditions,35,60,33,8,41
Punjab,Faridkot,Chronic Neurological Conditions,60,80,9,0,9
Punjab,Faridkot,Chronic Neurological Conditions,80,100,1,0,1
Haryana,Faridabad,Chronic Neurological Conditions,35,60,1,0,1
Haryana,Faridabad,Chronic Neurological Conditions,60,80,3,0,3
Uttar Pradesh,Etawah,Chronic Neurological Conditions,15,35,7,4,11
Uttar Pradesh,Etawah,Chronic Neurological Conditions,35,60,14,5,19
Uttar Pradesh,Etawah,Chronic Neurological Conditions,60,80,5,0,5
Uttar Pradesh,Etah,Chronic Neurological Conditions,6,15,2,1,3
Uttar Pradesh,Etah,Chronic Neurological Conditions,15,35,129,32,161
Uttar Pradesh,Etah,Chronic Neurological Conditions,35,60,220,49,269
Uttar Pradesh,Etah,Chronic Neurological Conditions,60,80,74,4,78
Uttar Pradesh,Etah,Chronic Neurological Conditions,80,100,6,0,6
Tamil Nadu,Erode,Chronic Neurological Conditions,6,15,0,1,1
Tamil Nadu,Erode,Chronic Neurological Conditions,15,35,3,3,6
Tamil Nadu,Erode,Chronic Neurological Conditions,35,60,6,5,11
Tamil Nadu,Erode,Chronic Neurological Conditions,60,80,2,3,5
Kerala,Ernakulam,Chronic Neurological Conditions,0,6,1,0,1
Kerala,Ernakulam,Chronic Neurological Conditions,6,15,1,6,7
Kerala,Ernakulam,Chronic Neurological Conditions,15,35,8,2,10
Kerala,Ernakulam,Chronic Neurological Conditions,35,60,17,6,23
Kerala,Ernakulam,Chronic Neurological Conditions,60,80,10,6,16
Meghalaya,Eastern West Khasi Hills,Chronic Neurological Conditions,15,35,1,0,1
Jharkhand,East Singhbum,Chronic Neurological Conditions,6,15,1,1,2
Jharkhand,East Singhbum,Chronic Neurological Conditions,15,35,34,24,58
Jharkhand,East Singhbum,Chronic Neurological Conditions,35,60,40,28,68
Jharkhand,East Singhbum,Chronic Neurological Conditions,60,80,11,7,18
Arunachal Pradesh,East Siang,Chronic Neurological Conditions,35,60,0,1,1
Madhya Pradesh,East Nimar,Chronic Neurological Conditions,15,35,0,2,2
Madhya Pradesh,East Nimar,Chronic Neurological Conditions,35,60,1,1,2
Madhya Pradesh,East Nimar,Chronic Neurological Conditions,60,80,1,0,1
Meghalaya,East Khasi Hills,Chronic Neurological Conditions,6,15,1,1,2
Meghalaya,East Khasi Hills,Chronic Neurological Conditions,15,35,2,4,6
Meghalaya,East Khasi Hills,Chronic Neurological Conditions,35,60,1,0,1
Meghalaya,East Khasi Hills,Chronic Neurological Conditions,80,100,0,1,1
Meghalaya,East Jaintia Hills,Chronic Neurological Conditions,6,15,2,0,2
Meghalaya,East Jaintia Hills,Chronic Neurological Conditions,15,35,5,7,12
Meghalaya,East Jaintia Hills,Chronic Neurological Conditions,35,60,1,1,2
Andhra Pradesh,East Godavari,Chronic Neurological Conditions,35,60,1,0,1
Andhra Pradesh,East Godavari,Chronic Neurological Conditions,60,80,1,1,2
Delhi,East,Chronic Neurological Conditions,6,15,3,1,4
Delhi,East,Chronic Neurological Conditions,15,35,10,10,20
Delhi,East,Chronic Neurological Conditions,35,60,13,7,20
Delhi,East,Chronic Neurological Conditions,60,80,8,0,8
Chhattisgarh,Durg,Chronic Neurological Conditions,0,6,0,1,1
Chhattisgarh,Durg,Chronic Neurological Conditions,6,15,4,1,5
Chhattisgarh,Durg,Chronic Neurological Conditions,15,35,2,0,2
Chhattisgarh,Durg,Chronic Neurological Conditions,35,60,2,0,2
Chhattisgarh,Durg,Chronic Neurological Conditions,60,80,2,1,3
Rajasthan,Dungarpur,Chronic Neurological Conditions,0,6,1,0,1
Rajasthan,Dungarpur,Chronic Neurological Conditions,15,35,2,1,3
Rajasthan,Dungarpur,Chronic Neurological Conditions,35,60,3,0,3
Jharkhand,Dumka,Chronic Neurological Conditions,6,15,2,0,2
Jharkhand,Dumka,Chronic Neurological Conditions,15,35,2,3,5
Jharkhand,Dumka,Chronic Neurological Conditions,35,60,3,0,3
Jharkhand,Dumka,Chronic Neurological Conditions,60,80,3,0,3
Jammu And Kashmir,Doda,Chronic Neurological Conditions,6,15,1,1,2
Jammu And Kashmir,Doda,Chronic Neurological Conditions,15,35,1,1,2
Jammu And Kashmir,Doda,Chronic Neurological Conditions,35,60,2,4,6
Jammu And Kashmir,Doda,Chronic Neurological Conditions,60,80,4,0,4
Dadra Nagar Haveli And Daman And Diu,Diu,Chronic Neurological Conditions,35,60,1,0,1
Madhya Pradesh,Dindori,Chronic Neurological Conditions,6,15,1,2,3
Madhya Pradesh,Dindori,Chronic Neurological Conditions,15,35,1,1,2
Madhya Pradesh,Dindori,Chronic Neurological Conditions,35,60,26,5,31
Madhya Pradesh,Dindori,Chronic Neurological Conditions,60,80,7,0,7
Madhya Pradesh,Dindori,Chronic Neurological Conditions,80,100,0,1,1
Tamil Nadu,Dindigul,Chronic Neurological Conditions,6,15,1,0,1
Tamil Nadu,Dindigul,Chronic Neurological Conditions,15,35,7,1,8
Tamil Nadu,Dindigul,Chronic Neurological Conditions,35,60,10,4,14
Tamil Nadu,Dindigul,Chronic Neurological Conditions,60,80,6,1,7
Assam,Dima Hasao,Chronic Neurological Conditions,6,15,4,1,5
Assam,Dima Hasao,Chronic Neurological Conditions,15,35,1,2,3
Assam,Dima Hasao,Chronic Neurological Conditions,35,60,3,0,3
Assam,Dibrugarh,Chronic Neurological Conditions,6,15,0,1,1
Assam,Dibrugarh,Chronic Neurological Conditions,15,35,7,3,10
Assam,Dibrugarh,Chronic Neurological Conditions,35,60,13,6,19
Assam,Dibrugarh,Chronic Neurological Conditions,60,80,1,1,2
Maharashtra,Dhule,Chronic Neurological Conditions,6,15,1,0,1
Maharashtra,Dhule,Chronic Neurological Conditions,15,35,5,1,6
Maharashtra,Dhule,Chronic Neurological Conditions,35,60,10,4,14
Maharashtra,Dhule,Chronic Neurological Conditions,60,80,1,0,1
Rajasthan,Dholpur,Chronic Neurological Conditions,15,35,1,0,1
Odisha,Dhenkanal,Chronic Neurological Conditions,0,6,2,2,4
Odisha,Dhenkanal,Chronic Neurological Conditions,6,15,9,7,16
Odisha,Dhenkanal,Chronic Neurological Conditions,15,35,26,9,35
Odisha,Dhenkanal,Chronic Neurological Conditions,35,60,79,25,104
Odisha,Dhenkanal,Chronic Neurological Conditions,60,80,18,5,23
Assam,Dhemaji,Chronic Neurological Conditions,0,6,1,0,1
Assam,Dhemaji,Chronic Neurological Conditions,15,35,2,0,2
Assam,Dhemaji,Chronic Neurological Conditions,35,60,2,0,2
Karnataka,Dharwad,Chronic Neurological Conditions,6,15,5,2,7
Karnataka,Dharwad,Chronic Neurological Conditions,15,35,4,2,6
Karnataka,Dharwad,Chronic Neurological Conditions,35,60,8,2,10
Karnataka,Dharwad,Chronic Neurological Conditions,60,80,4,0,4
Tamil Nadu,Dharmapuri,Chronic Neurological Conditions,6,15,1,1,2
Tamil Nadu,Dharmapuri,Chronic Neurological Conditions,15,35,5,2,7
Tamil Nadu,Dharmapuri,Chronic Neurological Conditions,35,60,14,2,16
Tamil Nadu,Dharmapuri,Chronic Neurological Conditions,60,80,1,2,3
Madhya Pradesh,Dhar,Chronic Neurological Conditions,6,15,1,0,1
Madhya Pradesh,Dhar,Chronic Neurological Conditions,15,35,13,1,14
Madhya Pradesh,Dhar,Chronic Neurological Conditions,35,60,12,4,16
Madhya Pradesh,Dhar,Chronic Neurological Conditions,60,80,4,1,5
Jharkhand,Dhanbad,Chronic Neurological Conditions,6,15,3,0,3
Jharkhand,Dhanbad,Chronic Neurological Conditions,15,35,6,4,10
Jharkhand,Dhanbad,Chronic Neurological Conditions,35,60,9,4,13
Jharkhand,Dhanbad,Chronic Neurological Conditions,60,80,1,1,2
Chhattisgarh,Dhamtari,Chronic Neurological Conditions,35,60,1,0,1
Tripura,Dhalai,Chronic Neurological Conditions,0,6,1,0,1
Tripura,Dhalai,Chronic Neurological Conditions,15,35,2,1,3
Tripura,Dhalai,Chronic Neurological Conditions,35,60,12,1,13
Tripura,Dhalai,Chronic Neurological Conditions,60,80,7,1,8
Madhya Pradesh,Dewas,Chronic Neurological Conditions,6,15,0,1,1
Madhya Pradesh,Dewas,Chronic Neurological Conditions,15,35,5,0,5
Madhya Pradesh,Dewas,Chronic Neurological Conditions,35,60,2,0,2
Madhya Pradesh,Dewas,Chronic Neurological Conditions,60,80,2,1,3
Uttar Pradesh,Deoria,Chronic Neurological Conditions,0,6,1,1,2
Uttar Pradesh,Deoria,Chronic Neurological Conditions,6,15,3,1,4
Uttar Pradesh,Deoria,Chronic Neurological Conditions,15,35,33,14,47
Uttar Pradesh,Deoria,Chronic Neurological Conditions,35,60,55,14,69
Uttar Pradesh,Deoria,Chronic Neurological Conditions,60,80,13,5,18
Jharkhand,Deoghar,Chronic Neurological Conditions,6,15,1,2,3
Jharkhand,Deoghar,Chronic Neurological Conditions,15,35,3,3,6
Jharkhand,Deoghar,Chronic Neurological Conditions,35,60,2,0,2
Odisha,Deogarh,Chronic Neurological Conditions,35,60,1,0,1
Uttarakhand,Dehradun,Chronic Neurological Conditions,15,35,7,3,10
Uttarakhand,Dehradun,Chronic Neurological Conditions,35,60,2,1,3
Uttarakhand,Dehradun,Chronic Neurological Conditions,60,80,2,0,2
Karnataka,Davangere,Chronic Neurological Conditions,6,15,1,0,1
Karnataka,Davangere,Chronic Neurological Conditions,15,35,5,0,5
Karnataka,Davangere,Chronic Neurological Conditions,35,60,17,5,22
Karnataka,Davangere,Chronic Neurological Conditions,60,80,4,2,6
Rajasthan,Dausa,Chronic Neurological Conditions,6,15,1,1,2
Rajasthan,Dausa,Chronic Neurological Conditions,15,35,3,1,4
Rajasthan,Dausa,Chronic Neurological Conditions,35,60,1,1,2
Madhya Pradesh,Datia,Chronic Neurological Conditions,6,15,1,0,1
Madhya Pradesh,Datia,Chronic Neurological Conditions,35,60,2,0,2
Assam,Darrang,Chronic Neurological Conditions,6,15,0,1,1
Assam,Darrang,Chronic Neurological Conditions,15,35,1,2,3
Assam,Darrang,Chronic Neurological Conditions,35,60,1,1,2
Assam,Darrang,Chronic Neurological Conditions,60,80,0,1,1
Bihar,Darbhanga,Chronic Neurological Conditions,6,15,1,0,1
Bihar,Darbhanga,Chronic Neurological Conditions,15,35,8,4,12
Bihar,Darbhanga,Chronic Neurological Conditions,35,60,5,0,5
Bihar,Darbhanga,Chronic Neurological Conditions,60,80,0,1,1
Gujarat,Dang,Chronic Neurological Conditions,15,35,1,0,1
Gujarat,Dang,Chronic Neurological Conditions,35,60,1,1,2
Gujarat,Dang,Chronic Neurological Conditions,60,80,3,1,4
Madhya Pradesh,Damoh,Chronic Neurological Conditions,6,15,0,2,2
Madhya Pradesh,Damoh,Chronic Neurological Conditions,15,35,13,8,21
Madhya Pradesh,Damoh,Chronic Neurological Conditions,35,60,43,11,54
Madhya Pradesh,Damoh,Chronic Neurological Conditions,60,80,11,5,16
Madhya Pradesh,Damoh,Chronic Neurological Conditions,80,100,0,1,1
Dadra Nagar Haveli And Daman And Diu,Daman,Chronic Neurological Conditions,6,15,1,0,1
Dadra Nagar Haveli And Daman And Diu,Daman,Chronic Neurological Conditions,15,35,2,2,4
Dadra Nagar Haveli And Daman And Diu,Daman,Chronic Neurological Conditions,35,60,8,1,9
Dadra Nagar Haveli And Daman And Diu,Daman,Chronic Neurological Conditions,60,80,6,0,6
Karnataka,Dakshina Kannada,Chronic Neurological Conditions,0,6,8,2,10
Karnataka,Dakshina Kannada,Chronic Neurological Conditions,6,15,9,10,19
Karnataka,Dakshina Kannada,Chronic Neurological Conditions,15,35,35,20,55
Karnataka,Dakshina Kannada,Chronic Neurological Conditions,35,60,326,80,406
Karnataka,Dakshina Kannada,Chronic Neurological Conditions,60,80,159,45,204
Karnataka,Dakshina Kannada,Chronic Neurological Conditions,80,100,1,0,1
Odisha,Cuttack,Chronic Neurological Conditions,0,6,12,4,16
Odisha,Cuttack,Chronic Neurological Conditions,6,15,55,19,74
Odisha,Cuttack,Chronic Neurological Conditions,15,35,100,43,143
Odisha,Cuttack,Chronic Neurological Conditions,35,60,254,75,329
Odisha,Cuttack,Chronic Neurological Conditions,60,80,65,27,92
Odisha,Cuttack,Chronic Neurological Conditions,80,100,1,1,2
Tamil Nadu,Cuddalore,Chronic Neurological Conditions,6,15,0,1,1
Tamil Nadu,Cuddalore,Chronic Neurological Conditions,15,35,3,1,4
Tamil Nadu,Cuddalore,Chronic Neurological Conditions,35,60,8,1,9
Tamil Nadu,Cuddalore,Chronic Neurological Conditions,60,80,3,0,3
Tamil Nadu,Coimbatore,Chronic Neurological Conditions,0,6,1,0,1
Tamil Nadu,Coimbatore,Chronic Neurological Conditions,6,15,3,3,6
Tamil Nadu,Coimbatore,Chronic Neurological Conditions,15,35,3,3,6
Tamil Nadu,Coimbatore,Chronic Neurological Conditions,35,60,2,2,4
Rajasthan,Churu,Chronic Neurological Conditions,15,35,1,0,1
Rajasthan,Churu,Chronic Neurological Conditions,35,60,3,0,3
Rajasthan,Churu,Chronic Neurological Conditions,60,80,1,0,1
Manipur,Churachandpur,Chronic Neurological Conditions,6,15,2,0,2
Manipur,Churachandpur,Chronic Neurological Conditions,15,35,1,1,2
Rajasthan,Chittorgarh,Chronic Neurological Conditions,6,15,2,1,3
Rajasthan,Chittorgarh,Chronic Neurological Conditions,15,35,1,1,2
Rajasthan,Chittorgarh,Chronic Neurological Conditions,35,60,1,0,1
Uttar Pradesh,Chitrakoot,Chronic Neurological Conditions,0,6,2,0,2
Uttar Pradesh,Chitrakoot,Chronic Neurological Conditions,6,15,1,4,5
Uttar Pradesh,Chitrakoot,Chronic Neurological Conditions,15,35,8,3,11
Uttar Pradesh,Chitrakoot,Chronic Neurological Conditions,35,60,25,8,33
Uttar Pradesh,Chitrakoot,Chronic Neurological Conditions,60,80,10,0,10
Uttar Pradesh,Chitrakoot,Chronic Neurological Conditions,80,100,1,0,1
Karnataka,Chitradurga,Chronic Neurological Conditions,6,15,2,0,2
Karnataka,Chitradurga,Chronic Neurological Conditions,15,35,8,7,15
Karnataka,Chitradurga,Chronic Neurological Conditions,35,60,10,4,14
Karnataka,Chitradurga,Chronic Neurological Conditions,60,80,2,0,2
Assam,Chirang,Chronic Neurological Conditions,15,35,0,1,1
Karnataka,Chikkamagaluru,Chronic Neurological Conditions,0,6,2,1,3
Karnataka,Chikkamagaluru,Chronic Neurological Conditions,6,15,3,2,5
Karnataka,Chikkamagaluru,Chronic Neurological Conditions,15,35,10,9,19
Karnataka,Chikkamagaluru,Chronic Neurological Conditions,35,60,163,35,198
Karnataka,Chikkamagaluru,Chronic Neurological Conditions,60,80,39,7,46
Karnataka,Chikkamagaluru,Chronic Neurological Conditions,80,100,1,0,1
Karnataka,Chikkaballapura,Chronic Neurological Conditions,0,6,1,3,4
Karnataka,Chikkaballapura,Chronic Neurological Conditions,6,15,7,8,15
Karnataka,Chikkaballapura,Chronic Neurological Conditions,15,35,75,43,118
Karnataka,Chikkaballapura,Chronic Neurological Conditions,35,60,444,146,590
Karnataka,Chikkaballapura,Chronic Neurological Conditions,60,80,154,24,178
Karnataka,Chikkaballapura,Chronic Neurological Conditions,80,100,3,0,3
Gujarat,Chhotaudepur,Chronic Neurological Conditions,15,35,1,0,1
Gujarat,Chhotaudepur,Chronic Neurological Conditions,35,60,1,0,1
Madhya Pradesh,Chhindwara,Chronic Neurological Conditions,6,15,1,0,1
Madhya Pradesh,Chhindwara,Chronic Neurological Conditions,15,35,5,7,12
Madhya Pradesh,Chhindwara,Chronic Neurological Conditions,35,60,11,5,16
Madhya Pradesh,Chhindwara,Chronic Neurological Conditions,60,80,6,0,6
Madhya Pradesh,Chhatarpur,Chronic Neurological Conditions,6,15,4,0,4
Madhya Pradesh,Chhatarpur,Chronic Neurological Conditions,15,35,14,7,21
Madhya Pradesh,Chhatarpur,Chronic Neurological Conditions,35,60,15,9,24
Madhya Pradesh,Chhatarpur,Chronic Neurological Conditions,60,80,2,1,3
Madhya Pradesh,Chhatarpur,Chronic Neurological Conditions,80,100,0,1,1
Tamil Nadu,Chennai,Chronic Neurological Conditions,0,6,2,1,3
Tamil Nadu,Chennai,Chronic Neurological Conditions,6,15,11,5,16
Tamil Nadu,Chennai,Chronic Neurological Conditions,15,35,16,13,29
Tamil Nadu,Chennai,Chronic Neurological Conditions,35,60,57,15,72
Tamil Nadu,Chennai,Chronic Neurological Conditions,60,80,11,4,15
Tamil Nadu,Chengalpattu,Chronic Neurological Conditions,0,6,2,1,3
Tamil Nadu,Chengalpattu,Chronic Neurological Conditions,6,15,3,4,7
Tamil Nadu,Chengalpattu,Chronic Neurological Conditions,15,35,5,2,7
Tamil Nadu,Chengalpattu,Chronic Neurological Conditions,35,60,45,18,63
Tamil Nadu,Chengalpattu,Chronic Neurological Conditions,60,80,17,3,20
Jharkhand,Chatra,Chronic Neurological Conditions,15,35,1,1,2
Jharkhand,Chatra,Chronic Neurological Conditions,35,60,1,0,1
Haryana,Charki Dadri,Chronic Neurological Conditions,6,15,3,0,3
Haryana,Charki Dadri,Chronic Neurological Conditions,15,35,22,7,29
Haryana,Charki Dadri,Chronic Neurological Conditions,35,60,44,3,47
Haryana,Charki Dadri,Chronic Neurological Conditions,60,80,7,1,8
Haryana,Charki Dadri,Chronic Neurological Conditions,80,100,0,1,1
Assam,Charaideo,Chronic Neurological Conditions,15,35,0,1,1
Assam,Charaideo,Chronic Neurological Conditions,35,60,1,0,1
Maharashtra,Chandrapur,Chronic Neurological Conditions,6,15,12,6,18
Maharashtra,Chandrapur,Chronic Neurological Conditions,15,35,16,8,24
Maharashtra,Chandrapur,Chronic Neurological Conditions,35,60,11,0,11
Maharashtra,Chandrapur,Chronic Neurological Conditions,60,80,6,1,7
Chandigarh,Chandigarh,Chronic Neurological Conditions,0,6,4,3,7
Chandigarh,Chandigarh,Chronic Neurological Conditions,6,15,6,2,8
Chandigarh,Chandigarh,Chronic Neurological Conditions,15,35,21,8,29
Chandigarh,Chandigarh,Chronic Neurological Conditions,35,60,28,5,33
Chandigarh,Chandigarh,Chronic Neurological Conditions,60,80,27,3,30
Uttar Pradesh,Chandauli,Chronic Neurological Conditions,35,60,2,0,2
Mizoram,Champhai,Chronic Neurological Conditions,6,15,1,0,1
Mizoram,Champhai,Chronic Neurological Conditions,15,35,2,1,3
Mizoram,Champhai,Chronic Neurological Conditions,35,60,3,1,4
Mizoram,Champhai,Chronic Neurological Conditions,60,80,0,1,1
Uttarakhand,Champawat,Chronic Neurological Conditions,6,15,2,0,2
Uttarakhand,Champawat,Chronic Neurological Conditions,15,35,4,4,8
Uttarakhand,Champawat,Chronic Neurological Conditions,35,60,6,2,8
Uttarakhand,Champawat,Chronic Neurological Conditions,60,80,1,0,1
Uttarakhand,Chamoli,Chronic Neurological Conditions,15,35,3,3,6
Uttarakhand,Chamoli,Chronic Neurological Conditions,35,60,6,4,10
Uttarakhand,Chamoli,Chronic Neurological Conditions,60,80,3,1,4
Uttarakhand,Chamoli,Chronic Neurological Conditions,80,100,1,0,1
Himachal Pradesh,Chamba,Chronic Neurological Conditions,6,15,1,1,2
Himachal Pradesh,Chamba,Chronic Neurological Conditions,15,35,1,0,1
Himachal Pradesh,Chamba,Chronic Neurological Conditions,35,60,8,2,10
Himachal Pradesh,Chamba,Chronic Neurological Conditions,60,80,3,0,3
Karnataka,Chamarajanagara,Chronic Neurological Conditions,15,35,17,8,25
Karnataka,Chamarajanagara,Chronic Neurological Conditions,35,60,168,26,194
Karnataka,Chamarajanagara,Chronic Neurological Conditions,60,80,41,12,53
Delhi,Central,Chronic Neurological Conditions,6,15,3,2,5
Delhi,Central,Chronic Neurological Conditions,15,35,7,0,7
Delhi,Central,Chronic Neurological Conditions,35,60,21,6,27
Delhi,Central,Chronic Neurological Conditions,60,80,8,1,9
Delhi,Central,Chronic Neurological Conditions,80,100,1,0,1
Assam,Cachar,Chronic Neurological Conditions,6,15,0,1,1
Assam,Cachar,Chronic Neurological Conditions,15,35,4,3,7
Assam,Cachar,Chronic Neurological Conditions,35,60,6,0,6
Assam,Cachar,Chronic Neurological Conditions,60,80,1,0,1
Bihar,Buxar,Chronic Neurological Conditions,15,35,1,3,4
Bihar,Buxar,Chronic Neurological Conditions,35,60,1,1,2
Madhya Pradesh,Burhanpur,Chronic Neurological Conditions,6,15,1,3,4
Madhya Pradesh,Burhanpur,Chronic Neurological Conditions,15,35,3,7,10
Madhya Pradesh,Burhanpur,Chronic Neurological Conditions,35,60,7,6,13
Madhya Pradesh,Burhanpur,Chronic Neurological Conditions,60,80,2,0,2
Rajasthan,Bundi,Chronic Neurological Conditions,15,35,2,1,3
Rajasthan,Bundi,Chronic Neurological Conditions,35,60,4,0,4
Maharashtra,Buldhana,Chronic Neurological Conditions,6,15,4,3,7
Maharashtra,Buldhana,Chronic Neurological Conditions,15,35,4,3,7
Maharashtra,Buldhana,Chronic Neurological Conditions,35,60,7,4,11
Maharashtra,Buldhana,Chronic Neurological Conditions,60,80,2,2,4
Uttar Pradesh,Bulandshahr,Chronic Neurological Conditions,15,35,7,2,9
Uttar Pradesh,Bulandshahr,Chronic Neurological Conditions,35,60,10,2,12
Uttar Pradesh,Bulandshahr,Chronic Neurological Conditions,60,80,2,2,4
Jammu And Kashmir,Budgam,Chronic Neurological Conditions,0,6,8,7,15
Jammu And Kashmir,Budgam,Chronic Neurological Conditions,6,15,17,17,34
Jammu And Kashmir,Budgam,Chronic Neurological Conditions,15,35,76,47,123
Jammu And Kashmir,Budgam,Chronic Neurological Conditions,35,60,96,58,154
Jammu And Kashmir,Budgam,Chronic Neurological Conditions,60,80,12,10,22
Jammu And Kashmir,Budgam,Chronic Neurological Conditions,80,100,0,1,1
Uttar Pradesh,Budaun,Chronic Neurological Conditions,15,35,3,0,3
Odisha,Boudh,Chronic Neurological Conditions,0,6,1,2,3
Odisha,Boudh,Chronic Neurological Conditions,15,35,3,4,7
Odisha,Boudh,Chronic Neurological Conditions,35,60,4,3,7
Odisha,Boudh,Chronic Neurological Conditions,60,80,4,1,5
Assam,Bongaigaon,Chronic Neurological Conditions,15,35,5,2,7
Assam,Bongaigaon,Chronic Neurological Conditions,35,60,6,0,6
Assam,Bongaigaon,Chronic Neurological Conditions,60,80,2,1,3
Jharkhand,Bokaro,Chronic Neurological Conditions,6,15,2,0,2
Jharkhand,Bokaro,Chronic Neurological Conditions,15,35,14,8,22
Jharkhand,Bokaro,Chronic Neurological Conditions,35,60,20,6,26
Jharkhand,Bokaro,Chronic Neurological Conditions,60,80,2,1,3
Assam,Biswanath,Chronic Neurological Conditions,15,35,1,0,1
Assam,Biswanath,Chronic Neurological Conditions,35,60,1,0,1
Assam,Biswanath,Chronic Neurological Conditions,60,80,1,0,1
Manipur,Bishnupur,Chronic Neurological Conditions,6,15,1,0,1
Manipur,Bishnupur,Chronic Neurological Conditions,35,60,1,1,2
Chhattisgarh,Bilaspur,Chronic Neurological Conditions,15,35,0,1,1
Chhattisgarh,Bilaspur,Chronic Neurological Conditions,35,60,2,0,2
Chhattisgarh,Bilaspur,Chronic Neurological Conditions,60,80,0,1,1
Himachal Pradesh,Bilaspur,Chronic Neurological Conditions,15,35,1,1,2
Himachal Pradesh,Bilaspur,Chronic Neurological Conditions,35,60,3,1,4
Himachal Pradesh,Bilaspur,Chronic Neurological Conditions,60,80,1,0,1
Himachal Pradesh,Bilaspur,Chronic Neurological Conditions,80,100,0,1,1
Rajasthan,Bikaner,Chronic Neurological Conditions,6,15,1,0,1
Rajasthan,Bikaner,Chronic Neurological Conditions,15,35,5,3,8
Rajasthan,Bikaner,Chronic Neurological Conditions,35,60,3,3,6
Rajasthan,Bikaner,Chronic Neurological Conditions,60,80,1,1,2
Uttar Pradesh,Bijnor,Chronic Neurological Conditions,15,35,15,9,24
Uttar Pradesh,Bijnor,Chronic Neurological Conditions,35,60,21,4,25
Uttar Pradesh,Bijnor,Chronic Neurological Conditions,60,80,2,0,2
Chhattisgarh,Bijapur,Chronic Neurological Conditions,0,6,0,1,1
Chhattisgarh,Bijapur,Chronic Neurological Conditions,6,15,1,0,1
Chhattisgarh,Bijapur,Chronic Neurological Conditions,15,35,2,2,4
Chhattisgarh,Bijapur,Chronic Neurological Conditions,35,60,3,0,3
Karnataka,Bidar,Chronic Neurological Conditions,0,6,0,1,1
Karnataka,Bidar,Chronic Neurological Conditions,6,15,3,2,5
Karnataka,Bidar,Chronic Neurological Conditions,15,35,33,4,37
Karnataka,Bidar,Chronic Neurological Conditions,35,60,132,29,161
Karnataka,Bidar,Chronic Neurological Conditions,60,80,37,1,38
Karnataka,Bidar,Chronic Neurological Conditions,80,100,1,0,1
Madhya Pradesh,Bhopal,Chronic Neurological Conditions,6,15,0,1,1
Madhya Pradesh,Bhopal,Chronic Neurological Conditions,15,35,10,12,22
Madhya Pradesh,Bhopal,Chronic Neurological Conditions,35,60,29,6,35
Madhya Pradesh,Bhopal,Chronic Neurological Conditions,60,80,8,2,10
Bihar,Bhojpur,Chronic Neurological Conditions,6,15,4,1,5
Bihar,Bhojpur,Chronic Neurological Conditions,15,35,6,8,14
Bihar,Bhojpur,Chronic Neurological Conditions,35,60,15,3,18
Bihar,Bhojpur,Chronic Neurological Conditions,60,80,1,1,2
Haryana,Bhiwani,Chronic Neurological Conditions,0,6,1,0,1
Haryana,Bhiwani,Chronic Neurological Conditions,6,15,1,1,2
Haryana,Bhiwani,Chronic Neurological Conditions,15,35,3,1,4
Haryana,Bhiwani,Chronic Neurological Conditions,35,60,1,3,4
Madhya Pradesh,Bhind,Chronic Neurological Conditions,6,15,0,1,1
Madhya Pradesh,Bhind,Chronic Neurological Conditions,15,35,5,2,7
Madhya Pradesh,Bhind,Chronic Neurological Conditions,35,60,8,4,12
Rajasthan,Bhilwara,Chronic Neurological Conditions,6,15,1,1,2
Rajasthan,Bhilwara,Chronic Neurological Conditions,15,35,4,2,6
Rajasthan,Bhilwara,Chronic Neurological Conditions,35,60,5,1,6
Rajasthan,Bhilwara,Chronic Neurological Conditions,60,80,8,3,11
Gujarat,Bhavnagar,Chronic Neurological Conditions,6,15,1,0,1
Gujarat,Bhavnagar,Chronic Neurological Conditions,15,35,2,1,3
Gujarat,Bhavnagar,Chronic Neurological Conditions,35,60,2,4,6
Gujarat,Bharuch,Chronic Neurological Conditions,6,15,3,1,4
Gujarat,Bharuch,Chronic Neurological Conditions,15,35,2,0,2
Gujarat,Bharuch,Chronic Neurological Conditions,35,60,5,0,5
Gujarat,Bharuch,Chronic Neurological Conditions,60,80,2,0,2
Rajasthan,Bharatpur,Chronic Neurological Conditions,6,15,0,1,1
Rajasthan,Bharatpur,Chronic Neurological Conditions,15,35,4,2,6
Rajasthan,Bharatpur,Chronic Neurological Conditions,35,60,2,0,2
Maharashtra,Bhandara,Chronic Neurological Conditions,35,60,2,0,2
Bihar,Bhagalpur,Chronic Neurological Conditions,6,15,2,3,5
Bihar,Bhagalpur,Chronic Neurological Conditions,15,35,6,3,9
Bihar,Bhagalpur,Chronic Neurological Conditions,35,60,6,2,8
Bihar,Bhagalpur,Chronic Neurological Conditions,60,80,2,0,2
Odisha,Bhadrak,Chronic Neurological Conditions,0,6,3,3,6
Odisha,Bhadrak,Chronic Neurological Conditions,6,15,12,6,18
Odisha,Bhadrak,Chronic Neurological Conditions,15,35,21,10,31
Odisha,Bhadrak,Chronic Neurological Conditions,35,60,91,31,122
Odisha,Bhadrak,Chronic Neurological Conditions,60,80,24,17,41
Odisha,Bhadrak,Chronic Neurological Conditions,80,100,1,0,1
Uttar Pradesh,Bhadohi,Chronic Neurological Conditions,15,35,0,1,1
Uttar Pradesh,Bhadohi,Chronic Neurological Conditions,60,80,1,0,1
Madhya Pradesh,Betul,Chronic Neurological Conditions,15,35,1,2,3
Madhya Pradesh,Betul,Chronic Neurological Conditions,35,60,4,0,4
Madhya Pradesh,Betul,Chronic Neurological Conditions,60,80,4,0,4
Karnataka,Bengaluru Urban,Chronic Neurological Conditions,0,6,11,6,17
Karnataka,Bengaluru Urban,Chronic Neurological Conditions,6,15,41,27,68
Karnataka,Bengaluru Urban,Chronic Neurological Conditions,15,35,90,50,140
Karnataka,Bengaluru Urban,Chronic Neurological Conditions,35,60,291,60,351
Karnataka,Bengaluru Urban,Chronic Neurological Conditions,60,80,67,14,81
Karnataka,Bengaluru Urban,Chronic Neurological Conditions,80,100,5,2,7
Karnataka,Bengaluru Rural,Chronic Neurological Conditions,6,15,4,1,5
Karnataka,Bengaluru Rural,Chronic Neurological Conditions,15,35,5,2,7
Karnataka,Bengaluru Rural,Chronic Neurological Conditions,35,60,20,7,27
Karnataka,Bengaluru Rural,Chronic Neurological Conditions,60,80,8,4,12
Karnataka,Belagavi,Chronic Neurological Conditions,0,6,2,1,3
Karnataka,Belagavi,Chronic Neurological Conditions,6,15,8,6,14
Karnataka,Belagavi,Chronic Neurological Conditions,15,35,36,19,55
Karnataka,Belagavi,Chronic Neurological Conditions,35,60,117,35,152
Karnataka,Belagavi,Chronic Neurological Conditions,60,80,23,4,27
Karnataka,Belagavi,Chronic Neurological Conditions,80,100,1,0,1
Bihar,Begusarai,Chronic Neurological Conditions,6,15,1,3,4
Bihar,Begusarai,Chronic Neurological Conditions,15,35,9,3,12
Bihar,Begusarai,Chronic Neurological Conditions,35,60,3,1,4
Bihar,Begusarai,Chronic Neurological Conditions,60,80,1,0,1
Maharashtra,Beed,Chronic Neurological Conditions,0,6,1,1,2
Maharashtra,Beed,Chronic Neurological Conditions,6,15,36,14,50
Maharashtra,Beed,Chronic Neurological Conditions,15,35,145,56,201
Maharashtra,Beed,Chronic Neurological Conditions,35,60,290,94,384
Maharashtra,Beed,Chronic Neurological Conditions,60,80,112,38,150
Maharashtra,Beed,Chronic Neurological Conditions,80,100,5,5,10
Punjab,Bathinda,Chronic Neurological Conditions,0,6,2,0,2
Punjab,Bathinda,Chronic Neurological Conditions,6,15,3,3,6
Punjab,Bathinda,Chronic Neurological Conditions,15,35,20,8,28
Punjab,Bathinda,Chronic Neurological Conditions,35,60,65,11,76
Punjab,Bathinda,Chronic Neurological Conditions,60,80,16,2,18
Uttar Pradesh,Basti,Chronic Neurological Conditions,0,6,0,1,1
Uttar Pradesh,Basti,Chronic Neurological Conditions,15,35,11,5,16
Uttar Pradesh,Basti,Chronic Neurological Conditions,35,60,14,3,17
Uttar Pradesh,Basti,Chronic Neurological Conditions,60,80,11,0,11
Chhattisgarh,Bastar,Chronic Neurological Conditions,6,15,4,0,4
Chhattisgarh,Bastar,Chronic Neurological Conditions,15,35,9,3,12
Chhattisgarh,Bastar,Chronic Neurological Conditions,35,60,8,4,12
Chhattisgarh,Bastar,Chronic Neurological Conditions,60,80,6,1,7
Madhya Pradesh,Barwani,Chronic Neurological Conditions,15,35,3,2,5
Madhya Pradesh,Barwani,Chronic Neurological Conditions,35,60,7,3,10
Madhya Pradesh,Barwani,Chronic Neurological Conditions,60,80,4,1,5
Assam,Barpeta,Chronic Neurological Conditions,0,6,1,1,2
Assam,Barpeta,Chronic Neurological Conditions,6,15,8,5,13
Assam,Barpeta,Chronic Neurological Conditions,15,35,12,7,19
Assam,Barpeta,Chronic Neurological Conditions,35,60,15,8,23
Assam,Barpeta,Chronic Neurological Conditions,60,80,5,3,8
Punjab,Barnala,Chronic Neurological Conditions,0,6,0,1,1
Punjab,Barnala,Chronic Neurological Conditions,6,15,4,0,4
Punjab,Barnala,Chronic Neurological Conditions,15,35,18,4,22
Punjab,Barnala,Chronic Neurological Conditions,35,60,56,10,66
Punjab,Barnala,Chronic Neurological Conditions,60,80,31,5,36
Punjab,Barnala,Chronic Neurological Conditions,80,100,2,0,2
Rajasthan,Barmer,Chronic Neurological Conditions,0,6,1,0,1
Rajasthan,Barmer,Chronic Neurological Conditions,6,15,1,2,3
Rajasthan,Barmer,Chronic Neurological Conditions,15,35,3,1,4
Rajasthan,Barmer,Chronic Neurological Conditions,35,60,8,1,9
Rajasthan,Barmer,Chronic Neurological Conditions,60,80,1,1,2
Odisha,Bargarh,Chronic Neurological Conditions,0,6,1,0,1
Odisha,Bargarh,Chronic Neurological Conditions,15,35,0,2,2
Odisha,Bargarh,Chronic Neurological Conditions,35,60,8,4,12
Odisha,Bargarh,Chronic Neurological Conditions,60,80,2,1,3
Uttar Pradesh,Bareilly,Chronic Neurological Conditions,15,35,10,5,15
Uttar Pradesh,Bareilly,Chronic Neurological Conditions,35,60,10,4,14
Uttar Pradesh,Bareilly,Chronic Neurological Conditions,60,80,4,1,5
Rajasthan,Baran,Chronic Neurological Conditions,0,6,1,1,2
Rajasthan,Baran,Chronic Neurological Conditions,6,15,6,1,7
Rajasthan,Baran,Chronic Neurological Conditions,15,35,7,4,11
Rajasthan,Baran,Chronic Neurological Conditions,35,60,2,1,3
Rajasthan,Baran,Chronic Neurological Conditions,60,80,1,0,1
Jammu And Kashmir,Baramulla,Chronic Neurological Conditions,0,6,11,6,17
Jammu And Kashmir,Baramulla,Chronic Neurological Conditions,6,15,37,19,56
Jammu And Kashmir,Baramulla,Chronic Neurological Conditions,15,35,33,31,64
Jammu And Kashmir,Baramulla,Chronic Neurological Conditions,35,60,32,29,61
Jammu And Kashmir,Baramulla,Chronic Neurological Conditions,60,80,5,2,7
Uttar Pradesh,Barabanki,Chronic Neurological Conditions,0,6,1,0,1
Uttar Pradesh,Barabanki,Chronic Neurological Conditions,6,15,2,5,7
Uttar Pradesh,Barabanki,Chronic Neurological Conditions,15,35,44,12,56
Uttar Pradesh,Barabanki,Chronic Neurological Conditions,35,60,52,11,63
Uttar Pradesh,Barabanki,Chronic Neurological Conditions,60,80,11,0,11
Uttar Pradesh,Barabanki,Chronic Neurological Conditions,80,100,1,0,1
Rajasthan,Banswara,Chronic Neurological Conditions,15,35,2,1,3
Bihar,Banka,Chronic Neurological Conditions,0,6,1,0,1
Bihar,Banka,Chronic Neurological Conditions,6,15,3,2,5
Bihar,Banka,Chronic Neurological Conditions,15,35,9,8,17
Bihar,Banka,Chronic Neurological Conditions,35,60,11,3,14
Bihar,Banka,Chronic Neurological Conditions,60,80,3,0,3
Bihar,Banka,Chronic Neurological Conditions,80,100,3,0,3
Jammu And Kashmir,Bandipora,Chronic Neurological Conditions,0,6,5,4,9
Jammu And Kashmir,Bandipora,Chronic Neurological Conditions,6,15,26,17,43
Jammu And Kashmir,Bandipora,Chronic Neurological Conditions,15,35,48,37,85
Jammu And Kashmir,Bandipora,Chronic Neurological Conditions,35,60,41,42,83
Jammu And Kashmir,Bandipora,Chronic Neurological Conditions,60,80,6,4,10
Jammu And Kashmir,Bandipora,Chronic Neurological Conditions,80,100,0,1,1
Uttar Pradesh,Banda,Chronic Neurological Conditions,15,35,3,1,4
Uttar Pradesh,Banda,Chronic Neurological Conditions,35,60,6,1,7
Uttar Pradesh,Banda,Chronic Neurological Conditions,60,80,4,1,5
Gujarat,Banas Kantha,Chronic Neurological Conditions,15,35,2,1,3
Gujarat,Banas Kantha,Chronic Neurological Conditions,35,60,7,0,7
Gujarat,Banas Kantha,Chronic Neurological Conditions,60,80,0,1,1
Chhattisgarh,Balrampur,Chronic Neurological Conditions,15,35,3,2,5
Chhattisgarh,Balrampur,Chronic Neurological Conditions,35,60,1,0,1
Uttar Pradesh,Balrampur,Chronic Neurological Conditions,6,15,4,3,7
Uttar Pradesh,Balrampur,Chronic Neurological Conditions,15,35,31,8,39
Uttar Pradesh,Balrampur,Chronic Neurological Conditions,35,60,45,7,52
Uttar Pradesh,Balrampur,Chronic Neurological Conditions,60,80,10,0,10
Uttar Pradesh,Balrampur,Chronic Neurological Conditions,80,100,1,0,1
Chhattisgarh,Baloda Bazar,Chronic Neurological Conditions,15,35,2,3,5
Chhattisgarh,Baloda Bazar,Chronic Neurological Conditions,35,60,9,2,11
Chhattisgarh,Baloda Bazar,Chronic Neurological Conditions,60,80,1,0,1
Chhattisgarh,Balod,Chronic Neurological Conditions,15,35,3,1,4
Chhattisgarh,Balod,Chronic Neurological Conditions,35,60,6,1,7
Chhattisgarh,Balod,Chronic Neurological Conditions,60,80,1,1,2
Uttar Pradesh,Ballia,Chronic Neurological Conditions,6,15,1,0,1
Uttar Pradesh,Ballia,Chronic Neurological Conditions,15,35,5,3,8
Uttar Pradesh,Ballia,Chronic Neurological Conditions,35,60,14,3,17
Uttar Pradesh,Ballia,Chronic Neurological Conditions,60,80,8,0,8
Karnataka,Ballari,Chronic Neurological Conditions,0,6,4,3,7
Karnataka,Ballari,Chronic Neurological Conditions,6,15,6,6,12
Karnataka,Ballari,Chronic Neurological Conditions,15,35,71,50,121
Karnataka,Ballari,Chronic Neurological Conditions,35,60,138,43,181
Karnataka,Ballari,Chronic Neurological Conditions,60,80,23,7,30
Karnataka,Ballari,Chronic Neurological Conditions,80,100,1,0,1
Odisha,Baleshwar,Chronic Neurological Conditions,0,6,5,2,7
Odisha,Baleshwar,Chronic Neurological Conditions,6,15,13,12,25
Odisha,Baleshwar,Chronic Neurological Conditions,15,35,25,14,39
Odisha,Baleshwar,Chronic Neurological Conditions,35,60,79,46,125
Odisha,Baleshwar,Chronic Neurological Conditions,60,80,29,10,39
Odisha,Baleshwar,Chronic Neurological Conditions,80,100,1,1,2
Odisha,Balangir,Chronic Neurological Conditions,0,6,1,3,4
Odisha,Balangir,Chronic Neurological Conditions,6,15,9,4,13
Odisha,Balangir,Chronic Neurological Conditions,15,35,11,5,16
Odisha,Balangir,Chronic Neurological Conditions,35,60,31,12,43
Odisha,Balangir,Chronic Neurological Conditions,60,80,6,2,8
Madhya Pradesh,Balaghat,Chronic Neurological Conditions,15,35,1,0,1
Assam,Baksa,Chronic Neurological Conditions,0,6,1,0,1
Assam,Baksa,Chronic Neurological Conditions,35,60,1,1,2
Assam,Bajali,Chronic Neurological Conditions,35,60,1,1,2
Uttar Pradesh,Bahraich,Chronic Neurological Conditions,6,15,1,0,1
Uttar Pradesh,Bahraich,Chronic Neurological Conditions,15,35,5,3,8
Uttar Pradesh,Bahraich,Chronic Neurological Conditions,35,60,18,2,20
Uttar Pradesh,Bahraich,Chronic Neurological Conditions,60,80,5,1,6
Uttar Pradesh,Baghpat,Chronic Neurological Conditions,6,15,1,1,2
Uttar Pradesh,Baghpat,Chronic Neurological Conditions,15,35,3,1,4
Uttar Pradesh,Baghpat,Chronic Neurological Conditions,35,60,6,1,7
Uttar Pradesh,Baghpat,Chronic Neurological Conditions,60,80,1,0,1
Uttarakhand,Bageshwar,Chronic Neurological Conditions,15,35,1,1,2
Uttarakhand,Bageshwar,Chronic Neurological Conditions,35,60,2,2,4
Uttarakhand,Bageshwar,Chronic Neurological Conditions,60,80,1,1,2
Karnataka,Bagalkote,Chronic Neurological Conditions,6,15,14,6,20
Karnataka,Bagalkote,Chronic Neurological Conditions,15,35,46,28,74
Karnataka,Bagalkote,Chronic Neurological Conditions,35,60,55,27,82
Karnataka,Bagalkote,Chronic Neurological Conditions,60,80,11,4,15
Uttar Pradesh,Azamgarh,Chronic Neurological Conditions,35,60,2,0,2
Uttar Pradesh,Ayodhya,Chronic Neurological Conditions,15,35,6,2,8
Uttar Pradesh,Ayodhya,Chronic Neurological Conditions,35,60,15,1,16
Uttar Pradesh,Ayodhya,Chronic Neurological Conditions,60,80,8,3,11
Bihar,Aurangabad,Chronic Neurological Conditions,6,15,2,1,3
Bihar,Aurangabad,Chronic Neurological Conditions,15,35,6,3,9
Bihar,Aurangabad,Chronic Neurological Conditions,35,60,14,7,21
Bihar,Aurangabad,Chronic Neurological Conditions,60,80,3,1,4
Maharashtra,Aurangabad,Chronic Neurological Conditions,0,6,1,0,1
Maharashtra,Aurangabad,Chronic Neurological Conditions,6,15,0,1,1
Maharashtra,Aurangabad,Chronic Neurological Conditions,15,35,20,11,31
Maharashtra,Aurangabad,Chronic Neurological Conditions,35,60,41,10,51
Maharashtra,Aurangabad,Chronic Neurological Conditions,60,80,9,1,10
Uttar Pradesh,Auraiya,Chronic Neurological Conditions,0,6,1,0,1
Uttar Pradesh,Auraiya,Chronic Neurological Conditions,6,15,3,0,3
Uttar Pradesh,Auraiya,Chronic Neurological Conditions,15,35,6,2,8
Uttar Pradesh,Auraiya,Chronic Neurological Conditions,35,60,15,2,17
Uttar Pradesh,Auraiya,Chronic Neurological Conditions,60,80,3,0,3
Bihar,Arwal,Chronic Neurological Conditions,15,35,1,0,1
Bihar,Arwal,Chronic Neurological Conditions,35,60,1,0,1
Gujarat,Arvalli,Chronic Neurological Conditions,15,35,0,1,1
Tamil Nadu,Ariyalur,Chronic Neurological Conditions,0,6,0,2,2
Tamil Nadu,Ariyalur,Chronic Neurological Conditions,6,15,1,2,3
Tamil Nadu,Ariyalur,Chronic Neurological Conditions,15,35,5,3,8
Tamil Nadu,Ariyalur,Chronic Neurological Conditions,35,60,11,2,13
Tamil Nadu,Ariyalur,Chronic Neurological Conditions,60,80,3,1,4
Bihar,Araria,Chronic Neurological Conditions,6,15,1,1,2
Bihar,Araria,Chronic Neurological Conditions,15,35,5,2,7
Bihar,Araria,Chronic Neurological Conditions,35,60,3,0,3
Bihar,Araria,Chronic Neurological Conditions,60,80,1,0,1
Madhya Pradesh,Anuppur,Chronic Neurological Conditions,6,15,1,1,2
Madhya Pradesh,Anuppur,Chronic Neurological Conditions,15,35,1,1,2
Madhya Pradesh,Anuppur,Chronic Neurological Conditions,35,60,5,0,5
Odisha,Anugul,Chronic Neurological Conditions,0,6,2,0,2
Odisha,Anugul,Chronic Neurological Conditions,6,15,9,2,11
Odisha,Anugul,Chronic Neurological Conditions,15,35,8,11,19
Odisha,Anugul,Chronic Neurological Conditions,35,60,49,21,70
Odisha,Anugul,Chronic Neurological Conditions,60,80,22,7,29
Jammu And Kashmir,Anantnag,Chronic Neurological Conditions,0,6,43,31,74
Jammu And Kashmir,Anantnag,Chronic Neurological Conditions,6,15,128,97,225
Jammu And Kashmir,Anantnag,Chronic Neurological Conditions,15,35,239,190,429
Jammu And Kashmir,Anantnag,Chronic Neurological Conditions,35,60,354,196,550
Jammu And Kashmir,Anantnag,Chronic Neurological Conditions,60,80,79,56,135
Jammu And Kashmir,Anantnag,Chronic Neurological Conditions,80,100,4,3,7
Andhra Pradesh,Anantapur,Chronic Neurological Conditions,15,35,1,0,1
Gujarat,Anand,Chronic Neurological Conditions,6,15,1,0,1
Gujarat,Anand,Chronic Neurological Conditions,15,35,1,0,1
Gujarat,Anand,Chronic Neurological Conditions,35,60,0,2,2
Gujarat,Anand,Chronic Neurological Conditions,60,80,2,0,2
Uttar Pradesh,Amroha,Chronic Neurological Conditions,15,35,9,2,11
Uttar Pradesh,Amroha,Chronic Neurological Conditions,35,60,5,0,5
Uttar Pradesh,Amroha,Chronic Neurological Conditions,60,80,1,1,2
Punjab,Amritsar,Chronic Neurological Conditions,6,15,24,9,33
Punjab,Amritsar,Chronic Neurological Conditions,15,35,110,35,145
Punjab,Amritsar,Chronic Neurological Conditions,35,60,285,77,362
Punjab,Amritsar,Chronic Neurological Conditions,60,80,126,14,140
Punjab,Amritsar,Chronic Neurological Conditions,80,100,3,2,5
Gujarat,Amreli,Chronic Neurological Conditions,15,35,1,2,3
Gujarat,Amreli,Chronic Neurological Conditions,35,60,2,0,2
Maharashtra,Amravati,Chronic Neurological Conditions,35,60,1,0,1
Maharashtra,Amravati,Chronic Neurological Conditions,60,80,1,0,1
Uttar Pradesh,Amethi,Chronic Neurological Conditions,6,15,1,0,1
Uttar Pradesh,Amethi,Chronic Neurological Conditions,15,35,10,2,12
Uttar Pradesh,Amethi,Chronic Neurological Conditions,35,60,16,0,16
Uttar Pradesh,Amethi,Chronic Neurological Conditions,60,80,9,1,10
Uttar Pradesh,Ambedkar Nagar,Chronic Neurological Conditions,6,15,1,0,1
Uttar Pradesh,Ambedkar Nagar,Chronic Neurological Conditions,15,35,10,1,11
Uttar Pradesh,Ambedkar Nagar,Chronic Neurological Conditions,35,60,15,5,20
Uttar Pradesh,Ambedkar Nagar,Chronic Neurological Conditions,60,80,9,0,9
Haryana,Ambala,Chronic Neurological Conditions,15,35,4,0,4
Haryana,Ambala,Chronic Neurological Conditions,35,60,12,3,15
Haryana,Ambala,Chronic Neurological Conditions,60,80,0,1,1
Rajasthan,Alwar,Chronic Neurological Conditions,6,15,3,1,4
Rajasthan,Alwar,Chronic Neurological Conditions,15,35,10,1,11
Rajasthan,Alwar,Chronic Neurological Conditions,35,60,9,6,15
Rajasthan,Alwar,Chronic Neurological Conditions,60,80,4,1,5
Uttarakhand,Almora,Chronic Neurological Conditions,15,35,1,0,1
Uttarakhand,Almora,Chronic Neurological Conditions,35,60,2,1,3
Uttarakhand,Almora,Chronic Neurological Conditions,60,80,1,0,1
Madhya Pradesh,Alirajpur,Chronic Neurological Conditions,35,60,2,0,2
Uttar Pradesh,Aligarh,Chronic Neurological Conditions,6,15,0,1,1
Uttar Pradesh,Aligarh,Chronic Neurological Conditions,15,35,7,3,10
Uttar Pradesh,Aligarh,Chronic Neurological Conditions,35,60,7,1,8
Kerala,Alappuzha,Chronic Neurological Conditions,0,6,3,2,5
Kerala,Alappuzha,Chronic Neurological Conditions,6,15,8,5,13
Kerala,Alappuzha,Chronic Neurological Conditions,15,35,26,9,35
Kerala,Alappuzha,Chronic Neurological Conditions,35,60,36,21,57
Kerala,Alappuzha,Chronic Neurological Conditions,60,80,11,7,18
Maharashtra,Akola,Chronic Neurological Conditions,0,6,5,1,6
Maharashtra,Akola,Chronic Neurological Conditions,6,15,23,4,27
Maharashtra,Akola,Chronic Neurological Conditions,15,35,105,45,150
Maharashtra,Akola,Chronic Neurological Conditions,35,60,285,102,387
Maharashtra,Akola,Chronic Neurological Conditions,60,80,163,39,202
Maharashtra,Akola,Chronic Neurological Conditions,80,100,5,1,6
Rajasthan,Ajmer,Chronic Neurological Conditions,15,35,7,1,8
Rajasthan,Ajmer,Chronic Neurological Conditions,35,60,8,2,10
Rajasthan,Ajmer,Chronic Neurological Conditions,60,80,2,0,2
Rajasthan,Ajmer,Chronic Neurological Conditions,80,100,1,1,2
Mizoram,Aizawl,Chronic Neurological Conditions,0,6,0,2,2
Mizoram,Aizawl,Chronic Neurological Conditions,6,15,2,0,2
Mizoram,Aizawl,Chronic Neurological Conditions,15,35,9,8,17
Mizoram,Aizawl,Chronic Neurological Conditions,35,60,13,7,20
Mizoram,Aizawl,Chronic Neurological Conditions,60,80,6,5,11
Mizoram,Aizawl,Chronic Neurological Conditions,80,100,0,2,2
Maharashtra,Ahmednagar,Chronic Neurological Conditions,6,15,1,1,2
Maharashtra,Ahmednagar,Chronic Neurological Conditions,15,35,6,4,10
Maharashtra,Ahmednagar,Chronic Neurological Conditions,35,60,5,0,5
Maharashtra,Ahmednagar,Chronic Neurological Conditions,60,80,2,1,3
Gujarat,Ahmadabad,Chronic Neurological Conditions,0,6,1,0,1
Gujarat,Ahmadabad,Chronic Neurological Conditions,6,15,3,0,3
Gujarat,Ahmadabad,Chronic Neurological Conditions,15,35,15,5,20
Gujarat,Ahmadabad,Chronic Neurological Conditions,35,60,13,3,16
Gujarat,Ahmadabad,Chronic Neurological Conditions,60,80,17,3,20
Gujarat,Ahmadabad,Chronic Neurological Conditions,80,100,2,0,2
Uttar Pradesh,Agra,Chronic Neurological Conditions,0,6,0,1,1
Uttar Pradesh,Agra,Chronic Neurological Conditions,6,15,0,2,2
Uttar Pradesh,Agra,Chronic Neurological Conditions,15,35,1,3,4
Uttar Pradesh,Agra,Chronic Neurological Conditions,35,60,5,0,5
Uttar Pradesh,Agra,Chronic Neurological Conditions,60,80,1,0,1
Madhya Pradesh,Agar Malwa,Chronic Neurological Conditions,6,15,1,0,1
Madhya Pradesh,Agar Malwa,Chronic Neurological Conditions,15,35,4,2,6
Madhya Pradesh,Agar Malwa,Chronic Neurological Conditions,35,60,5,0,5
Madhya Pradesh,Agar Malwa,Chronic Neurological Conditions,60,80,1,0,1
West Bengal,24 Paraganas South,Chronic Neurological Conditions,15,35,2,3,5
Nagaland,Zunheboto,Hearing Impairment,15,35,0,1,1
Nagaland,Zunheboto,Hearing Impairment,35,60,0,1,1
Maharashtra,Yavatmal,Hearing Impairment,0,6,73,50,123
Maharashtra,Yavatmal,Hearing Impairment,6,15,233,170,403
Maharashtra,Yavatmal,Hearing Impairment,15,35,516,351,867
Maharashtra,Yavatmal,Hearing Impairment,35,60,510,229,739
Maharashtra,Yavatmal,Hearing Impairment,60,80,288,72,360
Maharashtra,Yavatmal,Hearing Impairment,80,100,47,6,53
Puducherry,Yanam,Hearing Impairment,0,6,1,0,1
Puducherry,Yanam,Hearing Impairment,6,15,3,2,5
Puducherry,Yanam,Hearing Impairment,15,35,12,22,34
Puducherry,Yanam,Hearing Impairment,35,60,18,12,30
Puducherry,Yanam,Hearing Impairment,60,80,9,4,13
Puducherry,Yanam,Hearing Impairment,80,100,3,0,3
Haryana,Yamunanagar,Hearing Impairment,0,6,14,16,30
Haryana,Yamunanagar,Hearing Impairment,6,15,90,75,165
Haryana,Yamunanagar,Hearing Impairment,15,35,150,98,248
Haryana,Yamunanagar,Hearing Impairment,35,60,93,55,148
Haryana,Yamunanagar,Hearing Impairment,60,80,31,20,51
Haryana,Yamunanagar,Hearing Impairment,80,100,3,0,3
Karnataka,Yadgir,Hearing Impairment,0,6,11,9,20
Karnataka,Yadgir,Hearing Impairment,6,15,95,73,168
Karnataka,Yadgir,Hearing Impairment,15,35,145,118,263
Karnataka,Yadgir,Hearing Impairment,35,60,103,64,167
Karnataka,Yadgir,Hearing Impairment,60,80,29,9,38
Karnataka,Yadgir,Hearing Impairment,80,100,2,0,2
Telangana,Yadadri Bhuvanagiri,Hearing Impairment,6,15,44,31,75
Telangana,Yadadri Bhuvanagiri,Hearing Impairment,15,35,226,218,444
Telangana,Yadadri Bhuvanagiri,Hearing Impairment,35,60,326,288,614
Telangana,Yadadri Bhuvanagiri,Hearing Impairment,60,80,144,139,283
Telangana,Yadadri Bhuvanagiri,Hearing Impairment,80,100,31,17,48
Andhra Pradesh,Y.S.R.,Hearing Impairment,0,6,24,21,45
Andhra Pradesh,Y.S.R.,Hearing Impairment,6,15,147,80,227
Andhra Pradesh,Y.S.R.,Hearing Impairment,15,35,654,541,1195
Andhra Pradesh,Y.S.R.,Hearing Impairment,35,60,1983,758,2741
Andhra Pradesh,Y.S.R.,Hearing Impairment,60,80,832,202,1034
Andhra Pradesh,Y.S.R.,Hearing Impairment,80,100,88,15,103
Nagaland,Wokha,Hearing Impairment,0,6,1,0,1
Nagaland,Wokha,Hearing Impairment,6,15,1,0,1
Nagaland,Wokha,Hearing Impairment,15,35,6,2,8
Nagaland,Wokha,Hearing Impairment,35,60,2,4,6
Nagaland,Wokha,Hearing Impairment,60,80,2,0,2
Tripura,West Tripura,Hearing Impairment,0,6,7,9,16
Tripura,West Tripura,Hearing Impairment,6,15,63,49,112
Tripura,West Tripura,Hearing Impairment,15,35,147,113,260
Tripura,West Tripura,Hearing Impairment,35,60,285,213,498
Tripura,West Tripura,Hearing Impairment,60,80,211,128,339
Tripura,West Tripura,Hearing Impairment,80,100,32,35,67
Jharkhand,West Singhbhum,Hearing Impairment,0,6,4,3,7
Jharkhand,West Singhbhum,Hearing Impairment,6,15,120,105,225
Jharkhand,West Singhbhum,Hearing Impairment,15,35,200,189,389
Jharkhand,West Singhbhum,Hearing Impairment,35,60,135,110,245
Jharkhand,West Singhbhum,Hearing Impairment,60,80,22,10,32
Jharkhand,West Singhbhum,Hearing Impairment,80,100,2,2,4
Arunachal Pradesh,West Siang,Hearing Impairment,6,15,1,0,1
Arunachal Pradesh,West Siang,Hearing Impairment,15,35,6,13,19
Arunachal Pradesh,West Siang,Hearing Impairment,35,60,6,4,10
Arunachal Pradesh,West Siang,Hearing Impairment,60,80,4,0,4
Meghalaya,West Khasi Hills,Hearing Impairment,0,6,4,2,6
Meghalaya,West Khasi Hills,Hearing Impairment,6,15,19,23,42
Meghalaya,West Khasi Hills,Hearing Impairment,15,35,104,104,208
Meghalaya,West Khasi Hills,Hearing Impairment,35,60,49,61,110
Meghalaya,West Khasi Hills,Hearing Impairment,60,80,25,15,40
Meghalaya,West Khasi Hills,Hearing Impairment,80,100,12,5,17
Assam,West Karbi Anglong,Hearing Impairment,0,6,1,0,1
Assam,West Karbi Anglong,Hearing Impairment,6,15,6,4,10
Assam,West Karbi Anglong,Hearing Impairment,15,35,14,16,30
Assam,West Karbi Anglong,Hearing Impairment,35,60,20,34,54
Assam,West Karbi Anglong,Hearing Impairment,60,80,4,18,22
Assam,West Karbi Anglong,Hearing Impairment,80,100,1,1,2
Arunachal Pradesh,West Kameng,Hearing Impairment,15,35,0,1,1
Arunachal Pradesh,West Kameng,Hearing Impairment,35,60,1,0,1
Meghalaya,West Jaintia Hills,Hearing Impairment,0,6,3,1,4
Meghalaya,West Jaintia Hills,Hearing Impairment,6,15,41,19,60
Meghalaya,West Jaintia Hills,Hearing Impairment,15,35,95,109,204
Meghalaya,West Jaintia Hills,Hearing Impairment,35,60,58,72,130
Meghalaya,West Jaintia Hills,Hearing Impairment,60,80,20,31,51
Meghalaya,West Jaintia Hills,Hearing Impairment,80,100,4,4,8
Andhra Pradesh,West Godavari,Hearing Impairment,0,6,29,29,58
Andhra Pradesh,West Godavari,Hearing Impairment,6,15,170,147,317
Andhra Pradesh,West Godavari,Hearing Impairment,15,35,735,437,1172
Andhra Pradesh,West Godavari,Hearing Impairment,35,60,1647,646,2293
Andhra Pradesh,West Godavari,Hearing Impairment,60,80,657,249,906
Andhra Pradesh,West Godavari,Hearing Impairment,80,100,73,24,97
Meghalaya,West Garo Hills,Hearing Impairment,0,6,5,6,11
Meghalaya,West Garo Hills,Hearing Impairment,6,15,42,45,87
Meghalaya,West Garo Hills,Hearing Impairment,15,35,259,229,488
Meghalaya,West Garo Hills,Hearing Impairment,35,60,202,189,391
Meghalaya,West Garo Hills,Hearing Impairment,60,80,64,38,102
Meghalaya,West Garo Hills,Hearing Impairment,80,100,14,2,16
Delhi,West,Hearing Impairment,0,6,39,27,66
Delhi,West,Hearing Impairment,6,15,107,110,217
Delhi,West,Hearing Impairment,15,35,293,145,438
Delhi,West,Hearing Impairment,35,60,148,97,245
Delhi,West,Hearing Impairment,60,80,62,28,90
Delhi,West,Hearing Impairment,80,100,8,9,17
Kerala,Wayanad,Hearing Impairment,0,6,8,6,14
Kerala,Wayanad,Hearing Impairment,6,15,41,36,77
Kerala,Wayanad,Hearing Impairment,15,35,106,82,188
Kerala,Wayanad,Hearing Impairment,35,60,146,142,288
Kerala,Wayanad,Hearing Impairment,60,80,68,41,109
Kerala,Wayanad,Hearing Impairment,80,100,1,2,3
Maharashtra,Washim,Hearing Impairment,0,6,21,15,36
Maharashtra,Washim,Hearing Impairment,6,15,166,97,263
Maharashtra,Washim,Hearing Impairment,15,35,552,252,804
Maharashtra,Washim,Hearing Impairment,35,60,665,342,1007
Maharashtra,Washim,Hearing Impairment,60,80,297,149,446
Maharashtra,Washim,Hearing Impairment,80,100,28,5,33
Maharashtra,Wardha,Hearing Impairment,0,6,31,19,50
Maharashtra,Wardha,Hearing Impairment,6,15,169,138,307
Maharashtra,Wardha,Hearing Impairment,15,35,427,234,661
Maharashtra,Wardha,Hearing Impairment,35,60,390,173,563
Maharashtra,Wardha,Hearing Impairment,60,80,213,39,252
Maharashtra,Wardha,Hearing Impairment,80,100,33,1,34
Telangana,Warangal,Hearing Impairment,6,15,28,34,62
Telangana,Warangal,Hearing Impairment,15,35,220,193,413
Telangana,Warangal,Hearing Impairment,35,60,260,240,500
Telangana,Warangal,Hearing Impairment,60,80,76,68,144
Telangana,Warangal,Hearing Impairment,80,100,14,5,19
Telangana,Wanaparthy,Hearing Impairment,6,15,24,26,50
Telangana,Wanaparthy,Hearing Impairment,15,35,253,179,432
Telangana,Wanaparthy,Hearing Impairment,35,60,237,237,474
Telangana,Wanaparthy,Hearing Impairment,60,80,64,45,109
Telangana,Wanaparthy,Hearing Impairment,80,100,14,4,18
Andhra Pradesh,Vizianagaram,Hearing Impairment,0,6,20,13,33
Andhra Pradesh,Vizianagaram,Hearing Impairment,6,15,134,97,231
Andhra Pradesh,Vizianagaram,Hearing Impairment,15,35,903,619,1522
Andhra Pradesh,Vizianagaram,Hearing Impairment,35,60,1889,636,2525
Andhra Pradesh,Vizianagaram,Hearing Impairment,60,80,1051,171,1222
Andhra Pradesh,Vizianagaram,Hearing Impairment,80,100,65,11,76
Andhra Pradesh,Visakhapatanam,Hearing Impairment,0,6,24,24,48
Andhra Pradesh,Visakhapatanam,Hearing Impairment,6,15,234,184,418
Andhra Pradesh,Visakhapatanam,Hearing Impairment,15,35,931,572,1503
Andhra Pradesh,Visakhapatanam,Hearing Impairment,35,60,1157,379,1536
Andhra Pradesh,Visakhapatanam,Hearing Impairment,60,80,396,71,467
Andhra Pradesh,Visakhapatanam,Hearing Impairment,80,100,24,12,36
Tamil Nadu,Virudhunagar,Hearing Impairment,0,6,23,23,46
Tamil Nadu,Virudhunagar,Hearing Impairment,6,15,111,101,212
Tamil Nadu,Virudhunagar,Hearing Impairment,15,35,441,385,826
Tamil Nadu,Virudhunagar,Hearing Impairment,35,60,603,426,1029
Tamil Nadu,Virudhunagar,Hearing Impairment,60,80,223,117,340
Tamil Nadu,Virudhunagar,Hearing Impairment,80,100,20,4,24
Tamil Nadu,Villupuram,Hearing Impairment,0,6,14,14,28
Tamil Nadu,Villupuram,Hearing Impairment,6,15,170,129,299
Tamil Nadu,Villupuram,Hearing Impairment,15,35,510,459,969
Tamil Nadu,Villupuram,Hearing Impairment,35,60,789,737,1526
Tamil Nadu,Villupuram,Hearing Impairment,60,80,525,343,868
Tamil Nadu,Villupuram,Hearing Impairment,80,100,84,15,99
Telangana,Vikarabad,Hearing Impairment,6,15,60,43,103
Telangana,Vikarabad,Hearing Impairment,15,35,262,247,509
Telangana,Vikarabad,Hearing Impairment,35,60,260,233,493
Telangana,Vikarabad,Hearing Impairment,60,80,93,60,153
Telangana,Vikarabad,Hearing Impairment,80,100,4,2,6
Karnataka,Vijayapura,Hearing Impairment,0,6,41,50,91
Karnataka,Vijayapura,Hearing Impairment,6,15,277,228,505
Karnataka,Vijayapura,Hearing Impairment,15,35,498,368,866
Karnataka,Vijayapura,Hearing Impairment,35,60,419,346,765
Karnataka,Vijayapura,Hearing Impairment,60,80,66,31,97
Karnataka,Vijayapura,Hearing Impairment,80,100,1,3,4
Karnataka,Vijayanagar,Hearing Impairment,0,6,1,0,1
Karnataka,Vijayanagar,Hearing Impairment,6,15,1,0,1
Madhya Pradesh,Vidisha,Hearing Impairment,0,6,10,6,16
Madhya Pradesh,Vidisha,Hearing Impairment,6,15,65,47,112
Madhya Pradesh,Vidisha,Hearing Impairment,15,35,220,133,353
Madhya Pradesh,Vidisha,Hearing Impairment,35,60,205,84,289
Madhya Pradesh,Vidisha,Hearing Impairment,60,80,220,72,292
Madhya Pradesh,Vidisha,Hearing Impairment,80,100,50,16,66
Tamil Nadu,Vellore,Hearing Impairment,0,6,17,9,26
Tamil Nadu,Vellore,Hearing Impairment,6,15,155,136,291
Tamil Nadu,Vellore,Hearing Impairment,15,35,558,398,956
Tamil Nadu,Vellore,Hearing Impairment,35,60,722,556,1278
Tamil Nadu,Vellore,Hearing Impairment,60,80,385,184,569
Tamil Nadu,Vellore,Hearing Impairment,80,100,31,9,40
Uttar Pradesh,Varanasi,Hearing Impairment,0,6,30,25,55
Uttar Pradesh,Varanasi,Hearing Impairment,6,15,171,133,304
Uttar Pradesh,Varanasi,Hearing Impairment,15,35,594,392,986
Uttar Pradesh,Varanasi,Hearing Impairment,35,60,303,176,479
Uttar Pradesh,Varanasi,Hearing Impairment,60,80,58,11,69
Uttar Pradesh,Varanasi,Hearing Impairment,80,100,2,0,2
Gujarat,Valsad,Hearing Impairment,0,6,2,0,2
Gujarat,Valsad,Hearing Impairment,6,15,38,26,64
Gujarat,Valsad,Hearing Impairment,15,35,123,90,213
Gujarat,Valsad,Hearing Impairment,35,60,35,18,53
Gujarat,Valsad,Hearing Impairment,60,80,16,5,21
Gujarat,Valsad,Hearing Impairment,80,100,6,0,6
Bihar,Vaishali,Hearing Impairment,0,6,9,11,20
Bihar,Vaishali,Hearing Impairment,6,15,104,89,193
Bihar,Vaishali,Hearing Impairment,15,35,119,54,173
Bihar,Vaishali,Hearing Impairment,35,60,40,26,66
Bihar,Vaishali,Hearing Impairment,60,80,11,3,14
Bihar,Vaishali,Hearing Impairment,80,100,1,0,1
Gujarat,Vadodara,Hearing Impairment,0,6,39,36,75
Gujarat,Vadodara,Hearing Impairment,6,15,219,224,443
Gujarat,Vadodara,Hearing Impairment,15,35,606,378,984
Gujarat,Vadodara,Hearing Impairment,35,60,383,258,641
Gujarat,Vadodara,Hearing Impairment,60,80,144,52,196
Gujarat,Vadodara,Hearing Impairment,80,100,25,4,29
Karnataka,Uttara Kannada,Hearing Impairment,0,6,23,23,46
Karnataka,Uttara Kannada,Hearing Impairment,6,15,103,83,186
Karnataka,Uttara Kannada,Hearing Impairment,15,35,324,249,573
Karnataka,Uttara Kannada,Hearing Impairment,35,60,464,394,858
Karnataka,Uttara Kannada,Hearing Impairment,60,80,174,87,261
Karnataka,Uttara Kannada,Hearing Impairment,80,100,7,2,9
Uttarakhand,Uttar Kashi,Hearing Impairment,0,6,0,1,1
Uttarakhand,Uttar Kashi,Hearing Impairment,6,15,3,13,16
Uttarakhand,Uttar Kashi,Hearing Impairment,15,35,101,83,184
Uttarakhand,Uttar Kashi,Hearing Impairment,35,60,197,172,369
Uttarakhand,Uttar Kashi,Hearing Impairment,60,80,23,18,41
Uttarakhand,Uttar Kashi,Hearing Impairment,80,100,1,0,1
Arunachal Pradesh,Upper Subansiri,Hearing Impairment,15,35,0,1,1
Arunachal Pradesh,Upper Subansiri,Hearing Impairment,35,60,0,2,2
Arunachal Pradesh,Upper Subansiri,Hearing Impairment,60,80,0,1,1
Arunachal Pradesh,Upper Siang,Hearing Impairment,15,35,2,1,3
Arunachal Pradesh,Upper Siang,Hearing Impairment,35,60,2,0,2
Uttar Pradesh,Unnao,Hearing Impairment,0,6,21,18,39
Uttar Pradesh,Unnao,Hearing Impairment,6,15,89,79,168
Uttar Pradesh,Unnao,Hearing Impairment,15,35,213,113,326
Uttar Pradesh,Unnao,Hearing Impairment,35,60,113,48,161
Uttar Pradesh,Unnao,Hearing Impairment,60,80,22,4,26
Uttar Pradesh,Unnao,Hearing Impairment,80,100,2,1,3
Tripura,Unakoti,Hearing Impairment,0,6,0,4,4
Tripura,Unakoti,Hearing Impairment,6,15,22,19,41
Tripura,Unakoti,Hearing Impairment,15,35,75,76,151
Tripura,Unakoti,Hearing Impairment,35,60,147,132,279
Tripura,Unakoti,Hearing Impairment,60,80,107,82,189
Tripura,Unakoti,Hearing Impairment,80,100,34,12,46
Himachal Pradesh,Una,Hearing Impairment,0,6,6,5,11
Himachal Pradesh,Una,Hearing Impairment,6,15,21,31,52
Himachal Pradesh,Una,Hearing Impairment,15,35,102,59,161
Himachal Pradesh,Una,Hearing Impairment,35,60,92,47,139
Himachal Pradesh,Una,Hearing Impairment,60,80,31,11,42
Himachal Pradesh,Una,Hearing Impairment,80,100,7,0,7
Madhya Pradesh,Umaria,Hearing Impairment,0,6,2,2,4
Madhya Pradesh,Umaria,Hearing Impairment,6,15,52,34,86
Madhya Pradesh,Umaria,Hearing Impairment,15,35,88,79,167
Madhya Pradesh,Umaria,Hearing Impairment,35,60,48,33,81
Madhya Pradesh,Umaria,Hearing Impairment,60,80,21,5,26
Madhya Pradesh,Umaria,Hearing Impairment,80,100,3,1,4
Manipur,Ukhrul,Hearing Impairment,0,6,0,1,1
Manipur,Ukhrul,Hearing Impairment,6,15,0,4,4
Manipur,Ukhrul,Hearing Impairment,15,35,7,5,12
Manipur,Ukhrul,Hearing Impairment,35,60,9,9,18
Manipur,Ukhrul,Hearing Impairment,60,80,8,2,10
Manipur,Ukhrul,Hearing Impairment,80,100,2,0,2
Madhya Pradesh,Ujjain,Hearing Impairment,0,6,23,18,41
Madhya Pradesh,Ujjain,Hearing Impairment,6,15,111,84,195
Madhya Pradesh,Ujjain,Hearing Impairment,15,35,289,188,477
Madhya Pradesh,Ujjain,Hearing Impairment,35,60,224,168,392
Madhya Pradesh,Ujjain,Hearing Impairment,60,80,230,126,356
Madhya Pradesh,Ujjain,Hearing Impairment,80,100,72,27,99
Karnataka,Udupi,Hearing Impairment,0,6,12,10,22
Karnataka,Udupi,Hearing Impairment,6,15,69,82,151
Karnataka,Udupi,Hearing Impairment,15,35,232,214,446
Karnataka,Udupi,Hearing Impairment,35,60,437,429,866
Karnataka,Udupi,Hearing Impairment,60,80,139,106,245
Karnataka,Udupi,Hearing Impairment,80,100,11,10,21
Jammu And Kashmir,Udhampur,Hearing Impairment,0,6,9,3,12
Jammu And Kashmir,Udhampur,Hearing Impairment,6,15,62,39,101
Jammu And Kashmir,Udhampur,Hearing Impairment,15,35,137,100,237
Jammu And Kashmir,Udhampur,Hearing Impairment,35,60,151,80,231
Jammu And Kashmir,Udhampur,Hearing Impairment,60,80,20,11,31
Jammu And Kashmir,Udhampur,Hearing Impairment,80,100,1,2,3
Uttarakhand,Udam Singh Nagar,Hearing Impairment,0,6,10,4,14
Uttarakhand,Udam Singh Nagar,Hearing Impairment,6,15,31,21,52
Uttarakhand,Udam Singh Nagar,Hearing Impairment,15,35,122,63,185
Uttarakhand,Udam Singh Nagar,Hearing Impairment,35,60,96,34,130
Uttarakhand,Udam Singh Nagar,Hearing Impairment,60,80,23,8,31
Uttarakhand,Udam Singh Nagar,Hearing Impairment,80,100,2,1,3
Assam,Udalguri,Hearing Impairment,0,6,8,12,20
Assam,Udalguri,Hearing Impairment,6,15,28,26,54
Assam,Udalguri,Hearing Impairment,15,35,94,82,176
Assam,Udalguri,Hearing Impairment,35,60,197,154,351
Assam,Udalguri,Hearing Impairment,60,80,49,22,71
Assam,Udalguri,Hearing Impairment,80,100,3,4,7
Rajasthan,Udaipur,Hearing Impairment,0,6,8,6,14
Rajasthan,Udaipur,Hearing Impairment,6,15,105,65,170
Rajasthan,Udaipur,Hearing Impairment,15,35,202,194,396
Rajasthan,Udaipur,Hearing Impairment,35,60,125,78,203
Rajasthan,Udaipur,Hearing Impairment,60,80,37,13,50
Rajasthan,Udaipur,Hearing Impairment,80,100,1,2,3
Tamil Nadu,Tuticorin,Hearing Impairment,0,6,10,12,22
Tamil Nadu,Tuticorin,Hearing Impairment,6,15,126,83,209
Tamil Nadu,Tuticorin,Hearing Impairment,15,35,373,339,712
Tamil Nadu,Tuticorin,Hearing Impairment,35,60,639,634,1273
Tamil Nadu,Tuticorin,Hearing Impairment,60,80,427,354,781
Tamil Nadu,Tuticorin,Hearing Impairment,80,100,66,23,89
Karnataka,Tumakuru,Hearing Impairment,0,6,32,24,56
Karnataka,Tumakuru,Hearing Impairment,6,15,219,176,395
Karnataka,Tumakuru,Hearing Impairment,15,35,741,561,1302
Karnataka,Tumakuru,Hearing Impairment,35,60,1243,949,2192
Karnataka,Tumakuru,Hearing Impairment,60,80,391,138,529
Karnataka,Tumakuru,Hearing Impairment,80,100,23,1,24
Nagaland,Tuensang,Hearing Impairment,35,60,2,1,3
Rajasthan,Tonk,Hearing Impairment,0,6,14,9,23
Rajasthan,Tonk,Hearing Impairment,6,15,72,61,133
Rajasthan,Tonk,Hearing Impairment,15,35,209,148,357
Rajasthan,Tonk,Hearing Impairment,35,60,135,115,250
Rajasthan,Tonk,Hearing Impairment,60,80,46,36,82
Rajasthan,Tonk,Hearing Impairment,80,100,1,5,6
Tamil Nadu,Tiruvannamalai,Hearing Impairment,0,6,31,34,65
Tamil Nadu,Tiruvannamalai,Hearing Impairment,6,15,214,170,384
Tamil Nadu,Tiruvannamalai,Hearing Impairment,15,35,723,558,1281
Tamil Nadu,Tiruvannamalai,Hearing Impairment,35,60,1170,1096,2266
Tamil Nadu,Tiruvannamalai,Hearing Impairment,60,80,965,607,1572
Tamil Nadu,Tiruvannamalai,Hearing Impairment,80,100,129,36,165
Tamil Nadu,Tiruppur,Hearing Impairment,0,6,11,15,26
Tamil Nadu,Tiruppur,Hearing Impairment,6,15,105,97,202
Tamil Nadu,Tiruppur,Hearing Impairment,15,35,255,211,466
Tamil Nadu,Tiruppur,Hearing Impairment,35,60,362,266,628
Tamil Nadu,Tiruppur,Hearing Impairment,60,80,162,95,257
Tamil Nadu,Tiruppur,Hearing Impairment,80,100,10,4,14
Tamil Nadu,Tirupathur,Hearing Impairment,0,6,22,15,37
Tamil Nadu,Tirupathur,Hearing Impairment,6,15,51,39,90
Tamil Nadu,Tirupathur,Hearing Impairment,15,35,165,150,315
Tamil Nadu,Tirupathur,Hearing Impairment,35,60,270,247,517
Tamil Nadu,Tirupathur,Hearing Impairment,60,80,151,98,249
Tamil Nadu,Tirupathur,Hearing Impairment,80,100,11,4,15
Tamil Nadu,Tirunelveli,Hearing Impairment,0,6,19,14,33
Tamil Nadu,Tirunelveli,Hearing Impairment,6,15,158,108,266
Tamil Nadu,Tirunelveli,Hearing Impairment,15,35,504,417,921
Tamil Nadu,Tirunelveli,Hearing Impairment,35,60,609,409,1018
Tamil Nadu,Tirunelveli,Hearing Impairment,60,80,168,80,248
Tamil Nadu,Tirunelveli,Hearing Impairment,80,100,7,6,13
Tamil Nadu,Tiruchirappalli,Hearing Impairment,0,6,33,35,68
Tamil Nadu,Tiruchirappalli,Hearing Impairment,6,15,194,175,369
Tamil Nadu,Tiruchirappalli,Hearing Impairment,15,35,782,637,1419
Tamil Nadu,Tiruchirappalli,Hearing Impairment,35,60,1190,1022,2212
Tamil Nadu,Tiruchirappalli,Hearing Impairment,60,80,888,506,1394
Tamil Nadu,Tiruchirappalli,Hearing Impairment,80,100,131,36,167
Arunachal Pradesh,Tirap,Hearing Impairment,15,35,2,0,2
Arunachal Pradesh,Tirap,Hearing Impairment,35,60,2,0,2
Assam,Tinsukia,Hearing Impairment,0,6,1,2,3
Assam,Tinsukia,Hearing Impairment,6,15,46,24,70
Assam,Tinsukia,Hearing Impairment,15,35,91,60,151
Assam,Tinsukia,Hearing Impairment,35,60,114,85,199
Assam,Tinsukia,Hearing Impairment,60,80,25,10,35
Assam,Tinsukia,Hearing Impairment,80,100,4,7,11
Madhya Pradesh,Tikamgarh,Hearing Impairment,0,6,4,5,9
Madhya Pradesh,Tikamgarh,Hearing Impairment,6,15,77,45,122
Madhya Pradesh,Tikamgarh,Hearing Impairment,15,35,251,168,419
Madhya Pradesh,Tikamgarh,Hearing Impairment,35,60,158,71,229
Madhya Pradesh,Tikamgarh,Hearing Impairment,60,80,43,12,55
Madhya Pradesh,Tikamgarh,Hearing Impairment,80,100,1,1,2
Kerala,Thrissur,Hearing Impairment,0,6,34,25,59
Kerala,Thrissur,Hearing Impairment,6,15,166,113,279
Kerala,Thrissur,Hearing Impairment,15,35,527,430,957
Kerala,Thrissur,Hearing Impairment,35,60,891,821,1712
Kerala,Thrissur,Hearing Impairment,60,80,468,327,795
Kerala,Thrissur,Hearing Impairment,80,100,40,19,59
Manipur,Thoubal,Hearing Impairment,0,6,0,3,3
Manipur,Thoubal,Hearing Impairment,6,15,8,6,14
Manipur,Thoubal,Hearing Impairment,15,35,32,17,49
Manipur,Thoubal,Hearing Impairment,35,60,17,11,28
Manipur,Thoubal,Hearing Impairment,60,80,4,5,9
Tamil Nadu,Thiruvarur,Hearing Impairment,0,6,6,15,21
Tamil Nadu,Thiruvarur,Hearing Impairment,6,15,85,81,166
Tamil Nadu,Thiruvarur,Hearing Impairment,15,35,347,260,607
Tamil Nadu,Thiruvarur,Hearing Impairment,35,60,515,448,963
Tamil Nadu,Thiruvarur,Hearing Impairment,60,80,340,150,490
Tamil Nadu,Thiruvarur,Hearing Impairment,80,100,52,7,59
Kerala,Thiruvananthapuram,Hearing Impairment,0,6,43,28,71
Kerala,Thiruvananthapuram,Hearing Impairment,6,15,191,159,350
Kerala,Thiruvananthapuram,Hearing Impairment,15,35,619,505,1124
Kerala,Thiruvananthapuram,Hearing Impairment,35,60,735,679,1414
Kerala,Thiruvananthapuram,Hearing Impairment,60,80,321,206,527
Kerala,Thiruvananthapuram,Hearing Impairment,80,100,20,10,30
Tamil Nadu,Thiruvallur,Hearing Impairment,0,6,27,29,56
Tamil Nadu,Thiruvallur,Hearing Impairment,6,15,208,162,370
Tamil Nadu,Thiruvallur,Hearing Impairment,15,35,668,528,1196
Tamil Nadu,Thiruvallur,Hearing Impairment,35,60,971,862,1833
Tamil Nadu,Thiruvallur,Hearing Impairment,60,80,398,294,692
Tamil Nadu,Thiruvallur,Hearing Impairment,80,100,26,15,41
Tamil Nadu,Theni,Hearing Impairment,0,6,13,9,22
Tamil Nadu,Theni,Hearing Impairment,6,15,76,63,139
Tamil Nadu,Theni,Hearing Impairment,15,35,329,255,584
Tamil Nadu,Theni,Hearing Impairment,35,60,406,300,706
Tamil Nadu,Theni,Hearing Impairment,60,80,161,88,249
Tamil Nadu,Theni,Hearing Impairment,80,100,12,5,17
Tamil Nadu,The Nilgiris,Hearing Impairment,0,6,0,2,2
Tamil Nadu,The Nilgiris,Hearing Impairment,6,15,35,22,57
Tamil Nadu,The Nilgiris,Hearing Impairment,15,35,134,97,231
Tamil Nadu,The Nilgiris,Hearing Impairment,35,60,229,186,415
Tamil Nadu,The Nilgiris,Hearing Impairment,60,80,130,97,227
Tamil Nadu,The Nilgiris,Hearing Impairment,80,100,18,5,23
Tamil Nadu,Thanjavur,Hearing Impairment,0,6,24,21,45
Tamil Nadu,Thanjavur,Hearing Impairment,6,15,188,138,326
Tamil Nadu,Thanjavur,Hearing Impairment,15,35,583,469,1052
Tamil Nadu,Thanjavur,Hearing Impairment,35,60,890,756,1646
Tamil Nadu,Thanjavur,Hearing Impairment,60,80,525,281,806
Tamil Nadu,Thanjavur,Hearing Impairment,80,100,59,12,71
Maharashtra,Thane,Hearing Impairment,0,6,85,68,153
Maharashtra,Thane,Hearing Impairment,6,15,878,656,1534
Maharashtra,Thane,Hearing Impairment,15,35,2411,1560,3971
Maharashtra,Thane,Hearing Impairment,35,60,1643,635,2278
Maharashtra,Thane,Hearing Impairment,60,80,492,107,599
Maharashtra,Thane,Hearing Impairment,80,100,45,6,51
Tamil Nadu,Tenkasi,Hearing Impairment,0,6,15,19,34
Tamil Nadu,Tenkasi,Hearing Impairment,6,15,56,39,95
Tamil Nadu,Tenkasi,Hearing Impairment,15,35,82,81,163
Tamil Nadu,Tenkasi,Hearing Impairment,35,60,156,138,294
Tamil Nadu,Tenkasi,Hearing Impairment,60,80,73,38,111
Tamil Nadu,Tenkasi,Hearing Impairment,80,100,1,0,1
Manipur,Tengnoupal,Hearing Impairment,0,6,1,1,2
Manipur,Tengnoupal,Hearing Impairment,6,15,2,4,6
Manipur,Tengnoupal,Hearing Impairment,15,35,8,3,11
Manipur,Tengnoupal,Hearing Impairment,35,60,8,7,15
Manipur,Tengnoupal,Hearing Impairment,60,80,6,2,8
Manipur,Tengnoupal,Hearing Impairment,80,100,1,0,1
Uttarakhand,Tehri Garhwal,Hearing Impairment,0,6,9,2,11
Uttarakhand,Tehri Garhwal,Hearing Impairment,6,15,19,12,31
Uttarakhand,Tehri Garhwal,Hearing Impairment,15,35,100,55,155
Uttarakhand,Tehri Garhwal,Hearing Impairment,35,60,213,113,326
Uttarakhand,Tehri Garhwal,Hearing Impairment,60,80,40,13,53
Uttarakhand,Tehri Garhwal,Hearing Impairment,80,100,0,1,1
Arunachal Pradesh,Tawang,Hearing Impairment,15,35,0,1,1
Arunachal Pradesh,Tawang,Hearing Impairment,35,60,0,1,1
Punjab,Tarn Taran,Hearing Impairment,0,6,6,8,14
Punjab,Tarn Taran,Hearing Impairment,6,15,48,33,81
Punjab,Tarn Taran,Hearing Impairment,15,35,128,76,204
Punjab,Tarn Taran,Hearing Impairment,35,60,84,60,144
Punjab,Tarn Taran,Hearing Impairment,60,80,12,4,16
Punjab,Tarn Taran,Hearing Impairment,80,100,2,0,2
Gujarat,Tapi,Hearing Impairment,0,6,6,5,11
Gujarat,Tapi,Hearing Impairment,6,15,36,31,67
Gujarat,Tapi,Hearing Impairment,15,35,72,45,117
Gujarat,Tapi,Hearing Impairment,35,60,26,20,46
Gujarat,Tapi,Hearing Impairment,60,80,7,1,8
Manipur,Tamenglong,Hearing Impairment,6,15,2,0,2
Manipur,Tamenglong,Hearing Impairment,15,35,5,5,10
Manipur,Tamenglong,Hearing Impairment,35,60,10,5,15
Manipur,Tamenglong,Hearing Impairment,60,80,9,1,10
Manipur,Tamenglong,Hearing Impairment,80,100,2,0,2
Telangana,Suryapet,Hearing Impairment,6,15,20,16,36
Telangana,Suryapet,Hearing Impairment,15,35,296,251,547
Telangana,Suryapet,Hearing Impairment,35,60,338,312,650
Telangana,Suryapet,Hearing Impairment,60,80,91,91,182
Telangana,Suryapet,Hearing Impairment,80,100,10,15,25
Chhattisgarh,Surguja,Hearing Impairment,0,6,15,6,21
Chhattisgarh,Surguja,Hearing Impairment,6,15,86,77,163
Chhattisgarh,Surguja,Hearing Impairment,15,35,152,162,314
Chhattisgarh,Surguja,Hearing Impairment,35,60,105,47,152
Chhattisgarh,Surguja,Hearing Impairment,60,80,74,40,114
Chhattisgarh,Surguja,Hearing Impairment,80,100,25,5,30
Gujarat,Surendranagar,Hearing Impairment,0,6,11,5,16
Gujarat,Surendranagar,Hearing Impairment,6,15,122,92,214
Gujarat,Surendranagar,Hearing Impairment,15,35,216,140,356
Gujarat,Surendranagar,Hearing Impairment,35,60,116,59,175
Gujarat,Surendranagar,Hearing Impairment,60,80,54,12,66
Gujarat,Surendranagar,Hearing Impairment,80,100,13,4,17
Gujarat,Surat,Hearing Impairment,0,6,95,52,147
Gujarat,Surat,Hearing Impairment,6,15,505,333,838
Gujarat,Surat,Hearing Impairment,15,35,922,550,1472
Gujarat,Surat,Hearing Impairment,35,60,461,291,752
Gujarat,Surat,Hearing Impairment,60,80,203,56,259
Gujarat,Surat,Hearing Impairment,80,100,19,4,23
Chhattisgarh,Surajpur,Hearing Impairment,0,6,2,2,4
Chhattisgarh,Surajpur,Hearing Impairment,6,15,11,14,25
Chhattisgarh,Surajpur,Hearing Impairment,15,35,38,24,62
Chhattisgarh,Surajpur,Hearing Impairment,35,60,15,8,23
Chhattisgarh,Surajpur,Hearing Impairment,60,80,11,4,15
Chhattisgarh,Surajpur,Hearing Impairment,80,100,1,1,2
Bihar,Supaul,Hearing Impairment,0,6,1,5,6
Bihar,Supaul,Hearing Impairment,6,15,14,17,31
Bihar,Supaul,Hearing Impairment,15,35,43,14,57
Bihar,Supaul,Hearing Impairment,35,60,27,10,37
Bihar,Supaul,Hearing Impairment,60,80,4,2,6
Bihar,Supaul,Hearing Impairment,80,100,1,0,1
Odisha,Sundargarh,Hearing Impairment,0,6,20,20,40
Odisha,Sundargarh,Hearing Impairment,6,15,238,184,422
Odisha,Sundargarh,Hearing Impairment,15,35,738,680,1418
Odisha,Sundargarh,Hearing Impairment,35,60,1066,884,1950
Odisha,Sundargarh,Hearing Impairment,60,80,604,287,891
Odisha,Sundargarh,Hearing Impairment,80,100,66,43,109
Uttar Pradesh,Sultanpur,Hearing Impairment,0,6,8,9,17
Uttar Pradesh,Sultanpur,Hearing Impairment,6,15,28,17,45
Uttar Pradesh,Sultanpur,Hearing Impairment,15,35,130,53,183
Uttar Pradesh,Sultanpur,Hearing Impairment,35,60,50,25,75
Uttar Pradesh,Sultanpur,Hearing Impairment,60,80,4,2,6
Chhattisgarh,Sukma,Hearing Impairment,0,6,3,0,3
Chhattisgarh,Sukma,Hearing Impairment,6,15,31,16,47
Chhattisgarh,Sukma,Hearing Impairment,15,35,56,50,106
Chhattisgarh,Sukma,Hearing Impairment,35,60,52,44,96
Chhattisgarh,Sukma,Hearing Impairment,60,80,26,18,44
Jammu And Kashmir,Srinagar,Hearing Impairment,0,6,13,10,23
Jammu And Kashmir,Srinagar,Hearing Impairment,6,15,30,28,58
Jammu And Kashmir,Srinagar,Hearing Impairment,15,35,64,61,125
Jammu And Kashmir,Srinagar,Hearing Impairment,35,60,139,98,237
Jammu And Kashmir,Srinagar,Hearing Impairment,60,80,120,65,185
Jammu And Kashmir,Srinagar,Hearing Impairment,80,100,18,10,28
Andhra Pradesh,Srikakulam,Hearing Impairment,0,6,29,22,51
Andhra Pradesh,Srikakulam,Hearing Impairment,6,15,109,80,189
Andhra Pradesh,Srikakulam,Hearing Impairment,15,35,233,166,399
Andhra Pradesh,Srikakulam,Hearing Impairment,35,60,717,209,926
Andhra Pradesh,Srikakulam,Hearing Impairment,60,80,224,31,255
Andhra Pradesh,Srikakulam,Hearing Impairment,80,100,8,2,10
Punjab,Sri Muktsar Sahib,Hearing Impairment,0,6,3,2,5
Punjab,Sri Muktsar Sahib,Hearing Impairment,6,15,56,33,89
Punjab,Sri Muktsar Sahib,Hearing Impairment,15,35,85,55,140
Punjab,Sri Muktsar Sahib,Hearing Impairment,35,60,50,37,87
Punjab,Sri Muktsar Sahib,Hearing Impairment,60,80,12,3,15
Punjab,Sri Muktsar Sahib,Hearing Impairment,80,100,0,1,1
Andhra Pradesh,Spsr Nellore,Hearing Impairment,0,6,27,12,39
Andhra Pradesh,Spsr Nellore,Hearing Impairment,6,15,152,113,265
Andhra Pradesh,Spsr Nellore,Hearing Impairment,15,35,349,207,556
Andhra Pradesh,Spsr Nellore,Hearing Impairment,35,60,1003,182,1185
Andhra Pradesh,Spsr Nellore,Hearing Impairment,60,80,340,40,380
Andhra Pradesh,Spsr Nellore,Hearing Impairment,80,100,30,2,32
Meghalaya,South West Khasi Hills,Hearing Impairment,0,6,2,0,2
Meghalaya,South West Khasi Hills,Hearing Impairment,6,15,18,17,35
Meghalaya,South West Khasi Hills,Hearing Impairment,15,35,66,52,118
Meghalaya,South West Khasi Hills,Hearing Impairment,35,60,32,44,76
Meghalaya,South West Khasi Hills,Hearing Impairment,60,80,26,15,41
Meghalaya,South West Khasi Hills,Hearing Impairment,80,100,3,0,3
Meghalaya,South West Garo Hills,Hearing Impairment,0,6,0,3,3
Meghalaya,South West Garo Hills,Hearing Impairment,6,15,26,25,51
Meghalaya,South West Garo Hills,Hearing Impairment,15,35,81,68,149
Meghalaya,South West Garo Hills,Hearing Impairment,35,60,75,84,159
Meghalaya,South West Garo Hills,Hearing Impairment,60,80,14,12,26
Meghalaya,South West Garo Hills,Hearing Impairment,80,100,1,2,3
Delhi,South West,Hearing Impairment,0,6,37,28,65
Delhi,South West,Hearing Impairment,6,15,137,100,237
Delhi,South West,Hearing Impairment,15,35,254,152,406
Delhi,South West,Hearing Impairment,35,60,117,67,184
Delhi,South West,Hearing Impairment,60,80,19,6,25
Delhi,South West,Hearing Impairment,80,100,1,0,1
Tripura,South Tripura,Hearing Impairment,0,6,2,3,5
Tripura,South Tripura,Hearing Impairment,6,15,34,26,60
Tripura,South Tripura,Hearing Impairment,15,35,86,71,157
Tripura,South Tripura,Hearing Impairment,35,60,178,112,290
Tripura,South Tripura,Hearing Impairment,60,80,71,30,101
Tripura,South Tripura,Hearing Impairment,80,100,9,4,13
Assam,South Salmara Mancachar,Hearing Impairment,0,6,0,1,1
Assam,South Salmara Mancachar,Hearing Impairment,6,15,1,1,2
Assam,South Salmara Mancachar,Hearing Impairment,15,35,8,5,13
Assam,South Salmara Mancachar,Hearing Impairment,35,60,8,2,10
Goa,South Goa,Hearing Impairment,0,6,3,0,3
Goa,South Goa,Hearing Impairment,6,15,29,24,53
Goa,South Goa,Hearing Impairment,15,35,70,43,113
Goa,South Goa,Hearing Impairment,35,60,88,51,139
Goa,South Goa,Hearing Impairment,60,80,26,19,45
Goa,South Goa,Hearing Impairment,80,100,3,2,5
Meghalaya,South Garo Hills,Hearing Impairment,0,6,2,2,4
Meghalaya,South Garo Hills,Hearing Impairment,6,15,13,15,28
Meghalaya,South Garo Hills,Hearing Impairment,15,35,34,37,71
Meghalaya,South Garo Hills,Hearing Impairment,35,60,28,24,52
Meghalaya,South Garo Hills,Hearing Impairment,60,80,14,7,21
Meghalaya,South Garo Hills,Hearing Impairment,80,100,2,0,2
Delhi,South East,Hearing Impairment,0,6,6,9,15
Delhi,South East,Hearing Impairment,6,15,34,45,79
Delhi,South East,Hearing Impairment,15,35,75,33,108
Delhi,South East,Hearing Impairment,35,60,26,16,42
Delhi,South East,Hearing Impairment,60,80,4,0,4
Andaman And Nicobar Islands,South Andamans,Hearing Impairment,0,6,6,4,10
Andaman And Nicobar Islands,South Andamans,Hearing Impairment,6,15,18,14,32
Andaman And Nicobar Islands,South Andamans,Hearing Impairment,15,35,74,64,138
Andaman And Nicobar Islands,South Andamans,Hearing Impairment,35,60,104,78,182
Andaman And Nicobar Islands,South Andamans,Hearing Impairment,60,80,54,22,76
Andaman And Nicobar Islands,South Andamans,Hearing Impairment,80,100,5,2,7
Delhi,South,Hearing Impairment,0,6,15,16,31
Delhi,South,Hearing Impairment,6,15,64,49,113
Delhi,South,Hearing Impairment,15,35,147,82,229
Delhi,South,Hearing Impairment,35,60,65,39,104
Delhi,South,Hearing Impairment,60,80,13,2,15
Delhi,South,Hearing Impairment,80,100,1,0,1
Assam,Sonitpur,Hearing Impairment,0,6,14,13,27
Assam,Sonitpur,Hearing Impairment,6,15,80,93,173
Assam,Sonitpur,Hearing Impairment,15,35,156,156,312
Assam,Sonitpur,Hearing Impairment,35,60,260,229,489
Assam,Sonitpur,Hearing Impairment,60,80,62,29,91
Assam,Sonitpur,Hearing Impairment,80,100,4,1,5
Haryana,Sonipat,Hearing Impairment,0,6,10,5,15
Haryana,Sonipat,Hearing Impairment,6,15,35,48,83
Haryana,Sonipat,Hearing Impairment,15,35,111,77,188
Haryana,Sonipat,Hearing Impairment,35,60,54,23,77
Haryana,Sonipat,Hearing Impairment,60,80,8,5,13
Odisha,Sonepur,Hearing Impairment,0,6,14,14,28
Odisha,Sonepur,Hearing Impairment,6,15,149,95,244
Odisha,Sonepur,Hearing Impairment,15,35,420,326,746
Odisha,Sonepur,Hearing Impairment,35,60,557,346,903
Odisha,Sonepur,Hearing Impairment,60,80,173,79,252
Odisha,Sonepur,Hearing Impairment,80,100,16,2,18
Uttar Pradesh,Sonbhadra,Hearing Impairment,0,6,4,11,15
Uttar Pradesh,Sonbhadra,Hearing Impairment,6,15,33,29,62
Uttar Pradesh,Sonbhadra,Hearing Impairment,15,35,166,77,243
Uttar Pradesh,Sonbhadra,Hearing Impairment,35,60,129,54,183
Uttar Pradesh,Sonbhadra,Hearing Impairment,60,80,47,21,68
Uttar Pradesh,Sonbhadra,Hearing Impairment,80,100,3,1,4
Maharashtra,Solapur,Hearing Impairment,0,6,60,54,114
Maharashtra,Solapur,Hearing Impairment,6,15,590,476,1066
Maharashtra,Solapur,Hearing Impairment,15,35,1864,875,2739
Maharashtra,Solapur,Hearing Impairment,35,60,954,312,1266
Maharashtra,Solapur,Hearing Impairment,60,80,105,28,133
Maharashtra,Solapur,Hearing Impairment,80,100,7,2,9
Himachal Pradesh,Solan,Hearing Impairment,0,6,1,4,5
Himachal Pradesh,Solan,Hearing Impairment,6,15,30,33,63
Himachal Pradesh,Solan,Hearing Impairment,15,35,86,96,182
Himachal Pradesh,Solan,Hearing Impairment,35,60,143,78,221
Himachal Pradesh,Solan,Hearing Impairment,60,80,54,19,73
Himachal Pradesh,Solan,Hearing Impairment,80,100,5,1,6
Bihar,Siwan,Hearing Impairment,0,6,31,20,51
Bihar,Siwan,Hearing Impairment,6,15,176,159,335
Bihar,Siwan,Hearing Impairment,15,35,446,276,722
Bihar,Siwan,Hearing Impairment,35,60,205,110,315
Bihar,Siwan,Hearing Impairment,60,80,56,17,73
Bihar,Siwan,Hearing Impairment,80,100,1,1,2
Assam,Sivasagar,Hearing Impairment,0,6,7,4,11
Assam,Sivasagar,Hearing Impairment,6,15,40,39,79
Assam,Sivasagar,Hearing Impairment,15,35,114,80,194
Assam,Sivasagar,Hearing Impairment,35,60,140,127,267
Assam,Sivasagar,Hearing Impairment,60,80,60,25,85
Assam,Sivasagar,Hearing Impairment,80,100,3,1,4
Tamil Nadu,Sivaganga,Hearing Impairment,0,6,22,9,31
Tamil Nadu,Sivaganga,Hearing Impairment,6,15,120,89,209
Tamil Nadu,Sivaganga,Hearing Impairment,15,35,357,304,661
Tamil Nadu,Sivaganga,Hearing Impairment,35,60,702,609,1311
Tamil Nadu,Sivaganga,Hearing Impairment,60,80,563,340,903
Tamil Nadu,Sivaganga,Hearing Impairment,80,100,51,26,77
Uttar Pradesh,Sitapur,Hearing Impairment,0,6,19,19,38
Uttar Pradesh,Sitapur,Hearing Impairment,6,15,466,375,841
Uttar Pradesh,Sitapur,Hearing Impairment,15,35,316,183,499
Uttar Pradesh,Sitapur,Hearing Impairment,35,60,152,50,202
Uttar Pradesh,Sitapur,Hearing Impairment,60,80,30,7,37
Bihar,Sitamarhi,Hearing Impairment,0,6,11,2,13
Bihar,Sitamarhi,Hearing Impairment,6,15,43,40,83
Bihar,Sitamarhi,Hearing Impairment,15,35,139,56,195
Bihar,Sitamarhi,Hearing Impairment,35,60,80,40,120
Bihar,Sitamarhi,Hearing Impairment,60,80,11,9,20
Haryana,Sirsa,Hearing Impairment,0,6,9,11,20
Haryana,Sirsa,Hearing Impairment,6,15,53,52,105
Haryana,Sirsa,Hearing Impairment,15,35,108,64,172
Haryana,Sirsa,Hearing Impairment,35,60,64,40,104
Haryana,Sirsa,Hearing Impairment,60,80,15,8,23
Haryana,Sirsa,Hearing Impairment,80,100,1,0,1
Rajasthan,Sirohi,Hearing Impairment,0,6,2,1,3
Rajasthan,Sirohi,Hearing Impairment,6,15,46,36,82
Rajasthan,Sirohi,Hearing Impairment,15,35,137,87,224
Rajasthan,Sirohi,Hearing Impairment,35,60,74,28,102
Rajasthan,Sirohi,Hearing Impairment,60,80,24,9,33
Himachal Pradesh,Sirmaur,Hearing Impairment,0,6,2,4,6
Himachal Pradesh,Sirmaur,Hearing Impairment,6,15,37,25,62
Himachal Pradesh,Sirmaur,Hearing Impairment,15,35,90,61,151
Himachal Pradesh,Sirmaur,Hearing Impairment,35,60,134,38,172
Himachal Pradesh,Sirmaur,Hearing Impairment,60,80,29,3,32
Himachal Pradesh,Sirmaur,Hearing Impairment,80,100,4,0,4
Madhya Pradesh,Singrauli,Hearing Impairment,0,6,9,4,13
Madhya Pradesh,Singrauli,Hearing Impairment,6,15,90,61,151
Madhya Pradesh,Singrauli,Hearing Impairment,15,35,300,168,468
Madhya Pradesh,Singrauli,Hearing Impairment,35,60,168,69,237
Madhya Pradesh,Singrauli,Hearing Impairment,60,80,33,17,50
Madhya Pradesh,Singrauli,Hearing Impairment,80,100,7,2,9
Maharashtra,Sindhudurg,Hearing Impairment,0,6,3,10,13
Maharashtra,Sindhudurg,Hearing Impairment,6,15,97,96,193
Maharashtra,Sindhudurg,Hearing Impairment,15,35,329,261,590
Maharashtra,Sindhudurg,Hearing Impairment,35,60,452,186,638
Maharashtra,Sindhudurg,Hearing Impairment,60,80,188,59,247
Maharashtra,Sindhudurg,Hearing Impairment,80,100,33,3,36
Jharkhand,Simdega,Hearing Impairment,0,6,0,1,1
Jharkhand,Simdega,Hearing Impairment,6,15,14,6,20
Jharkhand,Simdega,Hearing Impairment,15,35,24,20,44
Jharkhand,Simdega,Hearing Impairment,35,60,24,11,35
Jharkhand,Simdega,Hearing Impairment,60,80,8,2,10
Rajasthan,Sikar,Hearing Impairment,0,6,14,8,22
Rajasthan,Sikar,Hearing Impairment,6,15,126,80,206
Rajasthan,Sikar,Hearing Impairment,15,35,296,152,448
Rajasthan,Sikar,Hearing Impairment,35,60,116,95,211
Rajasthan,Sikar,Hearing Impairment,60,80,21,14,35
Madhya Pradesh,Sidhi,Hearing Impairment,0,6,11,8,19
Madhya Pradesh,Sidhi,Hearing Impairment,6,15,133,93,226
Madhya Pradesh,Sidhi,Hearing Impairment,15,35,350,203,553
Madhya Pradesh,Sidhi,Hearing Impairment,35,60,158,90,248
Madhya Pradesh,Sidhi,Hearing Impairment,60,80,37,22,59
Madhya Pradesh,Sidhi,Hearing Impairment,80,100,4,0,4
Telangana,Siddipet,Hearing Impairment,6,15,13,9,22
Telangana,Siddipet,Hearing Impairment,15,35,148,150,298
Telangana,Siddipet,Hearing Impairment,35,60,192,160,352
Telangana,Siddipet,Hearing Impairment,60,80,116,86,202
Telangana,Siddipet,Hearing Impairment,80,100,29,4,33
Uttar Pradesh,Siddharth Nagar,Hearing Impairment,0,6,24,24,48
Uttar Pradesh,Siddharth Nagar,Hearing Impairment,6,15,147,117,264
Uttar Pradesh,Siddharth Nagar,Hearing Impairment,15,35,353,268,621
Uttar Pradesh,Siddharth Nagar,Hearing Impairment,35,60,263,142,405
Uttar Pradesh,Siddharth Nagar,Hearing Impairment,60,80,59,19,78
Uttar Pradesh,Siddharth Nagar,Hearing Impairment,80,100,5,3,8
Arunachal Pradesh,Siang,Hearing Impairment,6,15,1,0,1
Arunachal Pradesh,Siang,Hearing Impairment,15,35,1,3,4
Arunachal Pradesh,Siang,Hearing Impairment,35,60,2,2,4
Arunachal Pradesh,Siang,Hearing Impairment,60,80,2,1,3
Uttar Pradesh,Shravasti,Hearing Impairment,0,6,10,13,23
Uttar Pradesh,Shravasti,Hearing Impairment,6,15,71,51,122
Uttar Pradesh,Shravasti,Hearing Impairment,15,35,153,56,209
Uttar Pradesh,Shravasti,Hearing Impairment,35,60,101,34,135
Uttar Pradesh,Shravasti,Hearing Impairment,60,80,27,8,35
Uttar Pradesh,Shravasti,Hearing Impairment,80,100,6,0,6
Jammu And Kashmir,Shopian,Hearing Impairment,6,15,11,17,28
Jammu And Kashmir,Shopian,Hearing Impairment,15,35,65,35,100
Jammu And Kashmir,Shopian,Hearing Impairment,35,60,72,64,136
Jammu And Kashmir,Shopian,Hearing Impairment,60,80,54,17,71
Jammu And Kashmir,Shopian,Hearing Impairment,80,100,8,4,12
Madhya Pradesh,Shivpuri,Hearing Impairment,0,6,16,10,26
Madhya Pradesh,Shivpuri,Hearing Impairment,6,15,177,130,307
Madhya Pradesh,Shivpuri,Hearing Impairment,15,35,330,180,510
Madhya Pradesh,Shivpuri,Hearing Impairment,35,60,174,108,282
Madhya Pradesh,Shivpuri,Hearing Impairment,60,80,49,16,65
Madhya Pradesh,Shivpuri,Hearing Impairment,80,100,4,1,5
Karnataka,Shivamogga,Hearing Impairment,0,6,24,23,47
Karnataka,Shivamogga,Hearing Impairment,6,15,107,96,203
Karnataka,Shivamogga,Hearing Impairment,15,35,227,173,400
Karnataka,Shivamogga,Hearing Impairment,35,60,306,229,535
Karnataka,Shivamogga,Hearing Impairment,60,80,133,60,193
Karnataka,Shivamogga,Hearing Impairment,80,100,14,6,20
Himachal Pradesh,Shimla,Hearing Impairment,0,6,5,9,14
Himachal Pradesh,Shimla,Hearing Impairment,6,15,52,33,85
Himachal Pradesh,Shimla,Hearing Impairment,15,35,178,126,304
Himachal Pradesh,Shimla,Hearing Impairment,35,60,281,199,480
Himachal Pradesh,Shimla,Hearing Impairment,60,80,194,59,253
Himachal Pradesh,Shimla,Hearing Impairment,80,100,27,9,36
Madhya Pradesh,Sheopur,Hearing Impairment,0,6,5,4,9
Madhya Pradesh,Sheopur,Hearing Impairment,6,15,16,26,42
Madhya Pradesh,Sheopur,Hearing Impairment,15,35,94,61,155
Madhya Pradesh,Sheopur,Hearing Impairment,35,60,47,29,76
Madhya Pradesh,Sheopur,Hearing Impairment,60,80,17,6,23
Madhya Pradesh,Sheopur,Hearing Impairment,80,100,0,1,1
Bihar,Sheohar,Hearing Impairment,0,6,18,14,32
Bihar,Sheohar,Hearing Impairment,6,15,120,116,236
Bihar,Sheohar,Hearing Impairment,15,35,62,35,97
Bihar,Sheohar,Hearing Impairment,35,60,37,17,54
Bihar,Sheohar,Hearing Impairment,60,80,8,7,15
Bihar,Sheohar,Hearing Impairment,80,100,2,0,2
Bihar,Sheikhpura,Hearing Impairment,0,6,1,0,1
Bihar,Sheikhpura,Hearing Impairment,6,15,31,24,55
Bihar,Sheikhpura,Hearing Impairment,15,35,61,44,105
Bihar,Sheikhpura,Hearing Impairment,35,60,13,14,27
Bihar,Sheikhpura,Hearing Impairment,60,80,5,3,8
Bihar,Sheikhpura,Hearing Impairment,80,100,1,0,1
Uttar Pradesh,Shamli,Hearing Impairment,0,6,9,6,15
Uttar Pradesh,Shamli,Hearing Impairment,6,15,10,10,20
Uttar Pradesh,Shamli,Hearing Impairment,15,35,53,20,73
Uttar Pradesh,Shamli,Hearing Impairment,35,60,20,10,30
Uttar Pradesh,Shamli,Hearing Impairment,60,80,8,3,11
Madhya Pradesh,Shajapur,Hearing Impairment,0,6,8,7,15
Madhya Pradesh,Shajapur,Hearing Impairment,6,15,58,46,104
Madhya Pradesh,Shajapur,Hearing Impairment,15,35,120,95,215
Madhya Pradesh,Shajapur,Hearing Impairment,35,60,112,37,149
Madhya Pradesh,Shajapur,Hearing Impairment,60,80,60,14,74
Madhya Pradesh,Shajapur,Hearing Impairment,80,100,7,2,9
Uttar Pradesh,Shahjahanpur,Hearing Impairment,0,6,10,9,19
Uttar Pradesh,Shahjahanpur,Hearing Impairment,6,15,68,45,113
Uttar Pradesh,Shahjahanpur,Hearing Impairment,15,35,419,186,605
Uttar Pradesh,Shahjahanpur,Hearing Impairment,35,60,303,148,451
Uttar Pradesh,Shahjahanpur,Hearing Impairment,60,80,101,22,123
Uttar Pradesh,Shahjahanpur,Hearing Impairment,80,100,7,0,7
Punjab,Shahid Bhagat Singh Nagar,Hearing Impairment,0,6,6,7,13
Punjab,Shahid Bhagat Singh Nagar,Hearing Impairment,6,15,27,24,51
Punjab,Shahid Bhagat Singh Nagar,Hearing Impairment,15,35,85,66,151
Punjab,Shahid Bhagat Singh Nagar,Hearing Impairment,35,60,59,32,91
Punjab,Shahid Bhagat Singh Nagar,Hearing Impairment,60,80,16,6,22
Punjab,Shahid Bhagat Singh Nagar,Hearing Impairment,80,100,1,0,1
Madhya Pradesh,Shahdol,Hearing Impairment,0,6,4,3,7
Madhya Pradesh,Shahdol,Hearing Impairment,6,15,49,45,94
Madhya Pradesh,Shahdol,Hearing Impairment,15,35,208,118,326
Madhya Pradesh,Shahdol,Hearing Impairment,35,60,148,78,226
Madhya Pradesh,Shahdol,Hearing Impairment,60,80,41,11,52
Madhya Pradesh,Shahdol,Hearing Impairment,80,100,3,3,6
Delhi,Shahdara,Hearing Impairment,0,6,3,5,8
Delhi,Shahdara,Hearing Impairment,6,15,18,10,28
Delhi,Shahdara,Hearing Impairment,15,35,46,27,73
Delhi,Shahdara,Hearing Impairment,35,60,31,6,37
Delhi,Shahdara,Hearing Impairment,60,80,10,1,11
Delhi,Shahdara,Hearing Impairment,80,100,2,0,2
Mizoram,Serchhip,Hearing Impairment,6,15,8,4,12
Mizoram,Serchhip,Hearing Impairment,15,35,5,7,12
Mizoram,Serchhip,Hearing Impairment,35,60,20,21,41
Mizoram,Serchhip,Hearing Impairment,60,80,24,26,50
Mizoram,Serchhip,Hearing Impairment,80,100,12,4,16
Tripura,Sepahijala,Hearing Impairment,0,6,9,4,13
Tripura,Sepahijala,Hearing Impairment,6,15,39,21,60
Tripura,Sepahijala,Hearing Impairment,15,35,81,55,136
Tripura,Sepahijala,Hearing Impairment,35,60,114,73,187
Tripura,Sepahijala,Hearing Impairment,60,80,52,28,80
Tripura,Sepahijala,Hearing Impairment,80,100,9,10,19
Madhya Pradesh,Seoni,Hearing Impairment,6,15,35,31,66
Madhya Pradesh,Seoni,Hearing Impairment,15,35,325,187,512
Madhya Pradesh,Seoni,Hearing Impairment,35,60,223,107,330
Madhya Pradesh,Seoni,Hearing Impairment,60,80,79,22,101
Madhya Pradesh,Seoni,Hearing Impairment,80,100,11,1,12
Manipur,Senapati,Hearing Impairment,0,6,1,0,1
Manipur,Senapati,Hearing Impairment,6,15,2,1,3
Manipur,Senapati,Hearing Impairment,15,35,5,9,14
Manipur,Senapati,Hearing Impairment,35,60,4,2,6
Manipur,Senapati,Hearing Impairment,60,80,3,1,4
Madhya Pradesh,Sehore,Hearing Impairment,0,6,14,10,24
Madhya Pradesh,Sehore,Hearing Impairment,6,15,67,62,129
Madhya Pradesh,Sehore,Hearing Impairment,15,35,286,192,478
Madhya Pradesh,Sehore,Hearing Impairment,35,60,344,186,530
Madhya Pradesh,Sehore,Hearing Impairment,60,80,248,95,343
Madhya Pradesh,Sehore,Hearing Impairment,80,100,43,7,50
Rajasthan,Sawai Madhopur,Hearing Impairment,0,6,4,2,6
Rajasthan,Sawai Madhopur,Hearing Impairment,6,15,39,32,71
Rajasthan,Sawai Madhopur,Hearing Impairment,15,35,112,69,181
Rajasthan,Sawai Madhopur,Hearing Impairment,35,60,56,23,79
Rajasthan,Sawai Madhopur,Hearing Impairment,60,80,4,2,6
Rajasthan,Sawai Madhopur,Hearing Impairment,80,100,1,0,1
Madhya Pradesh,Satna,Hearing Impairment,0,6,23,14,37
Madhya Pradesh,Satna,Hearing Impairment,6,15,166,148,314
Madhya Pradesh,Satna,Hearing Impairment,15,35,750,455,1205
Madhya Pradesh,Satna,Hearing Impairment,35,60,746,482,1228
Madhya Pradesh,Satna,Hearing Impairment,60,80,462,228,690
Madhya Pradesh,Satna,Hearing Impairment,80,100,83,17,100
Maharashtra,Satara,Hearing Impairment,0,6,48,41,89
Maharashtra,Satara,Hearing Impairment,6,15,376,311,687
Maharashtra,Satara,Hearing Impairment,15,35,1216,664,1880
Maharashtra,Satara,Hearing Impairment,35,60,1028,314,1342
Maharashtra,Satara,Hearing Impairment,60,80,228,67,295
Maharashtra,Satara,Hearing Impairment,80,100,9,5,14
Bihar,Saran,Hearing Impairment,0,6,35,27,62
Bihar,Saran,Hearing Impairment,6,15,240,178,418
Bihar,Saran,Hearing Impairment,15,35,238,118,356
Bihar,Saran,Hearing Impairment,35,60,128,67,195
Bihar,Saran,Hearing Impairment,60,80,22,16,38
Bihar,Saran,Hearing Impairment,80,100,2,0,2
Jharkhand,Saraikela Kharsawan,Hearing Impairment,0,6,1,0,1
Jharkhand,Saraikela Kharsawan,Hearing Impairment,6,15,10,7,17
Jharkhand,Saraikela Kharsawan,Hearing Impairment,15,35,50,43,93
Jharkhand,Saraikela Kharsawan,Hearing Impairment,35,60,65,40,105
Jharkhand,Saraikela Kharsawan,Hearing Impairment,60,80,10,6,16
Uttar Pradesh,Sant Kabeer Nagar,Hearing Impairment,0,6,2,4,6
Uttar Pradesh,Sant Kabeer Nagar,Hearing Impairment,6,15,17,11,28
Uttar Pradesh,Sant Kabeer Nagar,Hearing Impairment,15,35,80,42,122
Uttar Pradesh,Sant Kabeer Nagar,Hearing Impairment,35,60,49,21,70
Uttar Pradesh,Sant Kabeer Nagar,Hearing Impairment,60,80,8,3,11
Punjab,Sangrur,Hearing Impairment,0,6,16,11,27
Punjab,Sangrur,Hearing Impairment,6,15,75,38,113
Punjab,Sangrur,Hearing Impairment,15,35,186,100,286
Punjab,Sangrur,Hearing Impairment,35,60,157,60,217
Punjab,Sangrur,Hearing Impairment,60,80,31,13,44
Punjab,Sangrur,Hearing Impairment,80,100,1,1,2
Maharashtra,Sangli,Hearing Impairment,0,6,56,37,93
Maharashtra,Sangli,Hearing Impairment,6,15,708,507,1215
Maharashtra,Sangli,Hearing Impairment,15,35,2434,1389,3823
Maharashtra,Sangli,Hearing Impairment,35,60,1481,484,1965
Maharashtra,Sangli,Hearing Impairment,60,80,585,129,714
Maharashtra,Sangli,Hearing Impairment,80,100,90,8,98
Telangana,Sangareddy,Hearing Impairment,0,6,0,1,1
Telangana,Sangareddy,Hearing Impairment,6,15,12,19,31
Telangana,Sangareddy,Hearing Impairment,15,35,101,85,186
Telangana,Sangareddy,Hearing Impairment,35,60,61,48,109
Telangana,Sangareddy,Hearing Impairment,60,80,17,13,30
Telangana,Sangareddy,Hearing Impairment,80,100,2,1,3
Uttar Pradesh,Sambhal,Hearing Impairment,0,6,7,3,10
Uttar Pradesh,Sambhal,Hearing Impairment,6,15,17,9,26
Uttar Pradesh,Sambhal,Hearing Impairment,15,35,44,24,68
Uttar Pradesh,Sambhal,Hearing Impairment,35,60,36,6,42
Uttar Pradesh,Sambhal,Hearing Impairment,60,80,4,1,5
Odisha,Sambalpur,Hearing Impairment,0,6,15,16,31
Odisha,Sambalpur,Hearing Impairment,6,15,91,102,193
Odisha,Sambalpur,Hearing Impairment,15,35,334,281,615
Odisha,Sambalpur,Hearing Impairment,35,60,388,313,701
Odisha,Sambalpur,Hearing Impairment,60,80,241,139,380
Odisha,Sambalpur,Hearing Impairment,80,100,36,18,54
Jammu And Kashmir,Samba,Hearing Impairment,0,6,2,3,5
Jammu And Kashmir,Samba,Hearing Impairment,6,15,30,21,51
Jammu And Kashmir,Samba,Hearing Impairment,15,35,67,55,122
Jammu And Kashmir,Samba,Hearing Impairment,35,60,80,56,136
Jammu And Kashmir,Samba,Hearing Impairment,60,80,7,9,16
Jammu And Kashmir,Samba,Hearing Impairment,80,100,2,1,3
Bihar,Samastipur,Hearing Impairment,0,6,30,25,55
Bihar,Samastipur,Hearing Impairment,6,15,116,117,233
Bihar,Samastipur,Hearing Impairment,15,35,221,164,385
Bihar,Samastipur,Hearing Impairment,35,60,129,69,198
Bihar,Samastipur,Hearing Impairment,60,80,25,14,39
Tamil Nadu,Salem,Hearing Impairment,0,6,24,21,45
Tamil Nadu,Salem,Hearing Impairment,6,15,184,162,346
Tamil Nadu,Salem,Hearing Impairment,15,35,543,369,912
Tamil Nadu,Salem,Hearing Impairment,35,60,592,432,1024
Tamil Nadu,Salem,Hearing Impairment,60,80,271,156,427
Tamil Nadu,Salem,Hearing Impairment,80,100,20,13,33
Mizoram,Saitual,Hearing Impairment,6,15,0,1,1
Mizoram,Saitual,Hearing Impairment,15,35,0,2,2
Mizoram,Saitual,Hearing Impairment,35,60,1,3,4
Mizoram,Saitual,Hearing Impairment,60,80,2,1,3
Mizoram,Saitual,Hearing Impairment,80,100,1,0,1
Mizoram,Saiha,Hearing Impairment,6,15,0,1,1
Mizoram,Saiha,Hearing Impairment,15,35,2,4,6
Mizoram,Saiha,Hearing Impairment,35,60,3,3,6
Mizoram,Saiha,Hearing Impairment,60,80,2,3,5
Mizoram,Saiha,Hearing Impairment,80,100,2,0,2
Jharkhand,Sahebganj,Hearing Impairment,0,6,9,8,17
Jharkhand,Sahebganj,Hearing Impairment,6,15,104,95,199
Jharkhand,Sahebganj,Hearing Impairment,15,35,239,250,489
Jharkhand,Sahebganj,Hearing Impairment,35,60,166,122,288
Jharkhand,Sahebganj,Hearing Impairment,60,80,17,11,28
Bihar,Saharsa,Hearing Impairment,0,6,3,8,11
Bihar,Saharsa,Hearing Impairment,6,15,39,42,81
Bihar,Saharsa,Hearing Impairment,15,35,123,62,185
Bihar,Saharsa,Hearing Impairment,35,60,48,32,80
Bihar,Saharsa,Hearing Impairment,60,80,8,2,10
Uttar Pradesh,Saharanpur,Hearing Impairment,0,6,17,6,23
Uttar Pradesh,Saharanpur,Hearing Impairment,6,15,60,45,105
Uttar Pradesh,Saharanpur,Hearing Impairment,15,35,163,81,244
Uttar Pradesh,Saharanpur,Hearing Impairment,35,60,111,51,162
Uttar Pradesh,Saharanpur,Hearing Impairment,60,80,15,6,21
Uttar Pradesh,Saharanpur,Hearing Impairment,80,100,2,0,2
Madhya Pradesh,Sagar,Hearing Impairment,0,6,5,3,8
Madhya Pradesh,Sagar,Hearing Impairment,6,15,129,92,221
Madhya Pradesh,Sagar,Hearing Impairment,15,35,691,425,1116
Madhya Pradesh,Sagar,Hearing Impairment,35,60,512,220,732
Madhya Pradesh,Sagar,Hearing Impairment,60,80,211,75,286
Madhya Pradesh,Sagar,Hearing Impairment,80,100,21,5,26
Gujarat,Sabar Kantha,Hearing Impairment,0,6,9,16,25
Gujarat,Sabar Kantha,Hearing Impairment,6,15,158,126,284
Gujarat,Sabar Kantha,Hearing Impairment,15,35,413,211,624
Gujarat,Sabar Kantha,Hearing Impairment,35,60,199,117,316
Gujarat,Sabar Kantha,Hearing Impairment,60,80,15,4,19
Punjab,S.A.S Nagar,Hearing Impairment,0,6,12,12,24
Punjab,S.A.S Nagar,Hearing Impairment,6,15,68,49,117
Punjab,S.A.S Nagar,Hearing Impairment,15,35,132,71,203
Punjab,S.A.S Nagar,Hearing Impairment,35,60,75,46,121
Punjab,S.A.S Nagar,Hearing Impairment,60,80,26,3,29
Punjab,S.A.S Nagar,Hearing Impairment,80,100,3,1,4
Punjab,Rupnagar,Hearing Impairment,0,6,2,5,7
Punjab,Rupnagar,Hearing Impairment,6,15,29,17,46
Punjab,Rupnagar,Hearing Impairment,15,35,79,60,139
Punjab,Rupnagar,Hearing Impairment,35,60,59,34,93
Punjab,Rupnagar,Hearing Impairment,60,80,17,1,18
Punjab,Rupnagar,Hearing Impairment,80,100,1,0,1
Uttarakhand,Rudra Prayag,Hearing Impairment,6,15,5,1,6
Uttarakhand,Rudra Prayag,Hearing Impairment,15,35,44,29,73
Uttarakhand,Rudra Prayag,Hearing Impairment,35,60,83,38,121
Uttarakhand,Rudra Prayag,Hearing Impairment,60,80,20,8,28
Uttarakhand,Rudra Prayag,Hearing Impairment,80,100,5,0,5
Bihar,Rohtas,Hearing Impairment,0,6,1,3,4
Bihar,Rohtas,Hearing Impairment,6,15,60,32,92
Bihar,Rohtas,Hearing Impairment,15,35,178,79,257
Bihar,Rohtas,Hearing Impairment,35,60,117,43,160
Bihar,Rohtas,Hearing Impairment,60,80,15,0,15
Haryana,Rohtak,Hearing Impairment,0,6,10,13,23
Haryana,Rohtak,Hearing Impairment,6,15,49,24,73
Haryana,Rohtak,Hearing Impairment,15,35,144,99,243
Haryana,Rohtak,Hearing Impairment,35,60,113,61,174
Haryana,Rohtak,Hearing Impairment,60,80,25,12,37
Haryana,Rohtak,Hearing Impairment,80,100,2,0,2
Meghalaya,Ri Bhoi,Hearing Impairment,0,6,1,1,2
Meghalaya,Ri Bhoi,Hearing Impairment,6,15,24,15,39
Meghalaya,Ri Bhoi,Hearing Impairment,15,35,104,107,211
Meghalaya,Ri Bhoi,Hearing Impairment,35,60,78,61,139
Meghalaya,Ri Bhoi,Hearing Impairment,60,80,27,30,57
Meghalaya,Ri Bhoi,Hearing Impairment,80,100,7,2,9
Haryana,Rewari,Hearing Impairment,0,6,6,4,10
Haryana,Rewari,Hearing Impairment,6,15,40,25,65
Haryana,Rewari,Hearing Impairment,15,35,81,40,121
Haryana,Rewari,Hearing Impairment,35,60,40,17,57
Haryana,Rewari,Hearing Impairment,60,80,10,3,13
Haryana,Rewari,Hearing Impairment,80,100,1,0,1
Madhya Pradesh,Rewa,Hearing Impairment,0,6,20,19,39
Madhya Pradesh,Rewa,Hearing Impairment,6,15,216,143,359
Madhya Pradesh,Rewa,Hearing Impairment,15,35,591,395,986
Madhya Pradesh,Rewa,Hearing Impairment,35,60,406,189,595
Madhya Pradesh,Rewa,Hearing Impairment,60,80,149,52,201
Madhya Pradesh,Rewa,Hearing Impairment,80,100,21,5,26
Jammu And Kashmir,Reasi,Hearing Impairment,0,6,1,0,1
Jammu And Kashmir,Reasi,Hearing Impairment,6,15,18,18,36
Jammu And Kashmir,Reasi,Hearing Impairment,15,35,38,28,66
Jammu And Kashmir,Reasi,Hearing Impairment,35,60,37,16,53
Jammu And Kashmir,Reasi,Hearing Impairment,60,80,4,2,6
Odisha,Rayagada,Hearing Impairment,0,6,1,5,6
Odisha,Rayagada,Hearing Impairment,6,15,84,76,160
Odisha,Rayagada,Hearing Impairment,15,35,354,298,652
Odisha,Rayagada,Hearing Impairment,35,60,327,236,563
Odisha,Rayagada,Hearing Impairment,60,80,162,72,234
Odisha,Rayagada,Hearing Impairment,80,100,10,5,15
Maharashtra,Ratnagiri,Hearing Impairment,0,6,17,17,34
Maharashtra,Ratnagiri,Hearing Impairment,6,15,156,165,321
Maharashtra,Ratnagiri,Hearing Impairment,15,35,911,615,1526
Maharashtra,Ratnagiri,Hearing Impairment,35,60,638,332,970
Maharashtra,Ratnagiri,Hearing Impairment,60,80,181,28,209
Maharashtra,Ratnagiri,Hearing Impairment,80,100,11,1,12
Madhya Pradesh,Ratlam,Hearing Impairment,0,6,10,9,19
Madhya Pradesh,Ratlam,Hearing Impairment,6,15,74,71,145
Madhya Pradesh,Ratlam,Hearing Impairment,15,35,191,138,329
Madhya Pradesh,Ratlam,Hearing Impairment,35,60,145,87,232
Madhya Pradesh,Ratlam,Hearing Impairment,60,80,115,49,164
Madhya Pradesh,Ratlam,Hearing Impairment,80,100,14,4,18
Tamil Nadu,Ranipet,Hearing Impairment,0,6,11,5,16
Tamil Nadu,Ranipet,Hearing Impairment,6,15,30,27,57
Tamil Nadu,Ranipet,Hearing Impairment,15,35,119,122,241
Tamil Nadu,Ranipet,Hearing Impairment,35,60,275,237,512
Tamil Nadu,Ranipet,Hearing Impairment,60,80,145,61,206
Tamil Nadu,Ranipet,Hearing Impairment,80,100,18,5,23
Telangana,Ranga Reddy,Hearing Impairment,0,6,0,1,1
Telangana,Ranga Reddy,Hearing Impairment,6,15,128,87,215
Telangana,Ranga Reddy,Hearing Impairment,15,35,479,419,898
Telangana,Ranga Reddy,Hearing Impairment,35,60,473,408,881
Telangana,Ranga Reddy,Hearing Impairment,60,80,238,128,366
Telangana,Ranga Reddy,Hearing Impairment,80,100,33,12,45
Jharkhand,Ranchi,Hearing Impairment,0,6,21,11,32
Jharkhand,Ranchi,Hearing Impairment,6,15,135,121,256
Jharkhand,Ranchi,Hearing Impairment,15,35,208,176,384
Jharkhand,Ranchi,Hearing Impairment,35,60,164,95,259
Jharkhand,Ranchi,Hearing Impairment,60,80,36,19,55
Jharkhand,Ranchi,Hearing Impairment,80,100,2,0,2
Uttar Pradesh,Rampur,Hearing Impairment,0,6,8,9,17
Uttar Pradesh,Rampur,Hearing Impairment,6,15,32,33,65
Uttar Pradesh,Rampur,Hearing Impairment,15,35,129,68,197
Uttar Pradesh,Rampur,Hearing Impairment,35,60,90,45,135
Uttar Pradesh,Rampur,Hearing Impairment,60,80,15,2,17
Uttar Pradesh,Rampur,Hearing Impairment,80,100,1,0,1
Jharkhand,Ramgarh,Hearing Impairment,0,6,5,4,9
Jharkhand,Ramgarh,Hearing Impairment,6,15,42,50,92
Jharkhand,Ramgarh,Hearing Impairment,15,35,350,214,564
Jharkhand,Ramgarh,Hearing Impairment,35,60,251,179,430
Jharkhand,Ramgarh,Hearing Impairment,60,80,20,19,39
Jharkhand,Ramgarh,Hearing Impairment,80,100,1,0,1
Jammu And Kashmir,Ramban,Hearing Impairment,0,6,4,5,9
Jammu And Kashmir,Ramban,Hearing Impairment,6,15,44,34,78
Jammu And Kashmir,Ramban,Hearing Impairment,15,35,110,79,189
Jammu And Kashmir,Ramban,Hearing Impairment,35,60,102,65,167
Jammu And Kashmir,Ramban,Hearing Impairment,60,80,15,8,23
Jammu And Kashmir,Ramban,Hearing Impairment,80,100,5,0,5
Tamil Nadu,Ramanathapuram,Hearing Impairment,0,6,19,14,33
Tamil Nadu,Ramanathapuram,Hearing Impairment,6,15,112,90,202
Tamil Nadu,Ramanathapuram,Hearing Impairment,15,35,376,313,689
Tamil Nadu,Ramanathapuram,Hearing Impairment,35,60,544,476,1020
Tamil Nadu,Ramanathapuram,Hearing Impairment,60,80,247,148,395
Tamil Nadu,Ramanathapuram,Hearing Impairment,80,100,22,10,32
Karnataka,Ramanagara,Hearing Impairment,0,6,19,24,43
Karnataka,Ramanagara,Hearing Impairment,6,15,114,83,197
Karnataka,Ramanagara,Hearing Impairment,15,35,306,246,552
Karnataka,Ramanagara,Hearing Impairment,35,60,430,290,720
Karnataka,Ramanagara,Hearing Impairment,60,80,170,52,222
Karnataka,Ramanagara,Hearing Impairment,80,100,12,2,14
Rajasthan,Rajsamand,Hearing Impairment,0,6,1,5,6
Rajasthan,Rajsamand,Hearing Impairment,6,15,50,30,80
Rajasthan,Rajsamand,Hearing Impairment,15,35,118,113,231
Rajasthan,Rajsamand,Hearing Impairment,35,60,93,102,195
Rajasthan,Rajsamand,Hearing Impairment,60,80,41,22,63
Rajasthan,Rajsamand,Hearing Impairment,80,100,10,2,12
Jammu And Kashmir,Rajouri,Hearing Impairment,0,6,10,4,14
Jammu And Kashmir,Rajouri,Hearing Impairment,6,15,47,45,92
Jammu And Kashmir,Rajouri,Hearing Impairment,15,35,147,121,268
Jammu And Kashmir,Rajouri,Hearing Impairment,35,60,207,129,336
Jammu And Kashmir,Rajouri,Hearing Impairment,60,80,26,30,56
Jammu And Kashmir,Rajouri,Hearing Impairment,80,100,4,1,5
Chhattisgarh,Rajnandgaon,Hearing Impairment,0,6,21,27,48
Chhattisgarh,Rajnandgaon,Hearing Impairment,6,15,115,96,211
Chhattisgarh,Rajnandgaon,Hearing Impairment,15,35,260,189,449
Chhattisgarh,Rajnandgaon,Hearing Impairment,35,60,223,139,362
Chhattisgarh,Rajnandgaon,Hearing Impairment,60,80,231,94,325
Chhattisgarh,Rajnandgaon,Hearing Impairment,80,100,24,15,39
Gujarat,Rajkot,Hearing Impairment,0,6,31,37,68
Gujarat,Rajkot,Hearing Impairment,6,15,172,135,307
Gujarat,Rajkot,Hearing Impairment,15,35,409,286,695
Gujarat,Rajkot,Hearing Impairment,35,60,271,194,465
Gujarat,Rajkot,Hearing Impairment,60,80,50,20,70
Gujarat,Rajkot,Hearing Impairment,80,100,4,0,4
Madhya Pradesh,Rajgarh,Hearing Impairment,0,6,2,2,4
Madhya Pradesh,Rajgarh,Hearing Impairment,6,15,64,55,119
Madhya Pradesh,Rajgarh,Hearing Impairment,15,35,279,122,401
Madhya Pradesh,Rajgarh,Hearing Impairment,35,60,310,205,515
Madhya Pradesh,Rajgarh,Hearing Impairment,60,80,359,121,480
Madhya Pradesh,Rajgarh,Hearing Impairment,80,100,52,8,60
Telangana,Rajanna Sircilla,Hearing Impairment,6,15,12,11,23
Telangana,Rajanna Sircilla,Hearing Impairment,15,35,99,103,202
Telangana,Rajanna Sircilla,Hearing Impairment,35,60,126,128,254
Telangana,Rajanna Sircilla,Hearing Impairment,60,80,123,94,217
Telangana,Rajanna Sircilla,Hearing Impairment,80,100,23,15,38
Madhya Pradesh,Raisen,Hearing Impairment,0,6,24,15,39
Madhya Pradesh,Raisen,Hearing Impairment,6,15,191,144,335
Madhya Pradesh,Raisen,Hearing Impairment,15,35,512,274,786
Madhya Pradesh,Raisen,Hearing Impairment,35,60,447,157,604
Madhya Pradesh,Raisen,Hearing Impairment,60,80,120,42,162
Madhya Pradesh,Raisen,Hearing Impairment,80,100,22,8,30
Chhattisgarh,Raipur,Hearing Impairment,0,6,38,14,52
Chhattisgarh,Raipur,Hearing Impairment,6,15,180,142,322
Chhattisgarh,Raipur,Hearing Impairment,15,35,312,263,575
Chhattisgarh,Raipur,Hearing Impairment,35,60,150,70,220
Chhattisgarh,Raipur,Hearing Impairment,60,80,32,11,43
Chhattisgarh,Raipur,Hearing Impairment,80,100,4,2,6
Chhattisgarh,Raigarh,Hearing Impairment,0,6,26,25,51
Chhattisgarh,Raigarh,Hearing Impairment,6,15,178,132,310
Chhattisgarh,Raigarh,Hearing Impairment,15,35,343,304,647
Chhattisgarh,Raigarh,Hearing Impairment,35,60,245,164,409
Chhattisgarh,Raigarh,Hearing Impairment,60,80,189,100,289
Chhattisgarh,Raigarh,Hearing Impairment,80,100,17,15,32
Maharashtra,Raigad,Hearing Impairment,0,6,22,20,42
Maharashtra,Raigad,Hearing Impairment,6,15,215,174,389
Maharashtra,Raigad,Hearing Impairment,15,35,757,508,1265
Maharashtra,Raigad,Hearing Impairment,35,60,630,270,900
Maharashtra,Raigad,Hearing Impairment,60,80,122,22,144
Maharashtra,Raigad,Hearing Impairment,80,100,1,1,2
Karnataka,Raichur,Hearing Impairment,0,6,12,9,21
Karnataka,Raichur,Hearing Impairment,6,15,83,65,148
Karnataka,Raichur,Hearing Impairment,15,35,282,299,581
Karnataka,Raichur,Hearing Impairment,35,60,553,498,1051
Karnataka,Raichur,Hearing Impairment,60,80,162,95,257
Karnataka,Raichur,Hearing Impairment,80,100,8,2,10
Uttar Pradesh,Rae Bareli,Hearing Impairment,0,6,8,9,17
Uttar Pradesh,Rae Bareli,Hearing Impairment,6,15,30,20,50
Uttar Pradesh,Rae Bareli,Hearing Impairment,15,35,218,117,335
Uttar Pradesh,Rae Bareli,Hearing Impairment,35,60,128,49,177
Uttar Pradesh,Rae Bareli,Hearing Impairment,60,80,25,5,30
Uttar Pradesh,Rae Bareli,Hearing Impairment,80,100,2,0,2
Bihar,Purnia,Hearing Impairment,0,6,4,4,8
Bihar,Purnia,Hearing Impairment,6,15,63,67,130
Bihar,Purnia,Hearing Impairment,15,35,149,81,230
Bihar,Purnia,Hearing Impairment,35,60,54,28,82
Bihar,Purnia,Hearing Impairment,60,80,13,5,18
Odisha,Puri,Hearing Impairment,0,6,24,31,55
Odisha,Puri,Hearing Impairment,6,15,207,149,356
Odisha,Puri,Hearing Impairment,15,35,553,443,996
Odisha,Puri,Hearing Impairment,35,60,1185,1029,2214
Odisha,Puri,Hearing Impairment,60,80,476,246,722
Odisha,Puri,Hearing Impairment,80,100,47,18,65
Bihar,Purbi Champaran,Hearing Impairment,0,6,6,4,10
Bihar,Purbi Champaran,Hearing Impairment,6,15,52,40,92
Bihar,Purbi Champaran,Hearing Impairment,15,35,81,38,119
Bihar,Purbi Champaran,Hearing Impairment,35,60,34,15,49
Bihar,Purbi Champaran,Hearing Impairment,60,80,1,3,4
Maharashtra,Pune,Hearing Impairment,0,6,164,148,312
Maharashtra,Pune,Hearing Impairment,6,15,928,766,1694
Maharashtra,Pune,Hearing Impairment,15,35,2418,1455,3873
Maharashtra,Pune,Hearing Impairment,35,60,1504,755,2259
Maharashtra,Pune,Hearing Impairment,60,80,506,159,665
Maharashtra,Pune,Hearing Impairment,80,100,98,7,105
Jammu And Kashmir,Pulwama,Hearing Impairment,0,6,2,10,12
Jammu And Kashmir,Pulwama,Hearing Impairment,6,15,34,18,52
Jammu And Kashmir,Pulwama,Hearing Impairment,15,35,88,85,173
Jammu And Kashmir,Pulwama,Hearing Impairment,35,60,126,110,236
Jammu And Kashmir,Pulwama,Hearing Impairment,60,80,68,37,105
Jammu And Kashmir,Pulwama,Hearing Impairment,80,100,7,0,7
Tamil Nadu,Pudukkottai,Hearing Impairment,0,6,17,11,28
Tamil Nadu,Pudukkottai,Hearing Impairment,6,15,125,123,248
Tamil Nadu,Pudukkottai,Hearing Impairment,15,35,423,361,784
Tamil Nadu,Pudukkottai,Hearing Impairment,35,60,593,487,1080
Tamil Nadu,Pudukkottai,Hearing Impairment,60,80,256,128,384
Tamil Nadu,Pudukkottai,Hearing Impairment,80,100,22,9,31
Uttar Pradesh,Prayagraj,Hearing Impairment,0,6,39,23,62
Uttar Pradesh,Prayagraj,Hearing Impairment,6,15,218,138,356
Uttar Pradesh,Prayagraj,Hearing Impairment,15,35,640,349,989
Uttar Pradesh,Prayagraj,Hearing Impairment,35,60,325,129,454
Uttar Pradesh,Prayagraj,Hearing Impairment,60,80,74,20,94
Uttar Pradesh,Prayagraj,Hearing Impairment,80,100,3,0,3
Rajasthan,Pratapgarh,Hearing Impairment,0,6,2,3,5
Rajasthan,Pratapgarh,Hearing Impairment,6,15,32,27,59
Rajasthan,Pratapgarh,Hearing Impairment,15,35,99,81,180
Rajasthan,Pratapgarh,Hearing Impairment,35,60,85,70,155
Rajasthan,Pratapgarh,Hearing Impairment,60,80,39,34,73
Rajasthan,Pratapgarh,Hearing Impairment,80,100,11,5,16
Uttar Pradesh,Pratapgarh,Hearing Impairment,0,6,4,0,4
Uttar Pradesh,Pratapgarh,Hearing Impairment,6,15,8,4,12
Uttar Pradesh,Pratapgarh,Hearing Impairment,15,35,288,184,472
Uttar Pradesh,Pratapgarh,Hearing Impairment,35,60,578,709,1287
Uttar Pradesh,Pratapgarh,Hearing Impairment,60,80,62,28,90
Uttar Pradesh,Pratapgarh,Hearing Impairment,80,100,2,0,2
Andhra Pradesh,Prakasam,Hearing Impairment,0,6,19,12,31
Andhra Pradesh,Prakasam,Hearing Impairment,6,15,260,203,463
Andhra Pradesh,Prakasam,Hearing Impairment,15,35,648,353,1001
Andhra Pradesh,Prakasam,Hearing Impairment,35,60,1026,318,1344
Andhra Pradesh,Prakasam,Hearing Impairment,60,80,398,83,481
Andhra Pradesh,Prakasam,Hearing Impairment,80,100,37,9,46
Gujarat,Porbandar,Hearing Impairment,0,6,1,1,2
Gujarat,Porbandar,Hearing Impairment,6,15,33,30,63
Gujarat,Porbandar,Hearing Impairment,15,35,119,77,196
Gujarat,Porbandar,Hearing Impairment,35,60,91,43,134
Gujarat,Porbandar,Hearing Impairment,60,80,68,13,81
Gujarat,Porbandar,Hearing Impairment,80,100,13,3,16
Jammu And Kashmir,Poonch,Hearing Impairment,0,6,20,14,34
Jammu And Kashmir,Poonch,Hearing Impairment,6,15,132,105,237
Jammu And Kashmir,Poonch,Hearing Impairment,15,35,280,407,687
Jammu And Kashmir,Poonch,Hearing Impairment,35,60,266,415,681
Jammu And Kashmir,Poonch,Hearing Impairment,60,80,24,23,47
Jammu And Kashmir,Poonch,Hearing Impairment,80,100,2,1,3
Puducherry,Pondicherry,Hearing Impairment,0,6,5,6,11
Puducherry,Pondicherry,Hearing Impairment,6,15,58,37,95
Puducherry,Pondicherry,Hearing Impairment,15,35,297,272,569
Puducherry,Pondicherry,Hearing Impairment,35,60,607,716,1323
Puducherry,Pondicherry,Hearing Impairment,60,80,388,490,878
Puducherry,Pondicherry,Hearing Impairment,80,100,75,112,187
Uttarakhand,Pithoragarh,Hearing Impairment,6,15,0,6,6
Uttarakhand,Pithoragarh,Hearing Impairment,15,35,9,1,10
Uttarakhand,Pithoragarh,Hearing Impairment,35,60,17,4,21
Uttarakhand,Pithoragarh,Hearing Impairment,60,80,3,1,4
Uttar Pradesh,Pilibhit,Hearing Impairment,0,6,20,9,29
Uttar Pradesh,Pilibhit,Hearing Impairment,6,15,47,43,90
Uttar Pradesh,Pilibhit,Hearing Impairment,15,35,316,190,506
Uttar Pradesh,Pilibhit,Hearing Impairment,35,60,314,170,484
Uttar Pradesh,Pilibhit,Hearing Impairment,60,80,84,42,126
Uttar Pradesh,Pilibhit,Hearing Impairment,80,100,3,4,7
Manipur,Pherzawl,Hearing Impairment,15,35,0,1,1
Manipur,Pherzawl,Hearing Impairment,60,80,1,0,1
Nagaland,Phek,Hearing Impairment,15,35,2,0,2
Nagaland,Phek,Hearing Impairment,35,60,3,1,4
Nagaland,Phek,Hearing Impairment,60,80,1,0,1
Nagaland,Peren,Hearing Impairment,15,35,1,1,2
Nagaland,Peren,Hearing Impairment,35,60,2,1,3
Tamil Nadu,Perambalur,Hearing Impairment,0,6,18,12,30
Tamil Nadu,Perambalur,Hearing Impairment,6,15,55,39,94
Tamil Nadu,Perambalur,Hearing Impairment,15,35,197,168,365
Tamil Nadu,Perambalur,Hearing Impairment,35,60,300,201,501
Tamil Nadu,Perambalur,Hearing Impairment,60,80,173,101,274
Tamil Nadu,Perambalur,Hearing Impairment,80,100,18,9,27
Telangana,Peddapalli,Hearing Impairment,0,6,2,0,2
Telangana,Peddapalli,Hearing Impairment,6,15,24,15,39
Telangana,Peddapalli,Hearing Impairment,15,35,214,195,409
Telangana,Peddapalli,Hearing Impairment,35,60,346,332,678
Telangana,Peddapalli,Hearing Impairment,60,80,238,194,432
Telangana,Peddapalli,Hearing Impairment,80,100,50,37,87
Uttarakhand,Pauri Garhwal,Hearing Impairment,0,6,4,3,7
Uttarakhand,Pauri Garhwal,Hearing Impairment,6,15,25,17,42
Uttarakhand,Pauri Garhwal,Hearing Impairment,15,35,57,32,89
Uttarakhand,Pauri Garhwal,Hearing Impairment,35,60,138,51,189
Uttarakhand,Pauri Garhwal,Hearing Impairment,60,80,24,9,33
Uttarakhand,Pauri Garhwal,Hearing Impairment,80,100,4,3,7
Bihar,Patna,Hearing Impairment,0,6,14,16,30
Bihar,Patna,Hearing Impairment,6,15,154,136,290
Bihar,Patna,Hearing Impairment,15,35,368,165,533
Bihar,Patna,Hearing Impairment,35,60,185,82,267
Bihar,Patna,Hearing Impairment,60,80,23,20,43
Bihar,Patna,Hearing Impairment,80,100,1,1,2
Punjab,Patiala,Hearing Impairment,0,6,20,20,40
Punjab,Patiala,Hearing Impairment,6,15,109,104,213
Punjab,Patiala,Hearing Impairment,15,35,282,184,466
Punjab,Patiala,Hearing Impairment,35,60,191,111,302
Punjab,Patiala,Hearing Impairment,60,80,51,14,65
Punjab,Patiala,Hearing Impairment,80,100,6,0,6
Punjab,Pathankot,Hearing Impairment,0,6,7,4,11
Punjab,Pathankot,Hearing Impairment,6,15,37,32,69
Punjab,Pathankot,Hearing Impairment,15,35,92,52,144
Punjab,Pathankot,Hearing Impairment,35,60,75,34,109
Punjab,Pathankot,Hearing Impairment,60,80,15,9,24
Punjab,Pathankot,Hearing Impairment,80,100,1,1,2
Kerala,Pathanamthitta,Hearing Impairment,0,6,5,8,13
Kerala,Pathanamthitta,Hearing Impairment,6,15,35,27,62
Kerala,Pathanamthitta,Hearing Impairment,15,35,179,131,310
Kerala,Pathanamthitta,Hearing Impairment,35,60,223,239,462
Kerala,Pathanamthitta,Hearing Impairment,60,80,159,121,280
Kerala,Pathanamthitta,Hearing Impairment,80,100,19,11,30
Gujarat,Patan,Hearing Impairment,0,6,1,3,4
Gujarat,Patan,Hearing Impairment,6,15,23,15,38
Gujarat,Patan,Hearing Impairment,15,35,24,8,32
Gujarat,Patan,Hearing Impairment,35,60,12,4,16
Gujarat,Patan,Hearing Impairment,60,80,18,3,21
Gujarat,Patan,Hearing Impairment,80,100,3,0,3
Bihar,Pashchim Champaran,Hearing Impairment,0,6,24,12,36
Bihar,Pashchim Champaran,Hearing Impairment,6,15,92,84,176
Bihar,Pashchim Champaran,Hearing Impairment,15,35,520,198,718
Bihar,Pashchim Champaran,Hearing Impairment,35,60,242,145,387
Bihar,Pashchim Champaran,Hearing Impairment,60,80,47,21,68
Bihar,Pashchim Champaran,Hearing Impairment,80,100,1,1,2
West Bengal,Paschim Bardhaman,Hearing Impairment,6,15,0,1,1
Maharashtra,Parbhani,Hearing Impairment,0,6,59,48,107
Maharashtra,Parbhani,Hearing Impairment,6,15,395,327,722
Maharashtra,Parbhani,Hearing Impairment,15,35,983,525,1508
Maharashtra,Parbhani,Hearing Impairment,35,60,464,183,647
Maharashtra,Parbhani,Hearing Impairment,60,80,79,36,115
Maharashtra,Parbhani,Hearing Impairment,80,100,9,1,10
Arunachal Pradesh,Papum Pare,Hearing Impairment,6,15,9,10,19
Arunachal Pradesh,Papum Pare,Hearing Impairment,15,35,35,25,60
Arunachal Pradesh,Papum Pare,Hearing Impairment,35,60,21,16,37
Arunachal Pradesh,Papum Pare,Hearing Impairment,60,80,3,1,4
Madhya Pradesh,Panna,Hearing Impairment,0,6,5,5,10
Madhya Pradesh,Panna,Hearing Impairment,6,15,56,45,101
Madhya Pradesh,Panna,Hearing Impairment,15,35,250,150,400
Madhya Pradesh,Panna,Hearing Impairment,35,60,162,85,247
Madhya Pradesh,Panna,Hearing Impairment,60,80,65,19,84
Madhya Pradesh,Panna,Hearing Impairment,80,100,9,4,13
Haryana,Panipat,Hearing Impairment,0,6,10,5,15
Haryana,Panipat,Hearing Impairment,6,15,49,42,91
Haryana,Panipat,Hearing Impairment,15,35,89,58,147
Haryana,Panipat,Hearing Impairment,35,60,49,47,96
Haryana,Panipat,Hearing Impairment,60,80,8,2,10
Haryana,Panchkula,Hearing Impairment,0,6,3,4,7
Haryana,Panchkula,Hearing Impairment,6,15,46,24,70
Haryana,Panchkula,Hearing Impairment,15,35,93,91,184
Haryana,Panchkula,Hearing Impairment,35,60,67,54,121
Haryana,Panchkula,Hearing Impairment,60,80,19,9,28
Haryana,Panchkula,Hearing Impairment,80,100,4,0,4
Gujarat,Panch Mahals,Hearing Impairment,0,6,9,5,14
Gujarat,Panch Mahals,Hearing Impairment,6,15,77,77,154
Gujarat,Panch Mahals,Hearing Impairment,15,35,236,133,369
Gujarat,Panch Mahals,Hearing Impairment,35,60,76,41,117
Gujarat,Panch Mahals,Hearing Impairment,60,80,16,4,20
Haryana,Palwal,Hearing Impairment,0,6,13,7,20
Haryana,Palwal,Hearing Impairment,6,15,44,34,78
Haryana,Palwal,Hearing Impairment,15,35,99,50,149
Haryana,Palwal,Hearing Impairment,35,60,49,16,65
Haryana,Palwal,Hearing Impairment,60,80,3,1,4
Rajasthan,Pali,Hearing Impairment,0,6,4,4,8
Rajasthan,Pali,Hearing Impairment,6,15,47,52,99
Rajasthan,Pali,Hearing Impairment,15,35,125,79,204
Rajasthan,Pali,Hearing Impairment,35,60,69,48,117
Rajasthan,Pali,Hearing Impairment,60,80,17,7,24
Rajasthan,Pali,Hearing Impairment,80,100,2,1,3
Maharashtra,Palghar,Hearing Impairment,0,6,18,19,37
Maharashtra,Palghar,Hearing Impairment,6,15,403,292,695
Maharashtra,Palghar,Hearing Impairment,15,35,736,578,1314
Maharashtra,Palghar,Hearing Impairment,35,60,527,232,759
Maharashtra,Palghar,Hearing Impairment,60,80,79,12,91
Maharashtra,Palghar,Hearing Impairment,80,100,4,0,4
Jharkhand,Palamu,Hearing Impairment,0,6,3,6,9
Jharkhand,Palamu,Hearing Impairment,6,15,48,23,71
Jharkhand,Palamu,Hearing Impairment,15,35,67,42,109
Jharkhand,Palamu,Hearing Impairment,35,60,39,15,54
Jharkhand,Palamu,Hearing Impairment,60,80,5,4,9
Kerala,Palakkad,Hearing Impairment,0,6,23,20,43
Kerala,Palakkad,Hearing Impairment,6,15,117,92,209
Kerala,Palakkad,Hearing Impairment,15,35,447,368,815
Kerala,Palakkad,Hearing Impairment,35,60,732,671,1403
Kerala,Palakkad,Hearing Impairment,60,80,353,262,615
Kerala,Palakkad,Hearing Impairment,80,100,29,19,48
Jharkhand,Pakur,Hearing Impairment,0,6,1,0,1
Jharkhand,Pakur,Hearing Impairment,6,15,93,90,183
Jharkhand,Pakur,Hearing Impairment,15,35,110,109,219
Jharkhand,Pakur,Hearing Impairment,35,60,88,82,170
Jharkhand,Pakur,Hearing Impairment,60,80,22,10,32
Jharkhand,Pakur,Hearing Impairment,80,100,0,1,1
Maharashtra,Osmanabad,Hearing Impairment,0,6,51,42,93
Maharashtra,Osmanabad,Hearing Impairment,6,15,270,206,476
Maharashtra,Osmanabad,Hearing Impairment,15,35,818,457,1275
Maharashtra,Osmanabad,Hearing Impairment,35,60,546,258,804
Maharashtra,Osmanabad,Hearing Impairment,60,80,271,121,392
Maharashtra,Osmanabad,Hearing Impairment,80,100,56,5,61
Haryana,Nuh,Hearing Impairment,0,6,17,11,28
Haryana,Nuh,Hearing Impairment,6,15,68,53,121
Haryana,Nuh,Hearing Impairment,15,35,99,66,165
Haryana,Nuh,Hearing Impairment,35,60,35,31,66
Haryana,Nuh,Hearing Impairment,60,80,8,6,14
Odisha,Nuapada,Hearing Impairment,0,6,15,12,27
Odisha,Nuapada,Hearing Impairment,6,15,170,132,302
Odisha,Nuapada,Hearing Impairment,15,35,302,228,530
Odisha,Nuapada,Hearing Impairment,35,60,386,244,630
Odisha,Nuapada,Hearing Impairment,60,80,132,72,204
Odisha,Nuapada,Hearing Impairment,80,100,13,4,17
Delhi,North West,Hearing Impairment,0,6,65,50,115
Delhi,North West,Hearing Impairment,6,15,218,192,410
Delhi,North West,Hearing Impairment,15,35,492,280,772
Delhi,North West,Hearing Impairment,35,60,241,124,365
Delhi,North West,Hearing Impairment,60,80,51,17,68
Delhi,North West,Hearing Impairment,80,100,1,1,2
Tripura,North Tripura,Hearing Impairment,0,6,8,3,11
Tripura,North Tripura,Hearing Impairment,6,15,40,28,68
Tripura,North Tripura,Hearing Impairment,15,35,88,74,162
Tripura,North Tripura,Hearing Impairment,35,60,147,118,265
Tripura,North Tripura,Hearing Impairment,60,80,74,60,134
Tripura,North Tripura,Hearing Impairment,80,100,17,8,25
Goa,North Goa,Hearing Impairment,0,6,2,3,5
Goa,North Goa,Hearing Impairment,6,15,45,37,82
Goa,North Goa,Hearing Impairment,15,35,94,72,166
Goa,North Goa,Hearing Impairment,35,60,81,65,146
Goa,North Goa,Hearing Impairment,60,80,11,4,15
Goa,North Goa,Hearing Impairment,80,100,2,0,2
Meghalaya,North Garo Hills,Hearing Impairment,0,6,2,1,3
Meghalaya,North Garo Hills,Hearing Impairment,6,15,16,9,25
Meghalaya,North Garo Hills,Hearing Impairment,15,35,68,45,113
Meghalaya,North Garo Hills,Hearing Impairment,35,60,33,43,76
Meghalaya,North Garo Hills,Hearing Impairment,60,80,15,9,24
Meghalaya,North Garo Hills,Hearing Impairment,80,100,2,2,4
Delhi,North East,Hearing Impairment,0,6,31,35,66
Delhi,North East,Hearing Impairment,6,15,142,127,269
Delhi,North East,Hearing Impairment,15,35,229,168,397
Delhi,North East,Hearing Impairment,35,60,101,35,136
Delhi,North East,Hearing Impairment,60,80,18,6,24
Delhi,North East,Hearing Impairment,80,100,1,0,1
Andaman And Nicobar Islands,North And Middle Andaman,Hearing Impairment,0,6,6,1,7
Andaman And Nicobar Islands,North And Middle Andaman,Hearing Impairment,6,15,9,2,11
Andaman And Nicobar Islands,North And Middle Andaman,Hearing Impairment,15,35,25,32,57
Andaman And Nicobar Islands,North And Middle Andaman,Hearing Impairment,35,60,52,41,93
Andaman And Nicobar Islands,North And Middle Andaman,Hearing Impairment,60,80,26,12,38
Andaman And Nicobar Islands,North And Middle Andaman,Hearing Impairment,80,100,2,1,3
Delhi,North,Hearing Impairment,0,6,13,7,20
Delhi,North,Hearing Impairment,6,15,51,32,83
Delhi,North,Hearing Impairment,15,35,106,66,172
Delhi,North,Hearing Impairment,35,60,51,27,78
Delhi,North,Hearing Impairment,60,80,19,3,22
Delhi,North,Hearing Impairment,80,100,4,0,4
Manipur,Noney,Hearing Impairment,6,15,2,0,2
Manipur,Noney,Hearing Impairment,15,35,5,0,5
Manipur,Noney,Hearing Impairment,35,60,10,4,14
Manipur,Noney,Hearing Impairment,60,80,1,4,5
Manipur,Noney,Hearing Impairment,80,100,1,1,2
Telangana,Nizamabad,Hearing Impairment,6,15,57,60,117
Telangana,Nizamabad,Hearing Impairment,15,35,381,382,763
Telangana,Nizamabad,Hearing Impairment,35,60,450,350,800
Telangana,Nizamabad,Hearing Impairment,60,80,155,131,286
Telangana,Nizamabad,Hearing Impairment,80,100,22,20,42
Madhya Pradesh,Niwari,Hearing Impairment,0,6,0,1,1
Madhya Pradesh,Niwari,Hearing Impairment,6,15,13,6,19
Madhya Pradesh,Niwari,Hearing Impairment,15,35,63,39,102
Madhya Pradesh,Niwari,Hearing Impairment,35,60,72,27,99
Madhya Pradesh,Niwari,Hearing Impairment,60,80,25,8,33
Madhya Pradesh,Niwari,Hearing Impairment,80,100,2,1,3
Telangana,Nirmal,Hearing Impairment,6,15,3,6,9
Telangana,Nirmal,Hearing Impairment,15,35,74,78,152
Telangana,Nirmal,Hearing Impairment,35,60,74,45,119
Telangana,Nirmal,Hearing Impairment,60,80,26,14,40
Telangana,Nirmal,Hearing Impairment,80,100,7,1,8
Andaman And Nicobar Islands,Nicobars,Hearing Impairment,6,15,3,1,4
Andaman And Nicobar Islands,Nicobars,Hearing Impairment,15,35,12,2,14
Andaman And Nicobar Islands,Nicobars,Hearing Impairment,35,60,16,9,25
Andaman And Nicobar Islands,Nicobars,Hearing Impairment,60,80,11,1,12
Andaman And Nicobar Islands,Nicobars,Hearing Impairment,80,100,1,0,1
Delhi,New Delhi,Hearing Impairment,0,6,2,1,3
Delhi,New Delhi,Hearing Impairment,6,15,3,3,6
Delhi,New Delhi,Hearing Impairment,15,35,21,12,33
Delhi,New Delhi,Hearing Impairment,35,60,3,1,4
Delhi,New Delhi,Hearing Impairment,60,80,2,1,3
Madhya Pradesh,Neemuch,Hearing Impairment,0,6,2,2,4
Madhya Pradesh,Neemuch,Hearing Impairment,6,15,19,17,36
Madhya Pradesh,Neemuch,Hearing Impairment,15,35,94,71,165
Madhya Pradesh,Neemuch,Hearing Impairment,35,60,59,40,99
Madhya Pradesh,Neemuch,Hearing Impairment,60,80,42,14,56
Madhya Pradesh,Neemuch,Hearing Impairment,80,100,3,0,3
Odisha,Nayagarh,Hearing Impairment,0,6,31,27,58
Odisha,Nayagarh,Hearing Impairment,6,15,161,117,278
Odisha,Nayagarh,Hearing Impairment,15,35,709,539,1248
Odisha,Nayagarh,Hearing Impairment,35,60,1536,1262,2798
Odisha,Nayagarh,Hearing Impairment,60,80,577,336,913
Odisha,Nayagarh,Hearing Impairment,80,100,59,14,73
Bihar,Nawada,Hearing Impairment,0,6,5,7,12
Bihar,Nawada,Hearing Impairment,6,15,32,34,66
Bihar,Nawada,Hearing Impairment,15,35,97,44,141
Bihar,Nawada,Hearing Impairment,35,60,36,15,51
Bihar,Nawada,Hearing Impairment,60,80,8,2,10
Gujarat,Navsari,Hearing Impairment,0,6,8,5,13
Gujarat,Navsari,Hearing Impairment,6,15,105,83,188
Gujarat,Navsari,Hearing Impairment,15,35,182,141,323
Gujarat,Navsari,Hearing Impairment,35,60,104,76,180
Gujarat,Navsari,Hearing Impairment,60,80,39,13,52
Gujarat,Navsari,Hearing Impairment,80,100,0,2,2
Maharashtra,Nashik,Hearing Impairment,0,6,77,70,147
Maharashtra,Nashik,Hearing Impairment,6,15,414,267,681
Maharashtra,Nashik,Hearing Impairment,15,35,1123,661,1784
Maharashtra,Nashik,Hearing Impairment,35,60,668,306,974
Maharashtra,Nashik,Hearing Impairment,60,80,183,53,236
Maharashtra,Nashik,Hearing Impairment,80,100,21,2,23
Madhya Pradesh,Narsinghpur,Hearing Impairment,0,6,5,10,15
Madhya Pradesh,Narsinghpur,Hearing Impairment,6,15,67,53,120
Madhya Pradesh,Narsinghpur,Hearing Impairment,15,35,163,80,243
Madhya Pradesh,Narsinghpur,Hearing Impairment,35,60,200,62,262
Madhya Pradesh,Narsinghpur,Hearing Impairment,60,80,65,32,97
Madhya Pradesh,Narsinghpur,Hearing Impairment,80,100,8,4,12
Madhya Pradesh,Narmadapuram,Hearing Impairment,6,15,25,17,42
Madhya Pradesh,Narmadapuram,Hearing Impairment,15,35,208,130,338
Madhya Pradesh,Narmadapuram,Hearing Impairment,35,60,123,62,185
Madhya Pradesh,Narmadapuram,Hearing Impairment,60,80,28,4,32
Madhya Pradesh,Narmadapuram,Hearing Impairment,80,100,2,0,2
Gujarat,Narmada,Hearing Impairment,0,6,3,2,5
Gujarat,Narmada,Hearing Impairment,6,15,24,20,44
Gujarat,Narmada,Hearing Impairment,15,35,90,76,166
Gujarat,Narmada,Hearing Impairment,35,60,43,24,67
Gujarat,Narmada,Hearing Impairment,60,80,2,0,2
Chhattisgarh,Narayanpur,Hearing Impairment,0,6,0,2,2
Chhattisgarh,Narayanpur,Hearing Impairment,6,15,16,4,20
Chhattisgarh,Narayanpur,Hearing Impairment,15,35,34,22,56
Chhattisgarh,Narayanpur,Hearing Impairment,35,60,20,13,33
Chhattisgarh,Narayanpur,Hearing Impairment,60,80,12,7,19
Chhattisgarh,Narayanpur,Hearing Impairment,80,100,2,0,2
Telangana,Narayanpet,Hearing Impairment,35,60,0,1,1
Telangana,Narayanpet,Hearing Impairment,60,80,0,1,1
Maharashtra,Nandurbar,Hearing Impairment,0,6,20,12,32
Maharashtra,Nandurbar,Hearing Impairment,6,15,122,108,230
Maharashtra,Nandurbar,Hearing Impairment,15,35,246,161,407
Maharashtra,Nandurbar,Hearing Impairment,35,60,226,126,352
Maharashtra,Nandurbar,Hearing Impairment,60,80,162,74,236
Maharashtra,Nandurbar,Hearing Impairment,80,100,23,2,25
Maharashtra,Nanded,Hearing Impairment,0,6,121,84,205
Maharashtra,Nanded,Hearing Impairment,6,15,696,518,1214
Maharashtra,Nanded,Hearing Impairment,15,35,1538,808,2346
Maharashtra,Nanded,Hearing Impairment,35,60,579,245,824
Maharashtra,Nanded,Hearing Impairment,60,80,66,41,107
Maharashtra,Nanded,Hearing Impairment,80,100,4,1,5
Arunachal Pradesh,Namsai,Hearing Impairment,0,6,1,0,1
Arunachal Pradesh,Namsai,Hearing Impairment,6,15,8,11,19
Arunachal Pradesh,Namsai,Hearing Impairment,15,35,10,11,21
Arunachal Pradesh,Namsai,Hearing Impairment,35,60,16,12,28
Arunachal Pradesh,Namsai,Hearing Impairment,60,80,4,6,10
Arunachal Pradesh,Namsai,Hearing Impairment,80,100,1,0,1
Sikkim,Namchi,Hearing Impairment,6,15,3,4,7
Sikkim,Namchi,Hearing Impairment,15,35,23,11,34
Sikkim,Namchi,Hearing Impairment,35,60,55,50,105
Sikkim,Namchi,Hearing Impairment,60,80,25,16,41
Sikkim,Namchi,Hearing Impairment,80,100,4,0,4
Tamil Nadu,Namakkal,Hearing Impairment,0,6,18,22,40
Tamil Nadu,Namakkal,Hearing Impairment,6,15,120,108,228
Tamil Nadu,Namakkal,Hearing Impairment,15,35,367,296,663
Tamil Nadu,Namakkal,Hearing Impairment,35,60,723,799,1522
Tamil Nadu,Namakkal,Hearing Impairment,60,80,544,388,932
Tamil Nadu,Namakkal,Hearing Impairment,80,100,46,23,69
Telangana,Nalgonda,Hearing Impairment,6,15,27,33,60
Telangana,Nalgonda,Hearing Impairment,15,35,459,454,913
Telangana,Nalgonda,Hearing Impairment,35,60,539,561,1100
Telangana,Nalgonda,Hearing Impairment,60,80,201,198,399
Telangana,Nalgonda,Hearing Impairment,80,100,50,25,75
Assam,Nalbari,Hearing Impairment,0,6,11,12,23
Assam,Nalbari,Hearing Impairment,6,15,98,63,161
Assam,Nalbari,Hearing Impairment,15,35,318,220,538
Assam,Nalbari,Hearing Impairment,35,60,350,257,607
Assam,Nalbari,Hearing Impairment,60,80,118,54,172
Assam,Nalbari,Hearing Impairment,80,100,6,1,7
Bihar,Nalanda,Hearing Impairment,0,6,20,20,40
Bihar,Nalanda,Hearing Impairment,6,15,102,82,184
Bihar,Nalanda,Hearing Impairment,15,35,224,93,317
Bihar,Nalanda,Hearing Impairment,35,60,77,54,131
Bihar,Nalanda,Hearing Impairment,60,80,23,9,32
Bihar,Nalanda,Hearing Impairment,80,100,3,1,4
Uttarakhand,Nainital,Hearing Impairment,0,6,4,2,6
Uttarakhand,Nainital,Hearing Impairment,6,15,28,9,37
Uttarakhand,Nainital,Hearing Impairment,15,35,86,59,145
Uttarakhand,Nainital,Hearing Impairment,35,60,178,87,265
Uttarakhand,Nainital,Hearing Impairment,60,80,94,31,125
Uttarakhand,Nainital,Hearing Impairment,80,100,9,2,11
Maharashtra,Nagpur,Hearing Impairment,0,6,128,72,200
Maharashtra,Nagpur,Hearing Impairment,6,15,606,487,1093
Maharashtra,Nagpur,Hearing Impairment,15,35,1419,947,2366
Maharashtra,Nagpur,Hearing Impairment,35,60,964,491,1455
Maharashtra,Nagpur,Hearing Impairment,60,80,206,63,269
Maharashtra,Nagpur,Hearing Impairment,80,100,14,1,15
Rajasthan,Nagaur,Hearing Impairment,0,6,23,15,38
Rajasthan,Nagaur,Hearing Impairment,6,15,154,121,275
Rajasthan,Nagaur,Hearing Impairment,15,35,396,266,662
Rajasthan,Nagaur,Hearing Impairment,35,60,219,157,376
Rajasthan,Nagaur,Hearing Impairment,60,80,57,44,101
Rajasthan,Nagaur,Hearing Impairment,80,100,6,4,10
Telangana,Nagarkurnool,Hearing Impairment,6,15,23,23,46
Telangana,Nagarkurnool,Hearing Impairment,15,35,183,141,324
Telangana,Nagarkurnool,Hearing Impairment,35,60,159,153,312
Telangana,Nagarkurnool,Hearing Impairment,60,80,42,39,81
Telangana,Nagarkurnool,Hearing Impairment,80,100,4,4,8
Tamil Nadu,Nagapattinam,Hearing Impairment,0,6,13,14,27
Tamil Nadu,Nagapattinam,Hearing Impairment,6,15,99,69,168
Tamil Nadu,Nagapattinam,Hearing Impairment,15,35,455,369,824
Tamil Nadu,Nagapattinam,Hearing Impairment,35,60,543,414,957
Tamil Nadu,Nagapattinam,Hearing Impairment,60,80,287,120,407
Tamil Nadu,Nagapattinam,Hearing Impairment,80,100,35,10,45
Assam,Nagaon,Hearing Impairment,0,6,21,19,40
Assam,Nagaon,Hearing Impairment,6,15,131,124,255
Assam,Nagaon,Hearing Impairment,15,35,213,188,401
Assam,Nagaon,Hearing Impairment,35,60,213,158,371
Assam,Nagaon,Hearing Impairment,60,80,75,41,116
Assam,Nagaon,Hearing Impairment,80,100,6,3,9
Odisha,Nabarangpur,Hearing Impairment,0,6,25,15,40
Odisha,Nabarangpur,Hearing Impairment,6,15,180,159,339
Odisha,Nabarangpur,Hearing Impairment,15,35,265,248,513
Odisha,Nabarangpur,Hearing Impairment,35,60,276,222,498
Odisha,Nabarangpur,Hearing Impairment,60,80,89,41,130
Odisha,Nabarangpur,Hearing Impairment,80,100,5,2,7
Karnataka,Mysuru,Hearing Impairment,0,6,39,15,54
Karnataka,Mysuru,Hearing Impairment,6,15,234,165,399
Karnataka,Mysuru,Hearing Impairment,15,35,657,559,1216
Karnataka,Mysuru,Hearing Impairment,35,60,821,611,1432
Karnataka,Mysuru,Hearing Impairment,60,80,225,77,302
Karnataka,Mysuru,Hearing Impairment,80,100,12,1,13
Bihar,Muzaffarpur,Hearing Impairment,0,6,12,8,20
Bihar,Muzaffarpur,Hearing Impairment,6,15,159,129,288
Bihar,Muzaffarpur,Hearing Impairment,15,35,83,54,137
Bihar,Muzaffarpur,Hearing Impairment,35,60,31,18,49
Bihar,Muzaffarpur,Hearing Impairment,60,80,4,1,5
Bihar,Muzaffarpur,Hearing Impairment,80,100,2,0,2
Uttar Pradesh,Muzaffarnagar,Hearing Impairment,0,6,8,5,13
Uttar Pradesh,Muzaffarnagar,Hearing Impairment,6,15,22,19,41
Uttar Pradesh,Muzaffarnagar,Hearing Impairment,15,35,83,48,131
Uttar Pradesh,Muzaffarnagar,Hearing Impairment,35,60,38,25,63
Uttar Pradesh,Muzaffarnagar,Hearing Impairment,60,80,18,3,21
Uttar Pradesh,Muzaffarnagar,Hearing Impairment,80,100,1,0,1
West Bengal,Murshidabad,Hearing Impairment,0,6,1,0,1
West Bengal,Murshidabad,Hearing Impairment,6,15,1,2,3
West Bengal,Murshidabad,Hearing Impairment,15,35,3,1,4
West Bengal,Murshidabad,Hearing Impairment,35,60,5,1,6
Bihar,Munger,Hearing Impairment,0,6,8,8,16
Bihar,Munger,Hearing Impairment,6,15,62,45,107
Bihar,Munger,Hearing Impairment,15,35,206,70,276
Bihar,Munger,Hearing Impairment,35,60,84,31,115
Bihar,Munger,Hearing Impairment,60,80,27,2,29
Bihar,Munger,Hearing Impairment,80,100,1,0,1
Chhattisgarh,Mungeli,Hearing Impairment,0,6,7,8,15
Chhattisgarh,Mungeli,Hearing Impairment,6,15,71,46,117
Chhattisgarh,Mungeli,Hearing Impairment,15,35,326,158,484
Chhattisgarh,Mungeli,Hearing Impairment,35,60,215,78,293
Chhattisgarh,Mungeli,Hearing Impairment,60,80,111,54,165
Chhattisgarh,Mungeli,Hearing Impairment,80,100,26,5,31
Maharashtra,Mumbai Suburban,Hearing Impairment,0,6,34,24,58
Maharashtra,Mumbai Suburban,Hearing Impairment,6,15,207,195,402
Maharashtra,Mumbai Suburban,Hearing Impairment,15,35,401,279,680
Maharashtra,Mumbai Suburban,Hearing Impairment,35,60,219,121,340
Maharashtra,Mumbai Suburban,Hearing Impairment,60,80,55,19,74
Maharashtra,Mumbai Suburban,Hearing Impairment,80,100,4,1,5
Maharashtra,Mumbai,Hearing Impairment,0,6,31,46,77
Maharashtra,Mumbai,Hearing Impairment,6,15,778,698,1476
Maharashtra,Mumbai,Hearing Impairment,15,35,2879,1791,4670
Maharashtra,Mumbai,Hearing Impairment,35,60,1972,763,2735
Maharashtra,Mumbai,Hearing Impairment,60,80,456,102,558
Maharashtra,Mumbai,Hearing Impairment,80,100,62,7,69
Telangana,Mulugu,Hearing Impairment,60,80,0,1,1
Madhya Pradesh,Morena,Hearing Impairment,0,6,10,13,23
Madhya Pradesh,Morena,Hearing Impairment,6,15,168,118,286
Madhya Pradesh,Morena,Hearing Impairment,15,35,846,285,1131
Madhya Pradesh,Morena,Hearing Impairment,35,60,248,87,335
Madhya Pradesh,Morena,Hearing Impairment,60,80,43,19,62
Madhya Pradesh,Morena,Hearing Impairment,80,100,4,5,9
Gujarat,Morbi,Hearing Impairment,0,6,12,11,23
Gujarat,Morbi,Hearing Impairment,6,15,46,31,77
Gujarat,Morbi,Hearing Impairment,15,35,91,72,163
Gujarat,Morbi,Hearing Impairment,35,60,56,31,87
Gujarat,Morbi,Hearing Impairment,60,80,17,6,23
Gujarat,Morbi,Hearing Impairment,80,100,2,0,2
Uttar Pradesh,Moradabad,Hearing Impairment,0,6,27,8,35
Uttar Pradesh,Moradabad,Hearing Impairment,6,15,81,72,153
Uttar Pradesh,Moradabad,Hearing Impairment,15,35,163,97,260
Uttar Pradesh,Moradabad,Hearing Impairment,35,60,110,34,144
Uttar Pradesh,Moradabad,Hearing Impairment,60,80,18,4,22
Nagaland,Mon,Hearing Impairment,6,15,3,1,4
Nagaland,Mon,Hearing Impairment,15,35,6,4,10
Nagaland,Mon,Hearing Impairment,35,60,13,10,23
Nagaland,Mon,Hearing Impairment,60,80,7,0,7
Nagaland,Mon,Hearing Impairment,80,100,1,0,1
Nagaland,Mokokchung,Hearing Impairment,6,15,6,1,7
Nagaland,Mokokchung,Hearing Impairment,15,35,11,9,20
Nagaland,Mokokchung,Hearing Impairment,35,60,18,13,31
Nagaland,Mokokchung,Hearing Impairment,60,80,15,13,28
Nagaland,Mokokchung,Hearing Impairment,80,100,3,2,5
Punjab,Moga,Hearing Impairment,0,6,5,5,10
Punjab,Moga,Hearing Impairment,6,15,43,37,80
Punjab,Moga,Hearing Impairment,15,35,121,59,180
Punjab,Moga,Hearing Impairment,35,60,58,49,107
Punjab,Moga,Hearing Impairment,60,80,12,2,14
Uttar Pradesh,Mirzapur,Hearing Impairment,0,6,10,11,21
Uttar Pradesh,Mirzapur,Hearing Impairment,6,15,56,55,111
Uttar Pradesh,Mirzapur,Hearing Impairment,15,35,169,93,262
Uttar Pradesh,Mirzapur,Hearing Impairment,35,60,90,57,147
Uttar Pradesh,Mirzapur,Hearing Impairment,60,80,13,9,22
Uttar Pradesh,Mirzapur,Hearing Impairment,80,100,2,0,2
Uttar Pradesh,Meerut,Hearing Impairment,0,6,28,27,55
Uttar Pradesh,Meerut,Hearing Impairment,6,15,154,85,239
Uttar Pradesh,Meerut,Hearing Impairment,15,35,295,168,463
Uttar Pradesh,Meerut,Hearing Impairment,35,60,118,59,177
Uttar Pradesh,Meerut,Hearing Impairment,60,80,25,5,30
Uttar Pradesh,Meerut,Hearing Impairment,80,100,3,1,4
Telangana,Medchal Malkajgiri,Hearing Impairment,6,15,117,93,210
Telangana,Medchal Malkajgiri,Hearing Impairment,15,35,474,386,860
Telangana,Medchal Malkajgiri,Hearing Impairment,35,60,530,326,856
Telangana,Medchal Malkajgiri,Hearing Impairment,60,80,201,101,302
Telangana,Medchal Malkajgiri,Hearing Impairment,80,100,21,6,27
Telangana,Medak,Hearing Impairment,6,15,4,7,11
Telangana,Medak,Hearing Impairment,15,35,71,96,167
Telangana,Medak,Hearing Impairment,35,60,64,57,121
Telangana,Medak,Hearing Impairment,60,80,13,4,17
Telangana,Medak,Hearing Impairment,80,100,2,1,3
Odisha,Mayurbhanj,Hearing Impairment,0,6,14,9,23
Odisha,Mayurbhanj,Hearing Impairment,6,15,219,213,432
Odisha,Mayurbhanj,Hearing Impairment,15,35,621,595,1216
Odisha,Mayurbhanj,Hearing Impairment,35,60,678,598,1276
Odisha,Mayurbhanj,Hearing Impairment,60,80,513,268,781
Odisha,Mayurbhanj,Hearing Impairment,80,100,72,33,105
Tamil Nadu,Mayiladuthurai,Hearing Impairment,0,6,8,5,13
Tamil Nadu,Mayiladuthurai,Hearing Impairment,6,15,36,15,51
Tamil Nadu,Mayiladuthurai,Hearing Impairment,15,35,54,50,104
Tamil Nadu,Mayiladuthurai,Hearing Impairment,35,60,87,72,159
Tamil Nadu,Mayiladuthurai,Hearing Impairment,60,80,39,15,54
Tamil Nadu,Mayiladuthurai,Hearing Impairment,80,100,5,0,5
Uttar Pradesh,Mau,Hearing Impairment,0,6,12,10,22
Uttar Pradesh,Mau,Hearing Impairment,6,15,52,48,100
Uttar Pradesh,Mau,Hearing Impairment,15,35,259,135,394
Uttar Pradesh,Mau,Hearing Impairment,35,60,113,46,159
Uttar Pradesh,Mau,Hearing Impairment,60,80,19,4,23
Uttar Pradesh,Mathura,Hearing Impairment,0,6,10,12,22
Uttar Pradesh,Mathura,Hearing Impairment,6,15,34,27,61
Uttar Pradesh,Mathura,Hearing Impairment,15,35,197,73,270
Uttar Pradesh,Mathura,Hearing Impairment,35,60,103,37,140
Uttar Pradesh,Mathura,Hearing Impairment,60,80,18,6,24
Uttar Pradesh,Mathura,Hearing Impairment,80,100,3,0,3
Assam,Marigaon,Hearing Impairment,0,6,11,8,19
Assam,Marigaon,Hearing Impairment,6,15,72,36,108
Assam,Marigaon,Hearing Impairment,15,35,164,161,325
Assam,Marigaon,Hearing Impairment,35,60,135,153,288
Assam,Marigaon,Hearing Impairment,60,80,34,20,54
Assam,Marigaon,Hearing Impairment,80,100,5,3,8
Punjab,Mansa,Hearing Impairment,0,6,8,6,14
Punjab,Mansa,Hearing Impairment,6,15,52,37,89
Punjab,Mansa,Hearing Impairment,15,35,64,42,106
Punjab,Mansa,Hearing Impairment,35,60,45,41,86
Punjab,Mansa,Hearing Impairment,60,80,15,3,18
Punjab,Mansa,Hearing Impairment,80,100,1,0,1
Sikkim,Mangan,Hearing Impairment,6,15,1,2,3
Sikkim,Mangan,Hearing Impairment,15,35,7,7,14
Sikkim,Mangan,Hearing Impairment,35,60,5,14,19
Sikkim,Mangan,Hearing Impairment,60,80,1,0,1
Karnataka,Mandya,Hearing Impairment,0,6,24,26,50
Karnataka,Mandya,Hearing Impairment,6,15,127,96,223
Karnataka,Mandya,Hearing Impairment,15,35,453,395,848
Karnataka,Mandya,Hearing Impairment,35,60,918,726,1644
Karnataka,Mandya,Hearing Impairment,60,80,327,133,460
Karnataka,Mandya,Hearing Impairment,80,100,18,5,23
Madhya Pradesh,Mandsaur,Hearing Impairment,0,6,6,5,11
Madhya Pradesh,Mandsaur,Hearing Impairment,6,15,45,31,76
Madhya Pradesh,Mandsaur,Hearing Impairment,15,35,159,99,258
Madhya Pradesh,Mandsaur,Hearing Impairment,35,60,106,75,181
Madhya Pradesh,Mandsaur,Hearing Impairment,60,80,60,26,86
Madhya Pradesh,Mandsaur,Hearing Impairment,80,100,16,4,20
Madhya Pradesh,Mandla,Hearing Impairment,0,6,1,7,8
Madhya Pradesh,Mandla,Hearing Impairment,6,15,85,91,176
Madhya Pradesh,Mandla,Hearing Impairment,15,35,287,219,506
Madhya Pradesh,Mandla,Hearing Impairment,35,60,333,201,534
Madhya Pradesh,Mandla,Hearing Impairment,60,80,166,63,229
Madhya Pradesh,Mandla,Hearing Impairment,80,100,14,6,20
Himachal Pradesh,Mandi,Hearing Impairment,0,6,10,11,21
Himachal Pradesh,Mandi,Hearing Impairment,6,15,71,51,122
Himachal Pradesh,Mandi,Hearing Impairment,15,35,329,223,552
Himachal Pradesh,Mandi,Hearing Impairment,35,60,610,344,954
Himachal Pradesh,Mandi,Hearing Impairment,60,80,305,138,443
Himachal Pradesh,Mandi,Hearing Impairment,80,100,45,9,54
Telangana,Mancherial,Hearing Impairment,6,15,17,9,26
Telangana,Mancherial,Hearing Impairment,15,35,201,160,361
Telangana,Mancherial,Hearing Impairment,35,60,212,171,383
Telangana,Mancherial,Hearing Impairment,60,80,68,59,127
Telangana,Mancherial,Hearing Impairment,80,100,6,6,12
Mizoram,Mamit,Hearing Impairment,6,15,6,5,11
Mizoram,Mamit,Hearing Impairment,15,35,5,4,9
Mizoram,Mamit,Hearing Impairment,35,60,11,9,20
Mizoram,Mamit,Hearing Impairment,60,80,15,16,31
Mizoram,Mamit,Hearing Impairment,80,100,7,0,7
Odisha,Malkangiri,Hearing Impairment,0,6,29,18,47
Odisha,Malkangiri,Hearing Impairment,6,15,340,243,583
Odisha,Malkangiri,Hearing Impairment,15,35,508,413,921
Odisha,Malkangiri,Hearing Impairment,35,60,547,463,1010
Odisha,Malkangiri,Hearing Impairment,60,80,127,78,205
Odisha,Malkangiri,Hearing Impairment,80,100,10,6,16
Punjab,Malerkotla,Hearing Impairment,0,6,2,6,8
Punjab,Malerkotla,Hearing Impairment,6,15,7,1,8
Punjab,Malerkotla,Hearing Impairment,15,35,10,7,17
Punjab,Malerkotla,Hearing Impairment,35,60,9,6,15
Punjab,Malerkotla,Hearing Impairment,60,80,5,0,5
Kerala,Malappuram,Hearing Impairment,0,6,43,34,77
Kerala,Malappuram,Hearing Impairment,6,15,246,200,446
Kerala,Malappuram,Hearing Impairment,15,35,744,476,1220
Kerala,Malappuram,Hearing Impairment,35,60,846,662,1508
Kerala,Malappuram,Hearing Impairment,60,80,292,204,496
Kerala,Malappuram,Hearing Impairment,80,100,15,14,29
Assam,Majuli,Hearing Impairment,0,6,4,1,5
Assam,Majuli,Hearing Impairment,6,15,4,3,7
Assam,Majuli,Hearing Impairment,15,35,27,27,54
Assam,Majuli,Hearing Impairment,35,60,37,21,58
Assam,Majuli,Hearing Impairment,60,80,15,8,23
Assam,Majuli,Hearing Impairment,80,100,1,1,2
Uttar Pradesh,Mainpuri,Hearing Impairment,0,6,14,12,26
Uttar Pradesh,Mainpuri,Hearing Impairment,6,15,152,130,282
Uttar Pradesh,Mainpuri,Hearing Impairment,15,35,355,161,516
Uttar Pradesh,Mainpuri,Hearing Impairment,35,60,218,100,318
Uttar Pradesh,Mainpuri,Hearing Impairment,60,80,47,18,65
Uttar Pradesh,Mainpuri,Hearing Impairment,80,100,2,1,3
Uttar Pradesh,Mahoba,Hearing Impairment,0,6,2,1,3
Uttar Pradesh,Mahoba,Hearing Impairment,6,15,28,17,45
Uttar Pradesh,Mahoba,Hearing Impairment,15,35,41,17,58
Uttar Pradesh,Mahoba,Hearing Impairment,35,60,17,9,26
Uttar Pradesh,Mahoba,Hearing Impairment,60,80,1,0,1
Gujarat,Mahisagar,Hearing Impairment,0,6,19,5,24
Gujarat,Mahisagar,Hearing Impairment,6,15,123,95,218
Gujarat,Mahisagar,Hearing Impairment,15,35,201,126,327
Gujarat,Mahisagar,Hearing Impairment,35,60,87,48,135
Gujarat,Mahisagar,Hearing Impairment,60,80,20,5,25
Gujarat,Mahisagar,Hearing Impairment,80,100,3,0,3
Gujarat,Mahesana,Hearing Impairment,0,6,11,10,21
Gujarat,Mahesana,Hearing Impairment,6,15,147,96,243
Gujarat,Mahesana,Hearing Impairment,15,35,246,174,420
Gujarat,Mahesana,Hearing Impairment,35,60,154,99,253
Gujarat,Mahesana,Hearing Impairment,60,80,32,13,45
Gujarat,Mahesana,Hearing Impairment,80,100,1,0,1
Haryana,Mahendragarh,Hearing Impairment,0,6,1,6,7
Haryana,Mahendragarh,Hearing Impairment,6,15,42,25,67
Haryana,Mahendragarh,Hearing Impairment,15,35,114,48,162
Haryana,Mahendragarh,Hearing Impairment,35,60,114,40,154
Haryana,Mahendragarh,Hearing Impairment,60,80,41,15,56
Haryana,Mahendragarh,Hearing Impairment,80,100,2,1,3
Puducherry,Mahe,Hearing Impairment,0,6,1,0,1
Puducherry,Mahe,Hearing Impairment,6,15,1,3,4
Puducherry,Mahe,Hearing Impairment,15,35,9,4,13
Puducherry,Mahe,Hearing Impairment,35,60,17,17,34
Puducherry,Mahe,Hearing Impairment,60,80,6,8,14
Chhattisgarh,Mahasamund,Hearing Impairment,0,6,16,8,24
Chhattisgarh,Mahasamund,Hearing Impairment,6,15,130,98,228
Chhattisgarh,Mahasamund,Hearing Impairment,15,35,225,213,438
Chhattisgarh,Mahasamund,Hearing Impairment,35,60,161,104,265
Chhattisgarh,Mahasamund,Hearing Impairment,60,80,142,75,217
Chhattisgarh,Mahasamund,Hearing Impairment,80,100,28,11,39
Uttar Pradesh,Maharajganj,Hearing Impairment,0,6,17,21,38
Uttar Pradesh,Maharajganj,Hearing Impairment,6,15,37,47,84
Uttar Pradesh,Maharajganj,Hearing Impairment,15,35,241,134,375
Uttar Pradesh,Maharajganj,Hearing Impairment,35,60,142,70,212
Uttar Pradesh,Maharajganj,Hearing Impairment,60,80,23,14,37
Uttar Pradesh,Maharajganj,Hearing Impairment,80,100,2,0,2
Telangana,Mahabubnagar,Hearing Impairment,6,15,48,47,95
Telangana,Mahabubnagar,Hearing Impairment,15,35,326,278,604
Telangana,Mahabubnagar,Hearing Impairment,35,60,450,444,894
Telangana,Mahabubnagar,Hearing Impairment,60,80,131,115,246
Telangana,Mahabubnagar,Hearing Impairment,80,100,16,6,22
Telangana,Mahabubabad,Hearing Impairment,0,6,1,0,1
Telangana,Mahabubabad,Hearing Impairment,6,15,35,35,70
Telangana,Mahabubabad,Hearing Impairment,15,35,240,217,457
Telangana,Mahabubabad,Hearing Impairment,35,60,222,203,425
Telangana,Mahabubabad,Hearing Impairment,60,80,96,59,155
Telangana,Mahabubabad,Hearing Impairment,80,100,19,7,26
Tamil Nadu,Madurai,Hearing Impairment,0,6,17,25,42
Tamil Nadu,Madurai,Hearing Impairment,6,15,177,129,306
Tamil Nadu,Madurai,Hearing Impairment,15,35,675,467,1142
Tamil Nadu,Madurai,Hearing Impairment,35,60,668,523,1191
Tamil Nadu,Madurai,Hearing Impairment,60,80,238,119,357
Tamil Nadu,Madurai,Hearing Impairment,80,100,28,8,36
Bihar,Madhubani,Hearing Impairment,0,6,1,2,3
Bihar,Madhubani,Hearing Impairment,6,15,18,25,43
Bihar,Madhubani,Hearing Impairment,15,35,102,37,139
Bihar,Madhubani,Hearing Impairment,35,60,46,14,60
Bihar,Madhubani,Hearing Impairment,60,80,6,0,6
Bihar,Madhepura,Hearing Impairment,0,6,1,4,5
Bihar,Madhepura,Hearing Impairment,6,15,37,24,61
Bihar,Madhepura,Hearing Impairment,15,35,66,29,95
Bihar,Madhepura,Hearing Impairment,35,60,35,10,45
Bihar,Madhepura,Hearing Impairment,60,80,5,2,7
Mizoram,Lunglei,Hearing Impairment,0,6,1,1,2
Mizoram,Lunglei,Hearing Impairment,6,15,5,0,5
Mizoram,Lunglei,Hearing Impairment,15,35,11,10,21
Mizoram,Lunglei,Hearing Impairment,35,60,18,12,30
Mizoram,Lunglei,Hearing Impairment,60,80,24,6,30
Mizoram,Lunglei,Hearing Impairment,80,100,5,5,10
Punjab,Ludhiana,Hearing Impairment,0,6,33,36,69
Punjab,Ludhiana,Hearing Impairment,6,15,221,169,390
Punjab,Ludhiana,Hearing Impairment,15,35,553,343,896
Punjab,Ludhiana,Hearing Impairment,35,60,372,224,596
Punjab,Ludhiana,Hearing Impairment,60,80,72,26,98
Punjab,Ludhiana,Hearing Impairment,80,100,5,3,8
Uttar Pradesh,Lucknow,Hearing Impairment,0,6,10,14,24
Uttar Pradesh,Lucknow,Hearing Impairment,6,15,113,85,198
Uttar Pradesh,Lucknow,Hearing Impairment,15,35,285,175,460
Uttar Pradesh,Lucknow,Hearing Impairment,35,60,161,66,227
Uttar Pradesh,Lucknow,Hearing Impairment,60,80,30,8,38
Uttar Pradesh,Lucknow,Hearing Impairment,80,100,1,1,2
Arunachal Pradesh,Lower Subansiri,Hearing Impairment,6,15,1,0,1
Arunachal Pradesh,Lower Subansiri,Hearing Impairment,35,60,1,0,1
Arunachal Pradesh,Lower Siang,Hearing Impairment,15,35,1,0,1
Arunachal Pradesh,Lower Dibang Valley,Hearing Impairment,6,15,6,6,12
Arunachal Pradesh,Lower Dibang Valley,Hearing Impairment,15,35,11,20,31
Arunachal Pradesh,Lower Dibang Valley,Hearing Impairment,35,60,19,13,32
Arunachal Pradesh,Lower Dibang Valley,Hearing Impairment,60,80,10,8,18
Arunachal Pradesh,Lower Dibang Valley,Hearing Impairment,80,100,1,0,1
Arunachal Pradesh,Longding,Hearing Impairment,6,15,1,0,1
Arunachal Pradesh,Lohit,Hearing Impairment,15,35,1,0,1
Jharkhand,Lohardaga,Hearing Impairment,0,6,3,0,3
Jharkhand,Lohardaga,Hearing Impairment,6,15,24,28,52
Jharkhand,Lohardaga,Hearing Impairment,15,35,79,70,149
Jharkhand,Lohardaga,Hearing Impairment,35,60,54,17,71
Jharkhand,Lohardaga,Hearing Impairment,60,80,6,3,9
Jharkhand,Lohardaga,Hearing Impairment,80,100,1,1,2
Ladakh,Leh Ladakh,Hearing Impairment,6,15,2,2,4
Ladakh,Leh Ladakh,Hearing Impairment,15,35,10,10,20
Ladakh,Leh Ladakh,Hearing Impairment,35,60,32,32,64
Ladakh,Leh Ladakh,Hearing Impairment,60,80,19,9,28
Ladakh,Leh Ladakh,Hearing Impairment,80,100,2,2,4
Mizoram,Lawngtlai,Hearing Impairment,0,6,0,1,1
Mizoram,Lawngtlai,Hearing Impairment,15,35,3,2,5
Mizoram,Lawngtlai,Hearing Impairment,35,60,3,1,4
Mizoram,Lawngtlai,Hearing Impairment,60,80,2,1,3
Mizoram,Lawngtlai,Hearing Impairment,80,100,1,0,1
Maharashtra,Latur,Hearing Impairment,0,6,54,28,82
Maharashtra,Latur,Hearing Impairment,6,15,393,246,639
Maharashtra,Latur,Hearing Impairment,15,35,991,605,1596
Maharashtra,Latur,Hearing Impairment,35,60,571,332,903
Maharashtra,Latur,Hearing Impairment,60,80,245,84,329
Maharashtra,Latur,Hearing Impairment,80,100,41,4,45
Jharkhand,Latehar,Hearing Impairment,6,15,12,7,19
Jharkhand,Latehar,Hearing Impairment,15,35,44,27,71
Jharkhand,Latehar,Hearing Impairment,35,60,17,12,29
Jharkhand,Latehar,Hearing Impairment,60,80,1,0,1
Uttar Pradesh,Lalitpur,Hearing Impairment,0,6,18,8,26
Uttar Pradesh,Lalitpur,Hearing Impairment,6,15,79,82,161
Uttar Pradesh,Lalitpur,Hearing Impairment,15,35,104,57,161
Uttar Pradesh,Lalitpur,Hearing Impairment,35,60,61,24,85
Uttar Pradesh,Lalitpur,Hearing Impairment,60,80,6,0,6
Lakshadweep,Lakshadweep District,Hearing Impairment,0,6,1,0,1
Lakshadweep,Lakshadweep District,Hearing Impairment,6,15,5,4,9
Lakshadweep,Lakshadweep District,Hearing Impairment,15,35,26,19,45
Lakshadweep,Lakshadweep District,Hearing Impairment,35,60,30,31,61
Lakshadweep,Lakshadweep District,Hearing Impairment,60,80,5,5,10
Lakshadweep,Lakshadweep District,Hearing Impairment,80,100,1,0,1
Bihar,Lakhisarai,Hearing Impairment,0,6,1,0,1
Bihar,Lakhisarai,Hearing Impairment,6,15,10,6,16
Bihar,Lakhisarai,Hearing Impairment,15,35,41,31,72
Bihar,Lakhisarai,Hearing Impairment,35,60,24,11,35
Bihar,Lakhisarai,Hearing Impairment,60,80,5,0,5
Assam,Lakhimpur,Hearing Impairment,0,6,5,16,21
Assam,Lakhimpur,Hearing Impairment,6,15,79,58,137
Assam,Lakhimpur,Hearing Impairment,15,35,156,131,287
Assam,Lakhimpur,Hearing Impairment,35,60,244,179,423
Assam,Lakhimpur,Hearing Impairment,60,80,67,33,100
Assam,Lakhimpur,Hearing Impairment,80,100,8,2,10
Himachal Pradesh,Lahul And Spiti,Hearing Impairment,6,15,2,0,2
Himachal Pradesh,Lahul And Spiti,Hearing Impairment,15,35,0,6,6
Himachal Pradesh,Lahul And Spiti,Hearing Impairment,35,60,3,10,13
Himachal Pradesh,Lahul And Spiti,Hearing Impairment,60,80,1,0,1
Uttar Pradesh,Kushi Nagar,Hearing Impairment,0,6,20,18,38
Uttar Pradesh,Kushi Nagar,Hearing Impairment,6,15,68,58,126
Uttar Pradesh,Kushi Nagar,Hearing Impairment,15,35,248,124,372
Uttar Pradesh,Kushi Nagar,Hearing Impairment,35,60,117,50,167
Uttar Pradesh,Kushi Nagar,Hearing Impairment,60,80,19,12,31
Arunachal Pradesh,Kurung Kumey,Hearing Impairment,15,35,2,1,3
Arunachal Pradesh,Kurung Kumey,Hearing Impairment,60,80,0,1,1
Haryana,Kurukshetra,Hearing Impairment,0,6,6,15,21
Haryana,Kurukshetra,Hearing Impairment,6,15,59,38,97
Haryana,Kurukshetra,Hearing Impairment,15,35,115,86,201
Haryana,Kurukshetra,Hearing Impairment,35,60,93,71,164
Haryana,Kurukshetra,Hearing Impairment,60,80,26,17,43
Haryana,Kurukshetra,Hearing Impairment,80,100,4,0,4
Andhra Pradesh,Kurnool,Hearing Impairment,0,6,46,56,102
Andhra Pradesh,Kurnool,Hearing Impairment,6,15,356,297,653
Andhra Pradesh,Kurnool,Hearing Impairment,15,35,1055,596,1651
Andhra Pradesh,Kurnool,Hearing Impairment,35,60,1411,353,1764
Andhra Pradesh,Kurnool,Hearing Impairment,60,80,466,88,554
Andhra Pradesh,Kurnool,Hearing Impairment,80,100,40,14,54
Jammu And Kashmir,Kupwara,Hearing Impairment,0,6,20,15,35
Jammu And Kashmir,Kupwara,Hearing Impairment,6,15,98,101,199
Jammu And Kashmir,Kupwara,Hearing Impairment,15,35,303,257,560
Jammu And Kashmir,Kupwara,Hearing Impairment,35,60,248,199,447
Jammu And Kashmir,Kupwara,Hearing Impairment,60,80,60,40,100
Jammu And Kashmir,Kupwara,Hearing Impairment,80,100,15,4,19
Telangana,Kumuram Bheem Asifabad,Hearing Impairment,6,15,8,6,14
Telangana,Kumuram Bheem Asifabad,Hearing Impairment,15,35,100,85,185
Telangana,Kumuram Bheem Asifabad,Hearing Impairment,35,60,73,83,156
Telangana,Kumuram Bheem Asifabad,Hearing Impairment,60,80,30,23,53
Telangana,Kumuram Bheem Asifabad,Hearing Impairment,80,100,2,0,2
Himachal Pradesh,Kullu,Hearing Impairment,0,6,5,7,12
Himachal Pradesh,Kullu,Hearing Impairment,6,15,18,28,46
Himachal Pradesh,Kullu,Hearing Impairment,15,35,101,90,191
Himachal Pradesh,Kullu,Hearing Impairment,35,60,162,99,261
Himachal Pradesh,Kullu,Hearing Impairment,60,80,91,26,117
Himachal Pradesh,Kullu,Hearing Impairment,80,100,13,4,17
Jammu And Kashmir,Kulgam,Hearing Impairment,0,6,4,4,8
Jammu And Kashmir,Kulgam,Hearing Impairment,6,15,34,19,53
Jammu And Kashmir,Kulgam,Hearing Impairment,15,35,79,79,158
Jammu And Kashmir,Kulgam,Hearing Impairment,35,60,105,87,192
Jammu And Kashmir,Kulgam,Hearing Impairment,60,80,58,32,90
Jammu And Kashmir,Kulgam,Hearing Impairment,80,100,9,2,11
Tamil Nadu,Krishnagiri,Hearing Impairment,0,6,24,14,38
Tamil Nadu,Krishnagiri,Hearing Impairment,6,15,179,172,351
Tamil Nadu,Krishnagiri,Hearing Impairment,15,35,497,357,854
Tamil Nadu,Krishnagiri,Hearing Impairment,35,60,452,333,785
Tamil Nadu,Krishnagiri,Hearing Impairment,60,80,183,116,299
Tamil Nadu,Krishnagiri,Hearing Impairment,80,100,10,10,20
Andhra Pradesh,Krishna,Hearing Impairment,0,6,24,27,51
Andhra Pradesh,Krishna,Hearing Impairment,6,15,154,104,258
Andhra Pradesh,Krishna,Hearing Impairment,15,35,431,237,668
Andhra Pradesh,Krishna,Hearing Impairment,35,60,1954,802,2756
Andhra Pradesh,Krishna,Hearing Impairment,60,80,840,170,1010
Andhra Pradesh,Krishna,Hearing Impairment,80,100,50,1,51
Kerala,Kozhikode,Hearing Impairment,0,6,34,47,81
Kerala,Kozhikode,Hearing Impairment,6,15,230,191,421
Kerala,Kozhikode,Hearing Impairment,15,35,679,574,1253
Kerala,Kozhikode,Hearing Impairment,35,60,1047,919,1966
Kerala,Kozhikode,Hearing Impairment,60,80,561,390,951
Kerala,Kozhikode,Hearing Impairment,80,100,63,25,88
Kerala,Kottayam,Hearing Impairment,0,6,12,15,27
Kerala,Kottayam,Hearing Impairment,6,15,79,56,135
Kerala,Kottayam,Hearing Impairment,15,35,320,267,587
Kerala,Kottayam,Hearing Impairment,35,60,509,493,1002
Kerala,Kottayam,Hearing Impairment,60,80,257,259,516
Kerala,Kottayam,Hearing Impairment,80,100,29,34,63
Rajasthan,Kota,Hearing Impairment,0,6,11,7,18
Rajasthan,Kota,Hearing Impairment,6,15,52,41,93
Rajasthan,Kota,Hearing Impairment,15,35,129,83,212
Rajasthan,Kota,Hearing Impairment,35,60,95,58,153
Rajasthan,Kota,Hearing Impairment,60,80,17,13,30
Rajasthan,Kota,Hearing Impairment,80,100,3,0,3
Chhattisgarh,Korea,Hearing Impairment,0,6,2,0,2
Chhattisgarh,Korea,Hearing Impairment,6,15,28,36,64
Chhattisgarh,Korea,Hearing Impairment,15,35,110,109,219
Chhattisgarh,Korea,Hearing Impairment,35,60,86,46,132
Chhattisgarh,Korea,Hearing Impairment,60,80,42,11,53
Chhattisgarh,Korea,Hearing Impairment,80,100,3,1,4
Chhattisgarh,Korba,Hearing Impairment,0,6,1,2,3
Chhattisgarh,Korba,Hearing Impairment,6,15,36,23,59
Chhattisgarh,Korba,Hearing Impairment,15,35,133,69,202
Chhattisgarh,Korba,Hearing Impairment,35,60,90,32,122
Chhattisgarh,Korba,Hearing Impairment,60,80,38,14,52
Chhattisgarh,Korba,Hearing Impairment,80,100,5,1,6
Odisha,Koraput,Hearing Impairment,0,6,22,27,49
Odisha,Koraput,Hearing Impairment,6,15,310,251,561
Odisha,Koraput,Hearing Impairment,15,35,740,582,1322
Odisha,Koraput,Hearing Impairment,35,60,779,546,1325
Odisha,Koraput,Hearing Impairment,60,80,399,171,570
Odisha,Koraput,Hearing Impairment,80,100,29,16,45
Karnataka,Koppal,Hearing Impairment,0,6,30,21,51
Karnataka,Koppal,Hearing Impairment,6,15,112,112,224
Karnataka,Koppal,Hearing Impairment,15,35,372,267,639
Karnataka,Koppal,Hearing Impairment,35,60,337,234,571
Karnataka,Koppal,Hearing Impairment,60,80,111,33,144
Karnataka,Koppal,Hearing Impairment,80,100,1,0,1
Chhattisgarh,Kondagaon,Hearing Impairment,0,6,1,0,1
Chhattisgarh,Kondagaon,Hearing Impairment,6,15,16,11,27
Chhattisgarh,Kondagaon,Hearing Impairment,15,35,54,37,91
Chhattisgarh,Kondagaon,Hearing Impairment,35,60,45,22,67
Chhattisgarh,Kondagaon,Hearing Impairment,60,80,25,10,35
Chhattisgarh,Kondagaon,Hearing Impairment,80,100,3,2,5
Kerala,Kollam,Hearing Impairment,0,6,15,15,30
Kerala,Kollam,Hearing Impairment,6,15,78,75,153
Kerala,Kollam,Hearing Impairment,15,35,368,307,675
Kerala,Kollam,Hearing Impairment,35,60,506,424,930
Kerala,Kollam,Hearing Impairment,60,80,206,150,356
Kerala,Kollam,Hearing Impairment,80,100,9,12,21
Maharashtra,Kolhapur,Hearing Impairment,0,6,56,45,101
Maharashtra,Kolhapur,Hearing Impairment,6,15,670,490,1160
Maharashtra,Kolhapur,Hearing Impairment,15,35,1726,974,2700
Maharashtra,Kolhapur,Hearing Impairment,35,60,1270,520,1790
Maharashtra,Kolhapur,Hearing Impairment,60,80,307,56,363
Maharashtra,Kolhapur,Hearing Impairment,80,100,22,2,24
Mizoram,Kolasib,Hearing Impairment,0,6,2,1,3
Mizoram,Kolasib,Hearing Impairment,6,15,3,4,7
Mizoram,Kolasib,Hearing Impairment,15,35,5,9,14
Mizoram,Kolasib,Hearing Impairment,35,60,9,22,31
Mizoram,Kolasib,Hearing Impairment,60,80,46,39,85
Mizoram,Kolasib,Hearing Impairment,80,100,16,14,30
Karnataka,Kolar,Hearing Impairment,0,6,20,14,34
Karnataka,Kolar,Hearing Impairment,6,15,141,109,250
Karnataka,Kolar,Hearing Impairment,15,35,358,281,639
Karnataka,Kolar,Hearing Impairment,35,60,606,397,1003
Karnataka,Kolar,Hearing Impairment,60,80,155,72,227
Karnataka,Kolar,Hearing Impairment,80,100,4,3,7
Assam,Kokrajhar,Hearing Impairment,0,6,8,7,15
Assam,Kokrajhar,Hearing Impairment,6,15,69,42,111
Assam,Kokrajhar,Hearing Impairment,15,35,115,103,218
Assam,Kokrajhar,Hearing Impairment,35,60,109,69,178
Assam,Kokrajhar,Hearing Impairment,60,80,22,7,29
Nagaland,Kohima,Hearing Impairment,0,6,1,0,1
Nagaland,Kohima,Hearing Impairment,6,15,4,3,7
Nagaland,Kohima,Hearing Impairment,15,35,12,16,28
Nagaland,Kohima,Hearing Impairment,35,60,9,6,15
Nagaland,Kohima,Hearing Impairment,60,80,1,2,3
Jharkhand,Koderma,Hearing Impairment,0,6,5,2,7
Jharkhand,Koderma,Hearing Impairment,6,15,32,34,66
Jharkhand,Koderma,Hearing Impairment,15,35,62,23,85
Jharkhand,Koderma,Hearing Impairment,35,60,36,25,61
Jharkhand,Koderma,Hearing Impairment,60,80,5,3,8
Karnataka,Kodagu,Hearing Impairment,0,6,4,4,8
Karnataka,Kodagu,Hearing Impairment,6,15,27,28,55
Karnataka,Kodagu,Hearing Impairment,15,35,110,84,194
Karnataka,Kodagu,Hearing Impairment,35,60,213,184,397
Karnataka,Kodagu,Hearing Impairment,60,80,149,125,274
Karnataka,Kodagu,Hearing Impairment,80,100,16,12,28
Jammu And Kashmir,Kishtwar,Hearing Impairment,0,6,1,5,6
Jammu And Kashmir,Kishtwar,Hearing Impairment,6,15,25,13,38
Jammu And Kashmir,Kishtwar,Hearing Impairment,15,35,82,84,166
Jammu And Kashmir,Kishtwar,Hearing Impairment,35,60,114,107,221
Jammu And Kashmir,Kishtwar,Hearing Impairment,60,80,14,11,25
Jammu And Kashmir,Kishtwar,Hearing Impairment,80,100,2,3,5
Bihar,Kishanganj,Hearing Impairment,0,6,1,0,1
Bihar,Kishanganj,Hearing Impairment,6,15,35,22,57
Bihar,Kishanganj,Hearing Impairment,15,35,126,94,220
Bihar,Kishanganj,Hearing Impairment,35,60,71,39,110
Bihar,Kishanganj,Hearing Impairment,60,80,7,3,10
Bihar,Kishanganj,Hearing Impairment,80,100,1,0,1
Nagaland,Kiphire,Hearing Impairment,6,15,1,0,1
Nagaland,Kiphire,Hearing Impairment,15,35,1,1,2
Nagaland,Kiphire,Hearing Impairment,35,60,2,0,2
Himachal Pradesh,Kinnaur,Hearing Impairment,6,15,4,1,5
Himachal Pradesh,Kinnaur,Hearing Impairment,15,35,14,3,17
Himachal Pradesh,Kinnaur,Hearing Impairment,35,60,23,11,34
Himachal Pradesh,Kinnaur,Hearing Impairment,60,80,20,5,25
Himachal Pradesh,Kinnaur,Hearing Impairment,80,100,3,2,5
Jharkhand,Khunti,Hearing Impairment,6,15,10,9,19
Jharkhand,Khunti,Hearing Impairment,15,35,26,19,45
Jharkhand,Khunti,Hearing Impairment,35,60,14,4,18
Jharkhand,Khunti,Hearing Impairment,60,80,3,3,6
Tripura,Khowai,Hearing Impairment,0,6,1,4,5
Tripura,Khowai,Hearing Impairment,6,15,19,24,43
Tripura,Khowai,Hearing Impairment,15,35,44,42,86
Tripura,Khowai,Hearing Impairment,35,60,79,53,132
Tripura,Khowai,Hearing Impairment,60,80,36,19,55
Tripura,Khowai,Hearing Impairment,80,100,5,6,11
Odisha,Khordha,Hearing Impairment,0,6,21,28,49
Odisha,Khordha,Hearing Impairment,6,15,152,153,305
Odisha,Khordha,Hearing Impairment,15,35,471,364,835
Odisha,Khordha,Hearing Impairment,35,60,912,598,1510
Odisha,Khordha,Hearing Impairment,60,80,421,181,602
Odisha,Khordha,Hearing Impairment,80,100,46,10,56
Uttar Pradesh,Kheri,Hearing Impairment,0,6,3,2,5
Uttar Pradesh,Kheri,Hearing Impairment,6,15,190,172,362
Uttar Pradesh,Kheri,Hearing Impairment,15,35,288,140,428
Uttar Pradesh,Kheri,Hearing Impairment,35,60,182,71,253
Uttar Pradesh,Kheri,Hearing Impairment,60,80,41,7,48
Uttar Pradesh,Kheri,Hearing Impairment,80,100,3,1,4
Gujarat,Kheda,Hearing Impairment,0,6,22,26,48
Gujarat,Kheda,Hearing Impairment,6,15,204,173,377
Gujarat,Kheda,Hearing Impairment,15,35,402,246,648
Gujarat,Kheda,Hearing Impairment,35,60,170,98,268
Gujarat,Kheda,Hearing Impairment,60,80,31,13,44
Gujarat,Kheda,Hearing Impairment,80,100,8,3,11
Mizoram,Khawzawl,Hearing Impairment,6,15,1,2,3
Mizoram,Khawzawl,Hearing Impairment,15,35,1,3,4
Mizoram,Khawzawl,Hearing Impairment,35,60,16,25,41
Mizoram,Khawzawl,Hearing Impairment,60,80,14,11,25
Mizoram,Khawzawl,Hearing Impairment,80,100,1,1,2
Madhya Pradesh,Khargone,Hearing Impairment,0,6,10,11,21
Madhya Pradesh,Khargone,Hearing Impairment,6,15,81,82,163
Madhya Pradesh,Khargone,Hearing Impairment,15,35,276,182,458
Madhya Pradesh,Khargone,Hearing Impairment,35,60,189,97,286
Madhya Pradesh,Khargone,Hearing Impairment,60,80,68,24,92
Madhya Pradesh,Khargone,Hearing Impairment,80,100,5,4,9
Telangana,Khammam,Hearing Impairment,6,15,83,63,146
Telangana,Khammam,Hearing Impairment,15,35,248,267,515
Telangana,Khammam,Hearing Impairment,35,60,311,311,622
Telangana,Khammam,Hearing Impairment,60,80,127,114,241
Telangana,Khammam,Hearing Impairment,80,100,28,13,41
Bihar,Khagaria,Hearing Impairment,0,6,4,1,5
Bihar,Khagaria,Hearing Impairment,6,15,8,15,23
Bihar,Khagaria,Hearing Impairment,15,35,72,35,107
Bihar,Khagaria,Hearing Impairment,35,60,42,18,60
Bihar,Khagaria,Hearing Impairment,60,80,3,2,5
Bihar,Khagaria,Hearing Impairment,80,100,1,0,1
Odisha,Kendujhar,Hearing Impairment,0,6,24,20,44
Odisha,Kendujhar,Hearing Impairment,6,15,221,174,395
Odisha,Kendujhar,Hearing Impairment,15,35,379,287,666
Odisha,Kendujhar,Hearing Impairment,35,60,391,250,641
Odisha,Kendujhar,Hearing Impairment,60,80,125,36,161
Odisha,Kendujhar,Hearing Impairment,80,100,8,1,9
Odisha,Kendrapara,Hearing Impairment,0,6,19,15,34
Odisha,Kendrapara,Hearing Impairment,6,15,122,90,212
Odisha,Kendrapara,Hearing Impairment,15,35,237,186,423
Odisha,Kendrapara,Hearing Impairment,35,60,303,196,499
Odisha,Kendrapara,Hearing Impairment,60,80,138,51,189
Odisha,Kendrapara,Hearing Impairment,80,100,14,2,16
Uttar Pradesh,Kaushambi,Hearing Impairment,0,6,3,5,8
Uttar Pradesh,Kaushambi,Hearing Impairment,6,15,61,44,105
Uttar Pradesh,Kaushambi,Hearing Impairment,15,35,104,62,166
Uttar Pradesh,Kaushambi,Hearing Impairment,35,60,45,21,66
Uttar Pradesh,Kaushambi,Hearing Impairment,60,80,3,4,7
Madhya Pradesh,Katni,Hearing Impairment,0,6,5,5,10
Madhya Pradesh,Katni,Hearing Impairment,6,15,52,34,86
Madhya Pradesh,Katni,Hearing Impairment,15,35,335,202,537
Madhya Pradesh,Katni,Hearing Impairment,35,60,217,98,315
Madhya Pradesh,Katni,Hearing Impairment,60,80,89,45,134
Madhya Pradesh,Katni,Hearing Impairment,80,100,13,1,14
Bihar,Katihar,Hearing Impairment,0,6,3,0,3
Bihar,Katihar,Hearing Impairment,6,15,16,17,33
Bihar,Katihar,Hearing Impairment,15,35,61,36,97
Bihar,Katihar,Hearing Impairment,35,60,49,41,90
Bihar,Katihar,Hearing Impairment,60,80,22,7,29
Bihar,Katihar,Hearing Impairment,80,100,1,2,3
Jammu And Kashmir,Kathua,Hearing Impairment,0,6,2,3,5
Jammu And Kashmir,Kathua,Hearing Impairment,6,15,25,23,48
Jammu And Kashmir,Kathua,Hearing Impairment,15,35,85,46,131
Jammu And Kashmir,Kathua,Hearing Impairment,35,60,76,54,130
Jammu And Kashmir,Kathua,Hearing Impairment,60,80,10,6,16
Jammu And Kashmir,Kathua,Hearing Impairment,80,100,2,1,3
Uttar Pradesh,Kasganj,Hearing Impairment,0,6,4,2,6
Uttar Pradesh,Kasganj,Hearing Impairment,6,15,24,15,39
Uttar Pradesh,Kasganj,Hearing Impairment,15,35,89,32,121
Uttar Pradesh,Kasganj,Hearing Impairment,35,60,80,21,101
Uttar Pradesh,Kasganj,Hearing Impairment,60,80,20,5,25
Uttar Pradesh,Kasganj,Hearing Impairment,80,100,3,0,3
Kerala,Kasaragod,Hearing Impairment,0,6,24,18,42
Kerala,Kasaragod,Hearing Impairment,6,15,102,87,189
Kerala,Kasaragod,Hearing Impairment,15,35,313,283,596
Kerala,Kasaragod,Hearing Impairment,35,60,497,486,983
Kerala,Kasaragod,Hearing Impairment,60,80,270,190,460
Kerala,Kasaragod,Hearing Impairment,80,100,20,13,33
Tamil Nadu,Karur,Hearing Impairment,0,6,18,11,29
Tamil Nadu,Karur,Hearing Impairment,6,15,82,58,140
Tamil Nadu,Karur,Hearing Impairment,15,35,288,236,524
Tamil Nadu,Karur,Hearing Impairment,35,60,365,293,658
Tamil Nadu,Karur,Hearing Impairment,60,80,227,115,342
Tamil Nadu,Karur,Hearing Impairment,80,100,42,15,57
Haryana,Karnal,Hearing Impairment,0,6,7,3,10
Haryana,Karnal,Hearing Impairment,6,15,52,42,94
Haryana,Karnal,Hearing Impairment,15,35,113,59,172
Haryana,Karnal,Hearing Impairment,35,60,81,47,128
Haryana,Karnal,Hearing Impairment,60,80,8,2,10
Haryana,Karnal,Hearing Impairment,80,100,1,0,1
Telangana,Karimnagar,Hearing Impairment,6,15,33,24,57
Telangana,Karimnagar,Hearing Impairment,15,35,230,223,453
Telangana,Karimnagar,Hearing Impairment,35,60,497,529,1026
Telangana,Karimnagar,Hearing Impairment,60,80,433,384,817
Telangana,Karimnagar,Hearing Impairment,80,100,77,57,134
Assam,Karimganj,Hearing Impairment,0,6,27,15,42
Assam,Karimganj,Hearing Impairment,6,15,134,126,260
Assam,Karimganj,Hearing Impairment,15,35,236,211,447
Assam,Karimganj,Hearing Impairment,35,60,207,137,344
Assam,Karimganj,Hearing Impairment,60,80,42,18,60
Assam,Karimganj,Hearing Impairment,80,100,3,0,3
Ladakh,Kargil,Hearing Impairment,0,6,2,0,2
Ladakh,Kargil,Hearing Impairment,6,15,18,14,32
Ladakh,Kargil,Hearing Impairment,15,35,51,48,99
Ladakh,Kargil,Hearing Impairment,35,60,97,136,233
Ladakh,Kargil,Hearing Impairment,60,80,39,45,84
Ladakh,Kargil,Hearing Impairment,80,100,9,6,15
Assam,Karbi Anglong,Hearing Impairment,0,6,10,6,16
Assam,Karbi Anglong,Hearing Impairment,6,15,90,66,156
Assam,Karbi Anglong,Hearing Impairment,15,35,450,880,1330
Assam,Karbi Anglong,Hearing Impairment,35,60,785,1901,2686
Assam,Karbi Anglong,Hearing Impairment,60,80,327,524,851
Assam,Karbi Anglong,Hearing Impairment,80,100,29,59,88
Rajasthan,Karauli,Hearing Impairment,0,6,2,8,10
Rajasthan,Karauli,Hearing Impairment,6,15,37,29,66
Rajasthan,Karauli,Hearing Impairment,15,35,106,49,155
Rajasthan,Karauli,Hearing Impairment,35,60,40,19,59
Rajasthan,Karauli,Hearing Impairment,60,80,5,4,9
Puducherry,Karaikal,Hearing Impairment,0,6,1,0,1
Puducherry,Karaikal,Hearing Impairment,6,15,13,7,20
Puducherry,Karaikal,Hearing Impairment,15,35,90,62,152
Puducherry,Karaikal,Hearing Impairment,35,60,114,105,219
Puducherry,Karaikal,Hearing Impairment,60,80,56,72,128
Puducherry,Karaikal,Hearing Impairment,80,100,6,11,17
Punjab,Kapurthala,Hearing Impairment,0,6,8,3,11
Punjab,Kapurthala,Hearing Impairment,6,15,17,25,42
Punjab,Kapurthala,Hearing Impairment,15,35,100,72,172
Punjab,Kapurthala,Hearing Impairment,35,60,77,34,111
Punjab,Kapurthala,Hearing Impairment,60,80,10,6,16
Punjab,Kapurthala,Hearing Impairment,80,100,0,2,2
Uttar Pradesh,Kanpur Nagar,Hearing Impairment,0,6,47,35,82
Uttar Pradesh,Kanpur Nagar,Hearing Impairment,6,15,185,133,318
Uttar Pradesh,Kanpur Nagar,Hearing Impairment,15,35,646,403,1049
Uttar Pradesh,Kanpur Nagar,Hearing Impairment,35,60,425,211,636
Uttar Pradesh,Kanpur Nagar,Hearing Impairment,60,80,161,53,214
Uttar Pradesh,Kanpur Nagar,Hearing Impairment,80,100,15,1,16
Uttar Pradesh,Kanpur Dehat,Hearing Impairment,0,6,20,10,30
Uttar Pradesh,Kanpur Dehat,Hearing Impairment,6,15,65,67,132
Uttar Pradesh,Kanpur Dehat,Hearing Impairment,15,35,332,169,501
Uttar Pradesh,Kanpur Dehat,Hearing Impairment,35,60,129,110,239
Uttar Pradesh,Kanpur Dehat,Hearing Impairment,60,80,37,11,48
Uttar Pradesh,Kanpur Dehat,Hearing Impairment,80,100,6,0,6
Kerala,Kannur,Hearing Impairment,0,6,21,13,34
Kerala,Kannur,Hearing Impairment,6,15,104,104,208
Kerala,Kannur,Hearing Impairment,15,35,321,275,596
Kerala,Kannur,Hearing Impairment,35,60,527,423,950
Kerala,Kannur,Hearing Impairment,60,80,224,170,394
Kerala,Kannur,Hearing Impairment,80,100,12,12,24
Tamil Nadu,Kanniyakumari,Hearing Impairment,0,6,8,6,14
Tamil Nadu,Kanniyakumari,Hearing Impairment,6,15,78,65,143
Tamil Nadu,Kanniyakumari,Hearing Impairment,15,35,284,225,509
Tamil Nadu,Kanniyakumari,Hearing Impairment,35,60,486,359,845
Tamil Nadu,Kanniyakumari,Hearing Impairment,60,80,179,105,284
Tamil Nadu,Kanniyakumari,Hearing Impairment,80,100,19,11,30
Uttar Pradesh,Kannauj,Hearing Impairment,0,6,14,17,31
Uttar Pradesh,Kannauj,Hearing Impairment,6,15,53,30,83
Uttar Pradesh,Kannauj,Hearing Impairment,15,35,141,75,216
Uttar Pradesh,Kannauj,Hearing Impairment,35,60,96,49,145
Uttar Pradesh,Kannauj,Hearing Impairment,60,80,39,20,59
Uttar Pradesh,Kannauj,Hearing Impairment,80,100,6,0,6
Chhattisgarh,Kanker,Hearing Impairment,0,6,9,12,21
Chhattisgarh,Kanker,Hearing Impairment,6,15,60,36,96
Chhattisgarh,Kanker,Hearing Impairment,15,35,115,75,190
Chhattisgarh,Kanker,Hearing Impairment,35,60,109,70,179
Chhattisgarh,Kanker,Hearing Impairment,60,80,82,38,120
Chhattisgarh,Kanker,Hearing Impairment,80,100,18,4,22
Himachal Pradesh,Kangra,Hearing Impairment,0,6,19,23,42
Himachal Pradesh,Kangra,Hearing Impairment,6,15,119,91,210
Himachal Pradesh,Kangra,Hearing Impairment,15,35,282,189,471
Himachal Pradesh,Kangra,Hearing Impairment,35,60,452,311,763
Himachal Pradesh,Kangra,Hearing Impairment,60,80,297,120,417
Himachal Pradesh,Kangra,Hearing Impairment,80,100,52,11,63
Manipur,Kangpokpi,Hearing Impairment,0,6,0,1,1
Manipur,Kangpokpi,Hearing Impairment,6,15,0,3,3
Manipur,Kangpokpi,Hearing Impairment,15,35,6,1,7
Manipur,Kangpokpi,Hearing Impairment,35,60,3,3,6
Manipur,Kangpokpi,Hearing Impairment,60,80,2,1,3
Odisha,Kandhamal,Hearing Impairment,0,6,7,5,12
Odisha,Kandhamal,Hearing Impairment,6,15,81,61,142
Odisha,Kandhamal,Hearing Impairment,15,35,256,231,487
Odisha,Kandhamal,Hearing Impairment,35,60,341,253,594
Odisha,Kandhamal,Hearing Impairment,60,80,225,119,344
Odisha,Kandhamal,Hearing Impairment,80,100,22,8,30
Tamil Nadu,Kanchipuram,Hearing Impairment,0,6,9,14,23
Tamil Nadu,Kanchipuram,Hearing Impairment,6,15,82,86,168
Tamil Nadu,Kanchipuram,Hearing Impairment,15,35,361,280,641
Tamil Nadu,Kanchipuram,Hearing Impairment,35,60,506,386,892
Tamil Nadu,Kanchipuram,Hearing Impairment,60,80,216,134,350
Tamil Nadu,Kanchipuram,Hearing Impairment,80,100,25,6,31
Assam,Kamrup Metro,Hearing Impairment,0,6,12,4,16
Assam,Kamrup Metro,Hearing Impairment,6,15,57,47,104
Assam,Kamrup Metro,Hearing Impairment,15,35,145,128,273
Assam,Kamrup Metro,Hearing Impairment,35,60,125,98,223
Assam,Kamrup Metro,Hearing Impairment,60,80,29,8,37
Assam,Kamrup Metro,Hearing Impairment,80,100,3,4,7
Assam,Kamrup,Hearing Impairment,0,6,25,18,43
Assam,Kamrup,Hearing Impairment,6,15,108,86,194
Assam,Kamrup,Hearing Impairment,15,35,292,226,518
Assam,Kamrup,Hearing Impairment,35,60,367,283,650
Assam,Kamrup,Hearing Impairment,60,80,109,83,192
Assam,Kamrup,Hearing Impairment,80,100,14,5,19
Manipur,Kamjong,Hearing Impairment,6,15,1,0,1
Manipur,Kamjong,Hearing Impairment,15,35,2,1,3
Manipur,Kamjong,Hearing Impairment,35,60,1,0,1
Manipur,Kamjong,Hearing Impairment,80,100,1,0,1
Telangana,Kamareddy,Hearing Impairment,6,15,49,53,102
Telangana,Kamareddy,Hearing Impairment,15,35,305,265,570
Telangana,Kamareddy,Hearing Impairment,35,60,381,329,710
Telangana,Kamareddy,Hearing Impairment,60,80,136,116,252
Telangana,Kamareddy,Hearing Impairment,80,100,15,7,22
Tamil Nadu,Kallakurichi,Hearing Impairment,0,6,9,9,18
Tamil Nadu,Kallakurichi,Hearing Impairment,6,15,87,73,160
Tamil Nadu,Kallakurichi,Hearing Impairment,15,35,129,91,220
Tamil Nadu,Kallakurichi,Hearing Impairment,35,60,255,242,497
Tamil Nadu,Kallakurichi,Hearing Impairment,60,80,205,119,324
Tamil Nadu,Kallakurichi,Hearing Impairment,80,100,29,8,37
Odisha,Kalahandi,Hearing Impairment,0,6,20,15,35
Odisha,Kalahandi,Hearing Impairment,6,15,164,156,320
Odisha,Kalahandi,Hearing Impairment,15,35,495,377,872
Odisha,Kalahandi,Hearing Impairment,35,60,676,403,1079
Odisha,Kalahandi,Hearing Impairment,60,80,214,88,302
Odisha,Kalahandi,Hearing Impairment,80,100,11,4,15
Karnataka,Kalaburagi,Hearing Impairment,0,6,51,38,89
Karnataka,Kalaburagi,Hearing Impairment,6,15,238,182,420
Karnataka,Kalaburagi,Hearing Impairment,15,35,580,462,1042
Karnataka,Kalaburagi,Hearing Impairment,35,60,663,366,1029
Karnataka,Kalaburagi,Hearing Impairment,60,80,192,43,235
Karnataka,Kalaburagi,Hearing Impairment,80,100,9,0,9
Manipur,Kakching,Hearing Impairment,0,6,1,2,3
Manipur,Kakching,Hearing Impairment,6,15,7,2,9
Manipur,Kakching,Hearing Impairment,15,35,5,8,13
Manipur,Kakching,Hearing Impairment,35,60,7,13,20
Manipur,Kakching,Hearing Impairment,60,80,2,2,4
Haryana,Kaithal,Hearing Impairment,0,6,10,4,14
Haryana,Kaithal,Hearing Impairment,6,15,49,28,77
Haryana,Kaithal,Hearing Impairment,15,35,100,54,154
Haryana,Kaithal,Hearing Impairment,35,60,41,26,67
Haryana,Kaithal,Hearing Impairment,60,80,3,5,8
Bihar,Kaimur (Bhabua),Hearing Impairment,0,6,7,11,18
Bihar,Kaimur (Bhabua),Hearing Impairment,6,15,89,70,159
Bihar,Kaimur (Bhabua),Hearing Impairment,15,35,114,60,174
Bihar,Kaimur (Bhabua),Hearing Impairment,35,60,79,33,112
Bihar,Kaimur (Bhabua),Hearing Impairment,60,80,19,7,26
Bihar,Kaimur (Bhabua),Hearing Impairment,80,100,1,1,2
Gujarat,Kachchh,Hearing Impairment,0,6,17,10,27
Gujarat,Kachchh,Hearing Impairment,6,15,208,178,386
Gujarat,Kachchh,Hearing Impairment,15,35,360,245,605
Gujarat,Kachchh,Hearing Impairment,35,60,140,71,211
Gujarat,Kachchh,Hearing Impairment,60,80,40,8,48
Gujarat,Kachchh,Hearing Impairment,80,100,1,2,3
Chhattisgarh,Kabirdham,Hearing Impairment,0,6,7,9,16
Chhattisgarh,Kabirdham,Hearing Impairment,6,15,114,69,183
Chhattisgarh,Kabirdham,Hearing Impairment,15,35,206,122,328
Chhattisgarh,Kabirdham,Hearing Impairment,35,60,171,96,267
Chhattisgarh,Kabirdham,Hearing Impairment,60,80,71,30,101
Chhattisgarh,Kabirdham,Hearing Impairment,80,100,8,3,11
Gujarat,Junagadh,Hearing Impairment,0,6,15,15,30
Gujarat,Junagadh,Hearing Impairment,6,15,84,58,142
Gujarat,Junagadh,Hearing Impairment,15,35,219,149,368
Gujarat,Junagadh,Hearing Impairment,35,60,95,67,162
Gujarat,Junagadh,Hearing Impairment,60,80,23,9,32
Gujarat,Junagadh,Hearing Impairment,80,100,0,1,1
Assam,Jorhat,Hearing Impairment,0,6,12,7,19
Assam,Jorhat,Hearing Impairment,6,15,39,34,73
Assam,Jorhat,Hearing Impairment,15,35,98,86,184
Assam,Jorhat,Hearing Impairment,35,60,128,124,252
Assam,Jorhat,Hearing Impairment,60,80,60,32,92
Assam,Jorhat,Hearing Impairment,80,100,4,5,9
Telangana,Jogulamba Gadwal,Hearing Impairment,6,15,27,16,43
Telangana,Jogulamba Gadwal,Hearing Impairment,15,35,143,159,302
Telangana,Jogulamba Gadwal,Hearing Impairment,35,60,200,193,393
Telangana,Jogulamba Gadwal,Hearing Impairment,60,80,55,47,102
Telangana,Jogulamba Gadwal,Hearing Impairment,80,100,10,6,16
Rajasthan,Jodhpur,Hearing Impairment,0,6,19,18,37
Rajasthan,Jodhpur,Hearing Impairment,6,15,162,138,300
Rajasthan,Jodhpur,Hearing Impairment,15,35,337,249,586
Rajasthan,Jodhpur,Hearing Impairment,35,60,158,83,241
Rajasthan,Jodhpur,Hearing Impairment,60,80,27,10,37
Rajasthan,Jodhpur,Hearing Impairment,80,100,0,1,1
Manipur,Jiribam,Hearing Impairment,0,6,0,1,1
Manipur,Jiribam,Hearing Impairment,6,15,1,2,3
Manipur,Jiribam,Hearing Impairment,15,35,4,4,8
Manipur,Jiribam,Hearing Impairment,35,60,4,7,11
Manipur,Jiribam,Hearing Impairment,60,80,1,4,5
Haryana,Jind,Hearing Impairment,0,6,6,4,10
Haryana,Jind,Hearing Impairment,6,15,70,36,106
Haryana,Jind,Hearing Impairment,15,35,211,84,295
Haryana,Jind,Hearing Impairment,35,60,84,25,109
Haryana,Jind,Hearing Impairment,60,80,6,4,10
Rajasthan,Jhunjhunu,Hearing Impairment,0,6,11,7,18
Rajasthan,Jhunjhunu,Hearing Impairment,6,15,67,45,112
Rajasthan,Jhunjhunu,Hearing Impairment,15,35,259,146,405
Rajasthan,Jhunjhunu,Hearing Impairment,35,60,153,94,247
Rajasthan,Jhunjhunu,Hearing Impairment,60,80,23,32,55
Rajasthan,Jhunjhunu,Hearing Impairment,80,100,1,3,4
Odisha,Jharsuguda,Hearing Impairment,0,6,8,3,11
Odisha,Jharsuguda,Hearing Impairment,6,15,43,45,88
Odisha,Jharsuguda,Hearing Impairment,15,35,126,114,240
Odisha,Jharsuguda,Hearing Impairment,35,60,182,138,320
Odisha,Jharsuguda,Hearing Impairment,60,80,104,60,164
Odisha,Jharsuguda,Hearing Impairment,80,100,20,10,30
Uttar Pradesh,Jhansi,Hearing Impairment,0,6,15,7,22
Uttar Pradesh,Jhansi,Hearing Impairment,6,15,54,64,118
Uttar Pradesh,Jhansi,Hearing Impairment,15,35,122,69,191
Uttar Pradesh,Jhansi,Hearing Impairment,35,60,89,30,119
Uttar Pradesh,Jhansi,Hearing Impairment,60,80,9,2,11
Uttar Pradesh,Jhansi,Hearing Impairment,80,100,1,0,1
Rajasthan,Jhalawar,Hearing Impairment,0,6,3,5,8
Rajasthan,Jhalawar,Hearing Impairment,6,15,43,31,74
Rajasthan,Jhalawar,Hearing Impairment,15,35,348,502,850
Rajasthan,Jhalawar,Hearing Impairment,35,60,285,385,670
Rajasthan,Jhalawar,Hearing Impairment,60,80,32,29,61
Rajasthan,Jhalawar,Hearing Impairment,80,100,3,3,6
Haryana,Jhajjar,Hearing Impairment,0,6,2,4,6
Haryana,Jhajjar,Hearing Impairment,6,15,14,9,23
Haryana,Jhajjar,Hearing Impairment,15,35,48,37,85
Haryana,Jhajjar,Hearing Impairment,35,60,32,11,43
Haryana,Jhajjar,Hearing Impairment,60,80,3,1,4
Haryana,Jhajjar,Hearing Impairment,80,100,2,0,2
Madhya Pradesh,Jhabua,Hearing Impairment,0,6,1,0,1
Madhya Pradesh,Jhabua,Hearing Impairment,6,15,48,33,81
Madhya Pradesh,Jhabua,Hearing Impairment,15,35,161,90,251
Madhya Pradesh,Jhabua,Hearing Impairment,35,60,103,54,157
Madhya Pradesh,Jhabua,Hearing Impairment,60,80,38,21,59
Madhya Pradesh,Jhabua,Hearing Impairment,80,100,6,2,8
Bihar,Jehanabad,Hearing Impairment,0,6,18,23,41
Bihar,Jehanabad,Hearing Impairment,6,15,90,93,183
Bihar,Jehanabad,Hearing Impairment,15,35,109,62,171
Bihar,Jehanabad,Hearing Impairment,35,60,54,39,93
Bihar,Jehanabad,Hearing Impairment,60,80,21,11,32
Bihar,Jehanabad,Hearing Impairment,80,100,1,2,3
Telangana,Jayashankar Bhupalapally,Hearing Impairment,6,15,28,21,49
Telangana,Jayashankar Bhupalapally,Hearing Impairment,15,35,199,195,394
Telangana,Jayashankar Bhupalapally,Hearing Impairment,35,60,229,227,456
Telangana,Jayashankar Bhupalapally,Hearing Impairment,60,80,89,74,163
Telangana,Jayashankar Bhupalapally,Hearing Impairment,80,100,17,7,24
Uttar Pradesh,Jaunpur,Hearing Impairment,0,6,22,20,42
Uttar Pradesh,Jaunpur,Hearing Impairment,6,15,212,158,370
Uttar Pradesh,Jaunpur,Hearing Impairment,15,35,767,406,1173
Uttar Pradesh,Jaunpur,Hearing Impairment,35,60,456,200,656
Uttar Pradesh,Jaunpur,Hearing Impairment,60,80,55,26,81
Uttar Pradesh,Jaunpur,Hearing Impairment,80,100,4,0,4
Chhattisgarh,Jashpur,Hearing Impairment,0,6,8,9,17
Chhattisgarh,Jashpur,Hearing Impairment,6,15,92,69,161
Chhattisgarh,Jashpur,Hearing Impairment,15,35,208,196,404
Chhattisgarh,Jashpur,Hearing Impairment,35,60,157,106,263
Chhattisgarh,Jashpur,Hearing Impairment,60,80,91,30,121
Chhattisgarh,Jashpur,Hearing Impairment,80,100,20,0,20
Chhattisgarh,Janjgir-Champa,Hearing Impairment,0,6,9,9,18
Chhattisgarh,Janjgir-Champa,Hearing Impairment,6,15,61,44,105
Chhattisgarh,Janjgir-Champa,Hearing Impairment,15,35,148,80,228
Chhattisgarh,Janjgir-Champa,Hearing Impairment,35,60,116,46,162
Chhattisgarh,Janjgir-Champa,Hearing Impairment,60,80,63,14,77
Chhattisgarh,Janjgir-Champa,Hearing Impairment,80,100,8,2,10
Telangana,Jangoan,Hearing Impairment,0,6,0,1,1
Telangana,Jangoan,Hearing Impairment,6,15,22,15,37
Telangana,Jangoan,Hearing Impairment,15,35,152,162,314
Telangana,Jangoan,Hearing Impairment,35,60,166,180,346
Telangana,Jangoan,Hearing Impairment,60,80,71,47,118
Telangana,Jangoan,Hearing Impairment,80,100,15,6,21
Bihar,Jamui,Hearing Impairment,0,6,6,0,6
Bihar,Jamui,Hearing Impairment,6,15,18,24,42
Bihar,Jamui,Hearing Impairment,15,35,59,30,89
Bihar,Jamui,Hearing Impairment,35,60,30,17,47
Bihar,Jamui,Hearing Impairment,60,80,6,2,8
Bihar,Jamui,Hearing Impairment,80,100,1,0,1
Jharkhand,Jamtara,Hearing Impairment,0,6,6,5,11
Jharkhand,Jamtara,Hearing Impairment,6,15,60,37,97
Jharkhand,Jamtara,Hearing Impairment,15,35,191,116,307
Jharkhand,Jamtara,Hearing Impairment,35,60,185,88,273
Jharkhand,Jamtara,Hearing Impairment,60,80,22,11,33
Gujarat,Jamnagar,Hearing Impairment,0,6,15,13,28
Gujarat,Jamnagar,Hearing Impairment,6,15,99,81,180
Gujarat,Jamnagar,Hearing Impairment,15,35,305,223,528
Gujarat,Jamnagar,Hearing Impairment,35,60,236,124,360
Gujarat,Jamnagar,Hearing Impairment,60,80,172,49,221
Gujarat,Jamnagar,Hearing Impairment,80,100,48,16,64
Jammu And Kashmir,Jammu,Hearing Impairment,0,6,12,7,19
Jammu And Kashmir,Jammu,Hearing Impairment,6,15,85,65,150
Jammu And Kashmir,Jammu,Hearing Impairment,15,35,297,202,499
Jammu And Kashmir,Jammu,Hearing Impairment,35,60,281,202,483
Jammu And Kashmir,Jammu,Hearing Impairment,60,80,76,34,110
Jammu And Kashmir,Jammu,Hearing Impairment,80,100,10,3,13
West Bengal,Jalpaiguri,Hearing Impairment,6,15,0,1,1
Rajasthan,Jalore,Hearing Impairment,0,6,9,7,16
Rajasthan,Jalore,Hearing Impairment,6,15,72,65,137
Rajasthan,Jalore,Hearing Impairment,15,35,222,113,335
Rajasthan,Jalore,Hearing Impairment,35,60,117,86,203
Rajasthan,Jalore,Hearing Impairment,60,80,37,26,63
Rajasthan,Jalore,Hearing Impairment,80,100,5,2,7
Maharashtra,Jalna,Hearing Impairment,0,6,33,19,52
Maharashtra,Jalna,Hearing Impairment,6,15,248,175,423
Maharashtra,Jalna,Hearing Impairment,15,35,539,295,834
Maharashtra,Jalna,Hearing Impairment,35,60,381,174,555
Maharashtra,Jalna,Hearing Impairment,60,80,83,36,119
Maharashtra,Jalna,Hearing Impairment,80,100,13,0,13
Maharashtra,Jalgaon,Hearing Impairment,0,6,66,48,114
Maharashtra,Jalgaon,Hearing Impairment,6,15,362,248,610
Maharashtra,Jalgaon,Hearing Impairment,15,35,781,438,1219
Maharashtra,Jalgaon,Hearing Impairment,35,60,882,465,1347
Maharashtra,Jalgaon,Hearing Impairment,60,80,338,129,467
Maharashtra,Jalgaon,Hearing Impairment,80,100,21,7,28
Uttar Pradesh,Jalaun,Hearing Impairment,0,6,4,6,10
Uttar Pradesh,Jalaun,Hearing Impairment,6,15,29,24,53
Uttar Pradesh,Jalaun,Hearing Impairment,15,35,129,66,195
Uttar Pradesh,Jalaun,Hearing Impairment,35,60,97,36,133
Uttar Pradesh,Jalaun,Hearing Impairment,60,80,13,6,19
Punjab,Jalandhar,Hearing Impairment,0,6,19,16,35
Punjab,Jalandhar,Hearing Impairment,6,15,147,114,261
Punjab,Jalandhar,Hearing Impairment,15,35,400,270,670
Punjab,Jalandhar,Hearing Impairment,35,60,287,167,454
Punjab,Jalandhar,Hearing Impairment,60,80,62,14,76
Punjab,Jalandhar,Hearing Impairment,80,100,6,1,7
Odisha,Jajapur,Hearing Impairment,0,6,21,10,31
Odisha,Jajapur,Hearing Impairment,6,15,155,122,277
Odisha,Jajapur,Hearing Impairment,15,35,363,242,605
Odisha,Jajapur,Hearing Impairment,35,60,552,336,888
Odisha,Jajapur,Hearing Impairment,60,80,192,60,252
Odisha,Jajapur,Hearing Impairment,80,100,20,4,24
Rajasthan,Jaisalmer,Hearing Impairment,0,6,5,3,8
Rajasthan,Jaisalmer,Hearing Impairment,6,15,31,34,65
Rajasthan,Jaisalmer,Hearing Impairment,15,35,107,56,163
Rajasthan,Jaisalmer,Hearing Impairment,35,60,56,31,87
Rajasthan,Jaisalmer,Hearing Impairment,60,80,27,17,44
Rajasthan,Jaisalmer,Hearing Impairment,80,100,3,1,4
Rajasthan,Jaipur,Hearing Impairment,0,6,43,27,70
Rajasthan,Jaipur,Hearing Impairment,6,15,290,187,477
Rajasthan,Jaipur,Hearing Impairment,15,35,821,486,1307
Rajasthan,Jaipur,Hearing Impairment,35,60,419,259,678
Rajasthan,Jaipur,Hearing Impairment,60,80,95,68,163
Rajasthan,Jaipur,Hearing Impairment,80,100,10,11,21
Telangana,Jagitial,Hearing Impairment,0,6,1,1,2
Telangana,Jagitial,Hearing Impairment,6,15,25,28,53
Telangana,Jagitial,Hearing Impairment,15,35,189,166,355
Telangana,Jagitial,Hearing Impairment,35,60,206,259,465
Telangana,Jagitial,Hearing Impairment,60,80,191,154,345
Telangana,Jagitial,Hearing Impairment,80,100,36,18,54
Odisha,Jagatsinghapur,Hearing Impairment,0,6,13,5,18
Odisha,Jagatsinghapur,Hearing Impairment,6,15,63,59,122
Odisha,Jagatsinghapur,Hearing Impairment,15,35,185,161,346
Odisha,Jagatsinghapur,Hearing Impairment,35,60,307,252,559
Odisha,Jagatsinghapur,Hearing Impairment,60,80,167,81,248
Odisha,Jagatsinghapur,Hearing Impairment,80,100,27,4,31
Madhya Pradesh,Jabalpur,Hearing Impairment,0,6,22,20,42
Madhya Pradesh,Jabalpur,Hearing Impairment,6,15,144,100,244
Madhya Pradesh,Jabalpur,Hearing Impairment,15,35,652,429,1081
Madhya Pradesh,Jabalpur,Hearing Impairment,35,60,459,256,715
Madhya Pradesh,Jabalpur,Hearing Impairment,60,80,198,94,292
Madhya Pradesh,Jabalpur,Hearing Impairment,80,100,46,19,65
Madhya Pradesh,Indore,Hearing Impairment,0,6,50,34,84
Madhya Pradesh,Indore,Hearing Impairment,6,15,189,149,338
Madhya Pradesh,Indore,Hearing Impairment,15,35,382,249,631
Madhya Pradesh,Indore,Hearing Impairment,35,60,262,159,421
Madhya Pradesh,Indore,Hearing Impairment,60,80,192,83,275
Madhya Pradesh,Indore,Hearing Impairment,80,100,40,11,51
Manipur,Imphal West,Hearing Impairment,0,6,4,2,6
Manipur,Imphal West,Hearing Impairment,6,15,14,16,30
Manipur,Imphal West,Hearing Impairment,15,35,21,32,53
Manipur,Imphal West,Hearing Impairment,35,60,46,37,83
Manipur,Imphal West,Hearing Impairment,60,80,34,21,55
Manipur,Imphal West,Hearing Impairment,80,100,10,9,19
Manipur,Imphal East,Hearing Impairment,0,6,4,3,7
Manipur,Imphal East,Hearing Impairment,6,15,14,15,29
Manipur,Imphal East,Hearing Impairment,15,35,37,31,68
Manipur,Imphal East,Hearing Impairment,35,60,30,28,58
Manipur,Imphal East,Hearing Impairment,60,80,11,11,22
Manipur,Imphal East,Hearing Impairment,80,100,3,5,8
Kerala,Idukki,Hearing Impairment,0,6,6,3,9
Kerala,Idukki,Hearing Impairment,6,15,54,45,99
Kerala,Idukki,Hearing Impairment,15,35,235,195,430
Kerala,Idukki,Hearing Impairment,35,60,325,274,599
Kerala,Idukki,Hearing Impairment,60,80,138,108,246
Kerala,Idukki,Hearing Impairment,80,100,17,4,21
Telangana,Hyderabad,Hearing Impairment,0,6,2,0,2
Telangana,Hyderabad,Hearing Impairment,6,15,174,170,344
Telangana,Hyderabad,Hearing Impairment,15,35,649,541,1190
Telangana,Hyderabad,Hearing Impairment,35,60,591,455,1046
Telangana,Hyderabad,Hearing Impairment,60,80,170,95,265
Telangana,Hyderabad,Hearing Impairment,80,100,13,6,19
West Bengal,Howrah,Hearing Impairment,6,15,1,0,1
West Bengal,Howrah,Hearing Impairment,15,35,1,0,1
Punjab,Hoshiarpur,Hearing Impairment,0,6,17,12,29
Punjab,Hoshiarpur,Hearing Impairment,6,15,70,72,142
Punjab,Hoshiarpur,Hearing Impairment,15,35,214,140,354
Punjab,Hoshiarpur,Hearing Impairment,35,60,162,114,276
Punjab,Hoshiarpur,Hearing Impairment,60,80,41,11,52
Punjab,Hoshiarpur,Hearing Impairment,80,100,1,0,1
Assam,Hojai,Hearing Impairment,0,6,8,9,17
Assam,Hojai,Hearing Impairment,6,15,45,45,90
Assam,Hojai,Hearing Impairment,15,35,76,68,144
Assam,Hojai,Hearing Impairment,35,60,55,33,88
Assam,Hojai,Hearing Impairment,60,80,16,7,23
Assam,Hojai,Hearing Impairment,80,100,3,0,3
Mizoram,Hnahthial,Hearing Impairment,0,6,1,0,1
Mizoram,Hnahthial,Hearing Impairment,15,35,0,1,1
Mizoram,Hnahthial,Hearing Impairment,35,60,3,0,3
Mizoram,Hnahthial,Hearing Impairment,60,80,5,5,10
Mizoram,Hnahthial,Hearing Impairment,80,100,0,1,1
Haryana,Hisar,Hearing Impairment,0,6,9,9,18
Haryana,Hisar,Hearing Impairment,6,15,45,25,70
Haryana,Hisar,Hearing Impairment,15,35,192,69,261
Haryana,Hisar,Hearing Impairment,35,60,154,57,211
Haryana,Hisar,Hearing Impairment,60,80,48,17,65
Haryana,Hisar,Hearing Impairment,80,100,3,1,4
Maharashtra,Hingoli,Hearing Impairment,0,6,28,20,48
Maharashtra,Hingoli,Hearing Impairment,6,15,216,154,370
Maharashtra,Hingoli,Hearing Impairment,15,35,468,191,659
Maharashtra,Hingoli,Hearing Impairment,35,60,190,39,229
Maharashtra,Hingoli,Hearing Impairment,60,80,24,1,25
Maharashtra,Hingoli,Hearing Impairment,80,100,2,1,3
Jharkhand,Hazaribagh,Hearing Impairment,0,6,3,5,8
Jharkhand,Hazaribagh,Hearing Impairment,6,15,56,42,98
Jharkhand,Hazaribagh,Hearing Impairment,15,35,136,90,226
Jharkhand,Hazaribagh,Hearing Impairment,35,60,113,85,198
Jharkhand,Hazaribagh,Hearing Impairment,60,80,27,17,44
Jharkhand,Hazaribagh,Hearing Impairment,80,100,3,3,6
Karnataka,Haveri,Hearing Impairment,0,6,32,30,62
Karnataka,Haveri,Hearing Impairment,6,15,234,183,417
Karnataka,Haveri,Hearing Impairment,15,35,605,465,1070
Karnataka,Haveri,Hearing Impairment,35,60,820,648,1468
Karnataka,Haveri,Hearing Impairment,60,80,292,82,374
Karnataka,Haveri,Hearing Impairment,80,100,19,3,22
Uttar Pradesh,Hathras,Hearing Impairment,0,6,4,4,8
Uttar Pradesh,Hathras,Hearing Impairment,6,15,45,16,61
Uttar Pradesh,Hathras,Hearing Impairment,15,35,139,49,188
Uttar Pradesh,Hathras,Hearing Impairment,35,60,60,27,87
Uttar Pradesh,Hathras,Hearing Impairment,60,80,32,3,35
Uttar Pradesh,Hathras,Hearing Impairment,80,100,3,0,3
Karnataka,Hassan,Hearing Impairment,0,6,25,21,46
Karnataka,Hassan,Hearing Impairment,6,15,101,65,166
Karnataka,Hassan,Hearing Impairment,15,35,332,220,552
Karnataka,Hassan,Hearing Impairment,35,60,562,441,1003
Karnataka,Hassan,Hearing Impairment,60,80,256,123,379
Karnataka,Hassan,Hearing Impairment,80,100,28,1,29
Uttarakhand,Haridwar,Hearing Impairment,0,6,7,6,13
Uttarakhand,Haridwar,Hearing Impairment,6,15,44,29,73
Uttarakhand,Haridwar,Hearing Impairment,15,35,149,75,224
Uttarakhand,Haridwar,Hearing Impairment,35,60,114,47,161
Uttarakhand,Haridwar,Hearing Impairment,60,80,14,2,16
Uttar Pradesh,Hardoi,Hearing Impairment,0,6,13,7,20
Uttar Pradesh,Hardoi,Hearing Impairment,6,15,130,109,239
Uttar Pradesh,Hardoi,Hearing Impairment,15,35,299,165,464
Uttar Pradesh,Hardoi,Hearing Impairment,35,60,247,102,349
Uttar Pradesh,Hardoi,Hearing Impairment,60,80,57,19,76
Uttar Pradesh,Hardoi,Hearing Impairment,80,100,11,1,12
Madhya Pradesh,Harda,Hearing Impairment,6,15,17,12,29
Madhya Pradesh,Harda,Hearing Impairment,15,35,71,50,121
Madhya Pradesh,Harda,Hearing Impairment,35,60,37,21,58
Madhya Pradesh,Harda,Hearing Impairment,60,80,40,5,45
Madhya Pradesh,Harda,Hearing Impairment,80,100,5,4,9
Uttar Pradesh,Hapur,Hearing Impairment,0,6,12,4,16
Uttar Pradesh,Hapur,Hearing Impairment,6,15,34,22,56
Uttar Pradesh,Hapur,Hearing Impairment,15,35,97,37,134
Uttar Pradesh,Hapur,Hearing Impairment,35,60,53,17,70
Uttar Pradesh,Hapur,Hearing Impairment,60,80,11,1,12
Rajasthan,Hanumangarh,Hearing Impairment,0,6,13,9,22
Rajasthan,Hanumangarh,Hearing Impairment,6,15,78,71,149
Rajasthan,Hanumangarh,Hearing Impairment,15,35,219,163,382
Rajasthan,Hanumangarh,Hearing Impairment,35,60,120,80,200
Rajasthan,Hanumangarh,Hearing Impairment,60,80,23,20,43
Rajasthan,Hanumangarh,Hearing Impairment,80,100,2,1,3
Telangana,Hanumakonda,Hearing Impairment,0,6,1,0,1
Telangana,Hanumakonda,Hearing Impairment,6,15,18,13,31
Telangana,Hanumakonda,Hearing Impairment,15,35,238,206,444
Telangana,Hanumakonda,Hearing Impairment,35,60,283,308,591
Telangana,Hanumakonda,Hearing Impairment,60,80,144,102,246
Telangana,Hanumakonda,Hearing Impairment,80,100,20,8,28
Himachal Pradesh,Hamirpur,Hearing Impairment,0,6,7,16,23
Himachal Pradesh,Hamirpur,Hearing Impairment,6,15,27,27,54
Himachal Pradesh,Hamirpur,Hearing Impairment,15,35,103,65,168
Himachal Pradesh,Hamirpur,Hearing Impairment,35,60,135,102,237
Himachal Pradesh,Hamirpur,Hearing Impairment,60,80,79,31,110
Himachal Pradesh,Hamirpur,Hearing Impairment,80,100,17,2,19
Uttar Pradesh,Hamirpur,Hearing Impairment,6,15,5,4,9
Uttar Pradesh,Hamirpur,Hearing Impairment,15,35,28,15,43
Uttar Pradesh,Hamirpur,Hearing Impairment,35,60,50,14,64
Uttar Pradesh,Hamirpur,Hearing Impairment,60,80,13,5,18
Uttar Pradesh,Hamirpur,Hearing Impairment,80,100,1,0,1
Assam,Hailakandi,Hearing Impairment,0,6,1,1,2
Assam,Hailakandi,Hearing Impairment,6,15,22,10,32
Assam,Hailakandi,Hearing Impairment,15,35,45,32,77
Assam,Hailakandi,Hearing Impairment,35,60,43,31,74
Assam,Hailakandi,Hearing Impairment,60,80,10,4,14
Assam,Hailakandi,Hearing Impairment,80,100,1,0,1
Sikkim,Gyalshing,Hearing Impairment,6,15,1,2,3
Sikkim,Gyalshing,Hearing Impairment,15,35,18,15,33
Sikkim,Gyalshing,Hearing Impairment,35,60,56,50,106
Sikkim,Gyalshing,Hearing Impairment,60,80,17,5,22
Sikkim,Gyalshing,Hearing Impairment,80,100,2,0,2
Madhya Pradesh,Gwalior,Hearing Impairment,0,6,16,9,25
Madhya Pradesh,Gwalior,Hearing Impairment,6,15,85,56,141
Madhya Pradesh,Gwalior,Hearing Impairment,15,35,481,253,734
Madhya Pradesh,Gwalior,Hearing Impairment,35,60,255,102,357
Madhya Pradesh,Gwalior,Hearing Impairment,60,80,76,26,102
Madhya Pradesh,Gwalior,Hearing Impairment,80,100,11,1,12
Haryana,Gurugram,Hearing Impairment,0,6,13,6,19
Haryana,Gurugram,Hearing Impairment,6,15,57,38,95
Haryana,Gurugram,Hearing Impairment,15,35,136,75,211
Haryana,Gurugram,Hearing Impairment,35,60,78,65,143
Haryana,Gurugram,Hearing Impairment,60,80,14,4,18
Haryana,Gurugram,Hearing Impairment,80,100,1,1,2
Punjab,Gurdaspur,Hearing Impairment,0,6,28,16,44
Punjab,Gurdaspur,Hearing Impairment,6,15,74,47,121
Punjab,Gurdaspur,Hearing Impairment,15,35,251,185,436
Punjab,Gurdaspur,Hearing Impairment,35,60,166,100,266
Punjab,Gurdaspur,Hearing Impairment,60,80,19,16,35
Punjab,Gurdaspur,Hearing Impairment,80,100,4,0,4
Andhra Pradesh,Guntur,Hearing Impairment,0,6,35,29,64
Andhra Pradesh,Guntur,Hearing Impairment,6,15,326,246,572
Andhra Pradesh,Guntur,Hearing Impairment,15,35,1054,658,1712
Andhra Pradesh,Guntur,Hearing Impairment,35,60,1883,396,2279
Andhra Pradesh,Guntur,Hearing Impairment,60,80,495,53,548
Andhra Pradesh,Guntur,Hearing Impairment,80,100,32,1,33
Madhya Pradesh,Guna,Hearing Impairment,0,6,14,7,21
Madhya Pradesh,Guna,Hearing Impairment,6,15,69,47,116
Madhya Pradesh,Guna,Hearing Impairment,15,35,205,117,322
Madhya Pradesh,Guna,Hearing Impairment,35,60,178,92,270
Madhya Pradesh,Guna,Hearing Impairment,60,80,160,46,206
Madhya Pradesh,Guna,Hearing Impairment,80,100,20,9,29
Jharkhand,Gumla,Hearing Impairment,0,6,4,1,5
Jharkhand,Gumla,Hearing Impairment,6,15,11,7,18
Jharkhand,Gumla,Hearing Impairment,15,35,35,35,70
Jharkhand,Gumla,Hearing Impairment,35,60,34,18,52
Jharkhand,Gumla,Hearing Impairment,60,80,7,4,11
Uttar Pradesh,Gorakhpur,Hearing Impairment,0,6,46,40,86
Uttar Pradesh,Gorakhpur,Hearing Impairment,6,15,194,176,370
Uttar Pradesh,Gorakhpur,Hearing Impairment,15,35,571,339,910
Uttar Pradesh,Gorakhpur,Hearing Impairment,35,60,383,184,567
Uttar Pradesh,Gorakhpur,Hearing Impairment,60,80,110,26,136
Uttar Pradesh,Gorakhpur,Hearing Impairment,80,100,4,0,4
Bihar,Gopalganj,Hearing Impairment,0,6,25,10,35
Bihar,Gopalganj,Hearing Impairment,6,15,180,122,302
Bihar,Gopalganj,Hearing Impairment,15,35,235,144,379
Bihar,Gopalganj,Hearing Impairment,35,60,130,52,182
Bihar,Gopalganj,Hearing Impairment,60,80,11,5,16
Bihar,Gopalganj,Hearing Impairment,80,100,3,0,3
Maharashtra,Gondia,Hearing Impairment,0,6,36,28,64
Maharashtra,Gondia,Hearing Impairment,6,15,70,82,152
Maharashtra,Gondia,Hearing Impairment,15,35,180,123,303
Maharashtra,Gondia,Hearing Impairment,35,60,135,51,186
Maharashtra,Gondia,Hearing Impairment,60,80,27,7,34
Maharashtra,Gondia,Hearing Impairment,80,100,3,1,4
Uttar Pradesh,Gonda,Hearing Impairment,0,6,25,26,51
Uttar Pradesh,Gonda,Hearing Impairment,6,15,133,102,235
Uttar Pradesh,Gonda,Hearing Impairment,15,35,329,124,453
Uttar Pradesh,Gonda,Hearing Impairment,35,60,206,83,289
Uttar Pradesh,Gonda,Hearing Impairment,60,80,35,12,47
Uttar Pradesh,Gonda,Hearing Impairment,80,100,2,0,2
Tripura,Gomati,Hearing Impairment,0,6,11,5,16
Tripura,Gomati,Hearing Impairment,6,15,27,33,60
Tripura,Gomati,Hearing Impairment,15,35,97,81,178
Tripura,Gomati,Hearing Impairment,35,60,145,127,272
Tripura,Gomati,Hearing Impairment,60,80,83,57,140
Tripura,Gomati,Hearing Impairment,80,100,10,6,16
Assam,Golaghat,Hearing Impairment,0,6,12,9,21
Assam,Golaghat,Hearing Impairment,6,15,70,62,132
Assam,Golaghat,Hearing Impairment,15,35,178,130,308
Assam,Golaghat,Hearing Impairment,35,60,185,181,366
Assam,Golaghat,Hearing Impairment,60,80,71,49,120
Assam,Golaghat,Hearing Impairment,80,100,6,0,6
Jharkhand,Godda,Hearing Impairment,0,6,1,1,2
Jharkhand,Godda,Hearing Impairment,6,15,13,11,24
Jharkhand,Godda,Hearing Impairment,15,35,73,41,114
Jharkhand,Godda,Hearing Impairment,35,60,48,26,74
Jharkhand,Godda,Hearing Impairment,60,80,8,9,17
Jharkhand,Godda,Hearing Impairment,80,100,1,1,2
Assam,Goalpara,Hearing Impairment,0,6,50,56,106
Assam,Goalpara,Hearing Impairment,6,15,360,302,662
Assam,Goalpara,Hearing Impairment,15,35,808,879,1687
Assam,Goalpara,Hearing Impairment,35,60,1256,1633,2889
Assam,Goalpara,Hearing Impairment,60,80,649,635,1284
Assam,Goalpara,Hearing Impairment,80,100,49,40,89
Jharkhand,Giridih,Hearing Impairment,0,6,4,3,7
Jharkhand,Giridih,Hearing Impairment,6,15,31,23,54
Jharkhand,Giridih,Hearing Impairment,15,35,141,65,206
Jharkhand,Giridih,Hearing Impairment,35,60,104,51,155
Jharkhand,Giridih,Hearing Impairment,60,80,21,9,30
Gujarat,Gir Somnath,Hearing Impairment,0,6,10,3,13
Gujarat,Gir Somnath,Hearing Impairment,6,15,64,47,111
Gujarat,Gir Somnath,Hearing Impairment,15,35,131,94,225
Gujarat,Gir Somnath,Hearing Impairment,35,60,60,32,92
Gujarat,Gir Somnath,Hearing Impairment,60,80,10,3,13
Uttar Pradesh,Ghazipur,Hearing Impairment,0,6,10,9,19
Uttar Pradesh,Ghazipur,Hearing Impairment,6,15,125,121,246
Uttar Pradesh,Ghazipur,Hearing Impairment,15,35,306,168,474
Uttar Pradesh,Ghazipur,Hearing Impairment,35,60,181,92,273
Uttar Pradesh,Ghazipur,Hearing Impairment,60,80,28,11,39
Uttar Pradesh,Ghazipur,Hearing Impairment,80,100,1,0,1
Uttar Pradesh,Ghaziabad,Hearing Impairment,0,6,34,22,56
Uttar Pradesh,Ghaziabad,Hearing Impairment,6,15,112,76,188
Uttar Pradesh,Ghaziabad,Hearing Impairment,15,35,288,162,450
Uttar Pradesh,Ghaziabad,Hearing Impairment,35,60,108,54,162
Uttar Pradesh,Ghaziabad,Hearing Impairment,60,80,27,4,31
Uttar Pradesh,Ghaziabad,Hearing Impairment,80,100,1,1,2
Bihar,Gaya,Hearing Impairment,0,6,26,20,46
Bihar,Gaya,Hearing Impairment,6,15,171,161,332
Bihar,Gaya,Hearing Impairment,15,35,369,187,556
Bihar,Gaya,Hearing Impairment,35,60,140,68,208
Bihar,Gaya,Hearing Impairment,60,80,46,6,52
Bihar,Gaya,Hearing Impairment,80,100,1,0,1
Uttar Pradesh,Gautam Buddha Nagar,Hearing Impairment,0,6,19,22,41
Uttar Pradesh,Gautam Buddha Nagar,Hearing Impairment,6,15,83,37,120
Uttar Pradesh,Gautam Buddha Nagar,Hearing Impairment,15,35,141,57,198
Uttar Pradesh,Gautam Buddha Nagar,Hearing Impairment,35,60,53,20,73
Uttar Pradesh,Gautam Buddha Nagar,Hearing Impairment,60,80,15,12,27
Uttar Pradesh,Gautam Buddha Nagar,Hearing Impairment,80,100,4,4,8
Chhattisgarh,Gaurella Pendra Marwahi,Hearing Impairment,0,6,0,3,3
Chhattisgarh,Gaurella Pendra Marwahi,Hearing Impairment,6,15,8,6,14
Chhattisgarh,Gaurella Pendra Marwahi,Hearing Impairment,15,35,10,11,21
Chhattisgarh,Gaurella Pendra Marwahi,Hearing Impairment,35,60,8,8,16
Chhattisgarh,Gaurella Pendra Marwahi,Hearing Impairment,60,80,7,3,10
Chhattisgarh,Gaurella Pendra Marwahi,Hearing Impairment,80,100,1,0,1
Chhattisgarh,Gariyaband,Hearing Impairment,0,6,10,8,18
Chhattisgarh,Gariyaband,Hearing Impairment,6,15,102,62,164
Chhattisgarh,Gariyaband,Hearing Impairment,15,35,148,100,248
Chhattisgarh,Gariyaband,Hearing Impairment,35,60,133,81,214
Chhattisgarh,Gariyaband,Hearing Impairment,60,80,90,47,137
Chhattisgarh,Gariyaband,Hearing Impairment,80,100,10,2,12
Jharkhand,Garhwa,Hearing Impairment,0,6,4,4,8
Jharkhand,Garhwa,Hearing Impairment,6,15,32,33,65
Jharkhand,Garhwa,Hearing Impairment,15,35,119,65,184
Jharkhand,Garhwa,Hearing Impairment,35,60,70,25,95
Jharkhand,Garhwa,Hearing Impairment,60,80,5,2,7
Odisha,Ganjam,Hearing Impairment,0,6,39,40,79
Odisha,Ganjam,Hearing Impairment,6,15,391,361,752
Odisha,Ganjam,Hearing Impairment,15,35,1334,1060,2394
Odisha,Ganjam,Hearing Impairment,35,60,2732,2307,5039
Odisha,Ganjam,Hearing Impairment,60,80,1023,492,1515
Odisha,Ganjam,Hearing Impairment,80,100,57,9,66
Sikkim,Gangtok,Hearing Impairment,6,15,10,6,16
Sikkim,Gangtok,Hearing Impairment,15,35,34,26,60
Sikkim,Gangtok,Hearing Impairment,35,60,92,54,146
Sikkim,Gangtok,Hearing Impairment,60,80,24,11,35
Sikkim,Gangtok,Hearing Impairment,80,100,4,1,5
Rajasthan,Ganganagar,Hearing Impairment,0,6,9,14,23
Rajasthan,Ganganagar,Hearing Impairment,6,15,106,76,182
Rajasthan,Ganganagar,Hearing Impairment,15,35,285,220,505
Rajasthan,Ganganagar,Hearing Impairment,35,60,217,140,357
Rajasthan,Ganganagar,Hearing Impairment,60,80,76,38,114
Rajasthan,Ganganagar,Hearing Impairment,80,100,15,6,21
Gujarat,Gandhinagar,Hearing Impairment,0,6,5,9,14
Gujarat,Gandhinagar,Hearing Impairment,6,15,64,30,94
Gujarat,Gandhinagar,Hearing Impairment,15,35,88,46,134
Gujarat,Gandhinagar,Hearing Impairment,35,60,36,29,65
Gujarat,Gandhinagar,Hearing Impairment,60,80,8,4,12
Jammu And Kashmir,Ganderbal,Hearing Impairment,0,6,3,6,9
Jammu And Kashmir,Ganderbal,Hearing Impairment,6,15,24,14,38
Jammu And Kashmir,Ganderbal,Hearing Impairment,15,35,73,53,126
Jammu And Kashmir,Ganderbal,Hearing Impairment,35,60,85,64,149
Jammu And Kashmir,Ganderbal,Hearing Impairment,60,80,55,16,71
Jammu And Kashmir,Ganderbal,Hearing Impairment,80,100,12,4,16
Odisha,Gajapati,Hearing Impairment,0,6,6,4,10
Odisha,Gajapati,Hearing Impairment,6,15,68,64,132
Odisha,Gajapati,Hearing Impairment,15,35,261,235,496
Odisha,Gajapati,Hearing Impairment,35,60,248,223,471
Odisha,Gajapati,Hearing Impairment,60,80,124,76,200
Odisha,Gajapati,Hearing Impairment,80,100,6,10,16
Maharashtra,Gadchiroli,Hearing Impairment,0,6,21,11,32
Maharashtra,Gadchiroli,Hearing Impairment,6,15,136,114,250
Maharashtra,Gadchiroli,Hearing Impairment,15,35,396,303,699
Maharashtra,Gadchiroli,Hearing Impairment,35,60,233,150,383
Maharashtra,Gadchiroli,Hearing Impairment,60,80,21,7,28
Karnataka,Gadag,Hearing Impairment,0,6,33,23,56
Karnataka,Gadag,Hearing Impairment,6,15,123,117,240
Karnataka,Gadag,Hearing Impairment,15,35,335,275,610
Karnataka,Gadag,Hearing Impairment,35,60,436,290,726
Karnataka,Gadag,Hearing Impairment,60,80,155,37,192
Karnataka,Gadag,Hearing Impairment,80,100,11,1,12
Uttar Pradesh,Firozabad,Hearing Impairment,0,6,28,14,42
Uttar Pradesh,Firozabad,Hearing Impairment,6,15,142,128,270
Uttar Pradesh,Firozabad,Hearing Impairment,15,35,328,154,482
Uttar Pradesh,Firozabad,Hearing Impairment,35,60,254,123,377
Uttar Pradesh,Firozabad,Hearing Impairment,60,80,108,39,147
Uttar Pradesh,Firozabad,Hearing Impairment,80,100,16,2,18
Punjab,Ferozepur,Hearing Impairment,0,6,16,11,27
Punjab,Ferozepur,Hearing Impairment,6,15,64,59,123
Punjab,Ferozepur,Hearing Impairment,15,35,170,84,254
Punjab,Ferozepur,Hearing Impairment,35,60,80,41,121
Punjab,Ferozepur,Hearing Impairment,60,80,9,2,11
Punjab,Ferozepur,Hearing Impairment,80,100,1,0,1
Punjab,Fazilka,Hearing Impairment,0,6,15,13,28
Punjab,Fazilka,Hearing Impairment,6,15,70,71,141
Punjab,Fazilka,Hearing Impairment,15,35,250,133,383
Punjab,Fazilka,Hearing Impairment,35,60,119,66,185
Punjab,Fazilka,Hearing Impairment,60,80,13,10,23
Punjab,Fazilka,Hearing Impairment,80,100,1,1,2
Uttar Pradesh,Fatehpur,Hearing Impairment,0,6,11,13,24
Uttar Pradesh,Fatehpur,Hearing Impairment,6,15,76,72,148
Uttar Pradesh,Fatehpur,Hearing Impairment,15,35,261,119,380
Uttar Pradesh,Fatehpur,Hearing Impairment,35,60,253,102,355
Uttar Pradesh,Fatehpur,Hearing Impairment,60,80,70,16,86
Uttar Pradesh,Fatehpur,Hearing Impairment,80,100,4,1,5
Punjab,Fatehgarh Sahib,Hearing Impairment,0,6,12,5,17
Punjab,Fatehgarh Sahib,Hearing Impairment,6,15,38,23,61
Punjab,Fatehgarh Sahib,Hearing Impairment,15,35,77,58,135
Punjab,Fatehgarh Sahib,Hearing Impairment,35,60,64,59,123
Punjab,Fatehgarh Sahib,Hearing Impairment,60,80,28,7,35
Haryana,Fatehabad,Hearing Impairment,0,6,9,8,17
Haryana,Fatehabad,Hearing Impairment,6,15,69,53,122
Haryana,Fatehabad,Hearing Impairment,15,35,155,97,252
Haryana,Fatehabad,Hearing Impairment,35,60,90,58,148
Haryana,Fatehabad,Hearing Impairment,60,80,17,6,23
Haryana,Fatehabad,Hearing Impairment,80,100,2,1,3
Uttar Pradesh,Farrukhabad,Hearing Impairment,0,6,5,7,12
Uttar Pradesh,Farrukhabad,Hearing Impairment,6,15,37,19,56
Uttar Pradesh,Farrukhabad,Hearing Impairment,15,35,113,51,164
Uttar Pradesh,Farrukhabad,Hearing Impairment,35,60,74,30,104
Uttar Pradesh,Farrukhabad,Hearing Impairment,60,80,28,9,37
Uttar Pradesh,Farrukhabad,Hearing Impairment,80,100,4,0,4
Punjab,Faridkot,Hearing Impairment,0,6,10,5,15
Punjab,Faridkot,Hearing Impairment,6,15,53,24,77
Punjab,Faridkot,Hearing Impairment,15,35,101,69,170
Punjab,Faridkot,Hearing Impairment,35,60,48,38,86
Punjab,Faridkot,Hearing Impairment,60,80,12,7,19
Punjab,Faridkot,Hearing Impairment,80,100,2,2,4
Haryana,Faridabad,Hearing Impairment,0,6,31,26,57
Haryana,Faridabad,Hearing Impairment,6,15,132,110,242
Haryana,Faridabad,Hearing Impairment,15,35,235,149,384
Haryana,Faridabad,Hearing Impairment,35,60,111,58,169
Haryana,Faridabad,Hearing Impairment,60,80,17,4,21
Uttar Pradesh,Etawah,Hearing Impairment,0,6,9,11,20
Uttar Pradesh,Etawah,Hearing Impairment,6,15,34,35,69
Uttar Pradesh,Etawah,Hearing Impairment,15,35,113,52,165
Uttar Pradesh,Etawah,Hearing Impairment,35,60,75,38,113
Uttar Pradesh,Etawah,Hearing Impairment,60,80,26,5,31
Uttar Pradesh,Etawah,Hearing Impairment,80,100,2,1,3
Uttar Pradesh,Etah,Hearing Impairment,0,6,12,9,21
Uttar Pradesh,Etah,Hearing Impairment,6,15,54,47,101
Uttar Pradesh,Etah,Hearing Impairment,15,35,161,85,246
Uttar Pradesh,Etah,Hearing Impairment,35,60,101,36,137
Uttar Pradesh,Etah,Hearing Impairment,60,80,18,6,24
Uttar Pradesh,Etah,Hearing Impairment,80,100,0,1,1
Tamil Nadu,Erode,Hearing Impairment,0,6,12,10,22
Tamil Nadu,Erode,Hearing Impairment,6,15,109,83,192
Tamil Nadu,Erode,Hearing Impairment,15,35,400,313,713
Tamil Nadu,Erode,Hearing Impairment,35,60,601,567,1168
Tamil Nadu,Erode,Hearing Impairment,60,80,360,231,591
Tamil Nadu,Erode,Hearing Impairment,80,100,41,17,58
Kerala,Ernakulam,Hearing Impairment,0,6,28,12,40
Kerala,Ernakulam,Hearing Impairment,6,15,106,87,193
Kerala,Ernakulam,Hearing Impairment,15,35,484,377,861
Kerala,Ernakulam,Hearing Impairment,35,60,679,620,1299
Kerala,Ernakulam,Hearing Impairment,60,80,270,238,508
Kerala,Ernakulam,Hearing Impairment,80,100,18,18,36
Meghalaya,Eastern West Khasi Hills,Hearing Impairment,0,6,1,1,2
Meghalaya,Eastern West Khasi Hills,Hearing Impairment,6,15,9,11,20
Meghalaya,Eastern West Khasi Hills,Hearing Impairment,15,35,34,52,86
Meghalaya,Eastern West Khasi Hills,Hearing Impairment,35,60,39,33,72
Meghalaya,Eastern West Khasi Hills,Hearing Impairment,60,80,14,16,30
Meghalaya,Eastern West Khasi Hills,Hearing Impairment,80,100,4,2,6
Jharkhand,East Singhbum,Hearing Impairment,0,6,7,9,16
Jharkhand,East Singhbum,Hearing Impairment,6,15,82,53,135
Jharkhand,East Singhbum,Hearing Impairment,15,35,260,284,544
Jharkhand,East Singhbum,Hearing Impairment,35,60,403,318,721
Jharkhand,East Singhbum,Hearing Impairment,60,80,149,88,237
Jharkhand,East Singhbum,Hearing Impairment,80,100,14,6,20
Arunachal Pradesh,East Siang,Hearing Impairment,0,6,1,0,1
Arunachal Pradesh,East Siang,Hearing Impairment,6,15,3,2,5
Arunachal Pradesh,East Siang,Hearing Impairment,15,35,17,31,48
Arunachal Pradesh,East Siang,Hearing Impairment,35,60,11,10,21
Arunachal Pradesh,East Siang,Hearing Impairment,60,80,8,1,9
Madhya Pradesh,East Nimar,Hearing Impairment,0,6,1,1,2
Madhya Pradesh,East Nimar,Hearing Impairment,6,15,34,23,57
Madhya Pradesh,East Nimar,Hearing Impairment,15,35,128,94,222
Madhya Pradesh,East Nimar,Hearing Impairment,35,60,75,44,119
Madhya Pradesh,East Nimar,Hearing Impairment,60,80,23,11,34
Madhya Pradesh,East Nimar,Hearing Impairment,80,100,4,0,4
Meghalaya,East Khasi Hills,Hearing Impairment,0,6,2,8,10
Meghalaya,East Khasi Hills,Hearing Impairment,6,15,76,76,152
Meghalaya,East Khasi Hills,Hearing Impairment,15,35,278,324,602
Meghalaya,East Khasi Hills,Hearing Impairment,35,60,210,226,436
Meghalaya,East Khasi Hills,Hearing Impairment,60,80,66,58,124
Meghalaya,East Khasi Hills,Hearing Impairment,80,100,9,9,18
Arunachal Pradesh,East Kameng,Hearing Impairment,6,15,1,3,4
Arunachal Pradesh,East Kameng,Hearing Impairment,15,35,10,10,20
Arunachal Pradesh,East Kameng,Hearing Impairment,35,60,8,5,13
Arunachal Pradesh,East Kameng,Hearing Impairment,60,80,4,1,5
Arunachal Pradesh,East Kameng,Hearing Impairment,80,100,0,1,1
Meghalaya,East Jaintia Hills,Hearing Impairment,0,6,1,1,2
Meghalaya,East Jaintia Hills,Hearing Impairment,6,15,17,17,34
Meghalaya,East Jaintia Hills,Hearing Impairment,15,35,42,49,91
Meghalaya,East Jaintia Hills,Hearing Impairment,35,60,25,27,52
Meghalaya,East Jaintia Hills,Hearing Impairment,60,80,8,19,27
Meghalaya,East Jaintia Hills,Hearing Impairment,80,100,1,2,3
Andhra Pradesh,East Godavari,Hearing Impairment,0,6,54,33,87
Andhra Pradesh,East Godavari,Hearing Impairment,6,15,240,185,425
Andhra Pradesh,East Godavari,Hearing Impairment,15,35,606,308,914
Andhra Pradesh,East Godavari,Hearing Impairment,35,60,1281,239,1520
Andhra Pradesh,East Godavari,Hearing Impairment,60,80,463,52,515
Andhra Pradesh,East Godavari,Hearing Impairment,80,100,31,6,37
Meghalaya,East Garo Hills,Hearing Impairment,0,6,2,0,2
Meghalaya,East Garo Hills,Hearing Impairment,6,15,21,8,29
Meghalaya,East Garo Hills,Hearing Impairment,15,35,65,75,140
Meghalaya,East Garo Hills,Hearing Impairment,35,60,68,56,124
Meghalaya,East Garo Hills,Hearing Impairment,60,80,46,18,64
Meghalaya,East Garo Hills,Hearing Impairment,80,100,7,2,9
Delhi,East,Hearing Impairment,0,6,24,27,51
Delhi,East,Hearing Impairment,6,15,112,99,211
Delhi,East,Hearing Impairment,15,35,235,172,407
Delhi,East,Hearing Impairment,35,60,153,77,230
Delhi,East,Hearing Impairment,60,80,57,43,100
Delhi,East,Hearing Impairment,80,100,7,6,13
Chhattisgarh,Durg,Hearing Impairment,0,6,35,19,54
Chhattisgarh,Durg,Hearing Impairment,6,15,140,127,267
Chhattisgarh,Durg,Hearing Impairment,15,35,307,244,551
Chhattisgarh,Durg,Hearing Impairment,35,60,248,149,397
Chhattisgarh,Durg,Hearing Impairment,60,80,117,47,164
Chhattisgarh,Durg,Hearing Impairment,80,100,30,3,33
Rajasthan,Dungarpur,Hearing Impairment,0,6,1,1,2
Rajasthan,Dungarpur,Hearing Impairment,6,15,23,25,48
Rajasthan,Dungarpur,Hearing Impairment,15,35,118,92,210
Rajasthan,Dungarpur,Hearing Impairment,35,60,64,38,102
Rajasthan,Dungarpur,Hearing Impairment,60,80,15,6,21
Rajasthan,Dungarpur,Hearing Impairment,80,100,0,1,1
Jharkhand,Dumka,Hearing Impairment,0,6,4,7,11
Jharkhand,Dumka,Hearing Impairment,6,15,38,42,80
Jharkhand,Dumka,Hearing Impairment,15,35,104,104,208
Jharkhand,Dumka,Hearing Impairment,35,60,121,72,193
Jharkhand,Dumka,Hearing Impairment,60,80,20,6,26
Jharkhand,Dumka,Hearing Impairment,80,100,2,0,2
Gujarat,Dohad,Hearing Impairment,0,6,2,3,5
Gujarat,Dohad,Hearing Impairment,6,15,50,43,93
Gujarat,Dohad,Hearing Impairment,15,35,114,62,176
Gujarat,Dohad,Hearing Impairment,35,60,50,21,71
Gujarat,Dohad,Hearing Impairment,60,80,20,6,26
Gujarat,Dohad,Hearing Impairment,80,100,3,0,3
Jammu And Kashmir,Doda,Hearing Impairment,0,6,11,11,22
Jammu And Kashmir,Doda,Hearing Impairment,6,15,101,71,172
Jammu And Kashmir,Doda,Hearing Impairment,15,35,361,348,709
Jammu And Kashmir,Doda,Hearing Impairment,35,60,480,517,997
Jammu And Kashmir,Doda,Hearing Impairment,60,80,127,83,210
Jammu And Kashmir,Doda,Hearing Impairment,80,100,11,8,19
Dadra Nagar Haveli And Daman And Diu,Diu,Hearing Impairment,6,15,2,1,3
Dadra Nagar Haveli And Daman And Diu,Diu,Hearing Impairment,15,35,2,2,4
Dadra Nagar Haveli And Daman And Diu,Diu,Hearing Impairment,35,60,4,4,8
Dadra Nagar Haveli And Daman And Diu,Diu,Hearing Impairment,60,80,2,1,3
Madhya Pradesh,Dindori,Hearing Impairment,0,6,2,1,3
Madhya Pradesh,Dindori,Hearing Impairment,6,15,16,13,29
Madhya Pradesh,Dindori,Hearing Impairment,15,35,76,51,127
Madhya Pradesh,Dindori,Hearing Impairment,35,60,45,24,69
Madhya Pradesh,Dindori,Hearing Impairment,60,80,15,8,23
Madhya Pradesh,Dindori,Hearing Impairment,80,100,1,0,1
Tamil Nadu,Dindigul,Hearing Impairment,0,6,14,19,33
Tamil Nadu,Dindigul,Hearing Impairment,6,15,133,93,226
Tamil Nadu,Dindigul,Hearing Impairment,15,35,426,360,786
Tamil Nadu,Dindigul,Hearing Impairment,35,60,628,507,1135
Tamil Nadu,Dindigul,Hearing Impairment,60,80,297,138,435
Tamil Nadu,Dindigul,Hearing Impairment,80,100,38,7,45
Nagaland,Dimapur,Hearing Impairment,6,15,3,4,7
Nagaland,Dimapur,Hearing Impairment,15,35,11,15,26
Nagaland,Dimapur,Hearing Impairment,35,60,29,19,48
Nagaland,Dimapur,Hearing Impairment,60,80,13,10,23
Nagaland,Dimapur,Hearing Impairment,80,100,10,4,14
Assam,Dima Hasao,Hearing Impairment,6,15,5,0,5
Assam,Dima Hasao,Hearing Impairment,15,35,12,6,18
Assam,Dima Hasao,Hearing Impairment,35,60,2,1,3
Assam,Dima Hasao,Hearing Impairment,60,80,1,0,1
Assam,Dibrugarh,Hearing Impairment,0,6,4,8,12
Assam,Dibrugarh,Hearing Impairment,6,15,50,31,81
Assam,Dibrugarh,Hearing Impairment,15,35,144,105,249
Assam,Dibrugarh,Hearing Impairment,35,60,142,104,246
Assam,Dibrugarh,Hearing Impairment,60,80,39,19,58
Assam,Dibrugarh,Hearing Impairment,80,100,3,1,4
Arunachal Pradesh,Dibang Valley,Hearing Impairment,15,35,1,0,1
Maharashtra,Dhule,Hearing Impairment,0,6,30,17,47
Maharashtra,Dhule,Hearing Impairment,6,15,350,241,591
Maharashtra,Dhule,Hearing Impairment,15,35,1000,542,1542
Maharashtra,Dhule,Hearing Impairment,35,60,1163,496,1659
Maharashtra,Dhule,Hearing Impairment,60,80,580,146,726
Maharashtra,Dhule,Hearing Impairment,80,100,62,9,71
Assam,Dhubri,Hearing Impairment,0,6,7,7,14
Assam,Dhubri,Hearing Impairment,6,15,70,75,145
Assam,Dhubri,Hearing Impairment,15,35,145,138,283
Assam,Dhubri,Hearing Impairment,35,60,92,50,142
Assam,Dhubri,Hearing Impairment,60,80,25,7,32
Rajasthan,Dholpur,Hearing Impairment,0,6,2,3,5
Rajasthan,Dholpur,Hearing Impairment,6,15,49,33,82
Rajasthan,Dholpur,Hearing Impairment,15,35,154,76,230
Rajasthan,Dholpur,Hearing Impairment,35,60,60,39,99
Rajasthan,Dholpur,Hearing Impairment,60,80,18,10,28
Rajasthan,Dholpur,Hearing Impairment,80,100,2,3,5
Odisha,Dhenkanal,Hearing Impairment,0,6,12,8,20
Odisha,Dhenkanal,Hearing Impairment,6,15,120,101,221
Odisha,Dhenkanal,Hearing Impairment,15,35,232,199,431
Odisha,Dhenkanal,Hearing Impairment,35,60,372,228,600
Odisha,Dhenkanal,Hearing Impairment,60,80,187,76,263
Odisha,Dhenkanal,Hearing Impairment,80,100,16,6,22
Assam,Dhemaji,Hearing Impairment,0,6,9,6,15
Assam,Dhemaji,Hearing Impairment,6,15,54,42,96
Assam,Dhemaji,Hearing Impairment,15,35,100,87,187
Assam,Dhemaji,Hearing Impairment,35,60,110,89,199
Assam,Dhemaji,Hearing Impairment,60,80,30,22,52
Assam,Dhemaji,Hearing Impairment,80,100,1,0,1
Karnataka,Dharwad,Hearing Impairment,0,6,48,35,83
Karnataka,Dharwad,Hearing Impairment,6,15,202,169,371
Karnataka,Dharwad,Hearing Impairment,15,35,490,515,1005
Karnataka,Dharwad,Hearing Impairment,35,60,909,950,1859
Karnataka,Dharwad,Hearing Impairment,60,80,288,115,403
Karnataka,Dharwad,Hearing Impairment,80,100,22,2,24
Tamil Nadu,Dharmapuri,Hearing Impairment,0,6,39,24,63
Tamil Nadu,Dharmapuri,Hearing Impairment,6,15,105,109,214
Tamil Nadu,Dharmapuri,Hearing Impairment,15,35,478,309,787
Tamil Nadu,Dharmapuri,Hearing Impairment,35,60,429,273,702
Tamil Nadu,Dharmapuri,Hearing Impairment,60,80,205,87,292
Tamil Nadu,Dharmapuri,Hearing Impairment,80,100,21,6,27
Madhya Pradesh,Dhar,Hearing Impairment,0,6,2,7,9
Madhya Pradesh,Dhar,Hearing Impairment,6,15,36,33,69
Madhya Pradesh,Dhar,Hearing Impairment,15,35,185,117,302
Madhya Pradesh,Dhar,Hearing Impairment,35,60,126,63,189
Madhya Pradesh,Dhar,Hearing Impairment,60,80,30,12,42
Madhya Pradesh,Dhar,Hearing Impairment,80,100,4,5,9
Jharkhand,Dhanbad,Hearing Impairment,0,6,0,2,2
Jharkhand,Dhanbad,Hearing Impairment,6,15,30,23,53
Jharkhand,Dhanbad,Hearing Impairment,15,35,188,134,322
Jharkhand,Dhanbad,Hearing Impairment,35,60,171,198,369
Jharkhand,Dhanbad,Hearing Impairment,60,80,23,26,49
Jharkhand,Dhanbad,Hearing Impairment,80,100,2,0,2
Chhattisgarh,Dhamtari,Hearing Impairment,0,6,7,5,12
Chhattisgarh,Dhamtari,Hearing Impairment,6,15,51,43,94
Chhattisgarh,Dhamtari,Hearing Impairment,15,35,136,107,243
Chhattisgarh,Dhamtari,Hearing Impairment,35,60,132,96,228
Chhattisgarh,Dhamtari,Hearing Impairment,60,80,225,127,352
Chhattisgarh,Dhamtari,Hearing Impairment,80,100,53,25,78
Tripura,Dhalai,Hearing Impairment,0,6,2,3,5
Tripura,Dhalai,Hearing Impairment,6,15,78,53,131
Tripura,Dhalai,Hearing Impairment,15,35,217,165,382
Tripura,Dhalai,Hearing Impairment,35,60,273,234,507
Tripura,Dhalai,Hearing Impairment,60,80,194,134,328
Tripura,Dhalai,Hearing Impairment,80,100,57,31,88
Madhya Pradesh,Dewas,Hearing Impairment,0,6,7,9,16
Madhya Pradesh,Dewas,Hearing Impairment,6,15,85,60,145
Madhya Pradesh,Dewas,Hearing Impairment,15,35,244,183,427
Madhya Pradesh,Dewas,Hearing Impairment,35,60,209,120,329
Madhya Pradesh,Dewas,Hearing Impairment,60,80,110,48,158
Madhya Pradesh,Dewas,Hearing Impairment,80,100,19,3,22
Gujarat,Devbhumi Dwarka,Hearing Impairment,0,6,3,11,14
Gujarat,Devbhumi Dwarka,Hearing Impairment,6,15,34,43,77
Gujarat,Devbhumi Dwarka,Hearing Impairment,15,35,108,80,188
Gujarat,Devbhumi Dwarka,Hearing Impairment,35,60,42,33,75
Gujarat,Devbhumi Dwarka,Hearing Impairment,60,80,24,5,29
Gujarat,Devbhumi Dwarka,Hearing Impairment,80,100,1,0,1
Uttar Pradesh,Deoria,Hearing Impairment,0,6,8,9,17
Uttar Pradesh,Deoria,Hearing Impairment,6,15,23,19,42
Uttar Pradesh,Deoria,Hearing Impairment,15,35,163,83,246
Uttar Pradesh,Deoria,Hearing Impairment,35,60,148,56,204
Uttar Pradesh,Deoria,Hearing Impairment,60,80,47,11,58
Uttar Pradesh,Deoria,Hearing Impairment,80,100,9,1,10
Jharkhand,Deoghar,Hearing Impairment,0,6,1,0,1
Jharkhand,Deoghar,Hearing Impairment,6,15,18,15,33
Jharkhand,Deoghar,Hearing Impairment,15,35,133,51,184
Jharkhand,Deoghar,Hearing Impairment,35,60,85,42,127
Jharkhand,Deoghar,Hearing Impairment,60,80,8,10,18
Odisha,Deogarh,Hearing Impairment,0,6,3,3,6
Odisha,Deogarh,Hearing Impairment,6,15,38,35,73
Odisha,Deogarh,Hearing Impairment,15,35,91,78,169
Odisha,Deogarh,Hearing Impairment,35,60,107,74,181
Odisha,Deogarh,Hearing Impairment,60,80,36,19,55
Odisha,Deogarh,Hearing Impairment,80,100,3,0,3
Uttarakhand,Dehradun,Hearing Impairment,0,6,11,10,21
Uttarakhand,Dehradun,Hearing Impairment,6,15,62,40,102
Uttarakhand,Dehradun,Hearing Impairment,15,35,168,92,260
Uttarakhand,Dehradun,Hearing Impairment,35,60,147,82,229
Uttarakhand,Dehradun,Hearing Impairment,60,80,56,20,76
Uttarakhand,Dehradun,Hearing Impairment,80,100,8,1,9
Karnataka,Davangere,Hearing Impairment,0,6,39,33,72
Karnataka,Davangere,Hearing Impairment,6,15,198,162,360
Karnataka,Davangere,Hearing Impairment,15,35,566,474,1040
Karnataka,Davangere,Hearing Impairment,35,60,806,605,1411
Karnataka,Davangere,Hearing Impairment,60,80,395,156,551
Karnataka,Davangere,Hearing Impairment,80,100,53,14,67
Rajasthan,Dausa,Hearing Impairment,0,6,7,7,14
Rajasthan,Dausa,Hearing Impairment,6,15,104,76,180
Rajasthan,Dausa,Hearing Impairment,15,35,381,980,1361
Rajasthan,Dausa,Hearing Impairment,35,60,182,406,588
Rajasthan,Dausa,Hearing Impairment,60,80,29,21,50
Rajasthan,Dausa,Hearing Impairment,80,100,2,4,6
Madhya Pradesh,Datia,Hearing Impairment,0,6,12,4,16
Madhya Pradesh,Datia,Hearing Impairment,6,15,138,74,212
Madhya Pradesh,Datia,Hearing Impairment,15,35,221,166,387
Madhya Pradesh,Datia,Hearing Impairment,35,60,130,77,207
Madhya Pradesh,Datia,Hearing Impairment,60,80,76,23,99
Madhya Pradesh,Datia,Hearing Impairment,80,100,9,4,13
Assam,Darrang,Hearing Impairment,0,6,9,2,11
Assam,Darrang,Hearing Impairment,6,15,70,57,127
Assam,Darrang,Hearing Impairment,15,35,232,223,455
Assam,Darrang,Hearing Impairment,35,60,364,231,595
Assam,Darrang,Hearing Impairment,60,80,91,52,143
Assam,Darrang,Hearing Impairment,80,100,4,1,5
West Bengal,Darjeeling,Hearing Impairment,0,6,2,0,2
West Bengal,Darjeeling,Hearing Impairment,6,15,1,0,1
Bihar,Darbhanga,Hearing Impairment,0,6,2,2,4
Bihar,Darbhanga,Hearing Impairment,6,15,40,48,88
Bihar,Darbhanga,Hearing Impairment,15,35,227,115,342
Bihar,Darbhanga,Hearing Impairment,35,60,89,46,135
Bihar,Darbhanga,Hearing Impairment,60,80,12,4,16
Bihar,Darbhanga,Hearing Impairment,80,100,1,0,1
Chhattisgarh,Dantewada,Hearing Impairment,0,6,2,2,4
Chhattisgarh,Dantewada,Hearing Impairment,6,15,32,18,50
Chhattisgarh,Dantewada,Hearing Impairment,15,35,106,71,177
Chhattisgarh,Dantewada,Hearing Impairment,35,60,86,54,140
Chhattisgarh,Dantewada,Hearing Impairment,60,80,28,16,44
Chhattisgarh,Dantewada,Hearing Impairment,80,100,2,0,2
Gujarat,Dang,Hearing Impairment,6,15,4,6,10
Gujarat,Dang,Hearing Impairment,15,35,10,7,17
Gujarat,Dang,Hearing Impairment,35,60,9,8,17
Gujarat,Dang,Hearing Impairment,60,80,2,2,4
Madhya Pradesh,Damoh,Hearing Impairment,0,6,0,2,2
Madhya Pradesh,Damoh,Hearing Impairment,6,15,32,16,48
Madhya Pradesh,Damoh,Hearing Impairment,15,35,265,128,393
Madhya Pradesh,Damoh,Hearing Impairment,35,60,189,89,278
Madhya Pradesh,Damoh,Hearing Impairment,60,80,69,17,86
Madhya Pradesh,Damoh,Hearing Impairment,80,100,5,4,9
Dadra Nagar Haveli And Daman And Diu,Daman,Hearing Impairment,0,6,3,0,3
Dadra Nagar Haveli And Daman And Diu,Daman,Hearing Impairment,6,15,14,14,28
Dadra Nagar Haveli And Daman And Diu,Daman,Hearing Impairment,15,35,16,13,29
Dadra Nagar Haveli And Daman And Diu,Daman,Hearing Impairment,35,60,11,8,19
Dadra Nagar Haveli And Daman And Diu,Daman,Hearing Impairment,60,80,8,5,13
Dadra Nagar Haveli And Daman And Diu,Daman,Hearing Impairment,80,100,3,4,7
Karnataka,Dakshina Kannada,Hearing Impairment,0,6,15,19,34
Karnataka,Dakshina Kannada,Hearing Impairment,6,15,91,98,189
Karnataka,Dakshina Kannada,Hearing Impairment,15,35,373,297,670
Karnataka,Dakshina Kannada,Hearing Impairment,35,60,555,501,1056
Karnataka,Dakshina Kannada,Hearing Impairment,60,80,238,167,405
Karnataka,Dakshina Kannada,Hearing Impairment,80,100,21,6,27
Dadra Nagar Haveli And Daman And Diu,Dadra And Nagar Haveli,Hearing Impairment,0,6,8,5,13
Dadra Nagar Haveli And Daman And Diu,Dadra And Nagar Haveli,Hearing Impairment,6,15,35,24,59
Dadra Nagar Haveli And Daman And Diu,Dadra And Nagar Haveli,Hearing Impairment,15,35,51,34,85
Dadra Nagar Haveli And Daman And Diu,Dadra And Nagar Haveli,Hearing Impairment,35,60,34,16,50
Dadra Nagar Haveli And Daman And Diu,Dadra And Nagar Haveli,Hearing Impairment,60,80,18,5,23
Dadra Nagar Haveli And Daman And Diu,Dadra And Nagar Haveli,Hearing Impairment,80,100,4,1,5
Odisha,Cuttack,Hearing Impairment,0,6,28,23,51
Odisha,Cuttack,Hearing Impairment,6,15,165,118,283
Odisha,Cuttack,Hearing Impairment,15,35,369,227,596
Odisha,Cuttack,Hearing Impairment,35,60,467,334,801
Odisha,Cuttack,Hearing Impairment,60,80,168,71,239
Odisha,Cuttack,Hearing Impairment,80,100,16,3,19
Tamil Nadu,Cuddalore,Hearing Impairment,0,6,16,28,44
Tamil Nadu,Cuddalore,Hearing Impairment,6,15,210,144,354
Tamil Nadu,Cuddalore,Hearing Impairment,15,35,686,511,1197
Tamil Nadu,Cuddalore,Hearing Impairment,35,60,968,808,1776
Tamil Nadu,Cuddalore,Hearing Impairment,60,80,546,295,841
Tamil Nadu,Cuddalore,Hearing Impairment,80,100,69,20,89
West Bengal,Coochbehar,Hearing Impairment,35,60,2,0,2
Tamil Nadu,Coimbatore,Hearing Impairment,0,6,15,16,31
Tamil Nadu,Coimbatore,Hearing Impairment,6,15,137,124,261
Tamil Nadu,Coimbatore,Hearing Impairment,15,35,469,381,850
Tamil Nadu,Coimbatore,Hearing Impairment,35,60,505,333,838
Tamil Nadu,Coimbatore,Hearing Impairment,60,80,173,64,237
Tamil Nadu,Coimbatore,Hearing Impairment,80,100,13,5,18
Rajasthan,Churu,Hearing Impairment,0,6,11,8,19
Rajasthan,Churu,Hearing Impairment,6,15,88,59,147
Rajasthan,Churu,Hearing Impairment,15,35,186,109,295
Rajasthan,Churu,Hearing Impairment,35,60,96,53,149
Rajasthan,Churu,Hearing Impairment,60,80,20,7,27
Rajasthan,Churu,Hearing Impairment,80,100,0,2,2
Manipur,Churachandpur,Hearing Impairment,0,6,3,4,7
Manipur,Churachandpur,Hearing Impairment,6,15,14,10,24
Manipur,Churachandpur,Hearing Impairment,15,35,18,14,32
Manipur,Churachandpur,Hearing Impairment,35,60,19,21,40
Manipur,Churachandpur,Hearing Impairment,60,80,23,10,33
Manipur,Churachandpur,Hearing Impairment,80,100,9,0,9
Rajasthan,Chittorgarh,Hearing Impairment,0,6,5,4,9
Rajasthan,Chittorgarh,Hearing Impairment,6,15,37,31,68
Rajasthan,Chittorgarh,Hearing Impairment,15,35,143,107,250
Rajasthan,Chittorgarh,Hearing Impairment,35,60,120,85,205
Rajasthan,Chittorgarh,Hearing Impairment,60,80,37,12,49
Rajasthan,Chittorgarh,Hearing Impairment,80,100,7,1,8
Andhra Pradesh,Chittoor,Hearing Impairment,0,6,52,34,86
Andhra Pradesh,Chittoor,Hearing Impairment,6,15,254,247,501
Andhra Pradesh,Chittoor,Hearing Impairment,15,35,1091,735,1826
Andhra Pradesh,Chittoor,Hearing Impairment,35,60,2660,1458,4118
Andhra Pradesh,Chittoor,Hearing Impairment,60,80,2279,1022,3301
Andhra Pradesh,Chittoor,Hearing Impairment,80,100,523,186,709
Uttar Pradesh,Chitrakoot,Hearing Impairment,0,6,8,6,14
Uttar Pradesh,Chitrakoot,Hearing Impairment,6,15,51,25,76
Uttar Pradesh,Chitrakoot,Hearing Impairment,15,35,207,76,283
Uttar Pradesh,Chitrakoot,Hearing Impairment,35,60,184,67,251
Uttar Pradesh,Chitrakoot,Hearing Impairment,60,80,20,5,25
Uttar Pradesh,Chitrakoot,Hearing Impairment,80,100,2,1,3
Karnataka,Chitradurga,Hearing Impairment,0,6,24,23,47
Karnataka,Chitradurga,Hearing Impairment,6,15,249,239,488
Karnataka,Chitradurga,Hearing Impairment,15,35,883,665,1548
Karnataka,Chitradurga,Hearing Impairment,35,60,1446,1373,2819
Karnataka,Chitradurga,Hearing Impairment,60,80,451,179,630
Karnataka,Chitradurga,Hearing Impairment,80,100,39,7,46
Assam,Chirang,Hearing Impairment,0,6,0,1,1
Assam,Chirang,Hearing Impairment,6,15,19,10,29
Assam,Chirang,Hearing Impairment,15,35,62,52,114
Assam,Chirang,Hearing Impairment,35,60,96,87,183
Assam,Chirang,Hearing Impairment,60,80,34,28,62
Assam,Chirang,Hearing Impairment,80,100,1,1,2
Karnataka,Chikkamagaluru,Hearing Impairment,0,6,9,10,19
Karnataka,Chikkamagaluru,Hearing Impairment,6,15,85,66,151
Karnataka,Chikkamagaluru,Hearing Impairment,15,35,170,181,351
Karnataka,Chikkamagaluru,Hearing Impairment,35,60,360,333,693
Karnataka,Chikkamagaluru,Hearing Impairment,60,80,174,90,264
Karnataka,Chikkamagaluru,Hearing Impairment,80,100,12,4,16
Karnataka,Chikkaballapura,Hearing Impairment,0,6,15,28,43
Karnataka,Chikkaballapura,Hearing Impairment,6,15,96,83,179
Karnataka,Chikkaballapura,Hearing Impairment,15,35,339,278,617
Karnataka,Chikkaballapura,Hearing Impairment,35,60,846,796,1642
Karnataka,Chikkaballapura,Hearing Impairment,60,80,346,134,480
Karnataka,Chikkaballapura,Hearing Impairment,80,100,31,4,35
Gujarat,Chhotaudepur,Hearing Impairment,0,6,1,1,2
Gujarat,Chhotaudepur,Hearing Impairment,6,15,30,26,56
Gujarat,Chhotaudepur,Hearing Impairment,15,35,81,52,133
Gujarat,Chhotaudepur,Hearing Impairment,35,60,20,19,39
Gujarat,Chhotaudepur,Hearing Impairment,60,80,8,0,8
Gujarat,Chhotaudepur,Hearing Impairment,80,100,1,0,1
Madhya Pradesh,Chhindwara,Hearing Impairment,0,6,4,1,5
Madhya Pradesh,Chhindwara,Hearing Impairment,6,15,105,80,185
Madhya Pradesh,Chhindwara,Hearing Impairment,15,35,554,368,922
Madhya Pradesh,Chhindwara,Hearing Impairment,35,60,533,337,870
Madhya Pradesh,Chhindwara,Hearing Impairment,60,80,206,73,279
Madhya Pradesh,Chhindwara,Hearing Impairment,80,100,24,1,25
Madhya Pradesh,Chhatarpur,Hearing Impairment,0,6,11,10,21
Madhya Pradesh,Chhatarpur,Hearing Impairment,6,15,143,96,239
Madhya Pradesh,Chhatarpur,Hearing Impairment,15,35,486,289,775
Madhya Pradesh,Chhatarpur,Hearing Impairment,35,60,247,126,373
Madhya Pradesh,Chhatarpur,Hearing Impairment,60,80,131,51,182
Madhya Pradesh,Chhatarpur,Hearing Impairment,80,100,21,4,25
Tamil Nadu,Chennai,Hearing Impairment,0,6,42,48,90
Tamil Nadu,Chennai,Hearing Impairment,6,15,282,235,517
Tamil Nadu,Chennai,Hearing Impairment,15,35,903,646,1549
Tamil Nadu,Chennai,Hearing Impairment,35,60,796,548,1344
Tamil Nadu,Chennai,Hearing Impairment,60,80,252,143,395
Tamil Nadu,Chennai,Hearing Impairment,80,100,11,3,14
Tamil Nadu,Chengalpattu,Hearing Impairment,0,6,17,11,28
Tamil Nadu,Chengalpattu,Hearing Impairment,6,15,70,79,149
Tamil Nadu,Chengalpattu,Hearing Impairment,15,35,180,183,363
Tamil Nadu,Chengalpattu,Hearing Impairment,35,60,370,348,718
Tamil Nadu,Chengalpattu,Hearing Impairment,60,80,303,157,460
Tamil Nadu,Chengalpattu,Hearing Impairment,80,100,27,12,39
Jharkhand,Chatra,Hearing Impairment,0,6,1,0,1
Jharkhand,Chatra,Hearing Impairment,6,15,17,11,28
Jharkhand,Chatra,Hearing Impairment,15,35,17,5,22
Jharkhand,Chatra,Hearing Impairment,35,60,11,5,16
Jharkhand,Chatra,Hearing Impairment,60,80,2,0,2
Haryana,Charki Dadri,Hearing Impairment,0,6,3,0,3
Haryana,Charki Dadri,Hearing Impairment,6,15,13,11,24
Haryana,Charki Dadri,Hearing Impairment,15,35,44,31,75
Haryana,Charki Dadri,Hearing Impairment,35,60,27,7,34
Haryana,Charki Dadri,Hearing Impairment,60,80,5,1,6
Assam,Charaideo,Hearing Impairment,0,6,2,0,2
Assam,Charaideo,Hearing Impairment,6,15,27,23,50
Assam,Charaideo,Hearing Impairment,15,35,62,44,106
Assam,Charaideo,Hearing Impairment,35,60,69,57,126
Assam,Charaideo,Hearing Impairment,60,80,15,11,26
Assam,Charaideo,Hearing Impairment,80,100,2,0,2
Arunachal Pradesh,Changlang,Hearing Impairment,6,15,0,2,2
Arunachal Pradesh,Changlang,Hearing Impairment,15,35,4,4,8
Arunachal Pradesh,Changlang,Hearing Impairment,35,60,4,3,7
Arunachal Pradesh,Changlang,Hearing Impairment,60,80,1,0,1
Arunachal Pradesh,Changlang,Hearing Impairment,80,100,0,1,1
Maharashtra,Chandrapur,Hearing Impairment,0,6,39,40,79
Maharashtra,Chandrapur,Hearing Impairment,6,15,235,188,423
Maharashtra,Chandrapur,Hearing Impairment,15,35,710,428,1138
Maharashtra,Chandrapur,Hearing Impairment,35,60,565,197,762
Maharashtra,Chandrapur,Hearing Impairment,60,80,129,19,148
Maharashtra,Chandrapur,Hearing Impairment,80,100,4,0,4
Chandigarh,Chandigarh,Hearing Impairment,0,6,13,12,25
Chandigarh,Chandigarh,Hearing Impairment,6,15,61,70,131
Chandigarh,Chandigarh,Hearing Impairment,15,35,172,136,308
Chandigarh,Chandigarh,Hearing Impairment,35,60,116,72,188
Chandigarh,Chandigarh,Hearing Impairment,60,80,45,17,62
Chandigarh,Chandigarh,Hearing Impairment,80,100,23,5,28
Manipur,Chandel,Hearing Impairment,6,15,1,3,4
Manipur,Chandel,Hearing Impairment,15,35,4,4,8
Manipur,Chandel,Hearing Impairment,35,60,10,15,25
Manipur,Chandel,Hearing Impairment,60,80,13,5,18
Manipur,Chandel,Hearing Impairment,80,100,1,1,2
Uttar Pradesh,Chandauli,Hearing Impairment,0,6,13,6,19
Uttar Pradesh,Chandauli,Hearing Impairment,6,15,40,35,75
Uttar Pradesh,Chandauli,Hearing Impairment,15,35,175,97,272
Uttar Pradesh,Chandauli,Hearing Impairment,35,60,68,23,91
Uttar Pradesh,Chandauli,Hearing Impairment,60,80,10,6,16
Mizoram,Champhai,Hearing Impairment,0,6,1,1,2
Mizoram,Champhai,Hearing Impairment,6,15,8,7,15
Mizoram,Champhai,Hearing Impairment,15,35,10,14,24
Mizoram,Champhai,Hearing Impairment,35,60,34,26,60
Mizoram,Champhai,Hearing Impairment,60,80,40,41,81
Mizoram,Champhai,Hearing Impairment,80,100,21,5,26
Uttarakhand,Champawat,Hearing Impairment,6,15,6,4,10
Uttarakhand,Champawat,Hearing Impairment,15,35,43,30,73
Uttarakhand,Champawat,Hearing Impairment,35,60,78,33,111
Uttarakhand,Champawat,Hearing Impairment,60,80,18,8,26
Uttarakhand,Chamoli,Hearing Impairment,0,6,4,1,5
Uttarakhand,Chamoli,Hearing Impairment,6,15,7,2,9
Uttarakhand,Chamoli,Hearing Impairment,15,35,37,15,52
Uttarakhand,Chamoli,Hearing Impairment,35,60,71,17,88
Uttarakhand,Chamoli,Hearing Impairment,60,80,17,4,21
Uttarakhand,Chamoli,Hearing Impairment,80,100,1,2,3
Himachal Pradesh,Chamba,Hearing Impairment,0,6,7,6,13
Himachal Pradesh,Chamba,Hearing Impairment,6,15,45,31,76
Himachal Pradesh,Chamba,Hearing Impairment,15,35,174,96,270
Himachal Pradesh,Chamba,Hearing Impairment,35,60,174,77,251
Himachal Pradesh,Chamba,Hearing Impairment,60,80,28,10,38
Himachal Pradesh,Chamba,Hearing Impairment,80,100,1,2,3
Karnataka,Chamarajanagara,Hearing Impairment,0,6,18,11,29
Karnataka,Chamarajanagara,Hearing Impairment,6,15,65,43,108
Karnataka,Chamarajanagara,Hearing Impairment,15,35,199,146,345
Karnataka,Chamarajanagara,Hearing Impairment,35,60,186,117,303
Karnataka,Chamarajanagara,Hearing Impairment,60,80,42,14,56
Delhi,Central,Hearing Impairment,0,6,13,5,18
Delhi,Central,Hearing Impairment,6,15,37,46,83
Delhi,Central,Hearing Impairment,15,35,87,51,138
Delhi,Central,Hearing Impairment,35,60,64,27,91
Delhi,Central,Hearing Impairment,60,80,15,5,20
Delhi,Central,Hearing Impairment,80,100,1,0,1
Assam,Cachar,Hearing Impairment,0,6,24,26,50
Assam,Cachar,Hearing Impairment,6,15,83,86,169
Assam,Cachar,Hearing Impairment,15,35,232,181,413
Assam,Cachar,Hearing Impairment,35,60,197,128,325
Assam,Cachar,Hearing Impairment,60,80,39,27,66
Assam,Cachar,Hearing Impairment,80,100,1,1,2
Bihar,Buxar,Hearing Impairment,0,6,4,9,13
Bihar,Buxar,Hearing Impairment,6,15,100,93,193
Bihar,Buxar,Hearing Impairment,15,35,153,88,241
Bihar,Buxar,Hearing Impairment,35,60,85,55,140
Bihar,Buxar,Hearing Impairment,60,80,25,7,32
Bihar,Buxar,Hearing Impairment,80,100,3,1,4
Madhya Pradesh,Burhanpur,Hearing Impairment,0,6,5,2,7
Madhya Pradesh,Burhanpur,Hearing Impairment,6,15,43,24,67
Madhya Pradesh,Burhanpur,Hearing Impairment,15,35,170,120,290
Madhya Pradesh,Burhanpur,Hearing Impairment,35,60,73,53,126
Madhya Pradesh,Burhanpur,Hearing Impairment,60,80,24,11,35
Madhya Pradesh,Burhanpur,Hearing Impairment,80,100,4,3,7
Rajasthan,Bundi,Hearing Impairment,0,6,9,9,18
Rajasthan,Bundi,Hearing Impairment,6,15,53,49,102
Rajasthan,Bundi,Hearing Impairment,15,35,154,110,264
Rajasthan,Bundi,Hearing Impairment,35,60,78,57,135
Rajasthan,Bundi,Hearing Impairment,60,80,16,10,26
Rajasthan,Bundi,Hearing Impairment,80,100,0,1,1
Maharashtra,Buldhana,Hearing Impairment,0,6,76,51,127
Maharashtra,Buldhana,Hearing Impairment,6,15,420,252,672
Maharashtra,Buldhana,Hearing Impairment,15,35,1518,679,2197
Maharashtra,Buldhana,Hearing Impairment,35,60,1213,458,1671
Maharashtra,Buldhana,Hearing Impairment,60,80,466,118,584
Maharashtra,Buldhana,Hearing Impairment,80,100,70,6,76
Uttar Pradesh,Bulandshahr,Hearing Impairment,0,6,19,20,39
Uttar Pradesh,Bulandshahr,Hearing Impairment,6,15,128,111,239
Uttar Pradesh,Bulandshahr,Hearing Impairment,15,35,237,124,361
Uttar Pradesh,Bulandshahr,Hearing Impairment,35,60,136,80,216
Uttar Pradesh,Bulandshahr,Hearing Impairment,60,80,29,10,39
Jammu And Kashmir,Budgam,Hearing Impairment,0,6,7,2,9
Jammu And Kashmir,Budgam,Hearing Impairment,6,15,45,60,105
Jammu And Kashmir,Budgam,Hearing Impairment,15,35,186,175,361
Jammu And Kashmir,Budgam,Hearing Impairment,35,60,192,150,342
Jammu And Kashmir,Budgam,Hearing Impairment,60,80,108,52,160
Jammu And Kashmir,Budgam,Hearing Impairment,80,100,20,6,26
Uttar Pradesh,Budaun,Hearing Impairment,0,6,12,7,19
Uttar Pradesh,Budaun,Hearing Impairment,6,15,58,60,118
Uttar Pradesh,Budaun,Hearing Impairment,15,35,326,168,494
Uttar Pradesh,Budaun,Hearing Impairment,35,60,199,80,279
Uttar Pradesh,Budaun,Hearing Impairment,60,80,39,4,43
Uttar Pradesh,Budaun,Hearing Impairment,80,100,3,1,4
Odisha,Boudh,Hearing Impairment,0,6,6,3,9
Odisha,Boudh,Hearing Impairment,6,15,72,60,132
Odisha,Boudh,Hearing Impairment,15,35,146,109,255
Odisha,Boudh,Hearing Impairment,35,60,153,94,247
Odisha,Boudh,Hearing Impairment,60,80,60,27,87
Odisha,Boudh,Hearing Impairment,80,100,6,5,11
Gujarat,Botad,Hearing Impairment,0,6,4,0,4
Gujarat,Botad,Hearing Impairment,6,15,12,8,20
Gujarat,Botad,Hearing Impairment,15,35,35,14,49
Gujarat,Botad,Hearing Impairment,35,60,18,6,24
Gujarat,Botad,Hearing Impairment,60,80,24,6,30
Gujarat,Botad,Hearing Impairment,80,100,4,0,4
Assam,Bongaigaon,Hearing Impairment,0,6,3,3,6
Assam,Bongaigaon,Hearing Impairment,6,15,41,32,73
Assam,Bongaigaon,Hearing Impairment,15,35,131,83,214
Assam,Bongaigaon,Hearing Impairment,35,60,79,55,134
Assam,Bongaigaon,Hearing Impairment,60,80,21,7,28
Assam,Bongaigaon,Hearing Impairment,80,100,3,0,3
Jharkhand,Bokaro,Hearing Impairment,0,6,9,2,11
Jharkhand,Bokaro,Hearing Impairment,6,15,63,43,106
Jharkhand,Bokaro,Hearing Impairment,15,35,296,204,500
Jharkhand,Bokaro,Hearing Impairment,35,60,301,152,453
Jharkhand,Bokaro,Hearing Impairment,60,80,71,16,87
Jharkhand,Bokaro,Hearing Impairment,80,100,4,1,5
Assam,Biswanath,Hearing Impairment,0,6,3,4,7
Assam,Biswanath,Hearing Impairment,6,15,14,16,30
Assam,Biswanath,Hearing Impairment,15,35,36,22,58
Assam,Biswanath,Hearing Impairment,35,60,39,28,67
Assam,Biswanath,Hearing Impairment,60,80,6,4,10
Manipur,Bishnupur,Hearing Impairment,0,6,1,2,3
Manipur,Bishnupur,Hearing Impairment,6,15,7,6,13
Manipur,Bishnupur,Hearing Impairment,15,35,12,14,26
Manipur,Bishnupur,Hearing Impairment,35,60,27,20,47
Manipur,Bishnupur,Hearing Impairment,60,80,27,9,36
Manipur,Bishnupur,Hearing Impairment,80,100,7,0,7
West Bengal,Birbhum,Hearing Impairment,35,60,0,1,1
Chhattisgarh,Bilaspur,Hearing Impairment,0,6,12,19,31
Chhattisgarh,Bilaspur,Hearing Impairment,6,15,199,171,370
Chhattisgarh,Bilaspur,Hearing Impairment,15,35,678,456,1134
Chhattisgarh,Bilaspur,Hearing Impairment,35,60,477,282,759
Chhattisgarh,Bilaspur,Hearing Impairment,60,80,371,192,563
Chhattisgarh,Bilaspur,Hearing Impairment,80,100,75,33,108
Himachal Pradesh,Bilaspur,Hearing Impairment,0,6,4,7,11
Himachal Pradesh,Bilaspur,Hearing Impairment,6,15,23,14,37
Himachal Pradesh,Bilaspur,Hearing Impairment,15,35,48,34,82
Himachal Pradesh,Bilaspur,Hearing Impairment,35,60,46,43,89
Himachal Pradesh,Bilaspur,Hearing Impairment,60,80,33,3,36
Himachal Pradesh,Bilaspur,Hearing Impairment,80,100,9,2,11
Rajasthan,Bikaner,Hearing Impairment,0,6,25,16,41
Rajasthan,Bikaner,Hearing Impairment,6,15,71,64,135
Rajasthan,Bikaner,Hearing Impairment,15,35,228,103,331
Rajasthan,Bikaner,Hearing Impairment,35,60,92,63,155
Rajasthan,Bikaner,Hearing Impairment,60,80,19,5,24
Rajasthan,Bikaner,Hearing Impairment,80,100,2,1,3
Uttar Pradesh,Bijnor,Hearing Impairment,0,6,20,13,33
Uttar Pradesh,Bijnor,Hearing Impairment,6,15,68,56,124
Uttar Pradesh,Bijnor,Hearing Impairment,15,35,235,125,360
Uttar Pradesh,Bijnor,Hearing Impairment,35,60,125,52,177
Uttar Pradesh,Bijnor,Hearing Impairment,60,80,22,7,29
Uttar Pradesh,Bijnor,Hearing Impairment,80,100,1,1,2
Chhattisgarh,Bijapur,Hearing Impairment,0,6,1,1,2
Chhattisgarh,Bijapur,Hearing Impairment,6,15,8,14,22
Chhattisgarh,Bijapur,Hearing Impairment,15,35,36,48,84
Chhattisgarh,Bijapur,Hearing Impairment,35,60,34,34,68
Chhattisgarh,Bijapur,Hearing Impairment,60,80,11,19,30
Chhattisgarh,Bijapur,Hearing Impairment,80,100,2,0,2
Karnataka,Bidar,Hearing Impairment,0,6,30,28,58
Karnataka,Bidar,Hearing Impairment,6,15,86,75,161
Karnataka,Bidar,Hearing Impairment,15,35,182,150,332
Karnataka,Bidar,Hearing Impairment,35,60,174,95,269
Karnataka,Bidar,Hearing Impairment,60,80,30,12,42
Madhya Pradesh,Bhopal,Hearing Impairment,0,6,13,5,18
Madhya Pradesh,Bhopal,Hearing Impairment,6,15,107,78,185
Madhya Pradesh,Bhopal,Hearing Impairment,15,35,453,242,695
Madhya Pradesh,Bhopal,Hearing Impairment,35,60,226,106,332
Madhya Pradesh,Bhopal,Hearing Impairment,60,80,42,19,61
Madhya Pradesh,Bhopal,Hearing Impairment,80,100,2,0,2
Bihar,Bhojpur,Hearing Impairment,0,6,8,8,16
Bihar,Bhojpur,Hearing Impairment,6,15,109,100,209
Bihar,Bhojpur,Hearing Impairment,15,35,311,124,435
Bihar,Bhojpur,Hearing Impairment,35,60,116,45,161
Bihar,Bhojpur,Hearing Impairment,60,80,11,5,16
Bihar,Bhojpur,Hearing Impairment,80,100,1,0,1
Haryana,Bhiwani,Hearing Impairment,0,6,3,1,4
Haryana,Bhiwani,Hearing Impairment,6,15,33,36,69
Haryana,Bhiwani,Hearing Impairment,15,35,95,54,149
Haryana,Bhiwani,Hearing Impairment,35,60,60,37,97
Haryana,Bhiwani,Hearing Impairment,60,80,12,5,17
Madhya Pradesh,Bhind,Hearing Impairment,0,6,8,2,10
Madhya Pradesh,Bhind,Hearing Impairment,6,15,86,54,140
Madhya Pradesh,Bhind,Hearing Impairment,15,35,408,177,585
Madhya Pradesh,Bhind,Hearing Impairment,35,60,254,100,354
Madhya Pradesh,Bhind,Hearing Impairment,60,80,55,17,72
Madhya Pradesh,Bhind,Hearing Impairment,80,100,5,1,6
Rajasthan,Bhilwara,Hearing Impairment,0,6,14,18,32
Rajasthan,Bhilwara,Hearing Impairment,6,15,109,83,192
Rajasthan,Bhilwara,Hearing Impairment,15,35,231,180,411
Rajasthan,Bhilwara,Hearing Impairment,35,60,175,138,313
Rajasthan,Bhilwara,Hearing Impairment,60,80,46,45,91
Rajasthan,Bhilwara,Hearing Impairment,80,100,3,4,7
Gujarat,Bhavnagar,Hearing Impairment,0,6,26,15,41
Gujarat,Bhavnagar,Hearing Impairment,6,15,184,161,345
Gujarat,Bhavnagar,Hearing Impairment,15,35,283,206,489
Gujarat,Bhavnagar,Hearing Impairment,35,60,139,76,215
Gujarat,Bhavnagar,Hearing Impairment,60,80,21,11,32
Gujarat,Bhavnagar,Hearing Impairment,80,100,0,1,1
Gujarat,Bharuch,Hearing Impairment,0,6,9,10,19
Gujarat,Bharuch,Hearing Impairment,6,15,55,56,111
Gujarat,Bharuch,Hearing Impairment,15,35,118,72,190
Gujarat,Bharuch,Hearing Impairment,35,60,65,43,108
Gujarat,Bharuch,Hearing Impairment,60,80,161,32,193
Gujarat,Bharuch,Hearing Impairment,80,100,55,7,62
Rajasthan,Bharatpur,Hearing Impairment,0,6,13,13,26
Rajasthan,Bharatpur,Hearing Impairment,6,15,104,62,166
Rajasthan,Bharatpur,Hearing Impairment,15,35,498,224,722
Rajasthan,Bharatpur,Hearing Impairment,35,60,177,95,272
Rajasthan,Bharatpur,Hearing Impairment,60,80,31,17,48
Rajasthan,Bharatpur,Hearing Impairment,80,100,0,1,1
Maharashtra,Bhandara,Hearing Impairment,0,6,27,25,52
Maharashtra,Bhandara,Hearing Impairment,6,15,186,137,323
Maharashtra,Bhandara,Hearing Impairment,15,35,650,364,1014
Maharashtra,Bhandara,Hearing Impairment,35,60,651,261,912
Maharashtra,Bhandara,Hearing Impairment,60,80,140,64,204
Maharashtra,Bhandara,Hearing Impairment,80,100,1,1,2
Bihar,Bhagalpur,Hearing Impairment,0,6,17,6,23
Bihar,Bhagalpur,Hearing Impairment,6,15,128,133,261
Bihar,Bhagalpur,Hearing Impairment,15,35,263,125,388
Bihar,Bhagalpur,Hearing Impairment,35,60,131,73,204
Bihar,Bhagalpur,Hearing Impairment,60,80,9,7,16
Bihar,Bhagalpur,Hearing Impairment,80,100,1,0,1
Odisha,Bhadrak,Hearing Impairment,0,6,11,9,20
Odisha,Bhadrak,Hearing Impairment,6,15,84,71,155
Odisha,Bhadrak,Hearing Impairment,15,35,300,202,502
Odisha,Bhadrak,Hearing Impairment,35,60,360,252,612
Odisha,Bhadrak,Hearing Impairment,60,80,147,51,198
Odisha,Bhadrak,Hearing Impairment,80,100,18,2,20
Telangana,Bhadradri Kothagudem,Hearing Impairment,0,6,1,0,1
Telangana,Bhadradri Kothagudem,Hearing Impairment,6,15,77,60,137
Telangana,Bhadradri Kothagudem,Hearing Impairment,15,35,294,270,564
Telangana,Bhadradri Kothagudem,Hearing Impairment,35,60,254,217,471
Telangana,Bhadradri Kothagudem,Hearing Impairment,60,80,67,71,138
Telangana,Bhadradri Kothagudem,Hearing Impairment,80,100,9,5,14
Uttar Pradesh,Bhadohi,Hearing Impairment,0,6,2,4,6
Uttar Pradesh,Bhadohi,Hearing Impairment,6,15,35,27,62
Uttar Pradesh,Bhadohi,Hearing Impairment,15,35,124,59,183
Uttar Pradesh,Bhadohi,Hearing Impairment,35,60,37,33,70
Uttar Pradesh,Bhadohi,Hearing Impairment,60,80,9,3,12
Uttar Pradesh,Bhadohi,Hearing Impairment,80,100,1,0,1
Madhya Pradesh,Betul,Hearing Impairment,0,6,9,4,13
Madhya Pradesh,Betul,Hearing Impairment,6,15,98,74,172
Madhya Pradesh,Betul,Hearing Impairment,15,35,385,304,689
Madhya Pradesh,Betul,Hearing Impairment,35,60,389,163,552
Madhya Pradesh,Betul,Hearing Impairment,60,80,125,56,181
Madhya Pradesh,Betul,Hearing Impairment,80,100,29,9,38
Karnataka,Bengaluru Urban,Hearing Impairment,0,6,83,69,152
Karnataka,Bengaluru Urban,Hearing Impairment,6,15,364,285,649
Karnataka,Bengaluru Urban,Hearing Impairment,15,35,934,687,1621
Karnataka,Bengaluru Urban,Hearing Impairment,35,60,1045,656,1701
Karnataka,Bengaluru Urban,Hearing Impairment,60,80,335,106,441
Karnataka,Bengaluru Urban,Hearing Impairment,80,100,35,4,39
Karnataka,Bengaluru Rural,Hearing Impairment,0,6,17,19,36
Karnataka,Bengaluru Rural,Hearing Impairment,6,15,71,70,141
Karnataka,Bengaluru Rural,Hearing Impairment,15,35,252,212,464
Karnataka,Bengaluru Rural,Hearing Impairment,35,60,372,288,660
Karnataka,Bengaluru Rural,Hearing Impairment,60,80,311,122,433
Karnataka,Bengaluru Rural,Hearing Impairment,80,100,80,18,98
Chhattisgarh,Bemetara,Hearing Impairment,0,6,5,8,13
Chhattisgarh,Bemetara,Hearing Impairment,6,15,54,55,109
Chhattisgarh,Bemetara,Hearing Impairment,15,35,83,52,135
Chhattisgarh,Bemetara,Hearing Impairment,35,60,30,9,39
Chhattisgarh,Bemetara,Hearing Impairment,60,80,22,5,27
Chhattisgarh,Bemetara,Hearing Impairment,80,100,2,1,3
Karnataka,Belagavi,Hearing Impairment,0,6,87,58,145
Karnataka,Belagavi,Hearing Impairment,6,15,600,526,1126
Karnataka,Belagavi,Hearing Impairment,15,35,1271,1053,2324
Karnataka,Belagavi,Hearing Impairment,35,60,1601,1408,3009
Karnataka,Belagavi,Hearing Impairment,60,80,357,128,485
Karnataka,Belagavi,Hearing Impairment,80,100,18,3,21
Bihar,Begusarai,Hearing Impairment,0,6,33,19,52
Bihar,Begusarai,Hearing Impairment,6,15,158,138,296
Bihar,Begusarai,Hearing Impairment,15,35,155,64,219
Bihar,Begusarai,Hearing Impairment,35,60,68,52,120
Bihar,Begusarai,Hearing Impairment,60,80,10,4,14
Bihar,Begusarai,Hearing Impairment,80,100,1,0,1
Maharashtra,Beed,Hearing Impairment,0,6,72,73,145
Maharashtra,Beed,Hearing Impairment,6,15,380,245,625
Maharashtra,Beed,Hearing Impairment,15,35,997,473,1470
Maharashtra,Beed,Hearing Impairment,35,60,627,273,900
Maharashtra,Beed,Hearing Impairment,60,80,195,80,275
Maharashtra,Beed,Hearing Impairment,80,100,23,5,28
Punjab,Bathinda,Hearing Impairment,0,6,17,17,34
Punjab,Bathinda,Hearing Impairment,6,15,119,99,218
Punjab,Bathinda,Hearing Impairment,15,35,280,165,445
Punjab,Bathinda,Hearing Impairment,35,60,147,108,255
Punjab,Bathinda,Hearing Impairment,60,80,35,15,50
Punjab,Bathinda,Hearing Impairment,80,100,2,3,5
Uttar Pradesh,Basti,Hearing Impairment,0,6,13,18,31
Uttar Pradesh,Basti,Hearing Impairment,6,15,80,78,158
Uttar Pradesh,Basti,Hearing Impairment,15,35,223,127,350
Uttar Pradesh,Basti,Hearing Impairment,35,60,104,61,165
Uttar Pradesh,Basti,Hearing Impairment,60,80,14,7,21
Uttar Pradesh,Basti,Hearing Impairment,80,100,3,1,4
Chhattisgarh,Bastar,Hearing Impairment,0,6,3,4,7
Chhattisgarh,Bastar,Hearing Impairment,6,15,68,48,116
Chhattisgarh,Bastar,Hearing Impairment,15,35,138,121,259
Chhattisgarh,Bastar,Hearing Impairment,35,60,85,62,147
Chhattisgarh,Bastar,Hearing Impairment,60,80,43,25,68
Chhattisgarh,Bastar,Hearing Impairment,80,100,5,4,9
Madhya Pradesh,Barwani,Hearing Impairment,0,6,14,10,24
Madhya Pradesh,Barwani,Hearing Impairment,6,15,71,51,122
Madhya Pradesh,Barwani,Hearing Impairment,15,35,112,103,215
Madhya Pradesh,Barwani,Hearing Impairment,35,60,83,54,137
Madhya Pradesh,Barwani,Hearing Impairment,60,80,25,5,30
Madhya Pradesh,Barwani,Hearing Impairment,80,100,0,1,1
Assam,Barpeta,Hearing Impairment,0,6,20,20,40
Assam,Barpeta,Hearing Impairment,6,15,152,157,309
Assam,Barpeta,Hearing Impairment,15,35,412,343,755
Assam,Barpeta,Hearing Impairment,35,60,435,250,685
Assam,Barpeta,Hearing Impairment,60,80,120,50,170
Assam,Barpeta,Hearing Impairment,80,100,8,3,11
Punjab,Barnala,Hearing Impairment,0,6,5,5,10
Punjab,Barnala,Hearing Impairment,6,15,42,35,77
Punjab,Barnala,Hearing Impairment,15,35,104,63,167
Punjab,Barnala,Hearing Impairment,35,60,61,40,101
Punjab,Barnala,Hearing Impairment,60,80,10,7,17
Punjab,Barnala,Hearing Impairment,80,100,1,0,1
Rajasthan,Barmer,Hearing Impairment,0,6,10,9,19
Rajasthan,Barmer,Hearing Impairment,6,15,134,97,231
Rajasthan,Barmer,Hearing Impairment,15,35,217,112,329
Rajasthan,Barmer,Hearing Impairment,35,60,133,62,195
Rajasthan,Barmer,Hearing Impairment,60,80,33,17,50
Odisha,Bargarh,Hearing Impairment,0,6,33,24,57
Odisha,Bargarh,Hearing Impairment,6,15,258,222,480
Odisha,Bargarh,Hearing Impairment,15,35,499,424,923
Odisha,Bargarh,Hearing Impairment,35,60,573,359,932
Odisha,Bargarh,Hearing Impairment,60,80,235,103,338
Odisha,Bargarh,Hearing Impairment,80,100,27,9,36
Uttar Pradesh,Bareilly,Hearing Impairment,0,6,17,16,33
Uttar Pradesh,Bareilly,Hearing Impairment,6,15,132,95,227
Uttar Pradesh,Bareilly,Hearing Impairment,15,35,716,367,1083
Uttar Pradesh,Bareilly,Hearing Impairment,35,60,382,170,552
Uttar Pradesh,Bareilly,Hearing Impairment,60,80,53,14,67
Uttar Pradesh,Bareilly,Hearing Impairment,80,100,4,1,5
Rajasthan,Baran,Hearing Impairment,0,6,4,7,11
Rajasthan,Baran,Hearing Impairment,6,15,31,21,52
Rajasthan,Baran,Hearing Impairment,15,35,105,75,180
Rajasthan,Baran,Hearing Impairment,35,60,79,34,113
Rajasthan,Baran,Hearing Impairment,60,80,14,8,22
Jammu And Kashmir,Baramulla,Hearing Impairment,0,6,18,17,35
Jammu And Kashmir,Baramulla,Hearing Impairment,6,15,92,110,202
Jammu And Kashmir,Baramulla,Hearing Impairment,15,35,269,230,499
Jammu And Kashmir,Baramulla,Hearing Impairment,35,60,244,164,408
Jammu And Kashmir,Baramulla,Hearing Impairment,60,80,80,57,137
Jammu And Kashmir,Baramulla,Hearing Impairment,80,100,5,9,14
Uttar Pradesh,Barabanki,Hearing Impairment,0,6,11,16,27
Uttar Pradesh,Barabanki,Hearing Impairment,6,15,84,89,173
Uttar Pradesh,Barabanki,Hearing Impairment,15,35,372,160,532
Uttar Pradesh,Barabanki,Hearing Impairment,35,60,253,101,354
Uttar Pradesh,Barabanki,Hearing Impairment,60,80,77,15,92
Uttar Pradesh,Barabanki,Hearing Impairment,80,100,9,0,9
Rajasthan,Banswara,Hearing Impairment,0,6,3,0,3
Rajasthan,Banswara,Hearing Impairment,6,15,36,30,66
Rajasthan,Banswara,Hearing Impairment,15,35,128,116,244
Rajasthan,Banswara,Hearing Impairment,35,60,83,73,156
Rajasthan,Banswara,Hearing Impairment,60,80,19,15,34
Rajasthan,Banswara,Hearing Impairment,80,100,2,2,4
Bihar,Banka,Hearing Impairment,0,6,0,2,2
Bihar,Banka,Hearing Impairment,6,15,79,88,167
Bihar,Banka,Hearing Impairment,15,35,110,67,177
Bihar,Banka,Hearing Impairment,35,60,62,26,88
Bihar,Banka,Hearing Impairment,60,80,14,6,20
Bihar,Banka,Hearing Impairment,80,100,1,0,1
Jammu And Kashmir,Bandipora,Hearing Impairment,0,6,0,3,3
Jammu And Kashmir,Bandipora,Hearing Impairment,6,15,20,9,29
Jammu And Kashmir,Bandipora,Hearing Impairment,15,35,88,62,150
Jammu And Kashmir,Bandipora,Hearing Impairment,35,60,76,53,129
Jammu And Kashmir,Bandipora,Hearing Impairment,60,80,39,16,55
Jammu And Kashmir,Bandipora,Hearing Impairment,80,100,8,2,10
Uttar Pradesh,Banda,Hearing Impairment,0,6,7,4,11
Uttar Pradesh,Banda,Hearing Impairment,6,15,44,49,93
Uttar Pradesh,Banda,Hearing Impairment,15,35,121,74,195
Uttar Pradesh,Banda,Hearing Impairment,35,60,104,38,142
Uttar Pradesh,Banda,Hearing Impairment,60,80,26,7,33
Uttar Pradesh,Banda,Hearing Impairment,80,100,3,0,3
Gujarat,Banas Kantha,Hearing Impairment,0,6,14,6,20
Gujarat,Banas Kantha,Hearing Impairment,6,15,69,49,118
Gujarat,Banas Kantha,Hearing Impairment,15,35,314,145,459
Gujarat,Banas Kantha,Hearing Impairment,35,60,89,48,137
Gujarat,Banas Kantha,Hearing Impairment,60,80,21,11,32
Gujarat,Banas Kantha,Hearing Impairment,80,100,1,1,2
Chhattisgarh,Balrampur,Hearing Impairment,0,6,1,0,1
Chhattisgarh,Balrampur,Hearing Impairment,6,15,7,5,12
Chhattisgarh,Balrampur,Hearing Impairment,15,35,19,22,41
Chhattisgarh,Balrampur,Hearing Impairment,35,60,22,6,28
Chhattisgarh,Balrampur,Hearing Impairment,60,80,7,8,15
Chhattisgarh,Balrampur,Hearing Impairment,80,100,0,1,1
Uttar Pradesh,Balrampur,Hearing Impairment,0,6,21,13,34
Uttar Pradesh,Balrampur,Hearing Impairment,6,15,110,82,192
Uttar Pradesh,Balrampur,Hearing Impairment,15,35,146,96,242
Uttar Pradesh,Balrampur,Hearing Impairment,35,60,74,36,110
Uttar Pradesh,Balrampur,Hearing Impairment,60,80,10,4,14
Chhattisgarh,Baloda Bazar,Hearing Impairment,0,6,3,3,6
Chhattisgarh,Baloda Bazar,Hearing Impairment,6,15,52,30,82
Chhattisgarh,Baloda Bazar,Hearing Impairment,15,35,156,114,270
Chhattisgarh,Baloda Bazar,Hearing Impairment,35,60,115,60,175
Chhattisgarh,Baloda Bazar,Hearing Impairment,60,80,55,24,79
Chhattisgarh,Baloda Bazar,Hearing Impairment,80,100,12,1,13
Chhattisgarh,Balod,Hearing Impairment,0,6,2,2,4
Chhattisgarh,Balod,Hearing Impairment,6,15,48,37,85
Chhattisgarh,Balod,Hearing Impairment,15,35,79,66,145
Chhattisgarh,Balod,Hearing Impairment,35,60,46,26,72
Chhattisgarh,Balod,Hearing Impairment,60,80,21,2,23
Chhattisgarh,Balod,Hearing Impairment,80,100,5,2,7
Uttar Pradesh,Ballia,Hearing Impairment,0,6,5,7,12
Uttar Pradesh,Ballia,Hearing Impairment,6,15,42,32,74
Uttar Pradesh,Ballia,Hearing Impairment,15,35,191,83,274
Uttar Pradesh,Ballia,Hearing Impairment,35,60,153,64,217
Uttar Pradesh,Ballia,Hearing Impairment,60,80,54,14,68
Uttar Pradesh,Ballia,Hearing Impairment,80,100,1,0,1
Karnataka,Ballari,Hearing Impairment,0,6,47,31,78
Karnataka,Ballari,Hearing Impairment,6,15,277,204,481
Karnataka,Ballari,Hearing Impairment,15,35,762,588,1350
Karnataka,Ballari,Hearing Impairment,35,60,889,810,1699
Karnataka,Ballari,Hearing Impairment,60,80,199,84,283
Karnataka,Ballari,Hearing Impairment,80,100,13,1,14
Odisha,Baleshwar,Hearing Impairment,0,6,27,22,49
Odisha,Baleshwar,Hearing Impairment,6,15,285,239,524
Odisha,Baleshwar,Hearing Impairment,15,35,1184,999,2183
Odisha,Baleshwar,Hearing Impairment,35,60,1743,1418,3161
Odisha,Baleshwar,Hearing Impairment,60,80,608,314,922
Odisha,Baleshwar,Hearing Impairment,80,100,66,12,78
Odisha,Balangir,Hearing Impairment,0,6,34,34,68
Odisha,Balangir,Hearing Impairment,6,15,301,195,496
Odisha,Balangir,Hearing Impairment,15,35,554,364,918
Odisha,Balangir,Hearing Impairment,35,60,732,440,1172
Odisha,Balangir,Hearing Impairment,60,80,347,138,485
Odisha,Balangir,Hearing Impairment,80,100,31,7,38
Madhya Pradesh,Balaghat,Hearing Impairment,0,6,18,10,28
Madhya Pradesh,Balaghat,Hearing Impairment,6,15,130,121,251
Madhya Pradesh,Balaghat,Hearing Impairment,15,35,389,323,712
Madhya Pradesh,Balaghat,Hearing Impairment,35,60,307,160,467
Madhya Pradesh,Balaghat,Hearing Impairment,60,80,65,24,89
Madhya Pradesh,Balaghat,Hearing Impairment,80,100,3,1,4
Assam,Baksa,Hearing Impairment,0,6,21,16,37
Assam,Baksa,Hearing Impairment,6,15,100,88,188
Assam,Baksa,Hearing Impairment,15,35,271,217,488
Assam,Baksa,Hearing Impairment,35,60,400,309,709
Assam,Baksa,Hearing Impairment,60,80,103,61,164
Assam,Baksa,Hearing Impairment,80,100,7,3,10
Assam,Bajali,Hearing Impairment,0,6,2,0,2
Assam,Bajali,Hearing Impairment,6,15,8,3,11
Assam,Bajali,Hearing Impairment,15,35,5,6,11
Assam,Bajali,Hearing Impairment,35,60,8,5,13
Assam,Bajali,Hearing Impairment,60,80,4,5,9
Uttar Pradesh,Bahraich,Hearing Impairment,0,6,21,15,36
Uttar Pradesh,Bahraich,Hearing Impairment,6,15,183,180,363
Uttar Pradesh,Bahraich,Hearing Impairment,15,35,162,72,234
Uttar Pradesh,Bahraich,Hearing Impairment,35,60,55,18,73
Uttar Pradesh,Bahraich,Hearing Impairment,60,80,12,5,17
Uttar Pradesh,Bahraich,Hearing Impairment,80,100,1,0,1
Uttar Pradesh,Baghpat,Hearing Impairment,0,6,8,6,14
Uttar Pradesh,Baghpat,Hearing Impairment,6,15,28,18,46
Uttar Pradesh,Baghpat,Hearing Impairment,15,35,118,41,159
Uttar Pradesh,Baghpat,Hearing Impairment,35,60,60,20,80
Uttar Pradesh,Baghpat,Hearing Impairment,60,80,19,3,22
Uttar Pradesh,Baghpat,Hearing Impairment,80,100,2,0,2
Uttarakhand,Bageshwar,Hearing Impairment,0,6,4,1,5
Uttarakhand,Bageshwar,Hearing Impairment,6,15,9,9,18
Uttarakhand,Bageshwar,Hearing Impairment,15,35,38,30,68
Uttarakhand,Bageshwar,Hearing Impairment,35,60,115,41,156
Uttarakhand,Bageshwar,Hearing Impairment,60,80,21,9,30
Karnataka,Bagalkote,Hearing Impairment,0,6,24,25,49
Karnataka,Bagalkote,Hearing Impairment,6,15,225,164,389
Karnataka,Bagalkote,Hearing Impairment,15,35,493,383,876
Karnataka,Bagalkote,Hearing Impairment,35,60,462,385,847
Karnataka,Bagalkote,Hearing Impairment,60,80,116,43,159
Karnataka,Bagalkote,Hearing Impairment,80,100,3,1,4
Uttar Pradesh,Azamgarh,Hearing Impairment,0,6,18,9,27
Uttar Pradesh,Azamgarh,Hearing Impairment,6,15,83,44,127
Uttar Pradesh,Azamgarh,Hearing Impairment,15,35,364,179,543
Uttar Pradesh,Azamgarh,Hearing Impairment,35,60,176,74,250
Uttar Pradesh,Azamgarh,Hearing Impairment,60,80,24,9,33
Uttar Pradesh,Azamgarh,Hearing Impairment,80,100,2,1,3
Uttar Pradesh,Ayodhya,Hearing Impairment,0,6,8,8,16
Uttar Pradesh,Ayodhya,Hearing Impairment,6,15,24,11,35
Uttar Pradesh,Ayodhya,Hearing Impairment,15,35,94,62,156
Uttar Pradesh,Ayodhya,Hearing Impairment,35,60,39,22,61
Uttar Pradesh,Ayodhya,Hearing Impairment,60,80,5,4,9
Bihar,Aurangabad,Hearing Impairment,0,6,0,1,1
Bihar,Aurangabad,Hearing Impairment,6,15,4,3,7
Bihar,Aurangabad,Hearing Impairment,15,35,35,14,49
Bihar,Aurangabad,Hearing Impairment,35,60,16,4,20
Bihar,Aurangabad,Hearing Impairment,60,80,3,0,3
Maharashtra,Aurangabad,Hearing Impairment,0,6,73,58,131
Maharashtra,Aurangabad,Hearing Impairment,6,15,408,306,714
Maharashtra,Aurangabad,Hearing Impairment,15,35,789,455,1244
Maharashtra,Aurangabad,Hearing Impairment,35,60,433,210,643
Maharashtra,Aurangabad,Hearing Impairment,60,80,152,34,186
Maharashtra,Aurangabad,Hearing Impairment,80,100,20,2,22
Uttar Pradesh,Auraiya,Hearing Impairment,0,6,3,12,15
Uttar Pradesh,Auraiya,Hearing Impairment,6,15,24,20,44
Uttar Pradesh,Auraiya,Hearing Impairment,15,35,131,57,188
Uttar Pradesh,Auraiya,Hearing Impairment,35,60,171,59,230
Uttar Pradesh,Auraiya,Hearing Impairment,60,80,22,6,28
Uttar Pradesh,Auraiya,Hearing Impairment,80,100,4,0,4
Madhya Pradesh,Ashoknagar,Hearing Impairment,0,6,6,5,11
Madhya Pradesh,Ashoknagar,Hearing Impairment,6,15,57,44,101
Madhya Pradesh,Ashoknagar,Hearing Impairment,15,35,177,111,288
Madhya Pradesh,Ashoknagar,Hearing Impairment,35,60,180,122,302
Madhya Pradesh,Ashoknagar,Hearing Impairment,60,80,210,77,287
Madhya Pradesh,Ashoknagar,Hearing Impairment,80,100,39,8,47
Bihar,Arwal,Hearing Impairment,0,6,0,1,1
Bihar,Arwal,Hearing Impairment,6,15,8,9,17
Bihar,Arwal,Hearing Impairment,15,35,32,13,45
Bihar,Arwal,Hearing Impairment,35,60,8,6,14
Bihar,Arwal,Hearing Impairment,60,80,1,0,1
Gujarat,Arvalli,Hearing Impairment,0,6,6,6,12
Gujarat,Arvalli,Hearing Impairment,6,15,103,72,175
Gujarat,Arvalli,Hearing Impairment,15,35,254,142,396
Gujarat,Arvalli,Hearing Impairment,35,60,94,53,147
Gujarat,Arvalli,Hearing Impairment,60,80,15,5,20
Gujarat,Arvalli,Hearing Impairment,80,100,0,1,1
Tamil Nadu,Ariyalur,Hearing Impairment,0,6,13,12,25
Tamil Nadu,Ariyalur,Hearing Impairment,6,15,76,54,130
Tamil Nadu,Ariyalur,Hearing Impairment,15,35,235,191,426
Tamil Nadu,Ariyalur,Hearing Impairment,35,60,409,303,712
Tamil Nadu,Ariyalur,Hearing Impairment,60,80,330,125,455
Tamil Nadu,Ariyalur,Hearing Impairment,80,100,44,6,50
Bihar,Araria,Hearing Impairment,0,6,1,1,2
Bihar,Araria,Hearing Impairment,6,15,43,33,76
Bihar,Araria,Hearing Impairment,15,35,113,73,186
Bihar,Araria,Hearing Impairment,35,60,48,17,65
Bihar,Araria,Hearing Impairment,60,80,4,3,7
Bihar,Araria,Hearing Impairment,80,100,1,0,1
Madhya Pradesh,Anuppur,Hearing Impairment,0,6,0,1,1
Madhya Pradesh,Anuppur,Hearing Impairment,6,15,12,9,21
Madhya Pradesh,Anuppur,Hearing Impairment,15,35,71,70,141
Madhya Pradesh,Anuppur,Hearing Impairment,35,60,61,39,100
Madhya Pradesh,Anuppur,Hearing Impairment,60,80,12,7,19
Madhya Pradesh,Anuppur,Hearing Impairment,80,100,1,0,1
Odisha,Anugul,Hearing Impairment,0,6,8,4,12
Odisha,Anugul,Hearing Impairment,6,15,116,83,199
Odisha,Anugul,Hearing Impairment,15,35,246,185,431
Odisha,Anugul,Hearing Impairment,35,60,343,204,547
Odisha,Anugul,Hearing Impairment,60,80,157,64,221
Odisha,Anugul,Hearing Impairment,80,100,6,7,13
Andhra Pradesh,Annamayya,Hearing Impairment,15,35,1,1,2
Andhra Pradesh,Annamayya,Hearing Impairment,35,60,1,0,1
Arunachal Pradesh,Anjaw,Hearing Impairment,15,35,1,2,3
Jammu And Kashmir,Anantnag,Hearing Impairment,0,6,6,11,17
Jammu And Kashmir,Anantnag,Hearing Impairment,6,15,38,47,85
Jammu And Kashmir,Anantnag,Hearing Impairment,15,35,123,100,223
Jammu And Kashmir,Anantnag,Hearing Impairment,35,60,180,150,330
Jammu And Kashmir,Anantnag,Hearing Impairment,60,80,86,43,129
Jammu And Kashmir,Anantnag,Hearing Impairment,80,100,15,7,22
Andhra Pradesh,Anantapur,Hearing Impairment,0,6,30,18,48
Andhra Pradesh,Anantapur,Hearing Impairment,6,15,192,150,342
Andhra Pradesh,Anantapur,Hearing Impairment,15,35,372,188,560
Andhra Pradesh,Anantapur,Hearing Impairment,35,60,878,176,1054
Andhra Pradesh,Anantapur,Hearing Impairment,60,80,205,26,231
Andhra Pradesh,Anantapur,Hearing Impairment,80,100,20,0,20
Gujarat,Anand,Hearing Impairment,0,6,21,16,37
Gujarat,Anand,Hearing Impairment,6,15,135,135,270
Gujarat,Anand,Hearing Impairment,15,35,275,187,462
Gujarat,Anand,Hearing Impairment,35,60,94,68,162
Gujarat,Anand,Hearing Impairment,60,80,35,9,44
Gujarat,Anand,Hearing Impairment,80,100,2,0,2
Uttar Pradesh,Amroha,Hearing Impairment,0,6,16,4,20
Uttar Pradesh,Amroha,Hearing Impairment,6,15,44,30,74
Uttar Pradesh,Amroha,Hearing Impairment,15,35,93,60,153
Uttar Pradesh,Amroha,Hearing Impairment,35,60,50,23,73
Uttar Pradesh,Amroha,Hearing Impairment,60,80,11,7,18
Uttar Pradesh,Amroha,Hearing Impairment,80,100,1,0,1
Punjab,Amritsar,Hearing Impairment,0,6,27,24,51
Punjab,Amritsar,Hearing Impairment,6,15,142,97,239
Punjab,Amritsar,Hearing Impairment,15,35,416,264,680
Punjab,Amritsar,Hearing Impairment,35,60,234,118,352
Punjab,Amritsar,Hearing Impairment,60,80,60,20,80
Punjab,Amritsar,Hearing Impairment,80,100,12,5,17
Gujarat,Amreli,Hearing Impairment,0,6,6,9,15
Gujarat,Amreli,Hearing Impairment,6,15,130,91,221
Gujarat,Amreli,Hearing Impairment,15,35,296,192,488
Gujarat,Amreli,Hearing Impairment,35,60,122,100,222
Gujarat,Amreli,Hearing Impairment,60,80,18,7,25
Gujarat,Amreli,Hearing Impairment,80,100,3,0,3
Maharashtra,Amravati,Hearing Impairment,0,6,85,65,150
Maharashtra,Amravati,Hearing Impairment,6,15,352,242,594
Maharashtra,Amravati,Hearing Impairment,15,35,1057,665,1722
Maharashtra,Amravati,Hearing Impairment,35,60,1518,888,2406
Maharashtra,Amravati,Hearing Impairment,60,80,748,240,988
Maharashtra,Amravati,Hearing Impairment,80,100,61,14,75
Uttar Pradesh,Amethi,Hearing Impairment,0,6,5,7,12
Uttar Pradesh,Amethi,Hearing Impairment,6,15,23,24,47
Uttar Pradesh,Amethi,Hearing Impairment,15,35,133,79,212
Uttar Pradesh,Amethi,Hearing Impairment,35,60,70,41,111
Uttar Pradesh,Amethi,Hearing Impairment,60,80,11,2,13
Uttar Pradesh,Amethi,Hearing Impairment,80,100,2,0,2
Uttar Pradesh,Ambedkar Nagar,Hearing Impairment,0,6,11,7,18
Uttar Pradesh,Ambedkar Nagar,Hearing Impairment,6,15,33,14,47
Uttar Pradesh,Ambedkar Nagar,Hearing Impairment,15,35,300,174,474
Uttar Pradesh,Ambedkar Nagar,Hearing Impairment,35,60,273,120,393
Uttar Pradesh,Ambedkar Nagar,Hearing Impairment,60,80,38,7,45
Uttar Pradesh,Ambedkar Nagar,Hearing Impairment,80,100,3,1,4
Haryana,Ambala,Hearing Impairment,0,6,13,4,17
Haryana,Ambala,Hearing Impairment,6,15,60,54,114
Haryana,Ambala,Hearing Impairment,15,35,167,103,270
Haryana,Ambala,Hearing Impairment,35,60,103,60,163
Haryana,Ambala,Hearing Impairment,60,80,22,10,32
Haryana,Ambala,Hearing Impairment,80,100,2,2,4
Rajasthan,Alwar,Hearing Impairment,0,6,24,21,45
Rajasthan,Alwar,Hearing Impairment,6,15,164,130,294
Rajasthan,Alwar,Hearing Impairment,15,35,315,191,506
Rajasthan,Alwar,Hearing Impairment,35,60,167,122,289
Rajasthan,Alwar,Hearing Impairment,60,80,37,32,69
Rajasthan,Alwar,Hearing Impairment,80,100,5,3,8
Uttarakhand,Almora,Hearing Impairment,0,6,1,2,3
Uttarakhand,Almora,Hearing Impairment,6,15,11,12,23
Uttarakhand,Almora,Hearing Impairment,15,35,73,55,128
Uttarakhand,Almora,Hearing Impairment,35,60,376,153,529
Uttarakhand,Almora,Hearing Impairment,60,80,74,18,92
Uttarakhand,Almora,Hearing Impairment,80,100,0,2,2
Madhya Pradesh,Alirajpur,Hearing Impairment,0,6,1,1,2
Madhya Pradesh,Alirajpur,Hearing Impairment,6,15,24,18,42
Madhya Pradesh,Alirajpur,Hearing Impairment,15,35,74,47,121
Madhya Pradesh,Alirajpur,Hearing Impairment,35,60,49,24,73
Madhya Pradesh,Alirajpur,Hearing Impairment,60,80,6,4,10
Uttar Pradesh,Aligarh,Hearing Impairment,0,6,56,44,100
Uttar Pradesh,Aligarh,Hearing Impairment,6,15,175,110,285
Uttar Pradesh,Aligarh,Hearing Impairment,15,35,437,201,638
Uttar Pradesh,Aligarh,Hearing Impairment,35,60,174,114,288
Uttar Pradesh,Aligarh,Hearing Impairment,60,80,55,16,71
Uttar Pradesh,Aligarh,Hearing Impairment,80,100,8,2,10
Kerala,Alappuzha,Hearing Impairment,0,6,10,10,20
Kerala,Alappuzha,Hearing Impairment,6,15,63,49,112
Kerala,Alappuzha,Hearing Impairment,15,35,253,187,440
Kerala,Alappuzha,Hearing Impairment,35,60,499,384,883
Kerala,Alappuzha,Hearing Impairment,60,80,223,142,365
Kerala,Alappuzha,Hearing Impairment,80,100,13,8,21
Maharashtra,Akola,Hearing Impairment,0,6,24,28,52
Maharashtra,Akola,Hearing Impairment,6,15,192,160,352
Maharashtra,Akola,Hearing Impairment,15,35,624,383,1007
Maharashtra,Akola,Hearing Impairment,35,60,819,296,1115
Maharashtra,Akola,Hearing Impairment,60,80,362,93,455
Maharashtra,Akola,Hearing Impairment,80,100,29,2,31
Rajasthan,Ajmer,Hearing Impairment,0,6,11,23,34
Rajasthan,Ajmer,Hearing Impairment,6,15,118,79,197
Rajasthan,Ajmer,Hearing Impairment,15,35,223,199,422
Rajasthan,Ajmer,Hearing Impairment,35,60,156,114,270
Rajasthan,Ajmer,Hearing Impairment,60,80,23,11,34
Rajasthan,Ajmer,Hearing Impairment,80,100,2,0,2
Mizoram,Aizawl,Hearing Impairment,0,6,8,8,16
Mizoram,Aizawl,Hearing Impairment,6,15,28,32,60
Mizoram,Aizawl,Hearing Impairment,15,35,52,48,100
Mizoram,Aizawl,Hearing Impairment,35,60,88,102,190
Mizoram,Aizawl,Hearing Impairment,60,80,187,145,332
Mizoram,Aizawl,Hearing Impairment,80,100,71,28,99
Maharashtra,Ahmednagar,Hearing Impairment,0,6,99,71,170
Maharashtra,Ahmednagar,Hearing Impairment,6,15,561,433,994
Maharashtra,Ahmednagar,Hearing Impairment,15,35,1532,647,2179
Maharashtra,Ahmednagar,Hearing Impairment,35,60,1015,372,1387
Maharashtra,Ahmednagar,Hearing Impairment,60,80,586,101,687
Maharashtra,Ahmednagar,Hearing Impairment,80,100,101,7,108
Gujarat,Ahmadabad,Hearing Impairment,0,6,56,38,94
Gujarat,Ahmadabad,Hearing Impairment,6,15,262,249,511
Gujarat,Ahmadabad,Hearing Impairment,15,35,700,413,1113
Gujarat,Ahmadabad,Hearing Impairment,35,60,496,326,822
Gujarat,Ahmadabad,Hearing Impairment,60,80,184,70,254
Gujarat,Ahmadabad,Hearing Impairment,80,100,28,7,35
Uttar Pradesh,Agra,Hearing Impairment,0,6,48,41,89
Uttar Pradesh,Agra,Hearing Impairment,6,15,243,200,443
Uttar Pradesh,Agra,Hearing Impairment,15,35,538,319,857
Uttar Pradesh,Agra,Hearing Impairment,35,60,296,150,446
Uttar Pradesh,Agra,Hearing Impairment,60,80,43,15,58
Uttar Pradesh,Agra,Hearing Impairment,80,100,4,0,4
Madhya Pradesh,Agar Malwa,Hearing Impairment,0,6,4,1,5
Madhya Pradesh,Agar Malwa,Hearing Impairment,6,15,11,15,26
Madhya Pradesh,Agar Malwa,Hearing Impairment,15,35,47,22,69
Madhya Pradesh,Agar Malwa,Hearing Impairment,35,60,34,10,44
Madhya Pradesh,Agar Malwa,Hearing Impairment,60,80,26,9,35
Madhya Pradesh,Agar Malwa,Hearing Impairment,80,100,7,0,7
Telangana,Adilabad,Hearing Impairment,6,15,21,23,44
Telangana,Adilabad,Hearing Impairment,15,35,101,74,175
Telangana,Adilabad,Hearing Impairment,35,60,70,51,121
Telangana,Adilabad,Hearing Impairment,60,80,30,22,52
Telangana,Adilabad,Hearing Impairment,80,100,1,1,2
West Bengal,24 Paraganas South,Hearing Impairment,15,35,4,2,6
West Bengal,24 Paraganas South,Hearing Impairment,35,60,2,0,2
Maharashtra,Yavatmal,Hemophilia,6,15,4,0,4
Maharashtra,Yavatmal,Hemophilia,15,35,7,0,7
Maharashtra,Yavatmal,Hemophilia,35,60,4,0,4
Puducherry,Yanam,Hemophilia,15,35,1,0,1
Puducherry,Yanam,Hemophilia,35,60,3,1,4
Puducherry,Yanam,Hemophilia,60,80,4,0,4
Haryana,Yamunanagar,Hemophilia,0,6,3,0,3
Haryana,Yamunanagar,Hemophilia,6,15,6,0,6
Haryana,Yamunanagar,Hemophilia,15,35,12,0,12
Haryana,Yamunanagar,Hemophilia,35,60,2,0,2
Haryana,Yamunanagar,Hemophilia,60,80,1,1,2
Karnataka,Yadgir,Hemophilia,0,6,1,0,1
Karnataka,Yadgir,Hemophilia,6,15,1,0,1
Karnataka,Yadgir,Hemophilia,15,35,3,0,3
Tripura,West Tripura,Hemophilia,6,15,3,0,3
Tripura,West Tripura,Hemophilia,15,35,1,0,1
Jharkhand,West Singhbhum,Hemophilia,6,15,1,2,3
Jharkhand,West Singhbhum,Hemophilia,15,35,8,4,12
Jharkhand,West Singhbhum,Hemophilia,35,60,16,3,19
Jharkhand,West Singhbhum,Hemophilia,60,80,1,2,3
Arunachal Pradesh,West Siang,Hemophilia,15,35,1,0,1
Arunachal Pradesh,West Siang,Hemophilia,35,60,1,0,1
Meghalaya,West Garo Hills,Hemophilia,15,35,2,0,2
Delhi,West,Hemophilia,6,15,3,0,3
Delhi,West,Hemophilia,15,35,13,0,13
Delhi,West,Hemophilia,35,60,1,0,1
Delhi,West,Hemophilia,60,80,1,0,1
Kerala,Wayanad,Hemophilia,6,15,1,0,1
Kerala,Wayanad,Hemophilia,15,35,4,0,4
Kerala,Wayanad,Hemophilia,35,60,3,0,3
Maharashtra,Washim,Hemophilia,6,15,7,0,7
Maharashtra,Washim,Hemophilia,15,35,9,0,9
Maharashtra,Wardha,Hemophilia,0,6,2,1,3
Maharashtra,Wardha,Hemophilia,6,15,3,0,3
Maharashtra,Wardha,Hemophilia,15,35,7,1,8
Maharashtra,Wardha,Hemophilia,35,60,2,0,2
Tamil Nadu,Virudhunagar,Hemophilia,0,6,0,1,1
Tamil Nadu,Virudhunagar,Hemophilia,6,15,12,1,13
Tamil Nadu,Virudhunagar,Hemophilia,15,35,7,4,11
Tamil Nadu,Virudhunagar,Hemophilia,35,60,5,4,9
Tamil Nadu,Virudhunagar,Hemophilia,60,80,2,2,4
Tamil Nadu,Villupuram,Hemophilia,6,15,3,0,3
Tamil Nadu,Villupuram,Hemophilia,15,35,6,2,8
Tamil Nadu,Villupuram,Hemophilia,35,60,5,2,7
Tamil Nadu,Villupuram,Hemophilia,60,80,0,1,1
Karnataka,Vijayapura,Hemophilia,0,6,1,0,1
Karnataka,Vijayapura,Hemophilia,6,15,7,0,7
Karnataka,Vijayapura,Hemophilia,15,35,14,4,18
Karnataka,Vijayapura,Hemophilia,35,60,13,3,16
Karnataka,Vijayapura,Hemophilia,60,80,3,0,3
Madhya Pradesh,Vidisha,Hemophilia,0,6,1,0,1
Madhya Pradesh,Vidisha,Hemophilia,6,15,2,1,3
Madhya Pradesh,Vidisha,Hemophilia,15,35,12,2,14
Madhya Pradesh,Vidisha,Hemophilia,35,60,10,1,11
Madhya Pradesh,Vidisha,Hemophilia,60,80,1,1,2
Tamil Nadu,Vellore,Hemophilia,0,6,1,0,1
Tamil Nadu,Vellore,Hemophilia,6,15,4,0,4
Tamil Nadu,Vellore,Hemophilia,15,35,6,0,6
Tamil Nadu,Vellore,Hemophilia,35,60,9,5,14
Tamil Nadu,Vellore,Hemophilia,60,80,2,1,3
Uttar Pradesh,Varanasi,Hemophilia,6,15,6,0,6
Uttar Pradesh,Varanasi,Hemophilia,15,35,5,0,5
Uttar Pradesh,Varanasi,Hemophilia,35,60,1,0,1
Gujarat,Valsad,Hemophilia,6,15,2,0,2
Gujarat,Valsad,Hemophilia,15,35,1,0,1
Gujarat,Valsad,Hemophilia,35,60,1,0,1
Bihar,Vaishali,Hemophilia,6,15,0,1,1
Bihar,Vaishali,Hemophilia,15,35,9,2,11
Bihar,Vaishali,Hemophilia,35,60,11,5,16
Bihar,Vaishali,Hemophilia,60,80,0,1,1
Gujarat,Vadodara,Hemophilia,0,6,1,0,1
Gujarat,Vadodara,Hemophilia,6,15,7,1,8
Gujarat,Vadodara,Hemophilia,15,35,9,0,9
Gujarat,Vadodara,Hemophilia,35,60,3,0,3
Karnataka,Uttara Kannada,Hemophilia,0,6,1,0,1
Karnataka,Uttara Kannada,Hemophilia,6,15,3,1,4
Karnataka,Uttara Kannada,Hemophilia,15,35,5,1,6
Karnataka,Uttara Kannada,Hemophilia,35,60,3,1,4
Uttarakhand,Uttar Kashi,Hemophilia,6,15,1,0,1
Uttarakhand,Uttar Kashi,Hemophilia,15,35,2,1,3
Uttarakhand,Uttar Kashi,Hemophilia,35,60,8,1,9
Uttarakhand,Uttar Kashi,Hemophilia,60,80,1,0,1
Uttar Pradesh,Unnao,Hemophilia,6,15,2,0,2
Uttar Pradesh,Unnao,Hemophilia,15,35,5,5,10
Uttar Pradesh,Unnao,Hemophilia,35,60,1,2,3
Uttar Pradesh,Unnao,Hemophilia,60,80,3,1,4
Himachal Pradesh,Una,Hemophilia,15,35,1,0,1
Himachal Pradesh,Una,Hemophilia,35,60,4,0,4
Himachal Pradesh,Una,Hemophilia,60,80,1,0,1
Himachal Pradesh,Una,Hemophilia,80,100,0,1,1
Madhya Pradesh,Umaria,Hemophilia,6,15,0,1,1
Madhya Pradesh,Umaria,Hemophilia,35,60,3,3,6
Madhya Pradesh,Umaria,Hemophilia,60,80,2,0,2
Madhya Pradesh,Ujjain,Hemophilia,0,6,0,1,1
Madhya Pradesh,Ujjain,Hemophilia,6,15,7,3,10
Madhya Pradesh,Ujjain,Hemophilia,15,35,10,1,11
Madhya Pradesh,Ujjain,Hemophilia,35,60,12,2,14
Madhya Pradesh,Ujjain,Hemophilia,60,80,7,3,10
Madhya Pradesh,Ujjain,Hemophilia,80,100,2,1,3
Karnataka,Udupi,Hemophilia,6,15,5,0,5
Karnataka,Udupi,Hemophilia,15,35,2,1,3
Karnataka,Udupi,Hemophilia,35,60,1,0,1
Karnataka,Udupi,Hemophilia,60,80,2,0,2
Jammu And Kashmir,Udhampur,Hemophilia,15,35,1,0,1
Jammu And Kashmir,Udhampur,Hemophilia,60,80,1,0,1
Uttarakhand,Udam Singh Nagar,Hemophilia,6,15,3,1,4
Uttarakhand,Udam Singh Nagar,Hemophilia,15,35,10,3,13
Uttarakhand,Udam Singh Nagar,Hemophilia,35,60,8,1,9
Uttarakhand,Udam Singh Nagar,Hemophilia,60,80,6,2,8
Assam,Udalguri,Hemophilia,6,15,1,0,1
Assam,Udalguri,Hemophilia,35,60,1,1,2
Rajasthan,Udaipur,Hemophilia,6,15,2,2,4
Rajasthan,Udaipur,Hemophilia,15,35,3,0,3
Rajasthan,Udaipur,Hemophilia,60,80,1,0,1
Tamil Nadu,Tuticorin,Hemophilia,6,15,3,0,3
Tamil Nadu,Tuticorin,Hemophilia,15,35,4,0,4
Tamil Nadu,Tuticorin,Hemophilia,35,60,1,0,1
Karnataka,Tumakuru,Hemophilia,0,6,0,1,1
Karnataka,Tumakuru,Hemophilia,6,15,1,0,1
Karnataka,Tumakuru,Hemophilia,15,35,4,0,4
Karnataka,Tumakuru,Hemophilia,35,60,9,5,14
Karnataka,Tumakuru,Hemophilia,60,80,4,0,4
Rajasthan,Tonk,Hemophilia,6,15,5,0,5
Rajasthan,Tonk,Hemophilia,15,35,8,0,8
Rajasthan,Tonk,Hemophilia,35,60,1,0,1
Tamil Nadu,Tiruvannamalai,Hemophilia,0,6,2,0,2
Tamil Nadu,Tiruvannamalai,Hemophilia,6,15,5,2,7
Tamil Nadu,Tiruvannamalai,Hemophilia,15,35,5,0,5
Tamil Nadu,Tiruvannamalai,Hemophilia,35,60,3,1,4
Tamil Nadu,Tiruvannamalai,Hemophilia,60,80,1,0,1
Tamil Nadu,Tiruppur,Hemophilia,0,6,1,1,2
Tamil Nadu,Tiruppur,Hemophilia,6,15,3,0,3
Tamil Nadu,Tiruppur,Hemophilia,15,35,8,0,8
Tamil Nadu,Tiruppur,Hemophilia,35,60,2,0,2
Tamil Nadu,Tirupathur,Hemophilia,0,6,1,1,2
Tamil Nadu,Tirupathur,Hemophilia,6,15,4,0,4
Tamil Nadu,Tirupathur,Hemophilia,15,35,2,0,2
Tamil Nadu,Tirupathur,Hemophilia,35,60,3,1,4
Tamil Nadu,Tirunelveli,Hemophilia,0,6,1,0,1
Tamil Nadu,Tirunelveli,Hemophilia,6,15,5,0,5
Tamil Nadu,Tirunelveli,Hemophilia,15,35,8,2,10
Tamil Nadu,Tirunelveli,Hemophilia,35,60,9,0,9
Tamil Nadu,Tirunelveli,Hemophilia,60,80,4,0,4
Tamil Nadu,Tiruchirappalli,Hemophilia,0,6,2,0,2
Tamil Nadu,Tiruchirappalli,Hemophilia,6,15,19,2,21
Tamil Nadu,Tiruchirappalli,Hemophilia,15,35,20,6,26
Tamil Nadu,Tiruchirappalli,Hemophilia,35,60,9,1,10
Tamil Nadu,Tiruchirappalli,Hemophilia,60,80,1,2,3
Madhya Pradesh,Tikamgarh,Hemophilia,0,6,0,1,1
Madhya Pradesh,Tikamgarh,Hemophilia,6,15,1,0,1
Madhya Pradesh,Tikamgarh,Hemophilia,15,35,5,4,9
Madhya Pradesh,Tikamgarh,Hemophilia,35,60,27,8,35
Madhya Pradesh,Tikamgarh,Hemophilia,60,80,11,4,15
Madhya Pradesh,Tikamgarh,Hemophilia,80,100,0,1,1
Kerala,Thrissur,Hemophilia,0,6,5,0,5
Kerala,Thrissur,Hemophilia,6,15,5,0,5
Kerala,Thrissur,Hemophilia,15,35,13,1,14
Kerala,Thrissur,Hemophilia,35,60,11,1,12
Kerala,Thrissur,Hemophilia,60,80,2,0,2
Manipur,Thoubal,Hemophilia,6,15,1,0,1
Manipur,Thoubal,Hemophilia,15,35,3,0,3
Tamil Nadu,Thiruvarur,Hemophilia,0,6,2,0,2
Tamil Nadu,Thiruvarur,Hemophilia,6,15,1,0,1
Tamil Nadu,Thiruvarur,Hemophilia,15,35,1,0,1
Kerala,Thiruvananthapuram,Hemophilia,0,6,1,0,1
Kerala,Thiruvananthapuram,Hemophilia,6,15,10,0,10
Kerala,Thiruvananthapuram,Hemophilia,15,35,25,1,26
Kerala,Thiruvananthapuram,Hemophilia,35,60,8,0,8
Tamil Nadu,Thiruvallur,Hemophilia,6,15,13,0,13
Tamil Nadu,Thiruvallur,Hemophilia,15,35,13,0,13
Tamil Nadu,Thiruvallur,Hemophilia,35,60,7,2,9
Tamil Nadu,Thiruvallur,Hemophilia,60,80,2,1,3
Tamil Nadu,Theni,Hemophilia,6,15,3,0,3
Tamil Nadu,Theni,Hemophilia,15,35,1,0,1
Tamil Nadu,Theni,Hemophilia,35,60,2,0,2
Tamil Nadu,Theni,Hemophilia,60,80,1,0,1
Tamil Nadu,The Nilgiris,Hemophilia,6,15,1,0,1
Tamil Nadu,The Nilgiris,Hemophilia,35,60,1,1,2
Tamil Nadu,Thanjavur,Hemophilia,0,6,1,1,2
Tamil Nadu,Thanjavur,Hemophilia,6,15,11,0,11
Tamil Nadu,Thanjavur,Hemophilia,15,35,14,2,16
Tamil Nadu,Thanjavur,Hemophilia,35,60,9,2,11
Tamil Nadu,Thanjavur,Hemophilia,60,80,4,0,4
Maharashtra,Thane,Hemophilia,0,6,6,0,6
Maharashtra,Thane,Hemophilia,6,15,33,0,33
Maharashtra,Thane,Hemophilia,15,35,48,1,49
Maharashtra,Thane,Hemophilia,35,60,19,1,20
Maharashtra,Thane,Hemophilia,60,80,8,0,8
Tamil Nadu,Tenkasi,Hemophilia,0,6,2,0,2
Tamil Nadu,Tenkasi,Hemophilia,6,15,6,0,6
Tamil Nadu,Tenkasi,Hemophilia,15,35,11,0,11
Tamil Nadu,Tenkasi,Hemophilia,35,60,2,0,2
Uttarakhand,Tehri Garhwal,Hemophilia,0,6,1,0,1
Uttarakhand,Tehri Garhwal,Hemophilia,6,15,5,0,5
Uttarakhand,Tehri Garhwal,Hemophilia,15,35,4,1,5
Uttarakhand,Tehri Garhwal,Hemophilia,35,60,2,3,5
Uttarakhand,Tehri Garhwal,Hemophilia,60,80,2,0,2
Punjab,Tarn Taran,Hemophilia,6,15,2,0,2
Punjab,Tarn Taran,Hemophilia,15,35,17,7,24
Punjab,Tarn Taran,Hemophilia,35,60,39,12,51
Punjab,Tarn Taran,Hemophilia,60,80,4,0,4
Chhattisgarh,Surguja,Hemophilia,35,60,2,0,2
Chhattisgarh,Surguja,Hemophilia,60,80,0,1,1
Gujarat,Surendranagar,Hemophilia,6,15,3,0,3
Gujarat,Surendranagar,Hemophilia,15,35,8,0,8
Gujarat,Surendranagar,Hemophilia,35,60,1,0,1
Gujarat,Surendranagar,Hemophilia,60,80,1,0,1
Gujarat,Surat,Hemophilia,0,6,1,0,1
Gujarat,Surat,Hemophilia,6,15,6,0,6
Gujarat,Surat,Hemophilia,15,35,17,3,20
Gujarat,Surat,Hemophilia,35,60,6,0,6
Gujarat,Surat,Hemophilia,60,80,1,0,1
Chhattisgarh,Surajpur,Hemophilia,6,15,2,1,3
Chhattisgarh,Surajpur,Hemophilia,15,35,4,6,10
Chhattisgarh,Surajpur,Hemophilia,35,60,8,1,9
Chhattisgarh,Surajpur,Hemophilia,60,80,2,1,3
Bihar,Supaul,Hemophilia,6,15,2,0,2
Bihar,Supaul,Hemophilia,35,60,2,0,2
Bihar,Supaul,Hemophilia,60,80,1,0,1
Odisha,Sundargarh,Hemophilia,0,6,1,0,1
Odisha,Sundargarh,Hemophilia,6,15,10,0,10
Odisha,Sundargarh,Hemophilia,15,35,7,3,10
Odisha,Sundargarh,Hemophilia,35,60,12,9,21
Odisha,Sundargarh,Hemophilia,60,80,3,1,4
Uttar Pradesh,Sultanpur,Hemophilia,6,15,5,1,6
Uttar Pradesh,Sultanpur,Hemophilia,15,35,9,4,13
Uttar Pradesh,Sultanpur,Hemophilia,35,60,9,5,14
Uttar Pradesh,Sultanpur,Hemophilia,60,80,2,1,3
Jammu And Kashmir,Srinagar,Hemophilia,0,6,2,0,2
Jammu And Kashmir,Srinagar,Hemophilia,6,15,4,0,4
Jammu And Kashmir,Srinagar,Hemophilia,15,35,9,1,10
Jammu And Kashmir,Srinagar,Hemophilia,35,60,4,0,4
Punjab,Sri Muktsar Sahib,Hemophilia,15,35,2,2,4
Punjab,Sri Muktsar Sahib,Hemophilia,35,60,5,4,9
Punjab,Sri Muktsar Sahib,Hemophilia,60,80,1,0,1
Andhra Pradesh,Spsr Nellore,Hemophilia,6,15,1,0,1
Delhi,South West,Hemophilia,6,15,8,0,8
Delhi,South West,Hemophilia,15,35,15,0,15
Delhi,South West,Hemophilia,35,60,3,0,3
Assam,South Salmara Mancachar,Hemophilia,15,35,2,0,2
Goa,South Goa,Hemophilia,15,35,1,0,1
Goa,South Goa,Hemophilia,35,60,2,1,3
Goa,South Goa,Hemophilia,60,80,1,0,1
Delhi,South East,Hemophilia,6,15,1,0,1
Delhi,South East,Hemophilia,15,35,3,0,3
Andaman And Nicobar Islands,South Andamans,Hemophilia,0,6,1,0,1
Andaman And Nicobar Islands,South Andamans,Hemophilia,6,15,1,0,1
Andaman And Nicobar Islands,South Andamans,Hemophilia,35,60,3,1,4
Andaman And Nicobar Islands,South Andamans,Hemophilia,80,100,1,0,1
Delhi,South,Hemophilia,0,6,1,0,1
Delhi,South,Hemophilia,6,15,1,0,1
Delhi,South,Hemophilia,35,60,4,0,4
Assam,Sonitpur,Hemophilia,6,15,1,0,1
Assam,Sonitpur,Hemophilia,15,35,1,0,1
Haryana,Sonipat,Hemophilia,6,15,1,0,1
Haryana,Sonipat,Hemophilia,15,35,1,0,1
Haryana,Sonipat,Hemophilia,35,60,4,0,4
Odisha,Sonepur,Hemophilia,6,15,2,0,2
Uttar Pradesh,Sonbhadra,Hemophilia,6,15,1,0,1
Uttar Pradesh,Sonbhadra,Hemophilia,15,35,5,2,7
Uttar Pradesh,Sonbhadra,Hemophilia,35,60,7,0,7
Uttar Pradesh,Sonbhadra,Hemophilia,60,80,3,0,3
Maharashtra,Solapur,Hemophilia,0,6,2,0,2
Maharashtra,Solapur,Hemophilia,6,15,10,0,10
Maharashtra,Solapur,Hemophilia,15,35,11,0,11
Maharashtra,Solapur,Hemophilia,35,60,7,0,7
Himachal Pradesh,Solan,Hemophilia,0,6,2,0,2
Himachal Pradesh,Solan,Hemophilia,6,15,2,0,2
Himachal Pradesh,Solan,Hemophilia,15,35,1,1,2
Himachal Pradesh,Solan,Hemophilia,35,60,1,0,1
Bihar,Siwan,Hemophilia,0,6,1,0,1
Bihar,Siwan,Hemophilia,35,60,2,1,3
Assam,Sivasagar,Hemophilia,15,35,1,0,1
Assam,Sivasagar,Hemophilia,35,60,1,0,1
Assam,Sivasagar,Hemophilia,60,80,1,0,1
Tamil Nadu,Sivaganga,Hemophilia,0,6,1,0,1
Tamil Nadu,Sivaganga,Hemophilia,6,15,3,0,3
Tamil Nadu,Sivaganga,Hemophilia,15,35,8,1,9
Tamil Nadu,Sivaganga,Hemophilia,35,60,1,1,2
Uttar Pradesh,Sitapur,Hemophilia,6,15,2,1,3
Uttar Pradesh,Sitapur,Hemophilia,15,35,14,3,17
Uttar Pradesh,Sitapur,Hemophilia,35,60,8,2,10
Uttar Pradesh,Sitapur,Hemophilia,60,80,2,1,3
Bihar,Sitamarhi,Hemophilia,15,35,1,0,1
Bihar,Sitamarhi,Hemophilia,35,60,3,0,3
Bihar,Sitamarhi,Hemophilia,60,80,1,0,1
Haryana,Sirsa,Hemophilia,6,15,2,0,2
Haryana,Sirsa,Hemophilia,15,35,12,0,12
Haryana,Sirsa,Hemophilia,35,60,1,0,1
Rajasthan,Sirohi,Hemophilia,6,15,1,0,1
Rajasthan,Sirohi,Hemophilia,15,35,3,0,3
Himachal Pradesh,Sirmaur,Hemophilia,6,15,3,0,3
Himachal Pradesh,Sirmaur,Hemophilia,35,60,1,0,1
Madhya Pradesh,Singrauli,Hemophilia,6,15,0,1,1
Madhya Pradesh,Singrauli,Hemophilia,15,35,4,0,4
Madhya Pradesh,Singrauli,Hemophilia,35,60,2,1,3
Madhya Pradesh,Singrauli,Hemophilia,60,80,2,0,2
Maharashtra,Sindhudurg,Hemophilia,0,6,1,0,1
Maharashtra,Sindhudurg,Hemophilia,6,15,3,0,3
Maharashtra,Sindhudurg,Hemophilia,15,35,4,0,4
Maharashtra,Sindhudurg,Hemophilia,35,60,1,0,1
Maharashtra,Sindhudurg,Hemophilia,60,80,2,0,2
Jharkhand,Simdega,Hemophilia,15,35,1,0,1
Jharkhand,Simdega,Hemophilia,35,60,2,0,2
Rajasthan,Sikar,Hemophilia,6,15,7,1,8
Rajasthan,Sikar,Hemophilia,15,35,15,0,15
Rajasthan,Sikar,Hemophilia,35,60,2,0,2
Madhya Pradesh,Sidhi,Hemophilia,15,35,8,1,9
Madhya Pradesh,Sidhi,Hemophilia,35,60,4,1,5
Madhya Pradesh,Sidhi,Hemophilia,60,80,2,2,4
Uttar Pradesh,Siddharth Nagar,Hemophilia,0,6,1,0,1
Uttar Pradesh,Siddharth Nagar,Hemophilia,6,15,4,3,7
Uttar Pradesh,Siddharth Nagar,Hemophilia,15,35,18,5,23
Uttar Pradesh,Siddharth Nagar,Hemophilia,35,60,22,4,26
Uttar Pradesh,Siddharth Nagar,Hemophilia,60,80,7,3,10
Uttar Pradesh,Shravasti,Hemophilia,15,35,2,1,3
Uttar Pradesh,Shravasti,Hemophilia,35,60,2,1,3
Uttar Pradesh,Shravasti,Hemophilia,60,80,1,0,1
Jammu And Kashmir,Shopian,Hemophilia,0,6,1,0,1
Jammu And Kashmir,Shopian,Hemophilia,6,15,1,0,1
Jammu And Kashmir,Shopian,Hemophilia,15,35,2,0,2
Jammu And Kashmir,Shopian,Hemophilia,35,60,1,1,2
Jammu And Kashmir,Shopian,Hemophilia,60,80,1,0,1
Madhya Pradesh,Shivpuri,Hemophilia,6,15,1,0,1
Madhya Pradesh,Shivpuri,Hemophilia,15,35,2,1,3
Madhya Pradesh,Shivpuri,Hemophilia,35,60,7,0,7
Madhya Pradesh,Shivpuri,Hemophilia,60,80,1,0,1
Karnataka,Shivamogga,Hemophilia,6,15,5,1,6
Karnataka,Shivamogga,Hemophilia,15,35,5,3,8
Karnataka,Shivamogga,Hemophilia,35,60,10,1,11
Karnataka,Shivamogga,Hemophilia,60,80,2,1,3
Himachal Pradesh,Shimla,Hemophilia,6,15,1,0,1
Himachal Pradesh,Shimla,Hemophilia,15,35,7,0,7
Himachal Pradesh,Shimla,Hemophilia,60,80,1,0,1
Madhya Pradesh,Sheopur,Hemophilia,6,15,2,0,2
Madhya Pradesh,Sheopur,Hemophilia,15,35,1,1,2
Bihar,Sheohar,Hemophilia,6,15,1,0,1
Bihar,Sheohar,Hemophilia,15,35,4,0,4
Bihar,Sheohar,Hemophilia,35,60,2,1,3
Bihar,Sheohar,Hemophilia,60,80,2,1,3
Bihar,Sheohar,Hemophilia,80,100,1,0,1
Bihar,Sheikhpura,Hemophilia,15,35,1,0,1
Bihar,Sheikhpura,Hemophilia,35,60,1,0,1
Uttar Pradesh,Shamli,Hemophilia,0,6,1,0,1
Uttar Pradesh,Shamli,Hemophilia,6,15,5,1,6
Uttar Pradesh,Shamli,Hemophilia,15,35,13,10,23
Uttar Pradesh,Shamli,Hemophilia,35,60,23,4,27
Uttar Pradesh,Shamli,Hemophilia,60,80,3,2,5
Madhya Pradesh,Shajapur,Hemophilia,15,35,3,1,4
Madhya Pradesh,Shajapur,Hemophilia,35,60,3,0,3
Madhya Pradesh,Shajapur,Hemophilia,60,80,1,0,1
Uttar Pradesh,Shahjahanpur,Hemophilia,0,6,1,0,1
Uttar Pradesh,Shahjahanpur,Hemophilia,6,15,6,2,8
Uttar Pradesh,Shahjahanpur,Hemophilia,15,35,50,17,67
Uttar Pradesh,Shahjahanpur,Hemophilia,35,60,32,21,53
Uttar Pradesh,Shahjahanpur,Hemophilia,60,80,6,3,9
Punjab,Shahid Bhagat Singh Nagar,Hemophilia,6,15,0,2,2
Punjab,Shahid Bhagat Singh Nagar,Hemophilia,15,35,5,4,9
Punjab,Shahid Bhagat Singh Nagar,Hemophilia,35,60,13,6,19
Punjab,Shahid Bhagat Singh Nagar,Hemophilia,60,80,5,0,5
Madhya Pradesh,Shahdol,Hemophilia,6,15,0,1,1
Madhya Pradesh,Shahdol,Hemophilia,15,35,1,3,4
Madhya Pradesh,Shahdol,Hemophilia,35,60,0,1,1
Madhya Pradesh,Shahdol,Hemophilia,60,80,1,0,1
Delhi,Shahdara,Hemophilia,15,35,2,0,2
Delhi,Shahdara,Hemophilia,35,60,1,0,1
Madhya Pradesh,Seoni,Hemophilia,6,15,1,0,1
Madhya Pradesh,Seoni,Hemophilia,15,35,4,0,4
Madhya Pradesh,Seoni,Hemophilia,35,60,12,2,14
Madhya Pradesh,Seoni,Hemophilia,60,80,2,2,4
Madhya Pradesh,Seoni,Hemophilia,80,100,1,0,1
Madhya Pradesh,Sehore,Hemophilia,0,6,2,0,2
Madhya Pradesh,Sehore,Hemophilia,6,15,1,0,1
Madhya Pradesh,Sehore,Hemophilia,60,80,1,0,1
Rajasthan,Sawai Madhopur,Hemophilia,0,6,1,0,1
Rajasthan,Sawai Madhopur,Hemophilia,6,15,6,1,7
Rajasthan,Sawai Madhopur,Hemophilia,15,35,2,0,2
Rajasthan,Sawai Madhopur,Hemophilia,35,60,1,0,1
Madhya Pradesh,Satna,Hemophilia,6,15,1,0,1
Madhya Pradesh,Satna,Hemophilia,15,35,4,0,4
Madhya Pradesh,Satna,Hemophilia,35,60,8,2,10
Maharashtra,Satara,Hemophilia,6,15,9,0,9
Maharashtra,Satara,Hemophilia,15,35,17,0,17
Maharashtra,Satara,Hemophilia,35,60,11,0,11
Maharashtra,Satara,Hemophilia,60,80,1,0,1
Bihar,Saran,Hemophilia,15,35,4,1,5
Bihar,Saran,Hemophilia,35,60,4,1,5
Bihar,Saran,Hemophilia,60,80,2,0,2
Jharkhand,Saraikela Kharsawan,Hemophilia,15,35,1,0,1
Jharkhand,Saraikela Kharsawan,Hemophilia,35,60,1,1,2
Jharkhand,Saraikela Kharsawan,Hemophilia,60,80,1,0,1
Uttar Pradesh,Sant Kabeer Nagar,Hemophilia,6,15,2,0,2
Uttar Pradesh,Sant Kabeer Nagar,Hemophilia,15,35,7,0,7
Uttar Pradesh,Sant Kabeer Nagar,Hemophilia,35,60,4,0,4
Uttar Pradesh,Sant Kabeer Nagar,Hemophilia,60,80,2,0,2
Punjab,Sangrur,Hemophilia,6,15,4,1,5
Punjab,Sangrur,Hemophilia,15,35,9,8,17
Punjab,Sangrur,Hemophilia,35,60,27,17,44
Punjab,Sangrur,Hemophilia,60,80,5,2,7
Punjab,Sangrur,Hemophilia,80,100,0,1,1
Maharashtra,Sangli,Hemophilia,6,15,14,0,14
Maharashtra,Sangli,Hemophilia,15,35,12,1,13
Maharashtra,Sangli,Hemophilia,35,60,2,0,2
Uttar Pradesh,Sambhal,Hemophilia,15,35,3,0,3
Odisha,Sambalpur,Hemophilia,0,6,1,0,1
Odisha,Sambalpur,Hemophilia,35,60,0,1,1
Jammu And Kashmir,Samba,Hemophilia,6,15,1,0,1
Jammu And Kashmir,Samba,Hemophilia,15,35,2,0,2
Jammu And Kashmir,Samba,Hemophilia,35,60,4,1,5
Jammu And Kashmir,Samba,Hemophilia,60,80,2,0,2
Bihar,Samastipur,Hemophilia,6,15,1,1,2
Bihar,Samastipur,Hemophilia,15,35,7,1,8
Bihar,Samastipur,Hemophilia,35,60,9,6,15
Bihar,Samastipur,Hemophilia,60,80,3,3,6
Tamil Nadu,Salem,Hemophilia,0,6,2,0,2
Tamil Nadu,Salem,Hemophilia,6,15,19,4,23
Tamil Nadu,Salem,Hemophilia,15,35,42,3,45
Tamil Nadu,Salem,Hemophilia,35,60,14,2,16
Jharkhand,Sahebganj,Hemophilia,6,15,1,1,2
Jharkhand,Sahebganj,Hemophilia,15,35,12,3,15
Jharkhand,Sahebganj,Hemophilia,35,60,8,7,15
Jharkhand,Sahebganj,Hemophilia,60,80,2,0,2
Bihar,Saharsa,Hemophilia,6,15,1,0,1
Bihar,Saharsa,Hemophilia,15,35,2,1,3
Bihar,Saharsa,Hemophilia,35,60,4,1,5
Bihar,Saharsa,Hemophilia,60,80,1,1,2
Uttar Pradesh,Saharanpur,Hemophilia,0,6,1,0,1
Uttar Pradesh,Saharanpur,Hemophilia,6,15,4,2,6
Uttar Pradesh,Saharanpur,Hemophilia,15,35,25,7,32
Uttar Pradesh,Saharanpur,Hemophilia,35,60,34,12,46
Uttar Pradesh,Saharanpur,Hemophilia,60,80,5,1,6
Madhya Pradesh,Sagar,Hemophilia,6,15,3,7,10
Madhya Pradesh,Sagar,Hemophilia,15,35,37,23,60
Madhya Pradesh,Sagar,Hemophilia,35,60,23,20,43
Madhya Pradesh,Sagar,Hemophilia,60,80,6,3,9
Madhya Pradesh,Sagar,Hemophilia,80,100,1,0,1
Gujarat,Sabar Kantha,Hemophilia,6,15,1,0,1
Gujarat,Sabar Kantha,Hemophilia,15,35,3,0,3
Gujarat,Sabar Kantha,Hemophilia,60,80,1,0,1
Punjab,S.A.S Nagar,Hemophilia,6,15,1,0,1
Punjab,S.A.S Nagar,Hemophilia,15,35,5,2,7
Punjab,S.A.S Nagar,Hemophilia,35,60,7,1,8
Punjab,Rupnagar,Hemophilia,6,15,1,0,1
Punjab,Rupnagar,Hemophilia,15,35,6,0,6
Punjab,Rupnagar,Hemophilia,35,60,4,4,8
Punjab,Rupnagar,Hemophilia,60,80,3,0,3
Uttarakhand,Rudra Prayag,Hemophilia,6,15,1,0,1
Uttarakhand,Rudra Prayag,Hemophilia,15,35,4,1,5
Uttarakhand,Rudra Prayag,Hemophilia,35,60,4,3,7
Uttarakhand,Rudra Prayag,Hemophilia,60,80,2,0,2
Bihar,Rohtas,Hemophilia,6,15,3,0,3
Bihar,Rohtas,Hemophilia,15,35,9,1,10
Bihar,Rohtas,Hemophilia,35,60,3,2,5
Bihar,Rohtas,Hemophilia,60,80,3,0,3
Haryana,Rohtak,Hemophilia,6,15,1,0,1
Haryana,Rohtak,Hemophilia,15,35,4,1,5
Haryana,Rewari,Hemophilia,6,15,5,0,5
Haryana,Rewari,Hemophilia,15,35,3,0,3
Haryana,Rewari,Hemophilia,35,60,1,0,1
Madhya Pradesh,Rewa,Hemophilia,0,6,0,1,1
Madhya Pradesh,Rewa,Hemophilia,6,15,2,0,2
Madhya Pradesh,Rewa,Hemophilia,15,35,8,1,9
Madhya Pradesh,Rewa,Hemophilia,35,60,1,2,3
Jammu And Kashmir,Reasi,Hemophilia,6,15,2,0,2
Jammu And Kashmir,Reasi,Hemophilia,15,35,1,1,2
Jammu And Kashmir,Reasi,Hemophilia,35,60,1,1,2
Jammu And Kashmir,Reasi,Hemophilia,60,80,1,0,1
Odisha,Rayagada,Hemophilia,15,35,4,1,5
Odisha,Rayagada,Hemophilia,35,60,1,1,2
Maharashtra,Ratnagiri,Hemophilia,6,15,9,0,9
Maharashtra,Ratnagiri,Hemophilia,15,35,10,0,10
Maharashtra,Ratnagiri,Hemophilia,35,60,6,0,6
Madhya Pradesh,Ratlam,Hemophilia,6,15,2,0,2
Madhya Pradesh,Ratlam,Hemophilia,15,35,5,1,6
Madhya Pradesh,Ratlam,Hemophilia,35,60,2,2,4
Tamil Nadu,Ranipet,Hemophilia,6,15,2,0,2
Tamil Nadu,Ranipet,Hemophilia,15,35,2,1,3
Tamil Nadu,Ranipet,Hemophilia,35,60,3,4,7
Tamil Nadu,Ranipet,Hemophilia,60,80,4,0,4
Jharkhand,Ranchi,Hemophilia,6,15,4,0,4
Jharkhand,Ranchi,Hemophilia,15,35,5,0,5
Jharkhand,Ranchi,Hemophilia,35,60,5,0,5
Uttar Pradesh,Rampur,Hemophilia,6,15,0,1,1
Uttar Pradesh,Rampur,Hemophilia,15,35,19,3,22
Uttar Pradesh,Rampur,Hemophilia,35,60,10,3,13
Uttar Pradesh,Rampur,Hemophilia,60,80,2,0,2
Uttar Pradesh,Rampur,Hemophilia,80,100,1,0,1
Jharkhand,Ramgarh,Hemophilia,0,6,1,0,1
Jharkhand,Ramgarh,Hemophilia,6,15,2,0,2
Jharkhand,Ramgarh,Hemophilia,15,35,6,5,11
Jharkhand,Ramgarh,Hemophilia,35,60,14,5,19
Jharkhand,Ramgarh,Hemophilia,60,80,3,0,3
Jammu And Kashmir,Ramban,Hemophilia,15,35,1,0,1
Tamil Nadu,Ramanathapuram,Hemophilia,6,15,6,0,6
Tamil Nadu,Ramanathapuram,Hemophilia,15,35,2,0,2
Tamil Nadu,Ramanathapuram,Hemophilia,35,60,2,0,2
Karnataka,Ramanagara,Hemophilia,6,15,3,1,4
Karnataka,Ramanagara,Hemophilia,15,35,6,1,7
Karnataka,Ramanagara,Hemophilia,35,60,13,4,17
Karnataka,Ramanagara,Hemophilia,60,80,12,0,12
Karnataka,Ramanagara,Hemophilia,80,100,1,0,1
Rajasthan,Rajsamand,Hemophilia,15,35,1,0,1
Rajasthan,Rajsamand,Hemophilia,35,60,1,1,2
Jammu And Kashmir,Rajouri,Hemophilia,6,15,5,0,5
Jammu And Kashmir,Rajouri,Hemophilia,15,35,3,2,5
Jammu And Kashmir,Rajouri,Hemophilia,35,60,1,0,1
Jammu And Kashmir,Rajouri,Hemophilia,60,80,1,0,1
Chhattisgarh,Rajnandgaon,Hemophilia,0,6,2,0,2
Chhattisgarh,Rajnandgaon,Hemophilia,6,15,0,2,2
Chhattisgarh,Rajnandgaon,Hemophilia,15,35,7,4,11
Chhattisgarh,Rajnandgaon,Hemophilia,35,60,8,5,13
Chhattisgarh,Rajnandgaon,Hemophilia,60,80,4,2,6
Gujarat,Rajkot,Hemophilia,15,35,1,0,1
Gujarat,Rajkot,Hemophilia,35,60,3,0,3
Gujarat,Rajkot,Hemophilia,60,80,1,0,1
Madhya Pradesh,Rajgarh,Hemophilia,6,15,1,0,1
Madhya Pradesh,Rajgarh,Hemophilia,15,35,7,3,10
Madhya Pradesh,Rajgarh,Hemophilia,35,60,3,0,3
Madhya Pradesh,Rajgarh,Hemophilia,60,80,1,0,1
Madhya Pradesh,Raisen,Hemophilia,0,6,2,0,2
Madhya Pradesh,Raisen,Hemophilia,6,15,2,1,3
Madhya Pradesh,Raisen,Hemophilia,15,35,4,1,5
Madhya Pradesh,Raisen,Hemophilia,60,80,1,0,1
Chhattisgarh,Raipur,Hemophilia,15,35,4,0,4
Chhattisgarh,Raipur,Hemophilia,35,60,1,1,2
Chhattisgarh,Raigarh,Hemophilia,6,15,2,0,2
Chhattisgarh,Raigarh,Hemophilia,15,35,5,0,5
Chhattisgarh,Raigarh,Hemophilia,35,60,1,2,3
Chhattisgarh,Raigarh,Hemophilia,60,80,2,0,2
Maharashtra,Raigad,Hemophilia,0,6,1,0,1
Maharashtra,Raigad,Hemophilia,6,15,3,0,3
Maharashtra,Raigad,Hemophilia,15,35,9,0,9
Maharashtra,Raigad,Hemophilia,35,60,9,0,9
Maharashtra,Raigad,Hemophilia,60,80,2,0,2
Karnataka,Raichur,Hemophilia,0,6,5,0,5
Karnataka,Raichur,Hemophilia,6,15,9,1,10
Karnataka,Raichur,Hemophilia,15,35,14,2,16
Karnataka,Raichur,Hemophilia,35,60,6,0,6
Uttar Pradesh,Rae Bareli,Hemophilia,0,6,1,0,1
Uttar Pradesh,Rae Bareli,Hemophilia,6,15,3,0,3
Uttar Pradesh,Rae Bareli,Hemophilia,15,35,4,0,4
Uttar Pradesh,Rae Bareli,Hemophilia,35,60,0,1,1
Bihar,Purnia,Hemophilia,15,35,1,0,1
Bihar,Purnia,Hemophilia,35,60,4,4,8
Bihar,Purnia,Hemophilia,60,80,2,0,2
Odisha,Puri,Hemophilia,6,15,2,2,4
Odisha,Puri,Hemophilia,15,35,5,1,6
Odisha,Puri,Hemophilia,35,60,4,4,8
Odisha,Puri,Hemophilia,60,80,4,0,4
Bihar,Purbi Champaran,Hemophilia,6,15,2,0,2
Bihar,Purbi Champaran,Hemophilia,15,35,17,4,21
Bihar,Purbi Champaran,Hemophilia,35,60,9,5,14
Bihar,Purbi Champaran,Hemophilia,60,80,8,1,9
Maharashtra,Pune,Hemophilia,0,6,4,1,5
Maharashtra,Pune,Hemophilia,6,15,29,1,30
Maharashtra,Pune,Hemophilia,15,35,69,0,69
Maharashtra,Pune,Hemophilia,35,60,27,2,29
Maharashtra,Pune,Hemophilia,60,80,1,0,1
Jammu And Kashmir,Pulwama,Hemophilia,0,6,2,0,2
Jammu And Kashmir,Pulwama,Hemophilia,6,15,4,0,4
Jammu And Kashmir,Pulwama,Hemophilia,15,35,2,1,3
Jammu And Kashmir,Pulwama,Hemophilia,35,60,2,1,3
Tamil Nadu,Pudukkottai,Hemophilia,0,6,1,0,1
Tamil Nadu,Pudukkottai,Hemophilia,6,15,3,0,3
Tamil Nadu,Pudukkottai,Hemophilia,15,35,5,0,5
Tamil Nadu,Pudukkottai,Hemophilia,35,60,2,0,2
Uttar Pradesh,Prayagraj,Hemophilia,6,15,3,0,3
Uttar Pradesh,Prayagraj,Hemophilia,15,35,10,1,11
Uttar Pradesh,Prayagraj,Hemophilia,35,60,5,1,6
Uttar Pradesh,Prayagraj,Hemophilia,60,80,2,1,3
Rajasthan,Pratapgarh,Hemophilia,15,35,1,1,2
Rajasthan,Pratapgarh,Hemophilia,60,80,1,1,2
Uttar Pradesh,Pratapgarh,Hemophilia,15,35,12,1,13
Uttar Pradesh,Pratapgarh,Hemophilia,35,60,8,4,12
Uttar Pradesh,Pratapgarh,Hemophilia,60,80,4,2,6
Andhra Pradesh,Prakasam,Hemophilia,15,35,1,0,1
Andhra Pradesh,Prakasam,Hemophilia,60,80,1,0,1
Gujarat,Porbandar,Hemophilia,6,15,1,0,1
Gujarat,Porbandar,Hemophilia,15,35,5,0,5
Gujarat,Porbandar,Hemophilia,35,60,1,0,1
Jammu And Kashmir,Poonch,Hemophilia,0,6,2,3,5
Jammu And Kashmir,Poonch,Hemophilia,6,15,9,5,14
Jammu And Kashmir,Poonch,Hemophilia,15,35,11,7,18
Jammu And Kashmir,Poonch,Hemophilia,35,60,11,7,18
Jammu And Kashmir,Poonch,Hemophilia,60,80,3,0,3
Jammu And Kashmir,Poonch,Hemophilia,80,100,1,0,1
Puducherry,Pondicherry,Hemophilia,15,35,2,0,2
Puducherry,Pondicherry,Hemophilia,35,60,0,1,1
Uttarakhand,Pithoragarh,Hemophilia,0,6,1,0,1
Uttarakhand,Pithoragarh,Hemophilia,15,35,3,0,3
Uttar Pradesh,Pilibhit,Hemophilia,6,15,6,1,7
Uttar Pradesh,Pilibhit,Hemophilia,15,35,34,9,43
Uttar Pradesh,Pilibhit,Hemophilia,35,60,31,10,41
Uttar Pradesh,Pilibhit,Hemophilia,60,80,10,1,11
Tamil Nadu,Perambalur,Hemophilia,0,6,1,0,1
Tamil Nadu,Perambalur,Hemophilia,6,15,6,0,6
Tamil Nadu,Perambalur,Hemophilia,15,35,6,0,6
Tamil Nadu,Perambalur,Hemophilia,35,60,1,2,3
Uttarakhand,Pauri Garhwal,Hemophilia,0,6,1,0,1
Uttarakhand,Pauri Garhwal,Hemophilia,6,15,1,0,1
Uttarakhand,Pauri Garhwal,Hemophilia,15,35,9,1,10
Uttarakhand,Pauri Garhwal,Hemophilia,35,60,14,1,15
Uttarakhand,Pauri Garhwal,Hemophilia,60,80,6,0,6
Uttarakhand,Pauri Garhwal,Hemophilia,80,100,1,1,2
Bihar,Patna,Hemophilia,0,6,0,2,2
Bihar,Patna,Hemophilia,6,15,1,4,5
Bihar,Patna,Hemophilia,15,35,20,2,22
Bihar,Patna,Hemophilia,35,60,8,5,13
Bihar,Patna,Hemophilia,60,80,1,0,1
Punjab,Patiala,Hemophilia,0,6,4,0,4
Punjab,Patiala,Hemophilia,6,15,7,1,8
Punjab,Patiala,Hemophilia,15,35,29,4,33
Punjab,Patiala,Hemophilia,35,60,26,14,40
Punjab,Patiala,Hemophilia,60,80,8,5,13
Punjab,Pathankot,Hemophilia,6,15,3,0,3
Punjab,Pathankot,Hemophilia,15,35,4,1,5
Punjab,Pathankot,Hemophilia,35,60,8,2,10
Punjab,Pathankot,Hemophilia,60,80,7,2,9
Kerala,Pathanamthitta,Hemophilia,15,35,5,0,5
Kerala,Pathanamthitta,Hemophilia,35,60,1,0,1
Kerala,Pathanamthitta,Hemophilia,60,80,2,0,2
Gujarat,Patan,Hemophilia,6,15,1,0,1
Gujarat,Patan,Hemophilia,15,35,5,0,5
Gujarat,Patan,Hemophilia,35,60,4,0,4
Gujarat,Patan,Hemophilia,60,80,1,0,1
Bihar,Pashchim Champaran,Hemophilia,0,6,1,0,1
Bihar,Pashchim Champaran,Hemophilia,15,35,10,5,15
Bihar,Pashchim Champaran,Hemophilia,35,60,8,7,15
Bihar,Pashchim Champaran,Hemophilia,60,80,7,1,8
Maharashtra,Parbhani,Hemophilia,0,6,1,0,1
Maharashtra,Parbhani,Hemophilia,6,15,2,0,2
Maharashtra,Parbhani,Hemophilia,15,35,15,1,16
Maharashtra,Parbhani,Hemophilia,35,60,3,0,3
Arunachal Pradesh,Papum Pare,Hemophilia,15,35,0,1,1
Madhya Pradesh,Panna,Hemophilia,6,15,0,2,2
Madhya Pradesh,Panna,Hemophilia,15,35,8,2,10
Madhya Pradesh,Panna,Hemophilia,35,60,10,4,14
Madhya Pradesh,Panna,Hemophilia,60,80,3,0,3
Haryana,Panipat,Hemophilia,0,6,1,0,1
Haryana,Panipat,Hemophilia,15,35,7,0,7
Haryana,Panipat,Hemophilia,35,60,1,0,1
Haryana,Panipat,Hemophilia,60,80,1,0,1
Haryana,Panchkula,Hemophilia,6,15,2,0,2
Haryana,Panchkula,Hemophilia,15,35,2,1,3
Haryana,Panchkula,Hemophilia,60,80,1,0,1
Gujarat,Panch Mahals,Hemophilia,0,6,3,0,3
Gujarat,Panch Mahals,Hemophilia,6,15,5,0,5
Gujarat,Panch Mahals,Hemophilia,15,35,5,0,5
Gujarat,Panch Mahals,Hemophilia,35,60,1,0,1
Gujarat,Panch Mahals,Hemophilia,60,80,2,0,2
Haryana,Palwal,Hemophilia,0,6,2,0,2
Haryana,Palwal,Hemophilia,6,15,15,0,15
Haryana,Palwal,Hemophilia,15,35,14,0,14
Haryana,Palwal,Hemophilia,35,60,2,0,2
Haryana,Palwal,Hemophilia,60,80,1,0,1
Rajasthan,Pali,Hemophilia,0,6,2,0,2
Rajasthan,Pali,Hemophilia,6,15,6,0,6
Rajasthan,Pali,Hemophilia,15,35,3,0,3
Rajasthan,Pali,Hemophilia,35,60,1,0,1
Maharashtra,Palghar,Hemophilia,0,6,1,0,1
Maharashtra,Palghar,Hemophilia,6,15,4,0,4
Maharashtra,Palghar,Hemophilia,15,35,15,1,16
Maharashtra,Palghar,Hemophilia,35,60,6,0,6
Maharashtra,Palghar,Hemophilia,60,80,5,0,5
Jharkhand,Palamu,Hemophilia,0,6,3,0,3
Jharkhand,Palamu,Hemophilia,6,15,3,0,3
Jharkhand,Palamu,Hemophilia,15,35,8,3,11
Jharkhand,Palamu,Hemophilia,35,60,6,1,7
Jharkhand,Palamu,Hemophilia,60,80,1,0,1
Kerala,Palakkad,Hemophilia,0,6,1,0,1
Kerala,Palakkad,Hemophilia,6,15,9,0,9
Kerala,Palakkad,Hemophilia,15,35,15,0,15
Kerala,Palakkad,Hemophilia,35,60,6,0,6
Kerala,Palakkad,Hemophilia,60,80,1,1,2
Jharkhand,Pakur,Hemophilia,15,35,1,0,1
Jharkhand,Pakur,Hemophilia,35,60,0,1,1
Maharashtra,Osmanabad,Hemophilia,6,15,4,0,4
Maharashtra,Osmanabad,Hemophilia,15,35,6,0,6
Maharashtra,Osmanabad,Hemophilia,35,60,1,0,1
Haryana,Nuh,Hemophilia,6,15,2,0,2
Haryana,Nuh,Hemophilia,15,35,3,2,5
Haryana,Nuh,Hemophilia,35,60,0,1,1
Odisha,Nuapada,Hemophilia,15,35,2,1,3
Odisha,Nuapada,Hemophilia,35,60,2,0,2
Delhi,North West,Hemophilia,6,15,6,0,6
Delhi,North West,Hemophilia,15,35,10,0,10
Goa,North Goa,Hemophilia,35,60,4,0,4
Goa,North Goa,Hemophilia,60,80,0,1,1
Delhi,North East,Hemophilia,6,15,4,0,4
Delhi,North East,Hemophilia,15,35,2,0,2
Andaman And Nicobar Islands,North And Middle Andaman,Hemophilia,15,35,2,0,2
Andaman And Nicobar Islands,North And Middle Andaman,Hemophilia,35,60,3,2,5
Delhi,North,Hemophilia,6,15,2,0,2
Delhi,North,Hemophilia,15,35,1,0,1
Delhi,North,Hemophilia,35,60,1,0,1
Delhi,North,Hemophilia,60,80,1,0,1
Madhya Pradesh,Niwari,Hemophilia,6,15,1,1,2
Madhya Pradesh,Niwari,Hemophilia,15,35,3,1,4
Madhya Pradesh,Niwari,Hemophilia,35,60,7,1,8
Madhya Pradesh,Niwari,Hemophilia,60,80,4,1,5
Andaman And Nicobar Islands,Nicobars,Hemophilia,60,80,1,0,1
Madhya Pradesh,Neemuch,Hemophilia,35,60,2,0,2
Odisha,Nayagarh,Hemophilia,0,6,1,0,1
Odisha,Nayagarh,Hemophilia,6,15,8,2,10
Odisha,Nayagarh,Hemophilia,15,35,4,1,5
Odisha,Nayagarh,Hemophilia,35,60,3,0,3
Odisha,Nayagarh,Hemophilia,60,80,2,1,3
Odisha,Nayagarh,Hemophilia,80,100,1,0,1
Bihar,Nawada,Hemophilia,6,15,4,2,6
Bihar,Nawada,Hemophilia,15,35,6,3,9
Bihar,Nawada,Hemophilia,35,60,5,2,7
Bihar,Nawada,Hemophilia,60,80,2,0,2
Gujarat,Navsari,Hemophilia,15,35,2,0,2
Gujarat,Navsari,Hemophilia,35,60,1,0,1
Maharashtra,Nashik,Hemophilia,0,6,4,0,4
Maharashtra,Nashik,Hemophilia,6,15,24,0,24
Maharashtra,Nashik,Hemophilia,15,35,43,1,44
Maharashtra,Nashik,Hemophilia,35,60,18,0,18
Maharashtra,Nashik,Hemophilia,60,80,2,0,2
Madhya Pradesh,Narsinghpur,Hemophilia,6,15,2,1,3
Madhya Pradesh,Narsinghpur,Hemophilia,15,35,16,9,25
Madhya Pradesh,Narsinghpur,Hemophilia,35,60,42,10,52
Madhya Pradesh,Narsinghpur,Hemophilia,60,80,16,1,17
Madhya Pradesh,Narmadapuram,Hemophilia,15,35,1,0,1
Madhya Pradesh,Narmadapuram,Hemophilia,35,60,5,0,5
Madhya Pradesh,Narmadapuram,Hemophilia,60,80,1,1,2
Gujarat,Narmada,Hemophilia,6,15,2,0,2
Gujarat,Narmada,Hemophilia,15,35,1,0,1
Gujarat,Narmada,Hemophilia,35,60,2,0,2
Gujarat,Narmada,Hemophilia,60,80,1,0,1
Chhattisgarh,Narayanpur,Hemophilia,35,60,1,0,1
Maharashtra,Nandurbar,Hemophilia,6,15,4,0,4
Maharashtra,Nandurbar,Hemophilia,15,35,3,0,3
Maharashtra,Nanded,Hemophilia,6,15,5,0,5
Maharashtra,Nanded,Hemophilia,15,35,8,2,10
Maharashtra,Nanded,Hemophilia,35,60,7,0,7
Maharashtra,Nanded,Hemophilia,60,80,2,0,2
Sikkim,Namchi,Hemophilia,35,60,3,0,3
Sikkim,Namchi,Hemophilia,60,80,1,0,1
Tamil Nadu,Namakkal,Hemophilia,0,6,2,0,2
Tamil Nadu,Namakkal,Hemophilia,6,15,8,1,9
Tamil Nadu,Namakkal,Hemophilia,15,35,12,0,12
Tamil Nadu,Namakkal,Hemophilia,35,60,11,1,12
Tamil Nadu,Namakkal,Hemophilia,60,80,2,0,2
Assam,Nalbari,Hemophilia,6,15,4,1,5
Assam,Nalbari,Hemophilia,15,35,2,0,2
Assam,Nalbari,Hemophilia,35,60,1,0,1
Bihar,Nalanda,Hemophilia,0,6,1,1,2
Bihar,Nalanda,Hemophilia,6,15,1,0,1
Bihar,Nalanda,Hemophilia,15,35,2,0,2
Bihar,Nalanda,Hemophilia,35,60,3,0,3
Bihar,Nalanda,Hemophilia,60,80,0,1,1
Uttarakhand,Nainital,Hemophilia,0,6,2,0,2
Uttarakhand,Nainital,Hemophilia,6,15,6,0,6
Uttarakhand,Nainital,Hemophilia,15,35,7,2,9
Uttarakhand,Nainital,Hemophilia,35,60,1,0,1
Maharashtra,Nagpur,Hemophilia,6,15,14,0,14
Maharashtra,Nagpur,Hemophilia,15,35,28,1,29
Maharashtra,Nagpur,Hemophilia,35,60,9,1,10
Maharashtra,Nagpur,Hemophilia,60,80,1,0,1
Rajasthan,Nagaur,Hemophilia,0,6,1,0,1
Rajasthan,Nagaur,Hemophilia,6,15,4,0,4
Rajasthan,Nagaur,Hemophilia,15,35,6,0,6
Rajasthan,Nagaur,Hemophilia,35,60,1,0,1
Tamil Nadu,Nagapattinam,Hemophilia,6,15,0,1,1
Tamil Nadu,Nagapattinam,Hemophilia,15,35,4,0,4
Tamil Nadu,Nagapattinam,Hemophilia,35,60,2,2,4
Assam,Nagaon,Hemophilia,15,35,1,1,2
Assam,Nagaon,Hemophilia,35,60,0,3,3
Assam,Nagaon,Hemophilia,60,80,1,0,1
Odisha,Nabarangpur,Hemophilia,6,15,1,0,1
Odisha,Nabarangpur,Hemophilia,15,35,1,0,1
Odisha,Nabarangpur,Hemophilia,35,60,1,0,1
Karnataka,Mysuru,Hemophilia,0,6,4,0,4
Karnataka,Mysuru,Hemophilia,6,15,6,2,8
Karnataka,Mysuru,Hemophilia,15,35,20,7,27
Karnataka,Mysuru,Hemophilia,35,60,26,8,34
Karnataka,Mysuru,Hemophilia,60,80,4,0,4
Bihar,Muzaffarpur,Hemophilia,0,6,1,0,1
Bihar,Muzaffarpur,Hemophilia,6,15,3,1,4
Bihar,Muzaffarpur,Hemophilia,15,35,6,2,8
Bihar,Muzaffarpur,Hemophilia,35,60,12,2,14
Bihar,Muzaffarpur,Hemophilia,60,80,4,0,4
Uttar Pradesh,Muzaffarnagar,Hemophilia,15,35,8,1,9
Uttar Pradesh,Muzaffarnagar,Hemophilia,35,60,3,1,4
Uttar Pradesh,Muzaffarnagar,Hemophilia,60,80,4,0,4
Bihar,Munger,Hemophilia,6,15,1,0,1
Bihar,Munger,Hemophilia,15,35,6,3,9
Bihar,Munger,Hemophilia,35,60,12,1,13
Bihar,Munger,Hemophilia,60,80,4,0,4
Chhattisgarh,Mungeli,Hemophilia,15,35,2,0,2
Chhattisgarh,Mungeli,Hemophilia,35,60,0,1,1
Chhattisgarh,Mungeli,Hemophilia,60,80,0,1,1
Maharashtra,Mumbai Suburban,Hemophilia,0,6,1,0,1
Maharashtra,Mumbai Suburban,Hemophilia,6,15,7,0,7
Maharashtra,Mumbai Suburban,Hemophilia,15,35,18,0,18
Maharashtra,Mumbai Suburban,Hemophilia,35,60,11,0,11
Maharashtra,Mumbai Suburban,Hemophilia,60,80,1,0,1
Maharashtra,Mumbai,Hemophilia,0,6,1,0,1
Maharashtra,Mumbai,Hemophilia,6,15,7,0,7
Maharashtra,Mumbai,Hemophilia,15,35,17,0,17
Maharashtra,Mumbai,Hemophilia,35,60,5,0,5
Maharashtra,Mumbai,Hemophilia,60,80,1,0,1
Madhya Pradesh,Morena,Hemophilia,6,15,7,0,7
Madhya Pradesh,Morena,Hemophilia,15,35,13,2,15
Madhya Pradesh,Morena,Hemophilia,35,60,12,3,15
Madhya Pradesh,Morena,Hemophilia,60,80,7,1,8
Gujarat,Morbi,Hemophilia,6,15,1,0,1
Gujarat,Morbi,Hemophilia,15,35,1,0,1
Gujarat,Morbi,Hemophilia,35,60,1,0,1
Uttar Pradesh,Moradabad,Hemophilia,6,15,1,0,1
Uttar Pradesh,Moradabad,Hemophilia,15,35,3,0,3
Uttar Pradesh,Moradabad,Hemophilia,35,60,3,1,4
Nagaland,Mon,Hemophilia,15,35,1,0,1
Nagaland,Mon,Hemophilia,35,60,1,0,1
Nagaland,Mon,Hemophilia,60,80,1,0,1
Punjab,Moga,Hemophilia,6,15,6,0,6
Punjab,Moga,Hemophilia,15,35,12,8,20
Punjab,Moga,Hemophilia,35,60,13,11,24
Punjab,Moga,Hemophilia,60,80,8,1,9
Uttar Pradesh,Mirzapur,Hemophilia,15,35,7,1,8
Uttar Pradesh,Mirzapur,Hemophilia,35,60,4,1,5
Uttar Pradesh,Meerut,Hemophilia,6,15,1,0,1
Uttar Pradesh,Meerut,Hemophilia,15,35,29,3,32
Uttar Pradesh,Meerut,Hemophilia,35,60,23,6,29
Uttar Pradesh,Meerut,Hemophilia,60,80,8,3,11
Uttar Pradesh,Meerut,Hemophilia,80,100,2,0,2
Odisha,Mayurbhanj,Hemophilia,0,6,1,0,1
Odisha,Mayurbhanj,Hemophilia,6,15,5,0,5
Odisha,Mayurbhanj,Hemophilia,15,35,4,1,5
Odisha,Mayurbhanj,Hemophilia,35,60,14,2,16
Odisha,Mayurbhanj,Hemophilia,60,80,6,0,6
Tamil Nadu,Mayiladuthurai,Hemophilia,6,15,1,0,1
Tamil Nadu,Mayiladuthurai,Hemophilia,60,80,1,0,1
Uttar Pradesh,Mau,Hemophilia,6,15,2,0,2
Uttar Pradesh,Mau,Hemophilia,15,35,7,0,7
Uttar Pradesh,Mathura,Hemophilia,6,15,6,0,6
Uttar Pradesh,Mathura,Hemophilia,15,35,13,0,13
Uttar Pradesh,Mathura,Hemophilia,35,60,3,0,3
Assam,Marigaon,Hemophilia,0,6,1,0,1
Assam,Marigaon,Hemophilia,6,15,1,0,1
Assam,Marigaon,Hemophilia,15,35,2,1,3
Assam,Marigaon,Hemophilia,35,60,1,1,2
Punjab,Mansa,Hemophilia,6,15,2,0,2
Punjab,Mansa,Hemophilia,15,35,8,4,12
Punjab,Mansa,Hemophilia,35,60,9,10,19
Punjab,Mansa,Hemophilia,60,80,1,0,1
Karnataka,Mandya,Hemophilia,0,6,1,0,1
Karnataka,Mandya,Hemophilia,6,15,7,5,12
Karnataka,Mandya,Hemophilia,15,35,12,3,15
Karnataka,Mandya,Hemophilia,35,60,10,3,13
Karnataka,Mandya,Hemophilia,60,80,6,2,8
Madhya Pradesh,Mandsaur,Hemophilia,35,60,2,0,2
Madhya Pradesh,Mandsaur,Hemophilia,60,80,1,1,2
Madhya Pradesh,Mandla,Hemophilia,6,15,1,0,1
Madhya Pradesh,Mandla,Hemophilia,15,35,3,3,6
Madhya Pradesh,Mandla,Hemophilia,35,60,3,1,4
Madhya Pradesh,Mandla,Hemophilia,60,80,2,0,2
Himachal Pradesh,Mandi,Hemophilia,6,15,3,0,3
Himachal Pradesh,Mandi,Hemophilia,15,35,6,3,9
Himachal Pradesh,Mandi,Hemophilia,35,60,5,1,6
Himachal Pradesh,Mandi,Hemophilia,60,80,3,2,5
Odisha,Malkangiri,Hemophilia,6,15,0,1,1
Odisha,Malkangiri,Hemophilia,35,60,1,2,3
Odisha,Malkangiri,Hemophilia,60,80,2,0,2
Punjab,Malerkotla,Hemophilia,15,35,3,0,3
Kerala,Malappuram,Hemophilia,0,6,5,0,5
Kerala,Malappuram,Hemophilia,6,15,8,1,9
Kerala,Malappuram,Hemophilia,15,35,26,0,26
Kerala,Malappuram,Hemophilia,35,60,7,1,8
Kerala,Malappuram,Hemophilia,60,80,0,2,2
Assam,Majuli,Hemophilia,15,35,2,0,2
Assam,Majuli,Hemophilia,60,80,0,1,1
Uttar Pradesh,Mainpuri,Hemophilia,6,15,1,0,1
Uttar Pradesh,Mainpuri,Hemophilia,15,35,12,2,14
Uttar Pradesh,Mainpuri,Hemophilia,35,60,4,0,4
Uttar Pradesh,Mahoba,Hemophilia,6,15,4,2,6
Uttar Pradesh,Mahoba,Hemophilia,15,35,18,6,24
Uttar Pradesh,Mahoba,Hemophilia,35,60,48,9,57
Uttar Pradesh,Mahoba,Hemophilia,60,80,6,2,8
Uttar Pradesh,Mahoba,Hemophilia,80,100,1,0,1
Gujarat,Mahisagar,Hemophilia,6,15,2,0,2
Gujarat,Mahisagar,Hemophilia,15,35,2,0,2
Gujarat,Mahisagar,Hemophilia,60,80,1,0,1
Gujarat,Mahesana,Hemophilia,0,6,1,0,1
Gujarat,Mahesana,Hemophilia,6,15,2,0,2
Gujarat,Mahesana,Hemophilia,15,35,2,0,2
Gujarat,Mahesana,Hemophilia,60,80,1,0,1
Haryana,Mahendragarh,Hemophilia,6,15,1,0,1
Haryana,Mahendragarh,Hemophilia,15,35,5,1,6
Haryana,Mahendragarh,Hemophilia,35,60,14,2,16
Haryana,Mahendragarh,Hemophilia,60,80,4,2,6
Chhattisgarh,Mahasamund,Hemophilia,35,60,1,0,1
Chhattisgarh,Mahasamund,Hemophilia,60,80,1,0,1
Uttar Pradesh,Maharajganj,Hemophilia,6,15,2,0,2
Uttar Pradesh,Maharajganj,Hemophilia,15,35,6,0,6
Tamil Nadu,Madurai,Hemophilia,6,15,6,1,7
Tamil Nadu,Madurai,Hemophilia,15,35,11,2,13
Tamil Nadu,Madurai,Hemophilia,35,60,3,2,5
Bihar,Madhubani,Hemophilia,6,15,2,0,2
Bihar,Madhubani,Hemophilia,15,35,5,2,7
Bihar,Madhubani,Hemophilia,35,60,6,4,10
Bihar,Madhubani,Hemophilia,60,80,3,0,3
Bihar,Madhubani,Hemophilia,80,100,1,0,1
Bihar,Madhepura,Hemophilia,6,15,2,2,4
Bihar,Madhepura,Hemophilia,15,35,12,7,19
Bihar,Madhepura,Hemophilia,35,60,14,4,18
Bihar,Madhepura,Hemophilia,60,80,3,2,5
Punjab,Ludhiana,Hemophilia,0,6,1,0,1
Punjab,Ludhiana,Hemophilia,6,15,7,0,7
Punjab,Ludhiana,Hemophilia,15,35,21,3,24
Punjab,Ludhiana,Hemophilia,35,60,32,15,47
Punjab,Ludhiana,Hemophilia,60,80,3,2,5
Uttar Pradesh,Lucknow,Hemophilia,6,15,3,1,4
Uttar Pradesh,Lucknow,Hemophilia,15,35,26,7,33
Uttar Pradesh,Lucknow,Hemophilia,35,60,44,2,46
Uttar Pradesh,Lucknow,Hemophilia,60,80,11,1,12
Jharkhand,Lohardaga,Hemophilia,6,15,1,1,2
Jharkhand,Lohardaga,Hemophilia,15,35,0,2,2
Jharkhand,Lohardaga,Hemophilia,35,60,7,6,13
Jharkhand,Lohardaga,Hemophilia,60,80,2,0,2
Maharashtra,Latur,Hemophilia,6,15,3,0,3
Maharashtra,Latur,Hemophilia,15,35,13,2,15
Maharashtra,Latur,Hemophilia,35,60,6,1,7
Maharashtra,Latur,Hemophilia,60,80,2,0,2
Jharkhand,Latehar,Hemophilia,6,15,1,0,1
Uttar Pradesh,Lalitpur,Hemophilia,6,15,2,1,3
Uttar Pradesh,Lalitpur,Hemophilia,15,35,3,4,7
Uttar Pradesh,Lalitpur,Hemophilia,35,60,5,0,5
Uttar Pradesh,Lalitpur,Hemophilia,60,80,1,0,1
Bihar,Lakhisarai,Hemophilia,6,15,0,1,1
Bihar,Lakhisarai,Hemophilia,15,35,4,2,6
Bihar,Lakhisarai,Hemophilia,35,60,2,2,4
Bihar,Lakhisarai,Hemophilia,60,80,2,2,4
Assam,Lakhimpur,Hemophilia,6,15,2,0,2
Assam,Lakhimpur,Hemophilia,15,35,1,3,4
Assam,Lakhimpur,Hemophilia,35,60,9,1,10
Uttar Pradesh,Kushi Nagar,Hemophilia,6,15,1,0,1
Uttar Pradesh,Kushi Nagar,Hemophilia,15,35,13,4,17
Uttar Pradesh,Kushi Nagar,Hemophilia,35,60,10,3,13
Uttar Pradesh,Kushi Nagar,Hemophilia,60,80,1,0,1
Haryana,Kurukshetra,Hemophilia,6,15,2,0,2
Haryana,Kurukshetra,Hemophilia,15,35,5,2,7
Haryana,Kurukshetra,Hemophilia,35,60,1,0,1
Andhra Pradesh,Kurnool,Hemophilia,15,35,2,0,2
Andhra Pradesh,Kurnool,Hemophilia,35,60,0,1,1
Jammu And Kashmir,Kupwara,Hemophilia,0,6,4,0,4
Jammu And Kashmir,Kupwara,Hemophilia,6,15,8,3,11
Jammu And Kashmir,Kupwara,Hemophilia,15,35,9,3,12
Jammu And Kashmir,Kupwara,Hemophilia,35,60,3,4,7
Himachal Pradesh,Kullu,Hemophilia,6,15,1,0,1
Jammu And Kashmir,Kulgam,Hemophilia,6,15,4,0,4
Jammu And Kashmir,Kulgam,Hemophilia,15,35,5,0,5
Jammu And Kashmir,Kulgam,Hemophilia,35,60,1,0,1
Tamil Nadu,Krishnagiri,Hemophilia,6,15,3,0,3
Tamil Nadu,Krishnagiri,Hemophilia,15,35,5,4,9
Tamil Nadu,Krishnagiri,Hemophilia,35,60,7,6,13
Tamil Nadu,Krishnagiri,Hemophilia,60,80,1,0,1
Kerala,Kozhikode,Hemophilia,0,6,2,0,2
Kerala,Kozhikode,Hemophilia,6,15,12,1,13
Kerala,Kozhikode,Hemophilia,15,35,15,1,16
Kerala,Kozhikode,Hemophilia,35,60,12,2,14
Kerala,Kozhikode,Hemophilia,60,80,2,0,2
Kerala,Kottayam,Hemophilia,15,35,7,1,8
Kerala,Kottayam,Hemophilia,35,60,1,0,1
Rajasthan,Kota,Hemophilia,6,15,2,0,2
Rajasthan,Kota,Hemophilia,15,35,3,0,3
Rajasthan,Kota,Hemophilia,35,60,8,0,8
Chhattisgarh,Korea,Hemophilia,6,15,3,0,3
Chhattisgarh,Korea,Hemophilia,15,35,5,2,7
Chhattisgarh,Korea,Hemophilia,35,60,8,9,17
Chhattisgarh,Korea,Hemophilia,60,80,4,3,7
Chhattisgarh,Korea,Hemophilia,80,100,1,0,1
Chhattisgarh,Korba,Hemophilia,15,35,1,1,2
Chhattisgarh,Korba,Hemophilia,35,60,1,0,1
Odisha,Koraput,Hemophilia,15,35,2,0,2
Karnataka,Koppal,Hemophilia,0,6,1,1,2
Karnataka,Koppal,Hemophilia,6,15,6,1,7
Karnataka,Koppal,Hemophilia,15,35,15,1,16
Karnataka,Koppal,Hemophilia,35,60,6,3,9
Karnataka,Koppal,Hemophilia,60,80,3,0,3
Chhattisgarh,Kondagaon,Hemophilia,6,15,2,0,2
Chhattisgarh,Kondagaon,Hemophilia,15,35,9,4,13
Chhattisgarh,Kondagaon,Hemophilia,35,60,22,9,31
Chhattisgarh,Kondagaon,Hemophilia,60,80,9,5,14
Chhattisgarh,Kondagaon,Hemophilia,80,100,0,1,1
Kerala,Kollam,Hemophilia,0,6,3,0,3
Kerala,Kollam,Hemophilia,6,15,5,2,7
Kerala,Kollam,Hemophilia,15,35,10,0,10
Kerala,Kollam,Hemophilia,35,60,7,0,7
Maharashtra,Kolhapur,Hemophilia,6,15,8,0,8
Maharashtra,Kolhapur,Hemophilia,15,35,10,1,11
Maharashtra,Kolhapur,Hemophilia,35,60,8,2,10
Maharashtra,Kolhapur,Hemophilia,60,80,2,0,2
Karnataka,Kolar,Hemophilia,0,6,0,1,1
Karnataka,Kolar,Hemophilia,6,15,0,1,1
Karnataka,Kolar,Hemophilia,15,35,4,2,6
Karnataka,Kolar,Hemophilia,35,60,10,2,12
Assam,Kokrajhar,Hemophilia,15,35,1,0,1
Assam,Kokrajhar,Hemophilia,35,60,1,0,1
Jharkhand,Koderma,Hemophilia,6,15,10,4,14
Jharkhand,Koderma,Hemophilia,15,35,24,15,39
Jharkhand,Koderma,Hemophilia,35,60,23,10,33
Jharkhand,Koderma,Hemophilia,60,80,7,0,7
Karnataka,Kodagu,Hemophilia,6,15,3,0,3
Karnataka,Kodagu,Hemophilia,15,35,2,0,2
Jammu And Kashmir,Kishtwar,Hemophilia,6,15,1,0,1
Jammu And Kashmir,Kishtwar,Hemophilia,15,35,1,0,1
Jammu And Kashmir,Kishtwar,Hemophilia,35,60,3,0,3
Jammu And Kashmir,Kishtwar,Hemophilia,60,80,1,2,3
Bihar,Kishanganj,Hemophilia,0,6,1,0,1
Bihar,Kishanganj,Hemophilia,6,15,0,2,2
Bihar,Kishanganj,Hemophilia,15,35,3,4,7
Bihar,Kishanganj,Hemophilia,35,60,6,2,8
Bihar,Kishanganj,Hemophilia,60,80,5,1,6
Jharkhand,Khunti,Hemophilia,6,15,3,1,4
Jharkhand,Khunti,Hemophilia,15,35,3,5,8
Jharkhand,Khunti,Hemophilia,35,60,9,3,12
Jharkhand,Khunti,Hemophilia,60,80,1,0,1
Odisha,Khordha,Hemophilia,0,6,2,0,2
Odisha,Khordha,Hemophilia,6,15,6,2,8
Odisha,Khordha,Hemophilia,15,35,11,0,11
Odisha,Khordha,Hemophilia,35,60,1,0,1
Odisha,Khordha,Hemophilia,60,80,0,1,1
Uttar Pradesh,Kheri,Hemophilia,6,15,1,0,1
Uttar Pradesh,Kheri,Hemophilia,15,35,19,5,24
Uttar Pradesh,Kheri,Hemophilia,35,60,25,5,30
Uttar Pradesh,Kheri,Hemophilia,60,80,5,2,7
Uttar Pradesh,Kheri,Hemophilia,80,100,1,0,1
Gujarat,Kheda,Hemophilia,0,6,4,0,4
Gujarat,Kheda,Hemophilia,6,15,1,1,2
Gujarat,Kheda,Hemophilia,15,35,3,0,3
Madhya Pradesh,Khargone,Hemophilia,6,15,2,0,2
Madhya Pradesh,Khargone,Hemophilia,15,35,2,3,5
Madhya Pradesh,Khargone,Hemophilia,35,60,4,0,4
Bihar,Khagaria,Hemophilia,6,15,1,0,1
Bihar,Khagaria,Hemophilia,15,35,3,2,5
Bihar,Khagaria,Hemophilia,35,60,4,0,4
Bihar,Khagaria,Hemophilia,60,80,2,1,3
Odisha,Kendujhar,Hemophilia,0,6,2,0,2
Odisha,Kendujhar,Hemophilia,6,15,1,0,1
Odisha,Kendujhar,Hemophilia,15,35,3,0,3
Odisha,Kendujhar,Hemophilia,35,60,1,2,3
Odisha,Kendujhar,Hemophilia,60,80,0,1,1
Odisha,Kendrapara,Hemophilia,0,6,2,0,2
Odisha,Kendrapara,Hemophilia,6,15,4,0,4
Odisha,Kendrapara,Hemophilia,15,35,4,1,5
Odisha,Kendrapara,Hemophilia,35,60,5,1,6
Odisha,Kendrapara,Hemophilia,60,80,1,0,1
Uttar Pradesh,Kaushambi,Hemophilia,15,35,5,0,5
Uttar Pradesh,Kaushambi,Hemophilia,35,60,6,0,6
Uttar Pradesh,Kaushambi,Hemophilia,60,80,2,0,2
Madhya Pradesh,Katni,Hemophilia,6,15,2,2,4
Madhya Pradesh,Katni,Hemophilia,15,35,11,3,14
Madhya Pradesh,Katni,Hemophilia,35,60,42,15,57
Madhya Pradesh,Katni,Hemophilia,60,80,29,6,35
Madhya Pradesh,Katni,Hemophilia,80,100,3,0,3
Bihar,Katihar,Hemophilia,15,35,2,1,3
Bihar,Katihar,Hemophilia,35,60,4,1,5
Bihar,Katihar,Hemophilia,60,80,0,1,1
Jammu And Kashmir,Kathua,Hemophilia,15,35,2,5,7
Jammu And Kashmir,Kathua,Hemophilia,35,60,7,4,11
Jammu And Kashmir,Kathua,Hemophilia,60,80,5,1,6
Uttar Pradesh,Kasganj,Hemophilia,6,15,1,0,1
Uttar Pradesh,Kasganj,Hemophilia,15,35,14,1,15
Uttar Pradesh,Kasganj,Hemophilia,35,60,12,4,16
Uttar Pradesh,Kasganj,Hemophilia,60,80,5,1,6
Kerala,Kasaragod,Hemophilia,0,6,3,0,3
Kerala,Kasaragod,Hemophilia,6,15,9,0,9
Kerala,Kasaragod,Hemophilia,15,35,5,0,5
Kerala,Kasaragod,Hemophilia,35,60,1,0,1
Tamil Nadu,Karur,Hemophilia,0,6,4,0,4
Tamil Nadu,Karur,Hemophilia,6,15,6,2,8
Tamil Nadu,Karur,Hemophilia,15,35,22,5,27
Tamil Nadu,Karur,Hemophilia,35,60,12,2,14
Tamil Nadu,Karur,Hemophilia,60,80,6,2,8
Tamil Nadu,Karur,Hemophilia,80,100,2,0,2
Haryana,Karnal,Hemophilia,6,15,2,0,2
Haryana,Karnal,Hemophilia,15,35,7,0,7
Haryana,Karnal,Hemophilia,35,60,4,0,4
Assam,Karimganj,Hemophilia,6,15,2,1,3
Assam,Karimganj,Hemophilia,15,35,8,18,26
Assam,Karimganj,Hemophilia,35,60,42,39,81
Assam,Karimganj,Hemophilia,60,80,14,8,22
Ladakh,Kargil,Hemophilia,6,15,1,0,1
Ladakh,Kargil,Hemophilia,35,60,1,0,1
Rajasthan,Karauli,Hemophilia,6,15,1,0,1
Rajasthan,Karauli,Hemophilia,15,35,2,0,2
Puducherry,Karaikal,Hemophilia,35,60,3,1,4
Punjab,Kapurthala,Hemophilia,6,15,0,1,1
Punjab,Kapurthala,Hemophilia,15,35,1,0,1
Punjab,Kapurthala,Hemophilia,35,60,1,0,1
Punjab,Kapurthala,Hemophilia,60,80,0,1,1
Uttar Pradesh,Kanpur Nagar,Hemophilia,15,35,23,0,23
Uttar Pradesh,Kanpur Nagar,Hemophilia,35,60,5,1,6
Uttar Pradesh,Kanpur Nagar,Hemophilia,60,80,1,0,1
Uttar Pradesh,Kanpur Dehat,Hemophilia,15,35,7,1,8
Uttar Pradesh,Kanpur Dehat,Hemophilia,35,60,3,2,5
Uttar Pradesh,Kanpur Dehat,Hemophilia,60,80,2,0,2
Kerala,Kannur,Hemophilia,6,15,5,0,5
Kerala,Kannur,Hemophilia,15,35,10,0,10
Kerala,Kannur,Hemophilia,35,60,10,0,10
Kerala,Kannur,Hemophilia,60,80,1,0,1
Tamil Nadu,Kanniyakumari,Hemophilia,6,15,6,0,6
Tamil Nadu,Kanniyakumari,Hemophilia,15,35,8,0,8
Tamil Nadu,Kanniyakumari,Hemophilia,35,60,4,0,4
Tamil Nadu,Kanniyakumari,Hemophilia,60,80,2,0,2
Uttar Pradesh,Kannauj,Hemophilia,15,35,4,2,6
Chhattisgarh,Kanker,Hemophilia,0,6,1,0,1
Chhattisgarh,Kanker,Hemophilia,6,15,13,2,15
Chhattisgarh,Kanker,Hemophilia,15,35,7,9,16
Chhattisgarh,Kanker,Hemophilia,35,60,26,5,31
Chhattisgarh,Kanker,Hemophilia,60,80,6,3,9
Chhattisgarh,Kanker,Hemophilia,80,100,1,0,1
Himachal Pradesh,Kangra,Hemophilia,0,6,0,1,1
Himachal Pradesh,Kangra,Hemophilia,6,15,2,0,2
Himachal Pradesh,Kangra,Hemophilia,15,35,11,4,15
Himachal Pradesh,Kangra,Hemophilia,35,60,7,2,9
Himachal Pradesh,Kangra,Hemophilia,60,80,7,2,9
Odisha,Kandhamal,Hemophilia,6,15,1,0,1
Odisha,Kandhamal,Hemophilia,15,35,5,5,10
Odisha,Kandhamal,Hemophilia,35,60,5,2,7
Odisha,Kandhamal,Hemophilia,60,80,3,1,4
Tamil Nadu,Kanchipuram,Hemophilia,0,6,1,0,1
Tamil Nadu,Kanchipuram,Hemophilia,6,15,5,0,5
Tamil Nadu,Kanchipuram,Hemophilia,15,35,3,0,3
Tamil Nadu,Kanchipuram,Hemophilia,35,60,5,0,5
Assam,Kamrup Metro,Hemophilia,0,6,1,0,1
Assam,Kamrup Metro,Hemophilia,6,15,2,0,2
Assam,Kamrup Metro,Hemophilia,15,35,3,0,3
Assam,Kamrup Metro,Hemophilia,35,60,1,0,1
Assam,Kamrup,Hemophilia,0,6,3,0,3
Assam,Kamrup,Hemophilia,6,15,2,0,2
Assam,Kamrup,Hemophilia,15,35,1,0,1
Tamil Nadu,Kallakurichi,Hemophilia,6,15,5,1,6
Tamil Nadu,Kallakurichi,Hemophilia,15,35,2,0,2
Tamil Nadu,Kallakurichi,Hemophilia,35,60,0,1,1
Tamil Nadu,Kallakurichi,Hemophilia,80,100,1,0,1
Odisha,Kalahandi,Hemophilia,6,15,1,0,1
Odisha,Kalahandi,Hemophilia,15,35,1,0,1
Odisha,Kalahandi,Hemophilia,35,60,0,1,1
Odisha,Kalahandi,Hemophilia,60,80,2,0,2
Karnataka,Kalaburagi,Hemophilia,6,15,2,0,2
Karnataka,Kalaburagi,Hemophilia,15,35,6,0,6
Karnataka,Kalaburagi,Hemophilia,35,60,6,1,7
Karnataka,Kalaburagi,Hemophilia,60,80,6,0,6
Haryana,Kaithal,Hemophilia,6,15,2,0,2
Haryana,Kaithal,Hemophilia,15,35,16,4,20
Haryana,Kaithal,Hemophilia,35,60,18,4,22
Haryana,Kaithal,Hemophilia,60,80,1,0,1
Bihar,Kaimur (Bhabua),Hemophilia,6,15,1,0,1
Bihar,Kaimur (Bhabua),Hemophilia,15,35,13,3,16
Bihar,Kaimur (Bhabua),Hemophilia,35,60,7,2,9
Bihar,Kaimur (Bhabua),Hemophilia,60,80,3,0,3
Bihar,Kaimur (Bhabua),Hemophilia,80,100,1,1,2
Gujarat,Kachchh,Hemophilia,6,15,6,0,6
Gujarat,Kachchh,Hemophilia,15,35,7,0,7
Gujarat,Kachchh,Hemophilia,35,60,1,0,1
Chhattisgarh,Kabirdham,Hemophilia,15,35,1,0,1
Chhattisgarh,Kabirdham,Hemophilia,35,60,1,0,1
Gujarat,Junagadh,Hemophilia,6,15,4,2,6
Gujarat,Junagadh,Hemophilia,15,35,11,1,12
Gujarat,Junagadh,Hemophilia,35,60,4,0,4
Rajasthan,Jodhpur,Hemophilia,0,6,1,0,1
Rajasthan,Jodhpur,Hemophilia,6,15,4,0,4
Rajasthan,Jodhpur,Hemophilia,15,35,3,0,3
Rajasthan,Jodhpur,Hemophilia,35,60,5,0,5
Haryana,Jind,Hemophilia,0,6,1,0,1
Haryana,Jind,Hemophilia,15,35,6,0,6
Haryana,Jind,Hemophilia,35,60,5,0,5
Rajasthan,Jhunjhunu,Hemophilia,6,15,0,1,1
Rajasthan,Jhunjhunu,Hemophilia,15,35,4,0,4
Rajasthan,Jhunjhunu,Hemophilia,35,60,1,1,2
Rajasthan,Jhunjhunu,Hemophilia,60,80,1,0,1
Rajasthan,Jhunjhunu,Hemophilia,80,100,0,1,1
Odisha,Jharsuguda,Hemophilia,6,15,1,1,2
Odisha,Jharsuguda,Hemophilia,15,35,1,1,2
Odisha,Jharsuguda,Hemophilia,35,60,1,2,3
Odisha,Jharsuguda,Hemophilia,60,80,2,2,4
Uttar Pradesh,Jhansi,Hemophilia,6,15,1,0,1
Uttar Pradesh,Jhansi,Hemophilia,15,35,4,1,5
Uttar Pradesh,Jhansi,Hemophilia,35,60,4,1,5
Uttar Pradesh,Jhansi,Hemophilia,60,80,1,0,1
Rajasthan,Jhalawar,Hemophilia,6,15,2,1,3
Rajasthan,Jhalawar,Hemophilia,15,35,4,0,4
Rajasthan,Jhalawar,Hemophilia,35,60,0,1,1
Haryana,Jhajjar,Hemophilia,15,35,6,0,6
Haryana,Jhajjar,Hemophilia,35,60,2,0,2
Madhya Pradesh,Jhabua,Hemophilia,6,15,3,0,3
Madhya Pradesh,Jhabua,Hemophilia,15,35,5,3,8
Madhya Pradesh,Jhabua,Hemophilia,35,60,4,2,6
Madhya Pradesh,Jhabua,Hemophilia,60,80,1,0,1
Bihar,Jehanabad,Hemophilia,15,35,1,0,1
Bihar,Jehanabad,Hemophilia,35,60,2,0,2
Uttar Pradesh,Jaunpur,Hemophilia,6,15,1,0,1
Uttar Pradesh,Jaunpur,Hemophilia,15,35,12,4,16
Uttar Pradesh,Jaunpur,Hemophilia,35,60,8,1,9
Uttar Pradesh,Jaunpur,Hemophilia,60,80,2,0,2
Chhattisgarh,Jashpur,Hemophilia,6,15,3,0,3
Chhattisgarh,Jashpur,Hemophilia,15,35,1,0,1
Chhattisgarh,Jashpur,Hemophilia,35,60,5,0,5
Chhattisgarh,Jashpur,Hemophilia,60,80,1,0,1
Chhattisgarh,Janjgir-Champa,Hemophilia,6,15,2,1,3
Chhattisgarh,Janjgir-Champa,Hemophilia,15,35,2,0,2
Chhattisgarh,Janjgir-Champa,Hemophilia,35,60,1,1,2
Chhattisgarh,Janjgir-Champa,Hemophilia,60,80,3,1,4
Bihar,Jamui,Hemophilia,0,6,1,0,1
Bihar,Jamui,Hemophilia,6,15,2,2,4
Bihar,Jamui,Hemophilia,15,35,5,3,8
Bihar,Jamui,Hemophilia,35,60,6,1,7
Bihar,Jamui,Hemophilia,60,80,1,0,1
Jharkhand,Jamtara,Hemophilia,35,60,3,0,3
Jharkhand,Jamtara,Hemophilia,60,80,1,0,1
Jharkhand,Jamtara,Hemophilia,80,100,0,1,1
Gujarat,Jamnagar,Hemophilia,6,15,5,0,5
Jammu And Kashmir,Jammu,Hemophilia,15,35,5,3,8
Jammu And Kashmir,Jammu,Hemophilia,35,60,5,2,7
Rajasthan,Jalore,Hemophilia,6,15,1,0,1
Rajasthan,Jalore,Hemophilia,35,60,1,0,1
Rajasthan,Jalore,Hemophilia,60,80,1,0,1
Maharashtra,Jalna,Hemophilia,0,6,3,0,3
Maharashtra,Jalna,Hemophilia,6,15,9,0,9
Maharashtra,Jalna,Hemophilia,15,35,12,0,12
Maharashtra,Jalna,Hemophilia,35,60,7,0,7
Maharashtra,Jalgaon,Hemophilia,0,6,2,0,2
Maharashtra,Jalgaon,Hemophilia,6,15,17,0,17
Maharashtra,Jalgaon,Hemophilia,15,35,18,0,18
Maharashtra,Jalgaon,Hemophilia,35,60,9,0,9
Maharashtra,Jalgaon,Hemophilia,60,80,1,1,2
Uttar Pradesh,Jalaun,Hemophilia,0,6,1,0,1
Uttar Pradesh,Jalaun,Hemophilia,6,15,5,0,5
Uttar Pradesh,Jalaun,Hemophilia,15,35,12,4,16
Uttar Pradesh,Jalaun,Hemophilia,35,60,23,7,30
Uttar Pradesh,Jalaun,Hemophilia,60,80,8,2,10
Punjab,Jalandhar,Hemophilia,6,15,2,0,2
Punjab,Jalandhar,Hemophilia,15,35,9,4,13
Punjab,Jalandhar,Hemophilia,35,60,21,3,24
Punjab,Jalandhar,Hemophilia,60,80,10,1,11
Odisha,Jajapur,Hemophilia,6,15,11,2,13
Odisha,Jajapur,Hemophilia,15,35,15,1,16
Odisha,Jajapur,Hemophilia,35,60,3,1,4
Rajasthan,Jaisalmer,Hemophilia,6,15,2,0,2
Rajasthan,Jaisalmer,Hemophilia,15,35,6,0,6
Rajasthan,Jaisalmer,Hemophilia,35,60,1,0,1
Rajasthan,Jaipur,Hemophilia,0,6,5,0,5
Rajasthan,Jaipur,Hemophilia,6,15,23,0,23
Rajasthan,Jaipur,Hemophilia,15,35,38,0,38
Rajasthan,Jaipur,Hemophilia,35,60,12,0,12
Rajasthan,Jaipur,Hemophilia,60,80,1,0,1
Odisha,Jagatsinghapur,Hemophilia,0,6,1,0,1
Odisha,Jagatsinghapur,Hemophilia,6,15,8,0,8
Odisha,Jagatsinghapur,Hemophilia,15,35,5,0,5
Odisha,Jagatsinghapur,Hemophilia,35,60,3,0,3
Odisha,Jagatsinghapur,Hemophilia,60,80,1,0,1
Madhya Pradesh,Jabalpur,Hemophilia,6,15,4,1,5
Madhya Pradesh,Jabalpur,Hemophilia,15,35,10,5,15
Madhya Pradesh,Jabalpur,Hemophilia,35,60,24,3,27
Madhya Pradesh,Jabalpur,Hemophilia,60,80,2,0,2
Madhya Pradesh,Indore,Hemophilia,6,15,4,2,6
Madhya Pradesh,Indore,Hemophilia,15,35,16,1,17
Madhya Pradesh,Indore,Hemophilia,35,60,16,2,18
Madhya Pradesh,Indore,Hemophilia,60,80,4,1,5
Manipur,Imphal West,Hemophilia,15,35,4,0,4
Kerala,Idukki,Hemophilia,6,15,1,0,1
Kerala,Idukki,Hemophilia,15,35,2,0,2
Kerala,Idukki,Hemophilia,35,60,5,0,5
Kerala,Idukki,Hemophilia,60,80,1,0,1
Punjab,Hoshiarpur,Hemophilia,6,15,1,1,2
Punjab,Hoshiarpur,Hemophilia,15,35,8,10,18
Punjab,Hoshiarpur,Hemophilia,35,60,45,21,66
Punjab,Hoshiarpur,Hemophilia,60,80,17,4,21
Assam,Hojai,Hemophilia,0,6,1,0,1
Assam,Hojai,Hemophilia,35,60,2,1,3
Assam,Hojai,Hemophilia,60,80,1,0,1
Haryana,Hisar,Hemophilia,0,6,1,0,1
Haryana,Hisar,Hemophilia,6,15,1,0,1
Haryana,Hisar,Hemophilia,15,35,8,1,9
Haryana,Hisar,Hemophilia,35,60,10,2,12
Haryana,Hisar,Hemophilia,60,80,3,0,3
Maharashtra,Hingoli,Hemophilia,6,15,4,0,4
Maharashtra,Hingoli,Hemophilia,15,35,3,0,3
Maharashtra,Hingoli,Hemophilia,60,80,1,0,1
Jharkhand,Hazaribagh,Hemophilia,6,15,5,0,5
Jharkhand,Hazaribagh,Hemophilia,15,35,3,0,3
Jharkhand,Hazaribagh,Hemophilia,35,60,12,5,17
Karnataka,Haveri,Hemophilia,0,6,1,1,2
Karnataka,Haveri,Hemophilia,6,15,10,1,11
Karnataka,Haveri,Hemophilia,15,35,12,4,16
Karnataka,Haveri,Hemophilia,35,60,6,6,12
Karnataka,Haveri,Hemophilia,60,80,9,0,9
Uttar Pradesh,Hathras,Hemophilia,6,15,2,2,4
Uttar Pradesh,Hathras,Hemophilia,15,35,7,1,8
Uttar Pradesh,Hathras,Hemophilia,35,60,11,1,12
Uttar Pradesh,Hathras,Hemophilia,60,80,4,1,5
Karnataka,Hassan,Hemophilia,0,6,1,0,1
Karnataka,Hassan,Hemophilia,6,15,9,4,13
Karnataka,Hassan,Hemophilia,15,35,15,3,18
Karnataka,Hassan,Hemophilia,35,60,14,3,17
Karnataka,Hassan,Hemophilia,60,80,5,1,6
Karnataka,Hassan,Hemophilia,80,100,1,0,1
Uttarakhand,Haridwar,Hemophilia,0,6,1,0,1
Uttarakhand,Haridwar,Hemophilia,15,35,8,1,9
Uttarakhand,Haridwar,Hemophilia,35,60,15,2,17
Uttarakhand,Haridwar,Hemophilia,60,80,4,0,4
Uttar Pradesh,Hardoi,Hemophilia,6,15,1,0,1
Uttar Pradesh,Hardoi,Hemophilia,15,35,10,0,10
Uttar Pradesh,Hardoi,Hemophilia,35,60,4,2,6
Uttar Pradesh,Hardoi,Hemophilia,60,80,3,1,4
Madhya Pradesh,Harda,Hemophilia,60,80,1,0,1
Uttar Pradesh,Hapur,Hemophilia,6,15,1,0,1
Uttar Pradesh,Hapur,Hemophilia,15,35,8,0,8
Uttar Pradesh,Hapur,Hemophilia,35,60,1,0,1
Rajasthan,Hanumangarh,Hemophilia,6,15,5,0,5
Rajasthan,Hanumangarh,Hemophilia,15,35,6,0,6
Rajasthan,Hanumangarh,Hemophilia,35,60,2,0,2
Himachal Pradesh,Hamirpur,Hemophilia,6,15,2,0,2
Himachal Pradesh,Hamirpur,Hemophilia,15,35,4,0,4
Himachal Pradesh,Hamirpur,Hemophilia,35,60,1,0,1
Himachal Pradesh,Hamirpur,Hemophilia,60,80,1,0,1
Uttar Pradesh,Hamirpur,Hemophilia,6,15,1,0,1
Uttar Pradesh,Hamirpur,Hemophilia,15,35,12,2,14
Uttar Pradesh,Hamirpur,Hemophilia,35,60,13,2,15
Uttar Pradesh,Hamirpur,Hemophilia,60,80,6,0,6
Assam,Hailakandi,Hemophilia,35,60,1,0,1
Sikkim,Gyalshing,Hemophilia,6,15,1,0,1
Madhya Pradesh,Gwalior,Hemophilia,0,6,1,0,1
Madhya Pradesh,Gwalior,Hemophilia,6,15,5,1,6
Madhya Pradesh,Gwalior,Hemophilia,15,35,11,3,14
Madhya Pradesh,Gwalior,Hemophilia,35,60,9,3,12
Madhya Pradesh,Gwalior,Hemophilia,60,80,3,0,3
Haryana,Gurugram,Hemophilia,6,15,3,1,4
Haryana,Gurugram,Hemophilia,15,35,4,0,4
Haryana,Gurugram,Hemophilia,35,60,1,0,1
Punjab,Gurdaspur,Hemophilia,0,6,1,0,1
Punjab,Gurdaspur,Hemophilia,6,15,2,0,2
Punjab,Gurdaspur,Hemophilia,15,35,3,1,4
Punjab,Gurdaspur,Hemophilia,35,60,8,3,11
Punjab,Gurdaspur,Hemophilia,60,80,1,0,1
Andhra Pradesh,Guntur,Hemophilia,0,6,4,0,4
Andhra Pradesh,Guntur,Hemophilia,6,15,6,0,6
Andhra Pradesh,Guntur,Hemophilia,15,35,11,0,11
Andhra Pradesh,Guntur,Hemophilia,35,60,5,0,5
Madhya Pradesh,Guna,Hemophilia,6,15,0,2,2
Madhya Pradesh,Guna,Hemophilia,15,35,2,0,2
Jharkhand,Gumla,Hemophilia,0,6,0,2,2
Jharkhand,Gumla,Hemophilia,6,15,5,5,10
Jharkhand,Gumla,Hemophilia,15,35,17,16,33
Jharkhand,Gumla,Hemophilia,35,60,45,22,67
Jharkhand,Gumla,Hemophilia,60,80,8,6,14
Jharkhand,Gumla,Hemophilia,80,100,1,0,1
Uttar Pradesh,Gorakhpur,Hemophilia,6,15,0,1,1
Uttar Pradesh,Gorakhpur,Hemophilia,15,35,15,5,20
Uttar Pradesh,Gorakhpur,Hemophilia,35,60,18,3,21
Uttar Pradesh,Gorakhpur,Hemophilia,60,80,5,0,5
Bihar,Gopalganj,Hemophilia,15,35,1,0,1
Bihar,Gopalganj,Hemophilia,35,60,1,0,1
Bihar,Gopalganj,Hemophilia,60,80,0,1,1
Maharashtra,Gondia,Hemophilia,0,6,0,2,2
Maharashtra,Gondia,Hemophilia,6,15,8,1,9
Maharashtra,Gondia,Hemophilia,15,35,4,1,5
Maharashtra,Gondia,Hemophilia,35,60,5,1,6
Uttar Pradesh,Gonda,Hemophilia,15,35,7,1,8
Uttar Pradesh,Gonda,Hemophilia,35,60,8,1,9
Uttar Pradesh,Gonda,Hemophilia,60,80,2,0,2
Assam,Golaghat,Hemophilia,0,6,1,0,1
Assam,Golaghat,Hemophilia,6,15,0,1,1
Assam,Golaghat,Hemophilia,15,35,5,1,6
Assam,Golaghat,Hemophilia,35,60,4,0,4
Assam,Golaghat,Hemophilia,60,80,3,0,3
Jharkhand,Godda,Hemophilia,6,15,0,1,1
Jharkhand,Godda,Hemophilia,15,35,14,10,24
Jharkhand,Godda,Hemophilia,35,60,16,10,26
Jharkhand,Godda,Hemophilia,60,80,12,8,20
Jharkhand,Godda,Hemophilia,80,100,1,0,1
Assam,Goalpara,Hemophilia,6,15,1,1,2
Assam,Goalpara,Hemophilia,35,60,1,0,1
Assam,Goalpara,Hemophilia,60,80,1,2,3
Jharkhand,Giridih,Hemophilia,0,6,2,0,2
Jharkhand,Giridih,Hemophilia,6,15,3,0,3
Jharkhand,Giridih,Hemophilia,15,35,10,1,11
Jharkhand,Giridih,Hemophilia,35,60,17,5,22
Jharkhand,Giridih,Hemophilia,60,80,1,2,3
Gujarat,Gir Somnath,Hemophilia,15,35,2,0,2
Uttar Pradesh,Ghazipur,Hemophilia,0,6,1,0,1
Uttar Pradesh,Ghazipur,Hemophilia,6,15,1,0,1
Uttar Pradesh,Ghazipur,Hemophilia,15,35,5,0,5
Uttar Pradesh,Ghazipur,Hemophilia,35,60,1,1,2
Uttar Pradesh,Ghazipur,Hemophilia,60,80,1,0,1
Uttar Pradesh,Ghaziabad,Hemophilia,15,35,11,0,11
Uttar Pradesh,Ghaziabad,Hemophilia,35,60,6,0,6
Uttar Pradesh,Ghaziabad,Hemophilia,60,80,2,0,2
Bihar,Gaya,Hemophilia,0,6,1,0,1
Bihar,Gaya,Hemophilia,6,15,0,1,1
Bihar,Gaya,Hemophilia,15,35,1,0,1
Uttar Pradesh,Gautam Buddha Nagar,Hemophilia,6,15,2,1,3
Uttar Pradesh,Gautam Buddha Nagar,Hemophilia,15,35,9,2,11
Uttar Pradesh,Gautam Buddha Nagar,Hemophilia,35,60,1,0,1
Chhattisgarh,Gaurella Pendra Marwahi,Hemophilia,35,60,2,1,3
Chhattisgarh,Gaurella Pendra Marwahi,Hemophilia,60,80,1,1,2
Chhattisgarh,Gariyaband,Hemophilia,6,15,3,0,3
Chhattisgarh,Gariyaband,Hemophilia,15,35,0,2,2
Chhattisgarh,Gariyaband,Hemophilia,35,60,6,2,8
Chhattisgarh,Gariyaband,Hemophilia,60,80,2,1,3
Jharkhand,Garhwa,Hemophilia,6,15,3,3,6
Jharkhand,Garhwa,Hemophilia,15,35,8,2,10
Jharkhand,Garhwa,Hemophilia,35,60,4,3,7
Jharkhand,Garhwa,Hemophilia,60,80,1,0,1
Odisha,Ganjam,Hemophilia,0,6,2,0,2
Odisha,Ganjam,Hemophilia,6,15,15,0,15
Odisha,Ganjam,Hemophilia,15,35,7,0,7
Odisha,Ganjam,Hemophilia,35,60,1,0,1
Sikkim,Gangtok,Hemophilia,6,15,1,0,1
Rajasthan,Ganganagar,Hemophilia,6,15,1,0,1
Rajasthan,Ganganagar,Hemophilia,15,35,2,0,2
Rajasthan,Ganganagar,Hemophilia,35,60,1,0,1
Gujarat,Gandhinagar,Hemophilia,0,6,1,0,1
Gujarat,Gandhinagar,Hemophilia,15,35,3,0,3
Gujarat,Gandhinagar,Hemophilia,35,60,1,0,1
Jammu And Kashmir,Ganderbal,Hemophilia,6,15,1,0,1
Jammu And Kashmir,Ganderbal,Hemophilia,15,35,2,1,3
Jammu And Kashmir,Ganderbal,Hemophilia,35,60,6,2,8
Maharashtra,Gadchiroli,Hemophilia,0,6,1,0,1
Maharashtra,Gadchiroli,Hemophilia,6,15,4,1,5
Maharashtra,Gadchiroli,Hemophilia,15,35,5,1,6
Maharashtra,Gadchiroli,Hemophilia,35,60,3,1,4
Karnataka,Gadag,Hemophilia,0,6,1,0,1
Karnataka,Gadag,Hemophilia,6,15,4,0,4
Karnataka,Gadag,Hemophilia,15,35,0,5,5
Karnataka,Gadag,Hemophilia,35,60,12,3,15
Karnataka,Gadag,Hemophilia,60,80,3,0,3
Karnataka,Gadag,Hemophilia,80,100,1,0,1
Uttar Pradesh,Firozabad,Hemophilia,6,15,3,0,3
Uttar Pradesh,Firozabad,Hemophilia,15,35,12,2,14
Uttar Pradesh,Firozabad,Hemophilia,35,60,11,0,11
Uttar Pradesh,Firozabad,Hemophilia,60,80,2,1,3
Punjab,Ferozepur,Hemophilia,6,15,0,1,1
Punjab,Ferozepur,Hemophilia,15,35,5,4,9
Punjab,Ferozepur,Hemophilia,35,60,4,2,6
Punjab,Ferozepur,Hemophilia,60,80,3,1,4
Punjab,Fazilka,Hemophilia,0,6,1,0,1
Punjab,Fazilka,Hemophilia,15,35,6,0,6
Punjab,Fazilka,Hemophilia,35,60,4,0,4
Uttar Pradesh,Fatehpur,Hemophilia,6,15,1,0,1
Uttar Pradesh,Fatehpur,Hemophilia,15,35,13,3,16
Uttar Pradesh,Fatehpur,Hemophilia,35,60,27,5,32
Uttar Pradesh,Fatehpur,Hemophilia,60,80,9,0,9
Punjab,Fatehgarh Sahib,Hemophilia,0,6,1,0,1
Punjab,Fatehgarh Sahib,Hemophilia,6,15,1,0,1
Punjab,Fatehgarh Sahib,Hemophilia,15,35,12,0,12
Punjab,Fatehgarh Sahib,Hemophilia,35,60,10,5,15
Punjab,Fatehgarh Sahib,Hemophilia,60,80,6,0,6
Haryana,Fatehabad,Hemophilia,6,15,1,0,1
Haryana,Fatehabad,Hemophilia,15,35,5,0,5
Haryana,Fatehabad,Hemophilia,35,60,6,0,6
Haryana,Fatehabad,Hemophilia,60,80,1,0,1
Uttar Pradesh,Farrukhabad,Hemophilia,6,15,2,0,2
Uttar Pradesh,Farrukhabad,Hemophilia,15,35,8,1,9
Uttar Pradesh,Farrukhabad,Hemophilia,35,60,10,0,10
Uttar Pradesh,Farrukhabad,Hemophilia,60,80,3,0,3
Punjab,Faridkot,Hemophilia,6,15,1,0,1
Punjab,Faridkot,Hemophilia,15,35,2,1,3
Punjab,Faridkot,Hemophilia,60,80,1,0,1
Haryana,Faridabad,Hemophilia,0,6,1,0,1
Haryana,Faridabad,Hemophilia,6,15,1,0,1
Haryana,Faridabad,Hemophilia,15,35,4,0,4
Haryana,Faridabad,Hemophilia,35,60,1,0,1
Uttar Pradesh,Etawah,Hemophilia,15,35,8,5,13
Uttar Pradesh,Etawah,Hemophilia,35,60,15,3,18
Uttar Pradesh,Etawah,Hemophilia,60,80,11,1,12
Uttar Pradesh,Etah,Hemophilia,15,35,4,0,4
Uttar Pradesh,Etah,Hemophilia,35,60,1,0,1
Uttar Pradesh,Etah,Hemophilia,60,80,0,1,1
Tamil Nadu,Erode,Hemophilia,0,6,1,0,1
Tamil Nadu,Erode,Hemophilia,6,15,3,0,3
Tamil Nadu,Erode,Hemophilia,15,35,21,1,22
Tamil Nadu,Erode,Hemophilia,35,60,9,0,9
Tamil Nadu,Erode,Hemophilia,60,80,1,0,1
Kerala,Ernakulam,Hemophilia,6,15,2,0,2
Kerala,Ernakulam,Hemophilia,15,35,3,0,3
Kerala,Ernakulam,Hemophilia,35,60,5,0,5
Jharkhand,East Singhbum,Hemophilia,6,15,1,0,1
Jharkhand,East Singhbum,Hemophilia,15,35,10,2,12
Jharkhand,East Singhbum,Hemophilia,35,60,10,7,17
Jharkhand,East Singhbum,Hemophilia,60,80,2,0,2
Arunachal Pradesh,East Siang,Hemophilia,15,35,1,0,1
Madhya Pradesh,East Nimar,Hemophilia,15,35,0,1,1
Madhya Pradesh,East Nimar,Hemophilia,35,60,2,0,2
Meghalaya,East Khasi Hills,Hemophilia,6,15,1,0,1
Meghalaya,East Khasi Hills,Hemophilia,15,35,2,0,2
Delhi,East,Hemophilia,0,6,1,0,1
Delhi,East,Hemophilia,6,15,3,0,3
Delhi,East,Hemophilia,15,35,5,0,5
Chhattisgarh,Durg,Hemophilia,0,6,1,0,1
Chhattisgarh,Durg,Hemophilia,6,15,1,1,2
Chhattisgarh,Durg,Hemophilia,15,35,5,0,5
Chhattisgarh,Durg,Hemophilia,35,60,1,2,3
Jharkhand,Dumka,Hemophilia,0,6,1,0,1
Jharkhand,Dumka,Hemophilia,6,15,2,1,3
Jharkhand,Dumka,Hemophilia,15,35,2,1,3
Jharkhand,Dumka,Hemophilia,35,60,4,2,6
Jharkhand,Dumka,Hemophilia,60,80,1,1,2
Gujarat,Dohad,Hemophilia,6,15,2,0,2
Gujarat,Dohad,Hemophilia,35,60,1,0,1
Jammu And Kashmir,Doda,Hemophilia,0,6,0,1,1
Jammu And Kashmir,Doda,Hemophilia,6,15,2,0,2
Jammu And Kashmir,Doda,Hemophilia,15,35,3,2,5
Jammu And Kashmir,Doda,Hemophilia,35,60,1,0,1
Madhya Pradesh,Dindori,Hemophilia,6,15,2,4,6
Madhya Pradesh,Dindori,Hemophilia,15,35,1,4,5
Madhya Pradesh,Dindori,Hemophilia,35,60,2,0,2
Madhya Pradesh,Dindori,Hemophilia,60,80,2,0,2
Tamil Nadu,Dindigul,Hemophilia,6,15,4,0,4
Tamil Nadu,Dindigul,Hemophilia,15,35,9,1,10
Tamil Nadu,Dindigul,Hemophilia,35,60,7,3,10
Tamil Nadu,Dindigul,Hemophilia,60,80,1,1,2
Tamil Nadu,Dindigul,Hemophilia,80,100,1,0,1
Assam,Dima Hasao,Hemophilia,15,35,2,0,2
Assam,Dibrugarh,Hemophilia,0,6,1,0,1
Assam,Dibrugarh,Hemophilia,6,15,4,1,5
Assam,Dibrugarh,Hemophilia,15,35,9,0,9
Assam,Dibrugarh,Hemophilia,35,60,3,0,3
Maharashtra,Dhule,Hemophilia,6,15,5,0,5
Maharashtra,Dhule,Hemophilia,15,35,13,0,13
Maharashtra,Dhule,Hemophilia,35,60,5,0,5
Maharashtra,Dhule,Hemophilia,60,80,3,0,3
Assam,Dhubri,Hemophilia,15,35,1,1,2
Assam,Dhubri,Hemophilia,35,60,1,2,3
Rajasthan,Dholpur,Hemophilia,0,6,1,0,1
Rajasthan,Dholpur,Hemophilia,6,15,2,0,2
Odisha,Dhenkanal,Hemophilia,6,15,4,0,4
Odisha,Dhenkanal,Hemophilia,15,35,6,0,6
Odisha,Dhenkanal,Hemophilia,35,60,8,2,10
Odisha,Dhenkanal,Hemophilia,60,80,2,0,2
Assam,Dhemaji,Hemophilia,6,15,2,0,2
Assam,Dhemaji,Hemophilia,35,60,2,0,2
Assam,Dhemaji,Hemophilia,60,80,0,2,2
Karnataka,Dharwad,Hemophilia,0,6,2,1,3
Karnataka,Dharwad,Hemophilia,6,15,9,3,12
Karnataka,Dharwad,Hemophilia,15,35,7,2,9
Karnataka,Dharwad,Hemophilia,35,60,14,5,19
Karnataka,Dharwad,Hemophilia,60,80,5,1,6
Tamil Nadu,Dharmapuri,Hemophilia,0,6,1,0,1
Tamil Nadu,Dharmapuri,Hemophilia,6,15,3,1,4
Tamil Nadu,Dharmapuri,Hemophilia,15,35,7,0,7
Tamil Nadu,Dharmapuri,Hemophilia,35,60,2,1,3
Tamil Nadu,Dharmapuri,Hemophilia,60,80,1,0,1
Madhya Pradesh,Dhar,Hemophilia,6,15,2,2,4
Madhya Pradesh,Dhar,Hemophilia,15,35,10,4,14
Madhya Pradesh,Dhar,Hemophilia,35,60,14,4,18
Madhya Pradesh,Dhar,Hemophilia,60,80,1,1,2
Jharkhand,Dhanbad,Hemophilia,6,15,6,0,6
Jharkhand,Dhanbad,Hemophilia,15,35,14,5,19
Jharkhand,Dhanbad,Hemophilia,35,60,17,10,27
Jharkhand,Dhanbad,Hemophilia,60,80,4,1,5
Chhattisgarh,Dhamtari,Hemophilia,35,60,1,1,2
Tripura,Dhalai,Hemophilia,6,15,2,0,2
Madhya Pradesh,Dewas,Hemophilia,6,15,1,1,2
Madhya Pradesh,Dewas,Hemophilia,15,35,1,3,4
Madhya Pradesh,Dewas,Hemophilia,35,60,12,4,16
Madhya Pradesh,Dewas,Hemophilia,60,80,5,3,8
Gujarat,Devbhumi Dwarka,Hemophilia,6,15,3,0,3
Gujarat,Devbhumi Dwarka,Hemophilia,15,35,1,0,1
Uttar Pradesh,Deoria,Hemophilia,6,15,2,0,2
Uttar Pradesh,Deoria,Hemophilia,15,35,12,3,15
Uttar Pradesh,Deoria,Hemophilia,35,60,10,4,14
Uttar Pradesh,Deoria,Hemophilia,60,80,6,0,6
Jharkhand,Deoghar,Hemophilia,0,6,0,1,1
Jharkhand,Deoghar,Hemophilia,6,15,6,4,10
Jharkhand,Deoghar,Hemophilia,15,35,6,5,11
Jharkhand,Deoghar,Hemophilia,35,60,6,2,8
Jharkhand,Deoghar,Hemophilia,60,80,4,1,5
Uttarakhand,Dehradun,Hemophilia,0,6,1,0,1
Uttarakhand,Dehradun,Hemophilia,6,15,1,1,2
Uttarakhand,Dehradun,Hemophilia,15,35,7,2,9
Uttarakhand,Dehradun,Hemophilia,35,60,13,2,15
Uttarakhand,Dehradun,Hemophilia,60,80,2,0,2
Karnataka,Davangere,Hemophilia,0,6,4,0,4
Karnataka,Davangere,Hemophilia,6,15,5,1,6
Karnataka,Davangere,Hemophilia,15,35,4,3,7
Karnataka,Davangere,Hemophilia,35,60,8,1,9
Karnataka,Davangere,Hemophilia,60,80,2,1,3
Rajasthan,Dausa,Hemophilia,6,15,3,0,3
Rajasthan,Dausa,Hemophilia,15,35,4,1,5
Rajasthan,Dausa,Hemophilia,35,60,1,0,1
Rajasthan,Dausa,Hemophilia,60,80,1,0,1
Madhya Pradesh,Datia,Hemophilia,0,6,1,0,1
Madhya Pradesh,Datia,Hemophilia,6,15,1,0,1
Madhya Pradesh,Datia,Hemophilia,15,35,7,3,10
Madhya Pradesh,Datia,Hemophilia,35,60,11,2,13
Madhya Pradesh,Datia,Hemophilia,60,80,5,1,6
Assam,Darrang,Hemophilia,15,35,1,1,2
Assam,Darrang,Hemophilia,35,60,2,1,3
Bihar,Darbhanga,Hemophilia,6,15,1,2,3
Bihar,Darbhanga,Hemophilia,15,35,9,2,11
Bihar,Darbhanga,Hemophilia,35,60,5,3,8
Bihar,Darbhanga,Hemophilia,60,80,2,1,3
Gujarat,Dang,Hemophilia,6,15,1,0,1
Gujarat,Dang,Hemophilia,15,35,4,0,4
Madhya Pradesh,Damoh,Hemophilia,6,15,2,2,4
Madhya Pradesh,Damoh,Hemophilia,15,35,19,7,26
Madhya Pradesh,Damoh,Hemophilia,35,60,58,8,66
Madhya Pradesh,Damoh,Hemophilia,60,80,15,3,18
Dadra Nagar Haveli And Daman And Diu,Daman,Hemophilia,35,60,1,0,1
Karnataka,Dakshina Kannada,Hemophilia,0,6,1,0,1
Karnataka,Dakshina Kannada,Hemophilia,6,15,3,0,3
Karnataka,Dakshina Kannada,Hemophilia,15,35,12,1,13
Karnataka,Dakshina Kannada,Hemophilia,35,60,4,3,7
Karnataka,Dakshina Kannada,Hemophilia,60,80,5,0,5
Dadra Nagar Haveli And Daman And Diu,Dadra And Nagar Haveli,Hemophilia,35,60,2,0,2
Odisha,Cuttack,Hemophilia,0,6,1,1,2
Odisha,Cuttack,Hemophilia,6,15,10,0,10
Odisha,Cuttack,Hemophilia,15,35,8,0,8
Odisha,Cuttack,Hemophilia,35,60,2,3,5
Tamil Nadu,Cuddalore,Hemophilia,0,6,1,0,1
Tamil Nadu,Cuddalore,Hemophilia,6,15,2,0,2
Tamil Nadu,Cuddalore,Hemophilia,15,35,7,0,7
Tamil Nadu,Cuddalore,Hemophilia,35,60,2,2,4
Tamil Nadu,Coimbatore,Hemophilia,0,6,3,0,3
Tamil Nadu,Coimbatore,Hemophilia,6,15,2,0,2
Tamil Nadu,Coimbatore,Hemophilia,15,35,10,1,11
Tamil Nadu,Coimbatore,Hemophilia,35,60,12,0,12
Tamil Nadu,Coimbatore,Hemophilia,60,80,1,1,2
Rajasthan,Churu,Hemophilia,6,15,3,0,3
Rajasthan,Churu,Hemophilia,15,35,5,1,6
Rajasthan,Churu,Hemophilia,35,60,1,0,1
Manipur,Churachandpur,Hemophilia,15,35,1,0,1
Rajasthan,Chittorgarh,Hemophilia,0,6,2,0,2
Rajasthan,Chittorgarh,Hemophilia,6,15,2,0,2
Rajasthan,Chittorgarh,Hemophilia,15,35,7,0,7
Rajasthan,Chittorgarh,Hemophilia,35,60,8,0,8
Rajasthan,Chittorgarh,Hemophilia,60,80,1,0,1
Uttar Pradesh,Chitrakoot,Hemophilia,6,15,1,0,1
Uttar Pradesh,Chitrakoot,Hemophilia,15,35,8,2,10
Uttar Pradesh,Chitrakoot,Hemophilia,35,60,13,3,16
Uttar Pradesh,Chitrakoot,Hemophilia,60,80,3,1,4
Karnataka,Chitradurga,Hemophilia,6,15,6,2,8
Karnataka,Chitradurga,Hemophilia,15,35,15,4,19
Karnataka,Chitradurga,Hemophilia,35,60,5,5,10
Karnataka,Chitradurga,Hemophilia,60,80,7,0,7
Karnataka,Chikkamagaluru,Hemophilia,0,6,0,1,1
Karnataka,Chikkamagaluru,Hemophilia,6,15,2,0,2
Karnataka,Chikkamagaluru,Hemophilia,15,35,3,2,5
Karnataka,Chikkamagaluru,Hemophilia,35,60,12,5,17
Karnataka,Chikkamagaluru,Hemophilia,60,80,6,0,6
Karnataka,Chikkamagaluru,Hemophilia,80,100,1,0,1
Karnataka,Chikkaballapura,Hemophilia,6,15,4,1,5
Karnataka,Chikkaballapura,Hemophilia,15,35,2,1,3
Karnataka,Chikkaballapura,Hemophilia,35,60,8,0,8
Karnataka,Chikkaballapura,Hemophilia,60,80,5,0,5
Gujarat,Chhotaudepur,Hemophilia,6,15,1,0,1
Gujarat,Chhotaudepur,Hemophilia,15,35,0,1,1
Madhya Pradesh,Chhindwara,Hemophilia,0,6,1,1,2
Madhya Pradesh,Chhindwara,Hemophilia,6,15,2,1,3
Madhya Pradesh,Chhindwara,Hemophilia,15,35,15,5,20
Madhya Pradesh,Chhindwara,Hemophilia,35,60,31,9,40
Madhya Pradesh,Chhindwara,Hemophilia,60,80,15,4,19
Madhya Pradesh,Chhindwara,Hemophilia,80,100,1,0,1
Madhya Pradesh,Chhatarpur,Hemophilia,6,15,1,0,1
Madhya Pradesh,Chhatarpur,Hemophilia,15,35,5,0,5
Madhya Pradesh,Chhatarpur,Hemophilia,35,60,5,0,5
Madhya Pradesh,Chhatarpur,Hemophilia,60,80,4,0,4
Tamil Nadu,Chennai,Hemophilia,0,6,4,0,4
Tamil Nadu,Chennai,Hemophilia,6,15,22,0,22
Tamil Nadu,Chennai,Hemophilia,15,35,34,1,35
Tamil Nadu,Chennai,Hemophilia,35,60,27,0,27
Tamil Nadu,Chennai,Hemophilia,60,80,3,0,3
Tamil Nadu,Chengalpattu,Hemophilia,0,6,1,0,1
Tamil Nadu,Chengalpattu,Hemophilia,6,15,5,0,5
Tamil Nadu,Chengalpattu,Hemophilia,15,35,11,0,11
Tamil Nadu,Chengalpattu,Hemophilia,35,60,5,0,5
Tamil Nadu,Chengalpattu,Hemophilia,60,80,1,0,1
Jharkhand,Chatra,Hemophilia,15,35,1,0,1
Jharkhand,Chatra,Hemophilia,35,60,10,0,10
Jharkhand,Chatra,Hemophilia,60,80,1,0,1
Haryana,Charki Dadri,Hemophilia,15,35,1,0,1
Haryana,Charki Dadri,Hemophilia,60,80,1,0,1
Assam,Charaideo,Hemophilia,6,15,1,0,1
Assam,Charaideo,Hemophilia,35,60,1,0,1
Maharashtra,Chandrapur,Hemophilia,0,6,1,0,1
Maharashtra,Chandrapur,Hemophilia,6,15,6,0,6
Maharashtra,Chandrapur,Hemophilia,15,35,3,0,3
Maharashtra,Chandrapur,Hemophilia,35,60,2,0,2
Chandigarh,Chandigarh,Hemophilia,0,6,1,0,1
Chandigarh,Chandigarh,Hemophilia,6,15,2,0,2
Chandigarh,Chandigarh,Hemophilia,15,35,9,5,14
Chandigarh,Chandigarh,Hemophilia,35,60,9,6,15
Chandigarh,Chandigarh,Hemophilia,60,80,3,2,5
Uttar Pradesh,Chandauli,Hemophilia,15,35,1,0,1
Uttarakhand,Champawat,Hemophilia,0,6,1,0,1
Uttarakhand,Champawat,Hemophilia,6,15,0,2,2
Uttarakhand,Champawat,Hemophilia,15,35,9,3,12
Uttarakhand,Champawat,Hemophilia,35,60,15,5,20
Uttarakhand,Champawat,Hemophilia,60,80,3,0,3
Uttarakhand,Chamoli,Hemophilia,0,6,0,1,1
Uttarakhand,Chamoli,Hemophilia,15,35,4,1,5
Uttarakhand,Chamoli,Hemophilia,35,60,12,2,14
Uttarakhand,Chamoli,Hemophilia,60,80,3,4,7
Uttarakhand,Chamoli,Hemophilia,80,100,1,0,1
Himachal Pradesh,Chamba,Hemophilia,6,15,2,0,2
Himachal Pradesh,Chamba,Hemophilia,15,35,6,0,6
Karnataka,Chamarajanagara,Hemophilia,6,15,5,0,5
Karnataka,Chamarajanagara,Hemophilia,15,35,4,0,4
Karnataka,Chamarajanagara,Hemophilia,60,80,3,0,3
Delhi,Central,Hemophilia,6,15,1,0,1
Delhi,Central,Hemophilia,15,35,2,0,2
Assam,Cachar,Hemophilia,15,35,5,0,5
Assam,Cachar,Hemophilia,35,60,2,1,3
Bihar,Buxar,Hemophilia,6,15,2,0,2
Bihar,Buxar,Hemophilia,15,35,1,1,2
Bihar,Buxar,Hemophilia,35,60,3,2,5
Bihar,Buxar,Hemophilia,60,80,1,0,1
Madhya Pradesh,Burhanpur,Hemophilia,6,15,1,0,1
Madhya Pradesh,Burhanpur,Hemophilia,15,35,2,0,2
Madhya Pradesh,Burhanpur,Hemophilia,35,60,4,2,6
Madhya Pradesh,Burhanpur,Hemophilia,60,80,1,1,2
Rajasthan,Bundi,Hemophilia,15,35,4,0,4
Rajasthan,Bundi,Hemophilia,35,60,1,0,1
Maharashtra,Buldhana,Hemophilia,0,6,2,0,2
Maharashtra,Buldhana,Hemophilia,6,15,5,3,8
Maharashtra,Buldhana,Hemophilia,15,35,13,0,13
Maharashtra,Buldhana,Hemophilia,35,60,7,0,7
Uttar Pradesh,Bulandshahr,Hemophilia,6,15,3,0,3
Uttar Pradesh,Bulandshahr,Hemophilia,15,35,15,2,17
Uttar Pradesh,Bulandshahr,Hemophilia,35,60,9,3,12
Uttar Pradesh,Bulandshahr,Hemophilia,60,80,5,2,7
Jammu And Kashmir,Budgam,Hemophilia,6,15,9,0,9
Jammu And Kashmir,Budgam,Hemophilia,15,35,6,1,7
Jammu And Kashmir,Budgam,Hemophilia,35,60,2,2,4
Jammu And Kashmir,Budgam,Hemophilia,60,80,1,0,1
Uttar Pradesh,Budaun,Hemophilia,0,6,1,0,1
Uttar Pradesh,Budaun,Hemophilia,6,15,10,0,10
Uttar Pradesh,Budaun,Hemophilia,15,35,3,0,3
Uttar Pradesh,Budaun,Hemophilia,35,60,2,0,2
Uttar Pradesh,Budaun,Hemophilia,60,80,1,0,1
Odisha,Boudh,Hemophilia,6,15,1,0,1
Odisha,Boudh,Hemophilia,15,35,1,0,1
Odisha,Boudh,Hemophilia,35,60,3,1,4
Odisha,Boudh,Hemophilia,60,80,1,0,1
Gujarat,Botad,Hemophilia,6,15,3,0,3
Gujarat,Botad,Hemophilia,15,35,1,0,1
Assam,Bongaigaon,Hemophilia,6,15,1,0,1
Assam,Bongaigaon,Hemophilia,15,35,1,0,1
Assam,Bongaigaon,Hemophilia,35,60,1,0,1
Jharkhand,Bokaro,Hemophilia,0,6,1,0,1
Jharkhand,Bokaro,Hemophilia,6,15,7,0,7
Jharkhand,Bokaro,Hemophilia,15,35,8,6,14
Jharkhand,Bokaro,Hemophilia,35,60,30,7,37
Jharkhand,Bokaro,Hemophilia,60,80,9,0,9
Assam,Biswanath,Hemophilia,15,35,2,1,3
Assam,Biswanath,Hemophilia,35,60,6,1,7
Assam,Biswanath,Hemophilia,60,80,1,0,1
Manipur,Bishnupur,Hemophilia,35,60,1,0,1
Chhattisgarh,Bilaspur,Hemophilia,15,35,2,0,2
Chhattisgarh,Bilaspur,Hemophilia,35,60,1,0,1
Chhattisgarh,Bilaspur,Hemophilia,60,80,1,1,2
Himachal Pradesh,Bilaspur,Hemophilia,15,35,1,0,1
Himachal Pradesh,Bilaspur,Hemophilia,35,60,2,0,2
Himachal Pradesh,Bilaspur,Hemophilia,60,80,3,0,3
Rajasthan,Bikaner,Hemophilia,0,6,1,0,1
Rajasthan,Bikaner,Hemophilia,6,15,1,0,1
Rajasthan,Bikaner,Hemophilia,15,35,6,0,6
Rajasthan,Bikaner,Hemophilia,35,60,3,0,3
Uttar Pradesh,Bijnor,Hemophilia,0,6,1,0,1
Uttar Pradesh,Bijnor,Hemophilia,6,15,1,0,1
Uttar Pradesh,Bijnor,Hemophilia,15,35,20,4,24
Uttar Pradesh,Bijnor,Hemophilia,35,60,20,6,26
Uttar Pradesh,Bijnor,Hemophilia,60,80,9,0,9
Uttar Pradesh,Bijnor,Hemophilia,80,100,2,1,3
Karnataka,Bidar,Hemophilia,0,6,3,0,3
Karnataka,Bidar,Hemophilia,6,15,6,0,6
Karnataka,Bidar,Hemophilia,15,35,13,7,20
Karnataka,Bidar,Hemophilia,35,60,51,10,61
Karnataka,Bidar,Hemophilia,60,80,13,1,14
Madhya Pradesh,Bhopal,Hemophilia,0,6,1,1,2
Madhya Pradesh,Bhopal,Hemophilia,6,15,6,0,6
Madhya Pradesh,Bhopal,Hemophilia,15,35,53,19,72
Madhya Pradesh,Bhopal,Hemophilia,35,60,52,15,67
Madhya Pradesh,Bhopal,Hemophilia,60,80,16,4,20
Bihar,Bhojpur,Hemophilia,6,15,2,1,3
Bihar,Bhojpur,Hemophilia,15,35,9,3,12
Bihar,Bhojpur,Hemophilia,35,60,8,2,10
Bihar,Bhojpur,Hemophilia,60,80,5,1,6
Bihar,Bhojpur,Hemophilia,80,100,1,0,1
Haryana,Bhiwani,Hemophilia,6,15,1,0,1
Haryana,Bhiwani,Hemophilia,15,35,12,0,12
Haryana,Bhiwani,Hemophilia,35,60,4,2,6
Haryana,Bhiwani,Hemophilia,60,80,0,2,2
Madhya Pradesh,Bhind,Hemophilia,6,15,3,0,3
Madhya Pradesh,Bhind,Hemophilia,15,35,14,3,17
Madhya Pradesh,Bhind,Hemophilia,35,60,12,1,13
Madhya Pradesh,Bhind,Hemophilia,60,80,7,1,8
Rajasthan,Bhilwara,Hemophilia,0,6,1,0,1
Rajasthan,Bhilwara,Hemophilia,6,15,7,0,7
Rajasthan,Bhilwara,Hemophilia,15,35,7,1,8
Rajasthan,Bhilwara,Hemophilia,35,60,6,1,7
Gujarat,Bhavnagar,Hemophilia,0,6,3,0,3
Gujarat,Bhavnagar,Hemophilia,6,15,10,0,10
Gujarat,Bhavnagar,Hemophilia,15,35,11,0,11
Gujarat,Bhavnagar,Hemophilia,35,60,1,0,1
Gujarat,Bharuch,Hemophilia,6,15,1,0,1
Gujarat,Bharuch,Hemophilia,15,35,2,0,2
Gujarat,Bharuch,Hemophilia,35,60,2,0,2
Gujarat,Bharuch,Hemophilia,60,80,2,0,2
Rajasthan,Bharatpur,Hemophilia,6,15,2,0,2
Rajasthan,Bharatpur,Hemophilia,15,35,11,0,11
Maharashtra,Bhandara,Hemophilia,0,6,2,0,2
Maharashtra,Bhandara,Hemophilia,6,15,10,0,10
Maharashtra,Bhandara,Hemophilia,15,35,8,1,9
Maharashtra,Bhandara,Hemophilia,35,60,5,2,7
Bihar,Bhagalpur,Hemophilia,6,15,0,2,2
Bihar,Bhagalpur,Hemophilia,15,35,3,1,4
Bihar,Bhagalpur,Hemophilia,35,60,6,1,7
Bihar,Bhagalpur,Hemophilia,60,80,1,0,1
Odisha,Bhadrak,Hemophilia,0,6,0,1,1
Odisha,Bhadrak,Hemophilia,6,15,6,0,6
Odisha,Bhadrak,Hemophilia,15,35,7,0,7
Odisha,Bhadrak,Hemophilia,35,60,4,2,6
Odisha,Bhadrak,Hemophilia,60,80,3,2,5
Uttar Pradesh,Bhadohi,Hemophilia,15,35,4,0,4
Uttar Pradesh,Bhadohi,Hemophilia,35,60,2,0,2
Madhya Pradesh,Betul,Hemophilia,6,15,1,0,1
Madhya Pradesh,Betul,Hemophilia,15,35,4,1,5
Madhya Pradesh,Betul,Hemophilia,35,60,4,1,5
Madhya Pradesh,Betul,Hemophilia,60,80,0,1,1
Karnataka,Bengaluru Urban,Hemophilia,6,15,10,0,10
Karnataka,Bengaluru Urban,Hemophilia,15,35,22,2,24
Karnataka,Bengaluru Urban,Hemophilia,35,60,14,3,17
Karnataka,Bengaluru Urban,Hemophilia,60,80,1,0,1
Karnataka,Bengaluru Rural,Hemophilia,6,15,1,0,1
Karnataka,Bengaluru Rural,Hemophilia,15,35,4,0,4
Karnataka,Bengaluru Rural,Hemophilia,35,60,2,1,3
Karnataka,Bengaluru Rural,Hemophilia,60,80,3,0,3
Karnataka,Bengaluru Rural,Hemophilia,80,100,2,0,2
Karnataka,Belagavi,Hemophilia,0,6,7,0,7
Karnataka,Belagavi,Hemophilia,6,15,5,2,7
Karnataka,Belagavi,Hemophilia,15,35,16,5,21
Karnataka,Belagavi,Hemophilia,35,60,34,16,50
Karnataka,Belagavi,Hemophilia,60,80,6,2,8
Karnataka,Belagavi,Hemophilia,80,100,1,0,1
Bihar,Begusarai,Hemophilia,6,15,2,0,2
Bihar,Begusarai,Hemophilia,15,35,9,0,9
Bihar,Begusarai,Hemophilia,35,60,1,0,1
Bihar,Begusarai,Hemophilia,60,80,1,0,1
Maharashtra,Beed,Hemophilia,6,15,9,0,9
Maharashtra,Beed,Hemophilia,15,35,22,0,22
Maharashtra,Beed,Hemophilia,35,60,8,1,9
Punjab,Bathinda,Hemophilia,6,15,2,0,2
Punjab,Bathinda,Hemophilia,15,35,6,1,7
Punjab,Bathinda,Hemophilia,35,60,4,1,5
Punjab,Bathinda,Hemophilia,60,80,2,0,2
Uttar Pradesh,Basti,Hemophilia,6,15,2,0,2
Uttar Pradesh,Basti,Hemophilia,15,35,6,0,6
Uttar Pradesh,Basti,Hemophilia,35,60,4,1,5
Uttar Pradesh,Basti,Hemophilia,60,80,2,0,2
Chhattisgarh,Bastar,Hemophilia,15,35,0,1,1
Chhattisgarh,Bastar,Hemophilia,35,60,1,0,1
Madhya Pradesh,Barwani,Hemophilia,0,6,1,1,2
Madhya Pradesh,Barwani,Hemophilia,6,15,1,1,2
Madhya Pradesh,Barwani,Hemophilia,15,35,0,1,1
Madhya Pradesh,Barwani,Hemophilia,35,60,6,3,9
Madhya Pradesh,Barwani,Hemophilia,60,80,3,3,6
Assam,Barpeta,Hemophilia,6,15,3,1,4
Assam,Barpeta,Hemophilia,15,35,5,0,5
Assam,Barpeta,Hemophilia,35,60,2,2,4
Punjab,Barnala,Hemophilia,6,15,1,0,1
Punjab,Barnala,Hemophilia,15,35,3,1,4
Punjab,Barnala,Hemophilia,35,60,6,2,8
Punjab,Barnala,Hemophilia,60,80,3,0,3
Rajasthan,Barmer,Hemophilia,0,6,2,0,2
Rajasthan,Barmer,Hemophilia,6,15,4,0,4
Rajasthan,Barmer,Hemophilia,15,35,6,0,6
Rajasthan,Barmer,Hemophilia,35,60,2,0,2
Rajasthan,Barmer,Hemophilia,60,80,1,0,1
Odisha,Bargarh,Hemophilia,0,6,1,0,1
Odisha,Bargarh,Hemophilia,6,15,3,0,3
Odisha,Bargarh,Hemophilia,35,60,4,1,5
Odisha,Bargarh,Hemophilia,60,80,1,0,1
Uttar Pradesh,Bareilly,Hemophilia,6,15,3,0,3
Uttar Pradesh,Bareilly,Hemophilia,15,35,24,3,27
Uttar Pradesh,Bareilly,Hemophilia,35,60,12,1,13
Uttar Pradesh,Bareilly,Hemophilia,60,80,3,0,3
Rajasthan,Baran,Hemophilia,0,6,2,0,2
Rajasthan,Baran,Hemophilia,15,35,2,0,2
Rajasthan,Baran,Hemophilia,35,60,4,0,4
Jammu And Kashmir,Baramulla,Hemophilia,0,6,2,0,2
Jammu And Kashmir,Baramulla,Hemophilia,6,15,5,0,5
Jammu And Kashmir,Baramulla,Hemophilia,15,35,9,4,13
Jammu And Kashmir,Baramulla,Hemophilia,35,60,6,5,11
Jammu And Kashmir,Baramulla,Hemophilia,60,80,4,1,5
Uttar Pradesh,Barabanki,Hemophilia,6,15,2,0,2
Uttar Pradesh,Barabanki,Hemophilia,15,35,11,3,14
Uttar Pradesh,Barabanki,Hemophilia,35,60,11,2,13
Uttar Pradesh,Barabanki,Hemophilia,60,80,6,1,7
Rajasthan,Banswara,Hemophilia,6,15,1,1,2
Rajasthan,Banswara,Hemophilia,35,60,2,1,3
Bihar,Banka,Hemophilia,15,35,3,4,7
Bihar,Banka,Hemophilia,35,60,7,2,9
Bihar,Banka,Hemophilia,60,80,2,0,2
Jammu And Kashmir,Bandipora,Hemophilia,0,6,1,1,2
Jammu And Kashmir,Bandipora,Hemophilia,6,15,7,3,10
Jammu And Kashmir,Bandipora,Hemophilia,15,35,13,12,25
Jammu And Kashmir,Bandipora,Hemophilia,35,60,15,11,26
Jammu And Kashmir,Bandipora,Hemophilia,60,80,3,5,8
Uttar Pradesh,Banda,Hemophilia,15,35,1,1,2
Uttar Pradesh,Banda,Hemophilia,35,60,0,1,1
Gujarat,Banas Kantha,Hemophilia,15,35,2,0,2
Gujarat,Banas Kantha,Hemophilia,35,60,2,0,2
Chhattisgarh,Balrampur,Hemophilia,6,15,1,0,1
Chhattisgarh,Balrampur,Hemophilia,15,35,3,4,7
Chhattisgarh,Balrampur,Hemophilia,35,60,7,2,9
Chhattisgarh,Balrampur,Hemophilia,60,80,3,1,4
Uttar Pradesh,Balrampur,Hemophilia,6,15,2,2,4
Uttar Pradesh,Balrampur,Hemophilia,15,35,28,10,38
Uttar Pradesh,Balrampur,Hemophilia,35,60,26,1,27
Uttar Pradesh,Balrampur,Hemophilia,60,80,9,1,10
Chhattisgarh,Baloda Bazar,Hemophilia,6,15,1,0,1
Chhattisgarh,Baloda Bazar,Hemophilia,15,35,1,1,2
Chhattisgarh,Baloda Bazar,Hemophilia,35,60,2,0,2
Chhattisgarh,Baloda Bazar,Hemophilia,60,80,1,0,1
Chhattisgarh,Balod,Hemophilia,6,15,1,0,1
Uttar Pradesh,Ballia,Hemophilia,6,15,1,0,1
Uttar Pradesh,Ballia,Hemophilia,15,35,12,3,15
Uttar Pradesh,Ballia,Hemophilia,35,60,9,3,12
Uttar Pradesh,Ballia,Hemophilia,60,80,4,2,6
Karnataka,Ballari,Hemophilia,0,6,1,0,1
Karnataka,Ballari,Hemophilia,6,15,12,4,16
Karnataka,Ballari,Hemophilia,15,35,20,10,30
Karnataka,Ballari,Hemophilia,35,60,25,4,29
Karnataka,Ballari,Hemophilia,60,80,3,1,4
Odisha,Baleshwar,Hemophilia,0,6,1,0,1
Odisha,Baleshwar,Hemophilia,6,15,12,2,14
Odisha,Baleshwar,Hemophilia,15,35,16,3,19
Odisha,Baleshwar,Hemophilia,35,60,13,8,21
Odisha,Baleshwar,Hemophilia,60,80,12,3,15
Odisha,Balangir,Hemophilia,6,15,2,2,4
Odisha,Balangir,Hemophilia,15,35,5,0,5
Odisha,Balangir,Hemophilia,35,60,12,4,16
Odisha,Balangir,Hemophilia,60,80,6,1,7
Madhya Pradesh,Balaghat,Hemophilia,15,35,8,6,14
Madhya Pradesh,Balaghat,Hemophilia,35,60,6,4,10
Assam,Baksa,Hemophilia,15,35,1,0,1
Uttar Pradesh,Bahraich,Hemophilia,0,6,1,0,1
Uttar Pradesh,Bahraich,Hemophilia,6,15,1,0,1
Uttar Pradesh,Bahraich,Hemophilia,15,35,4,2,6
Uttar Pradesh,Bahraich,Hemophilia,35,60,4,0,4
Uttar Pradesh,Bahraich,Hemophilia,60,80,2,0,2
Uttar Pradesh,Baghpat,Hemophilia,0,6,1,0,1
Uttar Pradesh,Baghpat,Hemophilia,6,15,2,1,3
Uttar Pradesh,Baghpat,Hemophilia,15,35,16,3,19
Uttar Pradesh,Baghpat,Hemophilia,35,60,17,7,24
Uttar Pradesh,Baghpat,Hemophilia,60,80,8,1,9
Uttarakhand,Bageshwar,Hemophilia,6,15,4,0,4
Uttarakhand,Bageshwar,Hemophilia,15,35,2,1,3
Uttarakhand,Bageshwar,Hemophilia,35,60,14,3,17
Uttarakhand,Bageshwar,Hemophilia,60,80,4,2,6
Karnataka,Bagalkote,Hemophilia,0,6,1,0,1
Karnataka,Bagalkote,Hemophilia,6,15,11,1,12
Karnataka,Bagalkote,Hemophilia,15,35,17,1,18
Karnataka,Bagalkote,Hemophilia,35,60,8,0,8
Karnataka,Bagalkote,Hemophilia,60,80,2,0,2
Uttar Pradesh,Azamgarh,Hemophilia,6,15,1,0,1
Uttar Pradesh,Azamgarh,Hemophilia,15,35,1,1,2
Uttar Pradesh,Azamgarh,Hemophilia,35,60,2,0,2
Uttar Pradesh,Azamgarh,Hemophilia,60,80,1,0,1
Uttar Pradesh,Ayodhya,Hemophilia,6,15,2,0,2
Uttar Pradesh,Ayodhya,Hemophilia,15,35,7,0,7
Uttar Pradesh,Ayodhya,Hemophilia,35,60,8,1,9
Uttar Pradesh,Ayodhya,Hemophilia,60,80,1,1,2
Bihar,Aurangabad,Hemophilia,15,35,4,1,5
Bihar,Aurangabad,Hemophilia,35,60,6,2,8
Bihar,Aurangabad,Hemophilia,60,80,1,0,1
Maharashtra,Aurangabad,Hemophilia,0,6,1,0,1
Maharashtra,Aurangabad,Hemophilia,6,15,14,1,15
Maharashtra,Aurangabad,Hemophilia,15,35,42,0,42
Maharashtra,Aurangabad,Hemophilia,35,60,12,0,12
Uttar Pradesh,Auraiya,Hemophilia,15,35,6,0,6
Uttar Pradesh,Auraiya,Hemophilia,35,60,5,2,7
Madhya Pradesh,Ashoknagar,Hemophilia,35,60,2,0,2
Bihar,Arwal,Hemophilia,6,15,0,2,2
Bihar,Arwal,Hemophilia,15,35,4,0,4
Bihar,Arwal,Hemophilia,35,60,4,1,5
Bihar,Arwal,Hemophilia,60,80,3,1,4
Gujarat,Arvalli,Hemophilia,6,15,1,0,1
Tamil Nadu,Ariyalur,Hemophilia,0,6,1,0,1
Tamil Nadu,Ariyalur,Hemophilia,6,15,3,0,3
Tamil Nadu,Ariyalur,Hemophilia,15,35,2,0,2
Tamil Nadu,Ariyalur,Hemophilia,35,60,2,0,2
Tamil Nadu,Ariyalur,Hemophilia,60,80,1,0,1
Bihar,Araria,Hemophilia,15,35,1,0,1
Bihar,Araria,Hemophilia,35,60,1,1,2
Madhya Pradesh,Anuppur,Hemophilia,6,15,1,0,1
Madhya Pradesh,Anuppur,Hemophilia,15,35,1,0,1
Madhya Pradesh,Anuppur,Hemophilia,35,60,4,2,6
Madhya Pradesh,Anuppur,Hemophilia,60,80,1,0,1
Odisha,Anugul,Hemophilia,6,15,1,1,2
Odisha,Anugul,Hemophilia,15,35,3,1,4
Odisha,Anugul,Hemophilia,35,60,4,1,5
Odisha,Anugul,Hemophilia,60,80,1,4,5
Jammu And Kashmir,Anantnag,Hemophilia,6,15,3,0,3
Jammu And Kashmir,Anantnag,Hemophilia,15,35,6,0,6
Gujarat,Anand,Hemophilia,6,15,2,0,2
Gujarat,Anand,Hemophilia,15,35,1,0,1
Gujarat,Anand,Hemophilia,35,60,1,0,1
Uttar Pradesh,Amroha,Hemophilia,6,15,3,0,3
Uttar Pradesh,Amroha,Hemophilia,15,35,7,4,11
Uttar Pradesh,Amroha,Hemophilia,35,60,3,1,4
Punjab,Amritsar,Hemophilia,0,6,1,0,1
Punjab,Amritsar,Hemophilia,6,15,1,0,1
Punjab,Amritsar,Hemophilia,15,35,8,1,9
Punjab,Amritsar,Hemophilia,35,60,7,1,8
Punjab,Amritsar,Hemophilia,60,80,2,1,3
Gujarat,Amreli,Hemophilia,6,15,1,1,2
Gujarat,Amreli,Hemophilia,15,35,2,0,2
Gujarat,Amreli,Hemophilia,35,60,0,1,1
Maharashtra,Amravati,Hemophilia,0,6,4,1,5
Maharashtra,Amravati,Hemophilia,6,15,38,3,41
Maharashtra,Amravati,Hemophilia,15,35,58,2,60
Maharashtra,Amravati,Hemophilia,35,60,15,0,15
Maharashtra,Amravati,Hemophilia,60,80,2,0,2
Uttar Pradesh,Amethi,Hemophilia,6,15,1,0,1
Uttar Pradesh,Amethi,Hemophilia,15,35,2,0,2
Uttar Pradesh,Amethi,Hemophilia,35,60,2,0,2
Uttar Pradesh,Ambedkar Nagar,Hemophilia,6,15,2,0,2
Uttar Pradesh,Ambedkar Nagar,Hemophilia,15,35,12,3,15
Uttar Pradesh,Ambedkar Nagar,Hemophilia,35,60,6,0,6
Uttar Pradesh,Ambedkar Nagar,Hemophilia,60,80,2,0,2
Haryana,Ambala,Hemophilia,6,15,2,0,2
Haryana,Ambala,Hemophilia,15,35,8,2,10
Haryana,Ambala,Hemophilia,35,60,7,1,8
Haryana,Ambala,Hemophilia,60,80,1,0,1
Rajasthan,Alwar,Hemophilia,0,6,4,0,4
Rajasthan,Alwar,Hemophilia,6,15,14,0,14
Rajasthan,Alwar,Hemophilia,15,35,14,0,14
Rajasthan,Alwar,Hemophilia,35,60,3,0,3
Uttarakhand,Almora,Hemophilia,6,15,2,0,2
Uttarakhand,Almora,Hemophilia,15,35,1,0,1
Uttarakhand,Almora,Hemophilia,35,60,0,1,1
Madhya Pradesh,Alirajpur,Hemophilia,15,35,0,3,3
Madhya Pradesh,Alirajpur,Hemophilia,35,60,2,0,2
Uttar Pradesh,Aligarh,Hemophilia,0,6,2,0,2
Uttar Pradesh,Aligarh,Hemophilia,6,15,2,0,2
Uttar Pradesh,Aligarh,Hemophilia,15,35,16,3,19
Uttar Pradesh,Aligarh,Hemophilia,35,60,19,4,23
Uttar Pradesh,Aligarh,Hemophilia,60,80,5,1,6
Uttar Pradesh,Aligarh,Hemophilia,80,100,2,0,2
Kerala,Alappuzha,Hemophilia,0,6,1,0,1
Kerala,Alappuzha,Hemophilia,6,15,1,0,1
Kerala,Alappuzha,Hemophilia,15,35,13,0,13
Kerala,Alappuzha,Hemophilia,35,60,5,0,5
Maharashtra,Akola,Hemophilia,0,6,2,0,2
Maharashtra,Akola,Hemophilia,6,15,17,3,20
Maharashtra,Akola,Hemophilia,15,35,20,3,23
Maharashtra,Akola,Hemophilia,35,60,6,0,6
Rajasthan,Ajmer,Hemophilia,6,15,6,0,6
Rajasthan,Ajmer,Hemophilia,15,35,2,0,2
Rajasthan,Ajmer,Hemophilia,35,60,3,0,3
Mizoram,Aizawl,Hemophilia,6,15,1,1,2
Mizoram,Aizawl,Hemophilia,35,60,1,0,1
Maharashtra,Ahmednagar,Hemophilia,0,6,1,0,1
Maharashtra,Ahmednagar,Hemophilia,6,15,17,0,17
Maharashtra,Ahmednagar,Hemophilia,15,35,25,1,26
Maharashtra,Ahmednagar,Hemophilia,35,60,9,1,10
Maharashtra,Ahmednagar,Hemophilia,60,80,1,0,1
Gujarat,Ahmadabad,Hemophilia,6,15,10,0,10
Gujarat,Ahmadabad,Hemophilia,15,35,19,0,19
Gujarat,Ahmadabad,Hemophilia,35,60,6,0,6
Uttar Pradesh,Agra,Hemophilia,0,6,2,0,2
Uttar Pradesh,Agra,Hemophilia,6,15,6,0,6
Uttar Pradesh,Agra,Hemophilia,15,35,26,1,27
Uttar Pradesh,Agra,Hemophilia,35,60,3,1,4
Madhya Pradesh,Agar Malwa,Hemophilia,6,15,5,1,6
Madhya Pradesh,Agar Malwa,Hemophilia,15,35,6,4,10
Madhya Pradesh,Agar Malwa,Hemophilia,35,60,3,3,6
Madhya Pradesh,Agar Malwa,Hemophilia,60,80,4,1,5
Nagaland,Zunheboto,Intellectual Disability,15,35,1,1,2
Nagaland,Zunheboto,Intellectual Disability,35,60,1,2,3
Nagaland,Zunheboto,Intellectual Disability,80,100,0,1,1
Maharashtra,Yavatmal,Intellectual Disability,0,6,20,4,24
Maharashtra,Yavatmal,Intellectual Disability,6,15,444,281,725
Maharashtra,Yavatmal,Intellectual Disability,15,35,617,388,1005
Maharashtra,Yavatmal,Intellectual Disability,35,60,198,127,325
Maharashtra,Yavatmal,Intellectual Disability,60,80,8,5,13
Puducherry,Yanam,Intellectual Disability,6,15,9,3,12
Puducherry,Yanam,Intellectual Disability,15,35,25,12,37
Puducherry,Yanam,Intellectual Disability,35,60,2,2,4
Haryana,Yamunanagar,Intellectual Disability,0,6,46,24,70
Haryana,Yamunanagar,Intellectual Disability,6,15,530,344,874
Haryana,Yamunanagar,Intellectual Disability,15,35,613,318,931
Haryana,Yamunanagar,Intellectual Disability,35,60,218,118,336
Haryana,Yamunanagar,Intellectual Disability,60,80,26,4,30
Haryana,Yamunanagar,Intellectual Disability,80,100,0,1,1
Karnataka,Yadgir,Intellectual Disability,0,6,48,38,86
Karnataka,Yadgir,Intellectual Disability,6,15,201,146,347
Karnataka,Yadgir,Intellectual Disability,15,35,192,202,394
Karnataka,Yadgir,Intellectual Disability,35,60,53,42,95
Karnataka,Yadgir,Intellectual Disability,60,80,1,2,3
Telangana,Yadadri Bhuvanagiri,Intellectual Disability,6,15,75,48,123
Telangana,Yadadri Bhuvanagiri,Intellectual Disability,15,35,632,413,1045
Telangana,Yadadri Bhuvanagiri,Intellectual Disability,35,60,130,118,248
Telangana,Yadadri Bhuvanagiri,Intellectual Disability,60,80,6,6,12
Andhra Pradesh,Y.S.R.,Intellectual Disability,0,6,35,29,64
Andhra Pradesh,Y.S.R.,Intellectual Disability,6,15,512,331,843
Andhra Pradesh,Y.S.R.,Intellectual Disability,15,35,1349,884,2233
Andhra Pradesh,Y.S.R.,Intellectual Disability,35,60,654,426,1080
Andhra Pradesh,Y.S.R.,Intellectual Disability,60,80,31,19,50
Andhra Pradesh,Y.S.R.,Intellectual Disability,80,100,1,1,2
Nagaland,Wokha,Intellectual Disability,6,15,3,0,3
Nagaland,Wokha,Intellectual Disability,15,35,2,2,4
Nagaland,Wokha,Intellectual Disability,35,60,4,5,9
Tripura,West Tripura,Intellectual Disability,0,6,17,6,23
Tripura,West Tripura,Intellectual Disability,6,15,277,132,409
Tripura,West Tripura,Intellectual Disability,15,35,452,261,713
Tripura,West Tripura,Intellectual Disability,35,60,174,110,284
Tripura,West Tripura,Intellectual Disability,60,80,9,4,13
Tripura,West Tripura,Intellectual Disability,80,100,2,0,2
Jharkhand,West Singhbhum,Intellectual Disability,0,6,7,4,11
Jharkhand,West Singhbhum,Intellectual Disability,6,15,117,84,201
Jharkhand,West Singhbhum,Intellectual Disability,15,35,72,70,142
Jharkhand,West Singhbhum,Intellectual Disability,35,60,35,21,56
Jharkhand,West Singhbhum,Intellectual Disability,60,80,1,2,3
Arunachal Pradesh,West Siang,Intellectual Disability,0,6,1,0,1
Arunachal Pradesh,West Siang,Intellectual Disability,6,15,1,0,1
Arunachal Pradesh,West Siang,Intellectual Disability,15,35,1,2,3
Arunachal Pradesh,West Siang,Intellectual Disability,35,60,1,0,1
Meghalaya,West Khasi Hills,Intellectual Disability,0,6,18,17,35
Meghalaya,West Khasi Hills,Intellectual Disability,6,15,94,81,175
Meghalaya,West Khasi Hills,Intellectual Disability,15,35,165,154,319
Meghalaya,West Khasi Hills,Intellectual Disability,35,60,24,34,58
Assam,West Karbi Anglong,Intellectual Disability,6,15,2,1,3
Assam,West Karbi Anglong,Intellectual Disability,15,35,4,3,7
Assam,West Karbi Anglong,Intellectual Disability,35,60,1,0,1
Meghalaya,West Jaintia Hills,Intellectual Disability,0,6,14,17,31
Meghalaya,West Jaintia Hills,Intellectual Disability,6,15,101,73,174
Meghalaya,West Jaintia Hills,Intellectual Disability,15,35,252,238,490
Meghalaya,West Jaintia Hills,Intellectual Disability,35,60,72,60,132
Meghalaya,West Jaintia Hills,Intellectual Disability,60,80,1,1,2
Meghalaya,West Jaintia Hills,Intellectual Disability,80,100,0,2,2
Andhra Pradesh,West Godavari,Intellectual Disability,0,6,15,7,22
Andhra Pradesh,West Godavari,Intellectual Disability,6,15,284,163,447
Andhra Pradesh,West Godavari,Intellectual Disability,15,35,660,479,1139
Andhra Pradesh,West Godavari,Intellectual Disability,35,60,308,234,542
Andhra Pradesh,West Godavari,Intellectual Disability,60,80,36,17,53
Andhra Pradesh,West Godavari,Intellectual Disability,80,100,2,0,2
Meghalaya,West Garo Hills,Intellectual Disability,0,6,4,4,8
Meghalaya,West Garo Hills,Intellectual Disability,6,15,53,63,116
Meghalaya,West Garo Hills,Intellectual Disability,15,35,183,151,334
Meghalaya,West Garo Hills,Intellectual Disability,35,60,49,26,75
Meghalaya,West Garo Hills,Intellectual Disability,60,80,0,4,4
Delhi,West,Intellectual Disability,0,6,37,9,46
Delhi,West,Intellectual Disability,6,15,210,142,352
Delhi,West,Intellectual Disability,15,35,253,175,428
Delhi,West,Intellectual Disability,35,60,48,26,74
Delhi,West,Intellectual Disability,60,80,5,2,7
Delhi,West,Intellectual Disability,80,100,1,0,1
Kerala,Wayanad,Intellectual Disability,0,6,9,15,24
Kerala,Wayanad,Intellectual Disability,6,15,157,111,268
Kerala,Wayanad,Intellectual Disability,15,35,432,310,742
Kerala,Wayanad,Intellectual Disability,35,60,211,189,400
Kerala,Wayanad,Intellectual Disability,60,80,20,18,38
Kerala,Wayanad,Intellectual Disability,80,100,1,0,1
Maharashtra,Washim,Intellectual Disability,0,6,55,39,94
Maharashtra,Washim,Intellectual Disability,6,15,413,260,673
Maharashtra,Washim,Intellectual Disability,15,35,597,322,919
Maharashtra,Washim,Intellectual Disability,35,60,139,103,242
Maharashtra,Washim,Intellectual Disability,60,80,10,5,15
Maharashtra,Wardha,Intellectual Disability,0,6,6,4,10
Maharashtra,Wardha,Intellectual Disability,6,15,262,163,425
Maharashtra,Wardha,Intellectual Disability,15,35,546,323,869
Maharashtra,Wardha,Intellectual Disability,35,60,179,144,323
Maharashtra,Wardha,Intellectual Disability,60,80,0,4,4
Telangana,Warangal,Intellectual Disability,6,15,41,29,70
Telangana,Warangal,Intellectual Disability,15,35,526,425,951
Telangana,Warangal,Intellectual Disability,35,60,241,194,435
Telangana,Warangal,Intellectual Disability,60,80,6,8,14
Telangana,Warangal,Intellectual Disability,80,100,2,0,2
Telangana,Wanaparthy,Intellectual Disability,6,15,92,72,164
Telangana,Wanaparthy,Intellectual Disability,15,35,490,346,836
Telangana,Wanaparthy,Intellectual Disability,35,60,92,108,200
Telangana,Wanaparthy,Intellectual Disability,60,80,13,4,17
Telangana,Wanaparthy,Intellectual Disability,80,100,1,1,2
Andhra Pradesh,Vizianagaram,Intellectual Disability,0,6,23,15,38
Andhra Pradesh,Vizianagaram,Intellectual Disability,6,15,344,214,558
Andhra Pradesh,Vizianagaram,Intellectual Disability,15,35,758,674,1432
Andhra Pradesh,Vizianagaram,Intellectual Disability,35,60,335,215,550
Andhra Pradesh,Vizianagaram,Intellectual Disability,60,80,54,18,72
Andhra Pradesh,Vizianagaram,Intellectual Disability,80,100,1,2,3
Andhra Pradesh,Visakhapatanam,Intellectual Disability,0,6,57,39,96
Andhra Pradesh,Visakhapatanam,Intellectual Disability,6,15,827,584,1411
Andhra Pradesh,Visakhapatanam,Intellectual Disability,15,35,1670,1193,2863
Andhra Pradesh,Visakhapatanam,Intellectual Disability,35,60,630,433,1063
Andhra Pradesh,Visakhapatanam,Intellectual Disability,60,80,44,23,67
Andhra Pradesh,Visakhapatanam,Intellectual Disability,80,100,1,0,1
Tamil Nadu,Virudhunagar,Intellectual Disability,0,6,91,68,159
Tamil Nadu,Virudhunagar,Intellectual Disability,6,15,1040,701,1741
Tamil Nadu,Virudhunagar,Intellectual Disability,15,35,1648,1067,2715
Tamil Nadu,Virudhunagar,Intellectual Disability,35,60,375,374,749
Tamil Nadu,Virudhunagar,Intellectual Disability,60,80,31,9,40
Tamil Nadu,Virudhunagar,Intellectual Disability,80,100,1,2,3
Tamil Nadu,Villupuram,Intellectual Disability,0,6,54,35,89
Tamil Nadu,Villupuram,Intellectual Disability,6,15,736,448,1184
Tamil Nadu,Villupuram,Intellectual Disability,15,35,1020,718,1738
Tamil Nadu,Villupuram,Intellectual Disability,35,60,292,243,535
Tamil Nadu,Villupuram,Intellectual Disability,60,80,17,15,32
Tamil Nadu,Villupuram,Intellectual Disability,80,100,2,1,3
Telangana,Vikarabad,Intellectual Disability,6,15,120,67,187
Telangana,Vikarabad,Intellectual Disability,15,35,336,302,638
Telangana,Vikarabad,Intellectual Disability,35,60,98,66,164
Telangana,Vikarabad,Intellectual Disability,60,80,7,5,12
Telangana,Vikarabad,Intellectual Disability,80,100,1,1,2
Karnataka,Vijayapura,Intellectual Disability,0,6,81,53,134
Karnataka,Vijayapura,Intellectual Disability,6,15,619,400,1019
Karnataka,Vijayapura,Intellectual Disability,15,35,898,711,1609
Karnataka,Vijayapura,Intellectual Disability,35,60,239,199,438
Karnataka,Vijayapura,Intellectual Disability,60,80,10,6,16
Karnataka,Vijayapura,Intellectual Disability,80,100,0,1,1
Karnataka,Vijayanagar,Intellectual Disability,0,6,1,0,1
Karnataka,Vijayanagar,Intellectual Disability,6,15,1,0,1
Madhya Pradesh,Vidisha,Intellectual Disability,0,6,18,11,29
Madhya Pradesh,Vidisha,Intellectual Disability,6,15,215,137,352
Madhya Pradesh,Vidisha,Intellectual Disability,15,35,487,258,745
Madhya Pradesh,Vidisha,Intellectual Disability,35,60,214,70,284
Madhya Pradesh,Vidisha,Intellectual Disability,60,80,38,12,50
Madhya Pradesh,Vidisha,Intellectual Disability,80,100,5,1,6
Tamil Nadu,Vellore,Intellectual Disability,0,6,46,24,70
Tamil Nadu,Vellore,Intellectual Disability,6,15,642,408,1050
Tamil Nadu,Vellore,Intellectual Disability,15,35,1355,857,2212
Tamil Nadu,Vellore,Intellectual Disability,35,60,353,296,649
Tamil Nadu,Vellore,Intellectual Disability,60,80,36,15,51
Tamil Nadu,Vellore,Intellectual Disability,80,100,1,1,2
Uttar Pradesh,Varanasi,Intellectual Disability,0,6,29,23,52
Uttar Pradesh,Varanasi,Intellectual Disability,6,15,285,183,468
Uttar Pradesh,Varanasi,Intellectual Disability,15,35,443,221,664
Uttar Pradesh,Varanasi,Intellectual Disability,35,60,113,64,177
Uttar Pradesh,Varanasi,Intellectual Disability,60,80,1,2,3
Gujarat,Valsad,Intellectual Disability,0,6,46,14,60
Gujarat,Valsad,Intellectual Disability,6,15,684,487,1171
Gujarat,Valsad,Intellectual Disability,15,35,693,425,1118
Gujarat,Valsad,Intellectual Disability,35,60,81,75,156
Gujarat,Valsad,Intellectual Disability,60,80,9,3,12
Bihar,Vaishali,Intellectual Disability,0,6,6,3,9
Bihar,Vaishali,Intellectual Disability,6,15,103,81,184
Bihar,Vaishali,Intellectual Disability,15,35,117,47,164
Bihar,Vaishali,Intellectual Disability,35,60,35,8,43
Bihar,Vaishali,Intellectual Disability,60,80,2,4,6
Gujarat,Vadodara,Intellectual Disability,0,6,142,90,232
Gujarat,Vadodara,Intellectual Disability,6,15,1448,900,2348
Gujarat,Vadodara,Intellectual Disability,15,35,1746,833,2579
Gujarat,Vadodara,Intellectual Disability,35,60,304,269,573
Gujarat,Vadodara,Intellectual Disability,60,80,34,26,60
Gujarat,Vadodara,Intellectual Disability,80,100,0,1,1
Karnataka,Uttara Kannada,Intellectual Disability,0,6,35,16,51
Karnataka,Uttara Kannada,Intellectual Disability,6,15,420,270,690
Karnataka,Uttara Kannada,Intellectual Disability,15,35,960,662,1622
Karnataka,Uttara Kannada,Intellectual Disability,35,60,430,391,821
Karnataka,Uttara Kannada,Intellectual Disability,60,80,42,22,64
Karnataka,Uttara Kannada,Intellectual Disability,80,100,1,0,1
Uttarakhand,Uttar Kashi,Intellectual Disability,0,6,8,4,12
Uttarakhand,Uttar Kashi,Intellectual Disability,6,15,82,33,115
Uttarakhand,Uttar Kashi,Intellectual Disability,15,35,209,113,322
Uttarakhand,Uttar Kashi,Intellectual Disability,35,60,152,54,206
Uttarakhand,Uttar Kashi,Intellectual Disability,60,80,10,8,18
Uttarakhand,Uttar Kashi,Intellectual Disability,80,100,1,0,1
Arunachal Pradesh,Upper Siang,Intellectual Disability,15,35,1,0,1
Uttar Pradesh,Unnao,Intellectual Disability,0,6,0,2,2
Uttar Pradesh,Unnao,Intellectual Disability,6,15,38,35,73
Uttar Pradesh,Unnao,Intellectual Disability,15,35,101,68,169
Uttar Pradesh,Unnao,Intellectual Disability,35,60,46,22,68
Uttar Pradesh,Unnao,Intellectual Disability,60,80,8,1,9
Tripura,Unakoti,Intellectual Disability,0,6,3,2,5
Tripura,Unakoti,Intellectual Disability,6,15,86,39,125
Tripura,Unakoti,Intellectual Disability,15,35,147,97,244
Tripura,Unakoti,Intellectual Disability,35,60,39,36,75
Tripura,Unakoti,Intellectual Disability,60,80,2,1,3
Tripura,Unakoti,Intellectual Disability,80,100,0,1,1
Himachal Pradesh,Una,Intellectual Disability,0,6,12,4,16
Himachal Pradesh,Una,Intellectual Disability,6,15,56,29,85
Himachal Pradesh,Una,Intellectual Disability,15,35,82,26,108
Himachal Pradesh,Una,Intellectual Disability,35,60,27,25,52
Himachal Pradesh,Una,Intellectual Disability,60,80,5,4,9
Madhya Pradesh,Umaria,Intellectual Disability,6,15,34,22,56
Madhya Pradesh,Umaria,Intellectual Disability,15,35,97,49,146
Madhya Pradesh,Umaria,Intellectual Disability,35,60,42,14,56
Madhya Pradesh,Umaria,Intellectual Disability,60,80,4,1,5
Manipur,Ukhrul,Intellectual Disability,0,6,1,2,3
Manipur,Ukhrul,Intellectual Disability,6,15,7,8,15
Manipur,Ukhrul,Intellectual Disability,15,35,14,10,24
Manipur,Ukhrul,Intellectual Disability,35,60,13,8,21
Manipur,Ukhrul,Intellectual Disability,60,80,1,1,2
Madhya Pradesh,Ujjain,Intellectual Disability,0,6,67,32,99
Madhya Pradesh,Ujjain,Intellectual Disability,6,15,578,428,1006
Madhya Pradesh,Ujjain,Intellectual Disability,15,35,1286,814,2100
Madhya Pradesh,Ujjain,Intellectual Disability,35,60,377,227,604
Madhya Pradesh,Ujjain,Intellectual Disability,60,80,28,13,41
Karnataka,Udupi,Intellectual Disability,0,6,11,11,22
Karnataka,Udupi,Intellectual Disability,6,15,244,169,413
Karnataka,Udupi,Intellectual Disability,15,35,696,502,1198
Karnataka,Udupi,Intellectual Disability,35,60,470,444,914
Karnataka,Udupi,Intellectual Disability,60,80,29,33,62
Jammu And Kashmir,Udhampur,Intellectual Disability,0,6,10,8,18
Jammu And Kashmir,Udhampur,Intellectual Disability,6,15,129,84,213
Jammu And Kashmir,Udhampur,Intellectual Disability,15,35,186,130,316
Jammu And Kashmir,Udhampur,Intellectual Disability,35,60,83,50,133
Jammu And Kashmir,Udhampur,Intellectual Disability,60,80,1,0,1
Uttarakhand,Udam Singh Nagar,Intellectual Disability,0,6,8,13,21
Uttarakhand,Udam Singh Nagar,Intellectual Disability,6,15,147,89,236
Uttarakhand,Udam Singh Nagar,Intellectual Disability,15,35,280,212,492
Uttarakhand,Udam Singh Nagar,Intellectual Disability,35,60,87,38,125
Uttarakhand,Udam Singh Nagar,Intellectual Disability,60,80,4,4,8
Assam,Udalguri,Intellectual Disability,0,6,20,14,34
Assam,Udalguri,Intellectual Disability,6,15,60,37,97
Assam,Udalguri,Intellectual Disability,15,35,99,85,184
Assam,Udalguri,Intellectual Disability,35,60,61,70,131
Assam,Udalguri,Intellectual Disability,60,80,3,4,7
Rajasthan,Udaipur,Intellectual Disability,0,6,3,2,5
Rajasthan,Udaipur,Intellectual Disability,6,15,47,40,87
Rajasthan,Udaipur,Intellectual Disability,15,35,145,55,200
Rajasthan,Udaipur,Intellectual Disability,35,60,44,15,59
Rajasthan,Udaipur,Intellectual Disability,60,80,6,3,9
Tamil Nadu,Tuticorin,Intellectual Disability,0,6,49,48,97
Tamil Nadu,Tuticorin,Intellectual Disability,6,15,783,508,1291
Tamil Nadu,Tuticorin,Intellectual Disability,15,35,1542,1180,2722
Tamil Nadu,Tuticorin,Intellectual Disability,35,60,585,521,1106
Tamil Nadu,Tuticorin,Intellectual Disability,60,80,31,36,67
Tamil Nadu,Tuticorin,Intellectual Disability,80,100,4,0,4
Karnataka,Tumakuru,Intellectual Disability,0,6,60,42,102
Karnataka,Tumakuru,Intellectual Disability,6,15,441,314,755
Karnataka,Tumakuru,Intellectual Disability,15,35,1003,696,1699
Karnataka,Tumakuru,Intellectual Disability,35,60,450,355,805
Karnataka,Tumakuru,Intellectual Disability,60,80,28,20,48
Karnataka,Tumakuru,Intellectual Disability,80,100,0,2,2
Nagaland,Tuensang,Intellectual Disability,15,35,1,0,1
Rajasthan,Tonk,Intellectual Disability,0,6,7,3,10
Rajasthan,Tonk,Intellectual Disability,6,15,92,53,145
Rajasthan,Tonk,Intellectual Disability,15,35,155,62,217
Rajasthan,Tonk,Intellectual Disability,35,60,35,17,52
Rajasthan,Tonk,Intellectual Disability,60,80,0,2,2
Tamil Nadu,Tiruvannamalai,Intellectual Disability,0,6,130,84,214
Tamil Nadu,Tiruvannamalai,Intellectual Disability,6,15,1388,1015,2403
Tamil Nadu,Tiruvannamalai,Intellectual Disability,15,35,2078,1422,3500
Tamil Nadu,Tiruvannamalai,Intellectual Disability,35,60,681,569,1250
Tamil Nadu,Tiruvannamalai,Intellectual Disability,60,80,50,31,81
Tamil Nadu,Tiruvannamalai,Intellectual Disability,80,100,3,3,6
Tamil Nadu,Tiruppur,Intellectual Disability,0,6,41,40,81
Tamil Nadu,Tiruppur,Intellectual Disability,6,15,778,467,1245
Tamil Nadu,Tiruppur,Intellectual Disability,15,35,1280,837,2117
Tamil Nadu,Tiruppur,Intellectual Disability,35,60,199,191,390
Tamil Nadu,Tiruppur,Intellectual Disability,60,80,11,4,15
Tamil Nadu,Tirupathur,Intellectual Disability,0,6,57,41,98
Tamil Nadu,Tirupathur,Intellectual Disability,6,15,229,164,393
Tamil Nadu,Tirupathur,Intellectual Disability,15,35,337,215,552
Tamil Nadu,Tirupathur,Intellectual Disability,35,60,135,69,204
Tamil Nadu,Tirupathur,Intellectual Disability,60,80,12,14,26
Tamil Nadu,Tirunelveli,Intellectual Disability,0,6,36,29,65
Tamil Nadu,Tirunelveli,Intellectual Disability,6,15,662,485,1147
Tamil Nadu,Tirunelveli,Intellectual Disability,15,35,2040,1349,3389
Tamil Nadu,Tirunelveli,Intellectual Disability,35,60,714,617,1331
Tamil Nadu,Tirunelveli,Intellectual Disability,60,80,37,17,54
Tamil Nadu,Tirunelveli,Intellectual Disability,80,100,1,1,2
Tamil Nadu,Tiruchirappalli,Intellectual Disability,0,6,162,102,264
Tamil Nadu,Tiruchirappalli,Intellectual Disability,6,15,1794,1043,2837
Tamil Nadu,Tiruchirappalli,Intellectual Disability,15,35,3589,2447,6036
Tamil Nadu,Tiruchirappalli,Intellectual Disability,35,60,1031,852,1883
Tamil Nadu,Tiruchirappalli,Intellectual Disability,60,80,76,72,148
Tamil Nadu,Tiruchirappalli,Intellectual Disability,80,100,1,2,3
Assam,Tinsukia,Intellectual Disability,0,6,7,4,11
Assam,Tinsukia,Intellectual Disability,6,15,23,20,43
Assam,Tinsukia,Intellectual Disability,15,35,38,47,85
Assam,Tinsukia,Intellectual Disability,35,60,11,7,18
Madhya Pradesh,Tikamgarh,Intellectual Disability,0,6,3,3,6
Madhya Pradesh,Tikamgarh,Intellectual Disability,6,15,40,26,66
Madhya Pradesh,Tikamgarh,Intellectual Disability,15,35,146,71,217
Madhya Pradesh,Tikamgarh,Intellectual Disability,35,60,65,40,105
Madhya Pradesh,Tikamgarh,Intellectual Disability,60,80,9,4,13
Madhya Pradesh,Tikamgarh,Intellectual Disability,80,100,1,1,2
Kerala,Thrissur,Intellectual Disability,0,6,30,24,54
Kerala,Thrissur,Intellectual Disability,6,15,643,372,1015
Kerala,Thrissur,Intellectual Disability,15,35,2441,1446,3887
Kerala,Thrissur,Intellectual Disability,35,60,936,820,1756
Kerala,Thrissur,Intellectual Disability,60,80,89,76,165
Kerala,Thrissur,Intellectual Disability,80,100,4,0,4
Manipur,Thoubal,Intellectual Disability,0,6,6,3,9
Manipur,Thoubal,Intellectual Disability,6,15,35,29,64
Manipur,Thoubal,Intellectual Disability,15,35,54,50,104
Manipur,Thoubal,Intellectual Disability,35,60,11,11,22
Tamil Nadu,Thiruvarur,Intellectual Disability,0,6,21,10,31
Tamil Nadu,Thiruvarur,Intellectual Disability,6,15,528,312,840
Tamil Nadu,Thiruvarur,Intellectual Disability,15,35,1205,816,2021
Tamil Nadu,Thiruvarur,Intellectual Disability,35,60,399,293,692
Tamil Nadu,Thiruvarur,Intellectual Disability,60,80,27,15,42
Tamil Nadu,Thiruvarur,Intellectual Disability,80,100,0,1,1
Kerala,Thiruvananthapuram,Intellectual Disability,0,6,65,47,112
Kerala,Thiruvananthapuram,Intellectual Disability,6,15,941,610,1551
Kerala,Thiruvananthapuram,Intellectual Disability,15,35,2878,1707,4585
Kerala,Thiruvananthapuram,Intellectual Disability,35,60,790,675,1465
Kerala,Thiruvananthapuram,Intellectual Disability,60,80,81,58,139
Kerala,Thiruvananthapuram,Intellectual Disability,80,100,2,1,3
Tamil Nadu,Thiruvallur,Intellectual Disability,0,6,84,70,154
Tamil Nadu,Thiruvallur,Intellectual Disability,6,15,1000,619,1619
Tamil Nadu,Thiruvallur,Intellectual Disability,15,35,1770,1135,2905
Tamil Nadu,Thiruvallur,Intellectual Disability,35,60,468,382,850
Tamil Nadu,Thiruvallur,Intellectual Disability,60,80,33,22,55
Tamil Nadu,Thiruvallur,Intellectual Disability,80,100,1,1,2
Tamil Nadu,Theni,Intellectual Disability,0,6,32,19,51
Tamil Nadu,Theni,Intellectual Disability,6,15,439,271,710
Tamil Nadu,Theni,Intellectual Disability,15,35,1213,725,1938
Tamil Nadu,Theni,Intellectual Disability,35,60,404,350,754
Tamil Nadu,Theni,Intellectual Disability,60,80,25,15,40
Tamil Nadu,Theni,Intellectual Disability,80,100,2,1,3
Tamil Nadu,The Nilgiris,Intellectual Disability,0,6,13,6,19
Tamil Nadu,The Nilgiris,Intellectual Disability,6,15,203,140,343
Tamil Nadu,The Nilgiris,Intellectual Disability,15,35,719,489,1208
Tamil Nadu,The Nilgiris,Intellectual Disability,35,60,260,283,543
Tamil Nadu,The Nilgiris,Intellectual Disability,60,80,31,15,46
Tamil Nadu,The Nilgiris,Intellectual Disability,80,100,0,1,1
Tamil Nadu,Thanjavur,Intellectual Disability,0,6,90,53,143
Tamil Nadu,Thanjavur,Intellectual Disability,6,15,964,621,1585
Tamil Nadu,Thanjavur,Intellectual Disability,15,35,1904,1233,3137
Tamil Nadu,Thanjavur,Intellectual Disability,35,60,661,565,1226
Tamil Nadu,Thanjavur,Intellectual Disability,60,80,26,18,44
Tamil Nadu,Thanjavur,Intellectual Disability,80,100,1,0,1
Maharashtra,Thane,Intellectual Disability,0,6,174,95,269
Maharashtra,Thane,Intellectual Disability,6,15,1857,1031,2888
Maharashtra,Thane,Intellectual Disability,15,35,2966,1427,4393
Maharashtra,Thane,Intellectual Disability,35,60,688,396,1084
Maharashtra,Thane,Intellectual Disability,60,80,39,15,54
Maharashtra,Thane,Intellectual Disability,80,100,3,1,4
Tamil Nadu,Tenkasi,Intellectual Disability,0,6,30,21,51
Tamil Nadu,Tenkasi,Intellectual Disability,6,15,240,167,407
Tamil Nadu,Tenkasi,Intellectual Disability,15,35,282,206,488
Tamil Nadu,Tenkasi,Intellectual Disability,35,60,97,87,184
Tamil Nadu,Tenkasi,Intellectual Disability,60,80,1,9,10
Manipur,Tengnoupal,Intellectual Disability,6,15,12,15,27
Manipur,Tengnoupal,Intellectual Disability,15,35,14,9,23
Manipur,Tengnoupal,Intellectual Disability,35,60,3,1,4
Manipur,Tengnoupal,Intellectual Disability,60,80,1,2,3
Uttarakhand,Tehri Garhwal,Intellectual Disability,0,6,12,7,19
Uttarakhand,Tehri Garhwal,Intellectual Disability,6,15,133,77,210
Uttarakhand,Tehri Garhwal,Intellectual Disability,15,35,263,176,439
Uttarakhand,Tehri Garhwal,Intellectual Disability,35,60,163,86,249
Uttarakhand,Tehri Garhwal,Intellectual Disability,60,80,12,8,20
Punjab,Tarn Taran,Intellectual Disability,0,6,1,2,3
Punjab,Tarn Taran,Intellectual Disability,6,15,15,13,28
Punjab,Tarn Taran,Intellectual Disability,15,35,43,26,69
Punjab,Tarn Taran,Intellectual Disability,35,60,23,9,32
Punjab,Tarn Taran,Intellectual Disability,60,80,5,0,5
Gujarat,Tapi,Intellectual Disability,0,6,31,29,60
Gujarat,Tapi,Intellectual Disability,6,15,324,224,548
Gujarat,Tapi,Intellectual Disability,15,35,255,204,459
Gujarat,Tapi,Intellectual Disability,35,60,29,25,54
Gujarat,Tapi,Intellectual Disability,60,80,2,3,5
Manipur,Tamenglong,Intellectual Disability,0,6,1,4,5
Manipur,Tamenglong,Intellectual Disability,6,15,7,1,8
Manipur,Tamenglong,Intellectual Disability,15,35,6,7,13
Manipur,Tamenglong,Intellectual Disability,35,60,2,5,7
Manipur,Tamenglong,Intellectual Disability,60,80,3,1,4
Telangana,Suryapet,Intellectual Disability,6,15,145,75,220
Telangana,Suryapet,Intellectual Disability,15,35,959,751,1710
Telangana,Suryapet,Intellectual Disability,35,60,181,162,343
Telangana,Suryapet,Intellectual Disability,60,80,5,6,11
Chhattisgarh,Surguja,Intellectual Disability,0,6,26,10,36
Chhattisgarh,Surguja,Intellectual Disability,6,15,183,167,350
Chhattisgarh,Surguja,Intellectual Disability,15,35,168,147,315
Chhattisgarh,Surguja,Intellectual Disability,35,60,41,37,78
Chhattisgarh,Surguja,Intellectual Disability,60,80,5,3,8
Gujarat,Surendranagar,Intellectual Disability,0,6,33,24,57
Gujarat,Surendranagar,Intellectual Disability,6,15,550,324,874
Gujarat,Surendranagar,Intellectual Disability,15,35,753,378,1131
Gujarat,Surendranagar,Intellectual Disability,35,60,104,58,162
Gujarat,Surendranagar,Intellectual Disability,60,80,7,5,12
Gujarat,Surendranagar,Intellectual Disability,80,100,1,0,1
Gujarat,Surat,Intellectual Disability,0,6,71,28,99
Gujarat,Surat,Intellectual Disability,6,15,1325,745,2070
Gujarat,Surat,Intellectual Disability,15,35,1571,872,2443
Gujarat,Surat,Intellectual Disability,35,60,231,141,372
Gujarat,Surat,Intellectual Disability,60,80,13,8,21
Gujarat,Surat,Intellectual Disability,80,100,1,0,1
Chhattisgarh,Surajpur,Intellectual Disability,0,6,3,3,6
Chhattisgarh,Surajpur,Intellectual Disability,6,15,56,35,91
Chhattisgarh,Surajpur,Intellectual Disability,15,35,23,28,51
Chhattisgarh,Surajpur,Intellectual Disability,35,60,2,0,2
Bihar,Supaul,Intellectual Disability,0,6,5,5,10
Bihar,Supaul,Intellectual Disability,6,15,71,31,102
Bihar,Supaul,Intellectual Disability,15,35,62,35,97
Bihar,Supaul,Intellectual Disability,35,60,8,11,19
Bihar,Supaul,Intellectual Disability,60,80,0,1,1
Odisha,Sundargarh,Intellectual Disability,0,6,49,26,75
Odisha,Sundargarh,Intellectual Disability,6,15,262,203,465
Odisha,Sundargarh,Intellectual Disability,15,35,418,378,796
Odisha,Sundargarh,Intellectual Disability,35,60,195,171,366
Odisha,Sundargarh,Intellectual Disability,60,80,25,16,41
Uttar Pradesh,Sultanpur,Intellectual Disability,0,6,1,0,1
Uttar Pradesh,Sultanpur,Intellectual Disability,6,15,9,6,15
Uttar Pradesh,Sultanpur,Intellectual Disability,15,35,49,16,65
Uttar Pradesh,Sultanpur,Intellectual Disability,35,60,37,10,47
Uttar Pradesh,Sultanpur,Intellectual Disability,60,80,10,0,10
Chhattisgarh,Sukma,Intellectual Disability,0,6,0,1,1
Chhattisgarh,Sukma,Intellectual Disability,6,15,11,9,20
Chhattisgarh,Sukma,Intellectual Disability,15,35,6,12,18
Chhattisgarh,Sukma,Intellectual Disability,35,60,2,2,4
Jammu And Kashmir,Srinagar,Intellectual Disability,0,6,38,20,58
Jammu And Kashmir,Srinagar,Intellectual Disability,6,15,155,109,264
Jammu And Kashmir,Srinagar,Intellectual Disability,15,35,363,292,655
Jammu And Kashmir,Srinagar,Intellectual Disability,35,60,196,155,351
Jammu And Kashmir,Srinagar,Intellectual Disability,60,80,14,7,21
Andhra Pradesh,Srikakulam,Intellectual Disability,0,6,21,22,43
Andhra Pradesh,Srikakulam,Intellectual Disability,6,15,297,234,531
Andhra Pradesh,Srikakulam,Intellectual Disability,15,35,288,217,505
Andhra Pradesh,Srikakulam,Intellectual Disability,35,60,98,46,144
Andhra Pradesh,Srikakulam,Intellectual Disability,60,80,6,2,8
Punjab,Sri Muktsar Sahib,Intellectual Disability,0,6,7,4,11
Punjab,Sri Muktsar Sahib,Intellectual Disability,6,15,111,73,184
Punjab,Sri Muktsar Sahib,Intellectual Disability,15,35,173,85,258
Punjab,Sri Muktsar Sahib,Intellectual Disability,35,60,68,34,102
Punjab,Sri Muktsar Sahib,Intellectual Disability,60,80,19,3,22
Andhra Pradesh,Spsr Nellore,Intellectual Disability,0,6,11,2,13
Andhra Pradesh,Spsr Nellore,Intellectual Disability,6,15,236,136,372
Andhra Pradesh,Spsr Nellore,Intellectual Disability,15,35,296,193,489
Andhra Pradesh,Spsr Nellore,Intellectual Disability,35,60,92,50,142
Andhra Pradesh,Spsr Nellore,Intellectual Disability,60,80,8,3,11
Meghalaya,South West Khasi Hills,Intellectual Disability,0,6,5,7,12
Meghalaya,South West Khasi Hills,Intellectual Disability,6,15,50,34,84
Meghalaya,South West Khasi Hills,Intellectual Disability,15,35,119,74,193
Meghalaya,South West Khasi Hills,Intellectual Disability,35,60,28,38,66
Meghalaya,South West Khasi Hills,Intellectual Disability,60,80,3,1,4
Meghalaya,South West Garo Hills,Intellectual Disability,0,6,2,1,3
Meghalaya,South West Garo Hills,Intellectual Disability,6,15,21,25,46
Meghalaya,South West Garo Hills,Intellectual Disability,15,35,56,39,95
Meghalaya,South West Garo Hills,Intellectual Disability,35,60,14,12,26
Delhi,South West,Intellectual Disability,0,6,20,9,29
Delhi,South West,Intellectual Disability,6,15,153,116,269
Delhi,South West,Intellectual Disability,15,35,232,122,354
Delhi,South West,Intellectual Disability,35,60,28,16,44
Delhi,South West,Intellectual Disability,60,80,3,1,4
Tripura,South Tripura,Intellectual Disability,0,6,17,4,21
Tripura,South Tripura,Intellectual Disability,6,15,124,59,183
Tripura,South Tripura,Intellectual Disability,15,35,174,111,285
Tripura,South Tripura,Intellectual Disability,35,60,65,39,104
Tripura,South Tripura,Intellectual Disability,60,80,4,2,6
Assam,South Salmara Mancachar,Intellectual Disability,15,35,2,3,5
Assam,South Salmara Mancachar,Intellectual Disability,35,60,1,1,2
Goa,South Goa,Intellectual Disability,0,6,9,10,19
Goa,South Goa,Intellectual Disability,6,15,175,111,286
Goa,South Goa,Intellectual Disability,15,35,443,285,728
Goa,South Goa,Intellectual Disability,35,60,146,122,268
Goa,South Goa,Intellectual Disability,60,80,19,15,34
Meghalaya,South Garo Hills,Intellectual Disability,0,6,1,0,1
Meghalaya,South Garo Hills,Intellectual Disability,6,15,5,14,19
Meghalaya,South Garo Hills,Intellectual Disability,15,35,28,25,53
Meghalaya,South Garo Hills,Intellectual Disability,35,60,7,8,15
Meghalaya,South Garo Hills,Intellectual Disability,60,80,1,0,1
Delhi,South East,Intellectual Disability,0,6,6,5,11
Delhi,South East,Intellectual Disability,6,15,45,52,97
Delhi,South East,Intellectual Disability,15,35,81,58,139
Delhi,South East,Intellectual Disability,35,60,12,9,21
Delhi,South East,Intellectual Disability,60,80,1,0,1
Andaman And Nicobar Islands,South Andamans,Intellectual Disability,0,6,16,9,25
Andaman And Nicobar Islands,South Andamans,Intellectual Disability,6,15,87,41,128
Andaman And Nicobar Islands,South Andamans,Intellectual Disability,15,35,108,77,185
Andaman And Nicobar Islands,South Andamans,Intellectual Disability,35,60,32,23,55
Andaman And Nicobar Islands,South Andamans,Intellectual Disability,60,80,0,1,1
Delhi,South,Intellectual Disability,0,6,11,5,16
Delhi,South,Intellectual Disability,6,15,89,61,150
Delhi,South,Intellectual Disability,15,35,120,80,200
Delhi,South,Intellectual Disability,35,60,12,12,24
Delhi,South,Intellectual Disability,60,80,1,0,1
Assam,Sonitpur,Intellectual Disability,0,6,32,18,50
Assam,Sonitpur,Intellectual Disability,6,15,228,188,416
Assam,Sonitpur,Intellectual Disability,15,35,295,275,570
Assam,Sonitpur,Intellectual Disability,35,60,85,86,171
Assam,Sonitpur,Intellectual Disability,60,80,2,3,5
Haryana,Sonipat,Intellectual Disability,0,6,27,13,40
Haryana,Sonipat,Intellectual Disability,6,15,312,234,546
Haryana,Sonipat,Intellectual Disability,15,35,417,182,599
Haryana,Sonipat,Intellectual Disability,35,60,100,35,135
Haryana,Sonipat,Intellectual Disability,60,80,2,1,3
Odisha,Sonepur,Intellectual Disability,0,6,54,25,79
Odisha,Sonepur,Intellectual Disability,6,15,234,180,414
Odisha,Sonepur,Intellectual Disability,15,35,405,311,716
Odisha,Sonepur,Intellectual Disability,35,60,105,64,169
Odisha,Sonepur,Intellectual Disability,60,80,8,2,10
Uttar Pradesh,Sonbhadra,Intellectual Disability,0,6,1,0,1
Uttar Pradesh,Sonbhadra,Intellectual Disability,6,15,7,3,10
Uttar Pradesh,Sonbhadra,Intellectual Disability,15,35,21,8,29
Uttar Pradesh,Sonbhadra,Intellectual Disability,35,60,13,6,19
Uttar Pradesh,Sonbhadra,Intellectual Disability,60,80,1,0,1
Maharashtra,Solapur,Intellectual Disability,0,6,16,14,30
Maharashtra,Solapur,Intellectual Disability,6,15,550,303,853
Maharashtra,Solapur,Intellectual Disability,15,35,949,490,1439
Maharashtra,Solapur,Intellectual Disability,35,60,202,149,351
Maharashtra,Solapur,Intellectual Disability,60,80,5,1,6
Himachal Pradesh,Solan,Intellectual Disability,0,6,20,17,37
Himachal Pradesh,Solan,Intellectual Disability,6,15,172,112,284
Himachal Pradesh,Solan,Intellectual Disability,15,35,299,182,481
Himachal Pradesh,Solan,Intellectual Disability,35,60,127,76,203
Himachal Pradesh,Solan,Intellectual Disability,60,80,11,2,13
Bihar,Siwan,Intellectual Disability,0,6,7,4,11
Bihar,Siwan,Intellectual Disability,6,15,101,61,162
Bihar,Siwan,Intellectual Disability,15,35,223,111,334
Bihar,Siwan,Intellectual Disability,35,60,73,18,91
Bihar,Siwan,Intellectual Disability,60,80,10,5,15
Bihar,Siwan,Intellectual Disability,80,100,1,2,3
Assam,Sivasagar,Intellectual Disability,0,6,7,1,8
Assam,Sivasagar,Intellectual Disability,6,15,40,31,71
Assam,Sivasagar,Intellectual Disability,15,35,89,58,147
Assam,Sivasagar,Intellectual Disability,35,60,19,19,38
Assam,Sivasagar,Intellectual Disability,60,80,0,3,3
Tamil Nadu,Sivaganga,Intellectual Disability,0,6,26,10,36
Tamil Nadu,Sivaganga,Intellectual Disability,6,15,429,242,671
Tamil Nadu,Sivaganga,Intellectual Disability,15,35,890,631,1521
Tamil Nadu,Sivaganga,Intellectual Disability,35,60,406,301,707
Tamil Nadu,Sivaganga,Intellectual Disability,60,80,27,22,49
Uttar Pradesh,Sitapur,Intellectual Disability,0,6,12,5,17
Uttar Pradesh,Sitapur,Intellectual Disability,6,15,455,339,794
Uttar Pradesh,Sitapur,Intellectual Disability,15,35,98,56,154
Uttar Pradesh,Sitapur,Intellectual Disability,35,60,20,6,26
Bihar,Sitamarhi,Intellectual Disability,0,6,21,8,29
Bihar,Sitamarhi,Intellectual Disability,6,15,83,46,129
Bihar,Sitamarhi,Intellectual Disability,15,35,91,66,157
Bihar,Sitamarhi,Intellectual Disability,35,60,40,23,63
Bihar,Sitamarhi,Intellectual Disability,60,80,2,2,4
Haryana,Sirsa,Intellectual Disability,0,6,59,23,82
Haryana,Sirsa,Intellectual Disability,6,15,350,227,577
Haryana,Sirsa,Intellectual Disability,15,35,295,169,464
Haryana,Sirsa,Intellectual Disability,35,60,188,113,301
Haryana,Sirsa,Intellectual Disability,60,80,12,15,27
Rajasthan,Sirohi,Intellectual Disability,0,6,6,0,6
Rajasthan,Sirohi,Intellectual Disability,6,15,62,49,111
Rajasthan,Sirohi,Intellectual Disability,15,35,165,90,255
Rajasthan,Sirohi,Intellectual Disability,35,60,102,47,149
Rajasthan,Sirohi,Intellectual Disability,60,80,5,1,6
Himachal Pradesh,Sirmaur,Intellectual Disability,0,6,16,9,25
Himachal Pradesh,Sirmaur,Intellectual Disability,6,15,64,51,115
Himachal Pradesh,Sirmaur,Intellectual Disability,15,35,71,37,108
Himachal Pradesh,Sirmaur,Intellectual Disability,35,60,26,17,43
Himachal Pradesh,Sirmaur,Intellectual Disability,60,80,2,3,5
Madhya Pradesh,Singrauli,Intellectual Disability,0,6,5,0,5
Madhya Pradesh,Singrauli,Intellectual Disability,6,15,54,28,82
Madhya Pradesh,Singrauli,Intellectual Disability,15,35,77,47,124
Madhya Pradesh,Singrauli,Intellectual Disability,35,60,15,1,16
Madhya Pradesh,Singrauli,Intellectual Disability,60,80,4,2,6
Maharashtra,Sindhudurg,Intellectual Disability,0,6,6,1,7
Maharashtra,Sindhudurg,Intellectual Disability,6,15,264,184,448
Maharashtra,Sindhudurg,Intellectual Disability,15,35,468,234,702
Maharashtra,Sindhudurg,Intellectual Disability,35,60,155,86,241
Maharashtra,Sindhudurg,Intellectual Disability,60,80,5,5,10
Jharkhand,Simdega,Intellectual Disability,0,6,2,4,6
Jharkhand,Simdega,Intellectual Disability,6,15,43,28,71
Jharkhand,Simdega,Intellectual Disability,15,35,52,60,112
Jharkhand,Simdega,Intellectual Disability,35,60,10,18,28
Jharkhand,Simdega,Intellectual Disability,60,80,2,2,4
Jharkhand,Simdega,Intellectual Disability,80,100,1,0,1
Rajasthan,Sikar,Intellectual Disability,0,6,4,2,6
Rajasthan,Sikar,Intellectual Disability,6,15,117,57,174
Rajasthan,Sikar,Intellectual Disability,15,35,231,101,332
Rajasthan,Sikar,Intellectual Disability,35,60,51,26,77
Rajasthan,Sikar,Intellectual Disability,60,80,4,0,4
Madhya Pradesh,Sidhi,Intellectual Disability,0,6,3,2,5
Madhya Pradesh,Sidhi,Intellectual Disability,6,15,135,69,204
Madhya Pradesh,Sidhi,Intellectual Disability,15,35,343,190,533
Madhya Pradesh,Sidhi,Intellectual Disability,35,60,152,62,214
Madhya Pradesh,Sidhi,Intellectual Disability,60,80,26,12,38
Madhya Pradesh,Sidhi,Intellectual Disability,80,100,1,1,2
Telangana,Siddipet,Intellectual Disability,6,15,87,66,153
Telangana,Siddipet,Intellectual Disability,15,35,749,609,1358
Telangana,Siddipet,Intellectual Disability,35,60,246,214,460
Telangana,Siddipet,Intellectual Disability,60,80,20,7,27
Telangana,Siddipet,Intellectual Disability,80,100,2,1,3
Uttar Pradesh,Siddharth Nagar,Intellectual Disability,0,6,9,3,12
Uttar Pradesh,Siddharth Nagar,Intellectual Disability,6,15,107,74,181
Uttar Pradesh,Siddharth Nagar,Intellectual Disability,15,35,94,42,136
Uttar Pradesh,Siddharth Nagar,Intellectual Disability,35,60,28,13,41
Uttar Pradesh,Siddharth Nagar,Intellectual Disability,60,80,8,5,13
Uttar Pradesh,Shravasti,Intellectual Disability,6,15,14,8,22
Uttar Pradesh,Shravasti,Intellectual Disability,15,35,19,9,28
Uttar Pradesh,Shravasti,Intellectual Disability,35,60,8,0,8
Uttar Pradesh,Shravasti,Intellectual Disability,60,80,2,0,2
Jammu And Kashmir,Shopian,Intellectual Disability,0,6,6,5,11
Jammu And Kashmir,Shopian,Intellectual Disability,6,15,15,12,27
Jammu And Kashmir,Shopian,Intellectual Disability,15,35,32,26,58
Jammu And Kashmir,Shopian,Intellectual Disability,35,60,11,13,24
Madhya Pradesh,Shivpuri,Intellectual Disability,0,6,25,13,38
Madhya Pradesh,Shivpuri,Intellectual Disability,6,15,156,96,252
Madhya Pradesh,Shivpuri,Intellectual Disability,15,35,375,174,549
Madhya Pradesh,Shivpuri,Intellectual Disability,35,60,82,43,125
Madhya Pradesh,Shivpuri,Intellectual Disability,60,80,10,4,14
Karnataka,Shivamogga,Intellectual Disability,0,6,57,37,94
Karnataka,Shivamogga,Intellectual Disability,6,15,346,230,576
Karnataka,Shivamogga,Intellectual Disability,15,35,552,402,954
Karnataka,Shivamogga,Intellectual Disability,35,60,184,182,366
Karnataka,Shivamogga,Intellectual Disability,60,80,16,11,27
Karnataka,Shivamogga,Intellectual Disability,80,100,1,0,1
Himachal Pradesh,Shimla,Intellectual Disability,0,6,24,11,35
Himachal Pradesh,Shimla,Intellectual Disability,6,15,140,88,228
Himachal Pradesh,Shimla,Intellectual Disability,15,35,230,147,377
Himachal Pradesh,Shimla,Intellectual Disability,35,60,102,86,188
Himachal Pradesh,Shimla,Intellectual Disability,60,80,4,5,9
Himachal Pradesh,Shimla,Intellectual Disability,80,100,0,1,1
Madhya Pradesh,Sheopur,Intellectual Disability,0,6,9,9,18
Madhya Pradesh,Sheopur,Intellectual Disability,6,15,89,57,146
Madhya Pradesh,Sheopur,Intellectual Disability,15,35,211,96,307
Madhya Pradesh,Sheopur,Intellectual Disability,35,60,94,44,138
Madhya Pradesh,Sheopur,Intellectual Disability,60,80,16,9,25
Madhya Pradesh,Sheopur,Intellectual Disability,80,100,3,0,3
Bihar,Sheohar,Intellectual Disability,0,6,11,5,16
Bihar,Sheohar,Intellectual Disability,6,15,68,54,122
Bihar,Sheohar,Intellectual Disability,15,35,33,10,43
Bihar,Sheohar,Intellectual Disability,35,60,1,1,2
Bihar,Sheohar,Intellectual Disability,80,100,0,2,2
Bihar,Sheikhpura,Intellectual Disability,6,15,31,25,56
Bihar,Sheikhpura,Intellectual Disability,15,35,47,32,79
Bihar,Sheikhpura,Intellectual Disability,35,60,14,5,19
Bihar,Sheikhpura,Intellectual Disability,60,80,3,2,5
Uttar Pradesh,Shamli,Intellectual Disability,0,6,3,0,3
Uttar Pradesh,Shamli,Intellectual Disability,6,15,8,9,17
Uttar Pradesh,Shamli,Intellectual Disability,15,35,42,18,60
Uttar Pradesh,Shamli,Intellectual Disability,35,60,18,12,30
Uttar Pradesh,Shamli,Intellectual Disability,60,80,5,0,5
Madhya Pradesh,Shajapur,Intellectual Disability,0,6,21,15,36
Madhya Pradesh,Shajapur,Intellectual Disability,6,15,153,90,243
Madhya Pradesh,Shajapur,Intellectual Disability,15,35,290,176,466
Madhya Pradesh,Shajapur,Intellectual Disability,35,60,97,47,144
Madhya Pradesh,Shajapur,Intellectual Disability,60,80,9,3,12
Madhya Pradesh,Shajapur,Intellectual Disability,80,100,0,1,1
Uttar Pradesh,Shahjahanpur,Intellectual Disability,0,6,10,3,13
Uttar Pradesh,Shahjahanpur,Intellectual Disability,6,15,142,92,234
Uttar Pradesh,Shahjahanpur,Intellectual Disability,15,35,166,77,243
Uttar Pradesh,Shahjahanpur,Intellectual Disability,35,60,61,25,86
Uttar Pradesh,Shahjahanpur,Intellectual Disability,60,80,13,1,14
Punjab,Shahid Bhagat Singh Nagar,Intellectual Disability,0,6,17,8,25
Punjab,Shahid Bhagat Singh Nagar,Intellectual Disability,6,15,151,97,248
Punjab,Shahid Bhagat Singh Nagar,Intellectual Disability,15,35,142,86,228
Punjab,Shahid Bhagat Singh Nagar,Intellectual Disability,35,60,60,30,90
Punjab,Shahid Bhagat Singh Nagar,Intellectual Disability,60,80,3,4,7
Madhya Pradesh,Shahdol,Intellectual Disability,0,6,6,4,10
Madhya Pradesh,Shahdol,Intellectual Disability,6,15,85,56,141
Madhya Pradesh,Shahdol,Intellectual Disability,15,35,380,258,638
Madhya Pradesh,Shahdol,Intellectual Disability,35,60,199,115,314
Madhya Pradesh,Shahdol,Intellectual Disability,60,80,37,19,56
Madhya Pradesh,Shahdol,Intellectual Disability,80,100,1,2,3
Delhi,Shahdara,Intellectual Disability,0,6,13,8,21
Delhi,Shahdara,Intellectual Disability,6,15,84,50,134
Delhi,Shahdara,Intellectual Disability,15,35,122,63,185
Delhi,Shahdara,Intellectual Disability,35,60,13,7,20
Mizoram,Serchhip,Intellectual Disability,0,6,1,0,1
Mizoram,Serchhip,Intellectual Disability,6,15,2,5,7
Mizoram,Serchhip,Intellectual Disability,15,35,5,9,14
Mizoram,Serchhip,Intellectual Disability,35,60,0,2,2
Mizoram,Serchhip,Intellectual Disability,60,80,0,2,2
Tripura,Sepahijala,Intellectual Disability,0,6,1,3,4
Tripura,Sepahijala,Intellectual Disability,6,15,81,50,131
Tripura,Sepahijala,Intellectual Disability,15,35,178,131,309
Tripura,Sepahijala,Intellectual Disability,35,60,50,28,78
Tripura,Sepahijala,Intellectual Disability,60,80,3,2,5
Madhya Pradesh,Seoni,Intellectual Disability,0,6,4,0,4
Madhya Pradesh,Seoni,Intellectual Disability,6,15,76,58,134
Madhya Pradesh,Seoni,Intellectual Disability,15,35,700,501,1201
Madhya Pradesh,Seoni,Intellectual Disability,35,60,355,236,591
Madhya Pradesh,Seoni,Intellectual Disability,60,80,35,29,64
Madhya Pradesh,Seoni,Intellectual Disability,80,100,2,4,6
Manipur,Senapati,Intellectual Disability,0,6,1,1,2
Manipur,Senapati,Intellectual Disability,6,15,5,5,10
Manipur,Senapati,Intellectual Disability,15,35,18,4,22
Manipur,Senapati,Intellectual Disability,35,60,1,5,6
Madhya Pradesh,Sehore,Intellectual Disability,0,6,39,31,70
Madhya Pradesh,Sehore,Intellectual Disability,6,15,321,217,538
Madhya Pradesh,Sehore,Intellectual Disability,15,35,1027,588,1615
Madhya Pradesh,Sehore,Intellectual Disability,35,60,448,227,675
Madhya Pradesh,Sehore,Intellectual Disability,60,80,59,36,95
Madhya Pradesh,Sehore,Intellectual Disability,80,100,3,3,6
Rajasthan,Sawai Madhopur,Intellectual Disability,6,15,12,7,19
Rajasthan,Sawai Madhopur,Intellectual Disability,15,35,15,6,21
Rajasthan,Sawai Madhopur,Intellectual Disability,35,60,2,1,3
Madhya Pradesh,Satna,Intellectual Disability,0,6,30,16,46
Madhya Pradesh,Satna,Intellectual Disability,6,15,237,144,381
Madhya Pradesh,Satna,Intellectual Disability,15,35,925,471,1396
Madhya Pradesh,Satna,Intellectual Disability,35,60,445,163,608
Madhya Pradesh,Satna,Intellectual Disability,60,80,39,20,59
Madhya Pradesh,Satna,Intellectual Disability,80,100,2,0,2
Maharashtra,Satara,Intellectual Disability,0,6,31,20,51
Maharashtra,Satara,Intellectual Disability,6,15,780,468,1248
Maharashtra,Satara,Intellectual Disability,15,35,1016,503,1519
Maharashtra,Satara,Intellectual Disability,35,60,297,165,462
Maharashtra,Satara,Intellectual Disability,60,80,13,6,19
Maharashtra,Satara,Intellectual Disability,80,100,2,0,2
Bihar,Saran,Intellectual Disability,0,6,60,26,86
Bihar,Saran,Intellectual Disability,6,15,377,234,611
Bihar,Saran,Intellectual Disability,15,35,164,88,252
Bihar,Saran,Intellectual Disability,35,60,29,9,38
Bihar,Saran,Intellectual Disability,60,80,0,1,1
Jharkhand,Saraikela Kharsawan,Intellectual Disability,0,6,3,0,3
Jharkhand,Saraikela Kharsawan,Intellectual Disability,6,15,24,12,36
Jharkhand,Saraikela Kharsawan,Intellectual Disability,15,35,20,20,40
Jharkhand,Saraikela Kharsawan,Intellectual Disability,35,60,7,8,15
Jharkhand,Saraikela Kharsawan,Intellectual Disability,60,80,4,0,4
Uttar Pradesh,Sant Kabeer Nagar,Intellectual Disability,0,6,1,2,3
Uttar Pradesh,Sant Kabeer Nagar,Intellectual Disability,6,15,40,33,73
Uttar Pradesh,Sant Kabeer Nagar,Intellectual Disability,15,35,117,41,158
Uttar Pradesh,Sant Kabeer Nagar,Intellectual Disability,35,60,24,7,31
Uttar Pradesh,Sant Kabeer Nagar,Intellectual Disability,60,80,3,1,4
Punjab,Sangrur,Intellectual Disability,0,6,20,16,36
Punjab,Sangrur,Intellectual Disability,6,15,254,173,427
Punjab,Sangrur,Intellectual Disability,15,35,205,107,312
Punjab,Sangrur,Intellectual Disability,35,60,98,37,135
Punjab,Sangrur,Intellectual Disability,60,80,5,4,9
Maharashtra,Sangli,Intellectual Disability,0,6,16,13,29
Maharashtra,Sangli,Intellectual Disability,6,15,499,285,784
Maharashtra,Sangli,Intellectual Disability,15,35,1191,658,1849
Maharashtra,Sangli,Intellectual Disability,35,60,368,267,635
Maharashtra,Sangli,Intellectual Disability,60,80,22,3,25
Maharashtra,Sangli,Intellectual Disability,80,100,0,2,2
Telangana,Sangareddy,Intellectual Disability,0,6,1,0,1
Telangana,Sangareddy,Intellectual Disability,6,15,157,100,257
Telangana,Sangareddy,Intellectual Disability,15,35,458,360,818
Telangana,Sangareddy,Intellectual Disability,35,60,80,74,154
Telangana,Sangareddy,Intellectual Disability,60,80,1,2,3
Telangana,Sangareddy,Intellectual Disability,80,100,0,1,1
Uttar Pradesh,Sambhal,Intellectual Disability,6,15,9,7,16
Uttar Pradesh,Sambhal,Intellectual Disability,15,35,29,4,33
Uttar Pradesh,Sambhal,Intellectual Disability,35,60,7,1,8
Uttar Pradesh,Sambhal,Intellectual Disability,60,80,1,0,1
Odisha,Sambalpur,Intellectual Disability,0,6,81,59,140
Odisha,Sambalpur,Intellectual Disability,6,15,433,325,758
Odisha,Sambalpur,Intellectual Disability,15,35,557,463,1020
Odisha,Sambalpur,Intellectual Disability,35,60,182,168,350
Odisha,Sambalpur,Intellectual Disability,60,80,18,16,34
Odisha,Sambalpur,Intellectual Disability,80,100,1,0,1
Jammu And Kashmir,Samba,Intellectual Disability,0,6,5,2,7
Jammu And Kashmir,Samba,Intellectual Disability,6,15,31,21,52
Jammu And Kashmir,Samba,Intellectual Disability,15,35,81,44,125
Jammu And Kashmir,Samba,Intellectual Disability,35,60,70,31,101
Jammu And Kashmir,Samba,Intellectual Disability,60,80,3,1,4
Bihar,Samastipur,Intellectual Disability,0,6,47,21,68
Bihar,Samastipur,Intellectual Disability,6,15,178,135,313
Bihar,Samastipur,Intellectual Disability,15,35,113,77,190
Bihar,Samastipur,Intellectual Disability,35,60,44,14,58
Bihar,Samastipur,Intellectual Disability,60,80,9,1,10
Tamil Nadu,Salem,Intellectual Disability,0,6,74,52,126
Tamil Nadu,Salem,Intellectual Disability,6,15,1226,723,1949
Tamil Nadu,Salem,Intellectual Disability,15,35,1196,746,1942
Tamil Nadu,Salem,Intellectual Disability,35,60,285,233,518
Tamil Nadu,Salem,Intellectual Disability,60,80,23,13,36
Mizoram,Saitual,Intellectual Disability,35,60,1,0,1
Mizoram,Saitual,Intellectual Disability,80,100,1,0,1
Mizoram,Saiha,Intellectual Disability,6,15,0,1,1
Mizoram,Saiha,Intellectual Disability,15,35,3,10,13
Mizoram,Saiha,Intellectual Disability,35,60,5,3,8
Jharkhand,Sahebganj,Intellectual Disability,6,15,80,57,137
Jharkhand,Sahebganj,Intellectual Disability,15,35,64,60,124
Jharkhand,Sahebganj,Intellectual Disability,35,60,25,17,42
Jharkhand,Sahebganj,Intellectual Disability,60,80,2,1,3
Bihar,Saharsa,Intellectual Disability,0,6,1,0,1
Bihar,Saharsa,Intellectual Disability,6,15,11,8,19
Bihar,Saharsa,Intellectual Disability,15,35,26,10,36
Bihar,Saharsa,Intellectual Disability,35,60,6,1,7
Bihar,Saharsa,Intellectual Disability,60,80,1,0,1
Bihar,Saharsa,Intellectual Disability,80,100,1,0,1
Uttar Pradesh,Saharanpur,Intellectual Disability,0,6,9,6,15
Uttar Pradesh,Saharanpur,Intellectual Disability,6,15,96,64,160
Uttar Pradesh,Saharanpur,Intellectual Disability,15,35,123,55,178
Uttar Pradesh,Saharanpur,Intellectual Disability,35,60,52,19,71
Uttar Pradesh,Saharanpur,Intellectual Disability,60,80,3,1,4
Madhya Pradesh,Sagar,Intellectual Disability,0,6,17,9,26
Madhya Pradesh,Sagar,Intellectual Disability,6,15,189,121,310
Madhya Pradesh,Sagar,Intellectual Disability,15,35,790,511,1301
Madhya Pradesh,Sagar,Intellectual Disability,35,60,347,150,497
Madhya Pradesh,Sagar,Intellectual Disability,60,80,43,31,74
Madhya Pradesh,Sagar,Intellectual Disability,80,100,3,3,6
Gujarat,Sabar Kantha,Intellectual Disability,0,6,44,21,65
Gujarat,Sabar Kantha,Intellectual Disability,6,15,685,459,1144
Gujarat,Sabar Kantha,Intellectual Disability,15,35,988,536,1524
Gujarat,Sabar Kantha,Intellectual Disability,35,60,483,272,755
Gujarat,Sabar Kantha,Intellectual Disability,60,80,56,39,95
Gujarat,Sabar Kantha,Intellectual Disability,80,100,1,4,5
Punjab,S.A.S Nagar,Intellectual Disability,0,6,27,16,43
Punjab,S.A.S Nagar,Intellectual Disability,6,15,316,201,517
Punjab,S.A.S Nagar,Intellectual Disability,15,35,444,232,676
Punjab,S.A.S Nagar,Intellectual Disability,35,60,144,91,235
Punjab,S.A.S Nagar,Intellectual Disability,60,80,20,7,27
Punjab,Rupnagar,Intellectual Disability,0,6,22,14,36
Punjab,Rupnagar,Intellectual Disability,6,15,219,175,394
Punjab,Rupnagar,Intellectual Disability,15,35,279,141,420
Punjab,Rupnagar,Intellectual Disability,35,60,107,46,153
Punjab,Rupnagar,Intellectual Disability,60,80,7,1,8
Uttarakhand,Rudra Prayag,Intellectual Disability,0,6,1,1,2
Uttarakhand,Rudra Prayag,Intellectual Disability,6,15,19,23,42
Uttarakhand,Rudra Prayag,Intellectual Disability,15,35,113,61,174
Uttarakhand,Rudra Prayag,Intellectual Disability,35,60,103,29,132
Uttarakhand,Rudra Prayag,Intellectual Disability,60,80,10,3,13
Bihar,Rohtas,Intellectual Disability,0,6,4,4,8
Bihar,Rohtas,Intellectual Disability,6,15,32,20,52
Bihar,Rohtas,Intellectual Disability,15,35,39,23,62
Bihar,Rohtas,Intellectual Disability,35,60,15,3,18
Bihar,Rohtas,Intellectual Disability,60,80,4,1,5
Haryana,Rohtak,Intellectual Disability,0,6,37,34,71
Haryana,Rohtak,Intellectual Disability,6,15,372,180,552
Haryana,Rohtak,Intellectual Disability,15,35,523,252,775
Haryana,Rohtak,Intellectual Disability,35,60,157,72,229
Haryana,Rohtak,Intellectual Disability,60,80,14,7,21
Haryana,Rohtak,Intellectual Disability,80,100,1,0,1
Meghalaya,Ri Bhoi,Intellectual Disability,0,6,10,2,12
Meghalaya,Ri Bhoi,Intellectual Disability,6,15,95,76,171
Meghalaya,Ri Bhoi,Intellectual Disability,15,35,211,210,421
Meghalaya,Ri Bhoi,Intellectual Disability,35,60,52,54,106
Meghalaya,Ri Bhoi,Intellectual Disability,60,80,4,1,5
Meghalaya,Ri Bhoi,Intellectual Disability,80,100,0,1,1
Haryana,Rewari,Intellectual Disability,0,6,7,6,13
Haryana,Rewari,Intellectual Disability,6,15,107,58,165
Haryana,Rewari,Intellectual Disability,15,35,161,64,225
Haryana,Rewari,Intellectual Disability,35,60,31,9,40
Haryana,Rewari,Intellectual Disability,60,80,2,1,3
Madhya Pradesh,Rewa,Intellectual Disability,0,6,12,11,23
Madhya Pradesh,Rewa,Intellectual Disability,6,15,358,208,566
Madhya Pradesh,Rewa,Intellectual Disability,15,35,1124,601,1725
Madhya Pradesh,Rewa,Intellectual Disability,35,60,483,201,684
Madhya Pradesh,Rewa,Intellectual Disability,60,80,41,19,60
Madhya Pradesh,Rewa,Intellectual Disability,80,100,1,0,1
Jammu And Kashmir,Reasi,Intellectual Disability,0,6,3,0,3
Jammu And Kashmir,Reasi,Intellectual Disability,6,15,18,15,33
Jammu And Kashmir,Reasi,Intellectual Disability,15,35,32,41,73
Jammu And Kashmir,Reasi,Intellectual Disability,35,60,20,12,32
Jammu And Kashmir,Reasi,Intellectual Disability,60,80,3,1,4
Odisha,Rayagada,Intellectual Disability,0,6,16,8,24
Odisha,Rayagada,Intellectual Disability,6,15,27,19,46
Odisha,Rayagada,Intellectual Disability,15,35,34,44,78
Odisha,Rayagada,Intellectual Disability,35,60,26,14,40
Odisha,Rayagada,Intellectual Disability,60,80,3,2,5
Odisha,Rayagada,Intellectual Disability,80,100,0,1,1
Maharashtra,Ratnagiri,Intellectual Disability,0,6,47,23,70
Maharashtra,Ratnagiri,Intellectual Disability,6,15,647,414,1061
Maharashtra,Ratnagiri,Intellectual Disability,15,35,1162,658,1820
Maharashtra,Ratnagiri,Intellectual Disability,35,60,358,255,613
Maharashtra,Ratnagiri,Intellectual Disability,60,80,36,11,47
Madhya Pradesh,Ratlam,Intellectual Disability,0,6,10,7,17
Madhya Pradesh,Ratlam,Intellectual Disability,6,15,218,148,366
Madhya Pradesh,Ratlam,Intellectual Disability,15,35,389,270,659
Madhya Pradesh,Ratlam,Intellectual Disability,35,60,145,79,224
Madhya Pradesh,Ratlam,Intellectual Disability,60,80,10,4,14
Tamil Nadu,Ranipet,Intellectual Disability,0,6,44,31,75
Tamil Nadu,Ranipet,Intellectual Disability,6,15,198,124,322
Tamil Nadu,Ranipet,Intellectual Disability,15,35,234,164,398
Tamil Nadu,Ranipet,Intellectual Disability,35,60,100,65,165
Tamil Nadu,Ranipet,Intellectual Disability,60,80,9,1,10
Telangana,Ranga Reddy,Intellectual Disability,0,6,1,0,1
Telangana,Ranga Reddy,Intellectual Disability,6,15,256,169,425
Telangana,Ranga Reddy,Intellectual Disability,15,35,999,792,1791
Telangana,Ranga Reddy,Intellectual Disability,35,60,398,247,645
Telangana,Ranga Reddy,Intellectual Disability,60,80,17,12,29
Telangana,Ranga Reddy,Intellectual Disability,80,100,2,0,2
Jharkhand,Ranchi,Intellectual Disability,0,6,16,10,26
Jharkhand,Ranchi,Intellectual Disability,6,15,264,175,439
Jharkhand,Ranchi,Intellectual Disability,15,35,252,182,434
Jharkhand,Ranchi,Intellectual Disability,35,60,58,37,95
Jharkhand,Ranchi,Intellectual Disability,60,80,1,1,2
Uttar Pradesh,Rampur,Intellectual Disability,0,6,6,3,9
Uttar Pradesh,Rampur,Intellectual Disability,6,15,48,30,78
Uttar Pradesh,Rampur,Intellectual Disability,15,35,68,28,96
Uttar Pradesh,Rampur,Intellectual Disability,35,60,34,10,44
Uttar Pradesh,Rampur,Intellectual Disability,60,80,5,1,6
Jharkhand,Ramgarh,Intellectual Disability,0,6,3,3,6
Jharkhand,Ramgarh,Intellectual Disability,6,15,64,56,120
Jharkhand,Ramgarh,Intellectual Disability,15,35,115,97,212
Jharkhand,Ramgarh,Intellectual Disability,35,60,101,64,165
Jharkhand,Ramgarh,Intellectual Disability,60,80,15,9,24
Jammu And Kashmir,Ramban,Intellectual Disability,0,6,12,5,17
Jammu And Kashmir,Ramban,Intellectual Disability,6,15,24,19,43
Jammu And Kashmir,Ramban,Intellectual Disability,15,35,20,8,28
Jammu And Kashmir,Ramban,Intellectual Disability,35,60,10,4,14
Jammu And Kashmir,Ramban,Intellectual Disability,60,80,2,0,2
Jammu And Kashmir,Ramban,Intellectual Disability,80,100,1,0,1
Tamil Nadu,Ramanathapuram,Intellectual Disability,0,6,46,37,83
Tamil Nadu,Ramanathapuram,Intellectual Disability,6,15,432,265,697
Tamil Nadu,Ramanathapuram,Intellectual Disability,15,35,1143,749,1892
Tamil Nadu,Ramanathapuram,Intellectual Disability,35,60,384,370,754
Tamil Nadu,Ramanathapuram,Intellectual Disability,60,80,30,16,46
Tamil Nadu,Ramanathapuram,Intellectual Disability,80,100,1,1,2
Karnataka,Ramanagara,Intellectual Disability,0,6,22,16,38
Karnataka,Ramanagara,Intellectual Disability,6,15,332,226,558
Karnataka,Ramanagara,Intellectual Disability,15,35,672,452,1124
Karnataka,Ramanagara,Intellectual Disability,35,60,277,285,562
Karnataka,Ramanagara,Intellectual Disability,60,80,16,8,24
Rajasthan,Rajsamand,Intellectual Disability,0,6,3,5,8
Rajasthan,Rajsamand,Intellectual Disability,6,15,31,24,55
Rajasthan,Rajsamand,Intellectual Disability,15,35,28,18,46
Rajasthan,Rajsamand,Intellectual Disability,35,60,8,4,12
Rajasthan,Rajsamand,Intellectual Disability,60,80,0,1,1
Rajasthan,Rajsamand,Intellectual Disability,80,100,1,0,1
Jammu And Kashmir,Rajouri,Intellectual Disability,0,6,9,2,11
Jammu And Kashmir,Rajouri,Intellectual Disability,6,15,35,22,57
Jammu And Kashmir,Rajouri,Intellectual Disability,15,35,89,54,143
Jammu And Kashmir,Rajouri,Intellectual Disability,35,60,59,39,98
Jammu And Kashmir,Rajouri,Intellectual Disability,60,80,1,2,3
Chhattisgarh,Rajnandgaon,Intellectual Disability,0,6,13,13,26
Chhattisgarh,Rajnandgaon,Intellectual Disability,6,15,254,175,429
Chhattisgarh,Rajnandgaon,Intellectual Disability,15,35,217,190,407
Chhattisgarh,Rajnandgaon,Intellectual Disability,35,60,39,25,64
Chhattisgarh,Rajnandgaon,Intellectual Disability,60,80,1,1,2
Chhattisgarh,Rajnandgaon,Intellectual Disability,80,100,3,3,6
Gujarat,Rajkot,Intellectual Disability,0,6,51,24,75
Gujarat,Rajkot,Intellectual Disability,6,15,707,442,1149
Gujarat,Rajkot,Intellectual Disability,15,35,1380,710,2090
Gujarat,Rajkot,Intellectual Disability,35,60,405,255,660
Gujarat,Rajkot,Intellectual Disability,60,80,32,20,52
Gujarat,Rajkot,Intellectual Disability,80,100,2,1,3
Madhya Pradesh,Rajgarh,Intellectual Disability,0,6,27,17,44
Madhya Pradesh,Rajgarh,Intellectual Disability,6,15,233,153,386
Madhya Pradesh,Rajgarh,Intellectual Disability,15,35,465,261,726
Madhya Pradesh,Rajgarh,Intellectual Disability,35,60,226,96,322
Madhya Pradesh,Rajgarh,Intellectual Disability,60,80,35,19,54
Madhya Pradesh,Rajgarh,Intellectual Disability,80,100,2,1,3
Telangana,Rajanna Sircilla,Intellectual Disability,6,15,56,43,99
Telangana,Rajanna Sircilla,Intellectual Disability,15,35,316,240,556
Telangana,Rajanna Sircilla,Intellectual Disability,35,60,138,119,257
Telangana,Rajanna Sircilla,Intellectual Disability,60,80,25,13,38
Telangana,Rajanna Sircilla,Intellectual Disability,80,100,1,0,1
Madhya Pradesh,Raisen,Intellectual Disability,0,6,9,5,14
Madhya Pradesh,Raisen,Intellectual Disability,6,15,165,102,267
Madhya Pradesh,Raisen,Intellectual Disability,15,35,421,246,667
Madhya Pradesh,Raisen,Intellectual Disability,35,60,198,89,287
Madhya Pradesh,Raisen,Intellectual Disability,60,80,27,11,38
Chhattisgarh,Raipur,Intellectual Disability,0,6,47,37,84
Chhattisgarh,Raipur,Intellectual Disability,6,15,393,287,680
Chhattisgarh,Raipur,Intellectual Disability,15,35,642,466,1108
Chhattisgarh,Raipur,Intellectual Disability,35,60,131,115,246
Chhattisgarh,Raipur,Intellectual Disability,60,80,3,4,7
Chhattisgarh,Raigarh,Intellectual Disability,0,6,13,12,25
Chhattisgarh,Raigarh,Intellectual Disability,6,15,275,190,465
Chhattisgarh,Raigarh,Intellectual Disability,15,35,439,293,732
Chhattisgarh,Raigarh,Intellectual Disability,35,60,74,74,148
Chhattisgarh,Raigarh,Intellectual Disability,60,80,4,2,6
Maharashtra,Raigad,Intellectual Disability,0,6,87,45,132
Maharashtra,Raigad,Intellectual Disability,6,15,834,489,1323
Maharashtra,Raigad,Intellectual Disability,15,35,1270,784,2054
Maharashtra,Raigad,Intellectual Disability,35,60,364,240,604
Maharashtra,Raigad,Intellectual Disability,60,80,19,12,31
Karnataka,Raichur,Intellectual Disability,0,6,177,134,311
Karnataka,Raichur,Intellectual Disability,6,15,848,604,1452
Karnataka,Raichur,Intellectual Disability,15,35,830,675,1505
Karnataka,Raichur,Intellectual Disability,35,60,114,107,221
Karnataka,Raichur,Intellectual Disability,60,80,4,4,8
Uttar Pradesh,Rae Bareli,Intellectual Disability,0,6,5,2,7
Uttar Pradesh,Rae Bareli,Intellectual Disability,6,15,43,18,61
Uttar Pradesh,Rae Bareli,Intellectual Disability,15,35,80,50,130
Uttar Pradesh,Rae Bareli,Intellectual Disability,35,60,21,10,31
Uttar Pradesh,Rae Bareli,Intellectual Disability,60,80,5,0,5
West Bengal,Purulia,Intellectual Disability,15,35,1,0,1
Bihar,Purnia,Intellectual Disability,0,6,9,7,16
Bihar,Purnia,Intellectual Disability,6,15,119,112,231
Bihar,Purnia,Intellectual Disability,15,35,118,57,175
Bihar,Purnia,Intellectual Disability,35,60,31,9,40
Bihar,Purnia,Intellectual Disability,60,80,1,1,2
Odisha,Puri,Intellectual Disability,0,6,29,22,51
Odisha,Puri,Intellectual Disability,6,15,262,170,432
Odisha,Puri,Intellectual Disability,15,35,363,257,620
Odisha,Puri,Intellectual Disability,35,60,189,113,302
Odisha,Puri,Intellectual Disability,60,80,17,15,32
Bihar,Purbi Champaran,Intellectual Disability,0,6,9,6,15
Bihar,Purbi Champaran,Intellectual Disability,6,15,87,50,137
Bihar,Purbi Champaran,Intellectual Disability,15,35,74,25,99
Bihar,Purbi Champaran,Intellectual Disability,35,60,18,8,26
Bihar,Purbi Champaran,Intellectual Disability,60,80,2,0,2
Bihar,Purbi Champaran,Intellectual Disability,80,100,1,0,1
Maharashtra,Pune,Intellectual Disability,0,6,140,62,202
Maharashtra,Pune,Intellectual Disability,6,15,1785,956,2741
Maharashtra,Pune,Intellectual Disability,15,35,2742,1478,4220
Maharashtra,Pune,Intellectual Disability,35,60,704,537,1241
Maharashtra,Pune,Intellectual Disability,60,80,31,27,58
Jammu And Kashmir,Pulwama,Intellectual Disability,0,6,35,30,65
Jammu And Kashmir,Pulwama,Intellectual Disability,6,15,134,96,230
Jammu And Kashmir,Pulwama,Intellectual Disability,15,35,231,181,412
Jammu And Kashmir,Pulwama,Intellectual Disability,35,60,123,96,219
Jammu And Kashmir,Pulwama,Intellectual Disability,60,80,6,0,6
Jammu And Kashmir,Pulwama,Intellectual Disability,80,100,2,0,2
Tamil Nadu,Pudukkottai,Intellectual Disability,0,6,59,26,85
Tamil Nadu,Pudukkottai,Intellectual Disability,6,15,660,490,1150
Tamil Nadu,Pudukkottai,Intellectual Disability,15,35,1194,768,1962
Tamil Nadu,Pudukkottai,Intellectual Disability,35,60,325,298,623
Tamil Nadu,Pudukkottai,Intellectual Disability,60,80,10,8,18
Tamil Nadu,Pudukkottai,Intellectual Disability,80,100,0,1,1
Uttar Pradesh,Prayagraj,Intellectual Disability,0,6,4,4,8
Uttar Pradesh,Prayagraj,Intellectual Disability,6,15,191,103,294
Uttar Pradesh,Prayagraj,Intellectual Disability,15,35,240,71,311
Uttar Pradesh,Prayagraj,Intellectual Disability,35,60,59,16,75
Uttar Pradesh,Prayagraj,Intellectual Disability,60,80,3,1,4
Uttar Pradesh,Prayagraj,Intellectual Disability,80,100,1,0,1
Rajasthan,Pratapgarh,Intellectual Disability,6,15,3,6,9
Rajasthan,Pratapgarh,Intellectual Disability,15,35,25,14,39
Rajasthan,Pratapgarh,Intellectual Disability,35,60,18,10,28
Rajasthan,Pratapgarh,Intellectual Disability,60,80,4,3,7
Uttar Pradesh,Pratapgarh,Intellectual Disability,0,6,3,1,4
Uttar Pradesh,Pratapgarh,Intellectual Disability,6,15,7,7,14
Uttar Pradesh,Pratapgarh,Intellectual Disability,15,35,56,29,85
Uttar Pradesh,Pratapgarh,Intellectual Disability,35,60,32,16,48
Uttar Pradesh,Pratapgarh,Intellectual Disability,60,80,6,1,7
Andhra Pradesh,Prakasam,Intellectual Disability,0,6,20,18,38
Andhra Pradesh,Prakasam,Intellectual Disability,6,15,461,350,811
Andhra Pradesh,Prakasam,Intellectual Disability,15,35,714,440,1154
Andhra Pradesh,Prakasam,Intellectual Disability,35,60,249,152,401
Andhra Pradesh,Prakasam,Intellectual Disability,60,80,21,7,28
Andhra Pradesh,Prakasam,Intellectual Disability,80,100,1,0,1
Gujarat,Porbandar,Intellectual Disability,0,6,5,6,11
Gujarat,Porbandar,Intellectual Disability,6,15,132,111,243
Gujarat,Porbandar,Intellectual Disability,15,35,315,209,524
Gujarat,Porbandar,Intellectual Disability,35,60,105,50,155
Gujarat,Porbandar,Intellectual Disability,60,80,1,5,6
Jammu And Kashmir,Poonch,Intellectual Disability,0,6,6,3,9
Jammu And Kashmir,Poonch,Intellectual Disability,6,15,33,31,64
Jammu And Kashmir,Poonch,Intellectual Disability,15,35,85,63,148
Jammu And Kashmir,Poonch,Intellectual Disability,35,60,68,55,123
Jammu And Kashmir,Poonch,Intellectual Disability,60,80,9,8,17
Jammu And Kashmir,Poonch,Intellectual Disability,80,100,2,1,3
Puducherry,Pondicherry,Intellectual Disability,0,6,24,17,41
Puducherry,Pondicherry,Intellectual Disability,6,15,214,123,337
Puducherry,Pondicherry,Intellectual Disability,15,35,782,432,1214
Puducherry,Pondicherry,Intellectual Disability,35,60,413,330,743
Puducherry,Pondicherry,Intellectual Disability,60,80,20,18,38
Puducherry,Pondicherry,Intellectual Disability,80,100,0,1,1
Uttarakhand,Pithoragarh,Intellectual Disability,0,6,1,0,1
Uttarakhand,Pithoragarh,Intellectual Disability,6,15,40,24,64
Uttarakhand,Pithoragarh,Intellectual Disability,15,35,131,60,191
Uttarakhand,Pithoragarh,Intellectual Disability,35,60,111,54,165
Uttarakhand,Pithoragarh,Intellectual Disability,60,80,12,8,20
Uttarakhand,Pithoragarh,Intellectual Disability,80,100,1,0,1
Uttar Pradesh,Pilibhit,Intellectual Disability,0,6,5,0,5
Uttar Pradesh,Pilibhit,Intellectual Disability,6,15,19,16,35
Uttar Pradesh,Pilibhit,Intellectual Disability,15,35,69,42,111
Uttar Pradesh,Pilibhit,Intellectual Disability,35,60,48,12,60
Uttar Pradesh,Pilibhit,Intellectual Disability,60,80,13,1,14
Uttar Pradesh,Pilibhit,Intellectual Disability,80,100,1,0,1
Nagaland,Phek,Intellectual Disability,6,15,0,1,1
Nagaland,Phek,Intellectual Disability,15,35,1,0,1
Nagaland,Phek,Intellectual Disability,35,60,2,0,2
Tamil Nadu,Perambalur,Intellectual Disability,0,6,47,27,74
Tamil Nadu,Perambalur,Intellectual Disability,6,15,235,157,392
Tamil Nadu,Perambalur,Intellectual Disability,15,35,572,414,986
Tamil Nadu,Perambalur,Intellectual Disability,35,60,182,179,361
Tamil Nadu,Perambalur,Intellectual Disability,60,80,16,7,23
Tamil Nadu,Perambalur,Intellectual Disability,80,100,1,0,1
Telangana,Peddapalli,Intellectual Disability,6,15,74,56,130
Telangana,Peddapalli,Intellectual Disability,15,35,481,412,893
Telangana,Peddapalli,Intellectual Disability,35,60,211,210,421
Telangana,Peddapalli,Intellectual Disability,60,80,22,25,47
Uttarakhand,Pauri Garhwal,Intellectual Disability,0,6,1,5,6
Uttarakhand,Pauri Garhwal,Intellectual Disability,6,15,52,39,91
Uttarakhand,Pauri Garhwal,Intellectual Disability,15,35,257,144,401
Uttarakhand,Pauri Garhwal,Intellectual Disability,35,60,273,116,389
Uttarakhand,Pauri Garhwal,Intellectual Disability,60,80,41,7,48
Uttarakhand,Pauri Garhwal,Intellectual Disability,80,100,1,1,2
Bihar,Patna,Intellectual Disability,0,6,4,2,6
Bihar,Patna,Intellectual Disability,6,15,78,47,125
Bihar,Patna,Intellectual Disability,15,35,132,61,193
Bihar,Patna,Intellectual Disability,35,60,42,18,60
Bihar,Patna,Intellectual Disability,60,80,4,3,7
Punjab,Patiala,Intellectual Disability,0,6,47,22,69
Punjab,Patiala,Intellectual Disability,6,15,533,308,841
Punjab,Patiala,Intellectual Disability,15,35,633,321,954
Punjab,Patiala,Intellectual Disability,35,60,288,124,412
Punjab,Patiala,Intellectual Disability,60,80,38,11,49
Punjab,Patiala,Intellectual Disability,80,100,2,1,3
Punjab,Pathankot,Intellectual Disability,0,6,20,9,29
Punjab,Pathankot,Intellectual Disability,6,15,151,81,232
Punjab,Pathankot,Intellectual Disability,15,35,155,69,224
Punjab,Pathankot,Intellectual Disability,35,60,90,42,132
Punjab,Pathankot,Intellectual Disability,60,80,14,5,19
Punjab,Pathankot,Intellectual Disability,80,100,1,0,1
Kerala,Pathanamthitta,Intellectual Disability,0,6,6,15,21
Kerala,Pathanamthitta,Intellectual Disability,6,15,208,129,337
Kerala,Pathanamthitta,Intellectual Disability,15,35,873,539,1412
Kerala,Pathanamthitta,Intellectual Disability,35,60,366,312,678
Kerala,Pathanamthitta,Intellectual Disability,60,80,51,39,90
Kerala,Pathanamthitta,Intellectual Disability,80,100,1,2,3
Gujarat,Patan,Intellectual Disability,0,6,91,59,150
Gujarat,Patan,Intellectual Disability,6,15,639,345,984
Gujarat,Patan,Intellectual Disability,15,35,718,287,1005
Gujarat,Patan,Intellectual Disability,35,60,143,61,204
Gujarat,Patan,Intellectual Disability,60,80,7,4,11
Gujarat,Patan,Intellectual Disability,80,100,1,0,1
Bihar,Pashchim Champaran,Intellectual Disability,0,6,7,2,9
Bihar,Pashchim Champaran,Intellectual Disability,6,15,61,56,117
Bihar,Pashchim Champaran,Intellectual Disability,15,35,83,34,117
Bihar,Pashchim Champaran,Intellectual Disability,35,60,44,17,61
Bihar,Pashchim Champaran,Intellectual Disability,60,80,7,2,9
West Bengal,Paschim Bardhaman,Intellectual Disability,6,15,1,0,1
Maharashtra,Parbhani,Intellectual Disability,0,6,41,24,65
Maharashtra,Parbhani,Intellectual Disability,6,15,424,263,687
Maharashtra,Parbhani,Intellectual Disability,15,35,584,393,977
Maharashtra,Parbhani,Intellectual Disability,35,60,130,102,232
Maharashtra,Parbhani,Intellectual Disability,60,80,4,13,17
Arunachal Pradesh,Papum Pare,Intellectual Disability,0,6,5,0,5
Arunachal Pradesh,Papum Pare,Intellectual Disability,6,15,15,10,25
Arunachal Pradesh,Papum Pare,Intellectual Disability,15,35,7,4,11
Arunachal Pradesh,Papum Pare,Intellectual Disability,35,60,1,0,1
Madhya Pradesh,Panna,Intellectual Disability,0,6,5,4,9
Madhya Pradesh,Panna,Intellectual Disability,6,15,43,36,79
Madhya Pradesh,Panna,Intellectual Disability,15,35,186,129,315
Madhya Pradesh,Panna,Intellectual Disability,35,60,74,36,110
Madhya Pradesh,Panna,Intellectual Disability,60,80,12,8,20
Madhya Pradesh,Panna,Intellectual Disability,80,100,3,0,3
Haryana,Panipat,Intellectual Disability,0,6,26,22,48
Haryana,Panipat,Intellectual Disability,6,15,212,141,353
Haryana,Panipat,Intellectual Disability,15,35,257,116,373
Haryana,Panipat,Intellectual Disability,35,60,59,31,90
Haryana,Panipat,Intellectual Disability,60,80,4,0,4
Haryana,Panchkula,Intellectual Disability,0,6,12,12,24
Haryana,Panchkula,Intellectual Disability,6,15,216,149,365
Haryana,Panchkula,Intellectual Disability,15,35,345,191,536
Haryana,Panchkula,Intellectual Disability,35,60,107,42,149
Haryana,Panchkula,Intellectual Disability,60,80,5,6,11
Gujarat,Panch Mahals,Intellectual Disability,0,6,45,38,83
Gujarat,Panch Mahals,Intellectual Disability,6,15,845,638,1483
Gujarat,Panch Mahals,Intellectual Disability,15,35,935,588,1523
Gujarat,Panch Mahals,Intellectual Disability,35,60,109,77,186
Gujarat,Panch Mahals,Intellectual Disability,60,80,5,5,10
Gujarat,Panch Mahals,Intellectual Disability,80,100,1,0,1
Haryana,Palwal,Intellectual Disability,0,6,6,4,10
Haryana,Palwal,Intellectual Disability,6,15,88,66,154
Haryana,Palwal,Intellectual Disability,15,35,139,68,207
Haryana,Palwal,Intellectual Disability,35,60,18,5,23
Rajasthan,Pali,Intellectual Disability,0,6,1,0,1
Rajasthan,Pali,Intellectual Disability,6,15,28,22,50
Rajasthan,Pali,Intellectual Disability,15,35,68,39,107
Rajasthan,Pali,Intellectual Disability,35,60,20,8,28
Rajasthan,Pali,Intellectual Disability,60,80,2,1,3
Maharashtra,Palghar,Intellectual Disability,0,6,34,17,51
Maharashtra,Palghar,Intellectual Disability,6,15,404,245,649
Maharashtra,Palghar,Intellectual Disability,15,35,542,354,896
Maharashtra,Palghar,Intellectual Disability,35,60,137,95,232
Maharashtra,Palghar,Intellectual Disability,60,80,7,3,10
Jharkhand,Palamu,Intellectual Disability,6,15,10,11,21
Jharkhand,Palamu,Intellectual Disability,15,35,39,28,67
Jharkhand,Palamu,Intellectual Disability,35,60,15,4,19
Kerala,Palakkad,Intellectual Disability,0,6,41,27,68
Kerala,Palakkad,Intellectual Disability,6,15,487,253,740
Kerala,Palakkad,Intellectual Disability,15,35,1467,944,2411
Kerala,Palakkad,Intellectual Disability,35,60,568,562,1130
Kerala,Palakkad,Intellectual Disability,60,80,48,36,84
Kerala,Palakkad,Intellectual Disability,80,100,1,0,1
Jharkhand,Pakur,Intellectual Disability,0,6,3,0,3
Jharkhand,Pakur,Intellectual Disability,6,15,161,133,294
Jharkhand,Pakur,Intellectual Disability,15,35,152,148,300
Jharkhand,Pakur,Intellectual Disability,35,60,39,30,69
Jharkhand,Pakur,Intellectual Disability,60,80,5,3,8
Maharashtra,Osmanabad,Intellectual Disability,0,6,45,17,62
Maharashtra,Osmanabad,Intellectual Disability,6,15,498,329,827
Maharashtra,Osmanabad,Intellectual Disability,15,35,628,487,1115
Maharashtra,Osmanabad,Intellectual Disability,35,60,135,95,230
Maharashtra,Osmanabad,Intellectual Disability,60,80,5,3,8
Maharashtra,Osmanabad,Intellectual Disability,80,100,2,0,2
Haryana,Nuh,Intellectual Disability,0,6,1,2,3
Haryana,Nuh,Intellectual Disability,6,15,64,38,102
Haryana,Nuh,Intellectual Disability,15,35,74,37,111
Haryana,Nuh,Intellectual Disability,35,60,11,7,18
Haryana,Nuh,Intellectual Disability,60,80,1,1,2
Odisha,Nuapada,Intellectual Disability,0,6,11,7,18
Odisha,Nuapada,Intellectual Disability,6,15,105,78,183
Odisha,Nuapada,Intellectual Disability,15,35,123,88,211
Odisha,Nuapada,Intellectual Disability,35,60,28,24,52
Odisha,Nuapada,Intellectual Disability,60,80,3,3,6
Delhi,North West,Intellectual Disability,0,6,49,21,70
Delhi,North West,Intellectual Disability,6,15,364,246,610
Delhi,North West,Intellectual Disability,15,35,437,254,691
Delhi,North West,Intellectual Disability,35,60,52,25,77
Delhi,North West,Intellectual Disability,60,80,1,2,3
Tripura,North Tripura,Intellectual Disability,0,6,7,5,12
Tripura,North Tripura,Intellectual Disability,6,15,79,70,149
Tripura,North Tripura,Intellectual Disability,15,35,125,111,236
Tripura,North Tripura,Intellectual Disability,35,60,36,29,65
Tripura,North Tripura,Intellectual Disability,60,80,1,1,2
Goa,North Goa,Intellectual Disability,0,6,8,9,17
Goa,North Goa,Intellectual Disability,6,15,206,119,325
Goa,North Goa,Intellectual Disability,15,35,571,355,926
Goa,North Goa,Intellectual Disability,35,60,208,160,368
Goa,North Goa,Intellectual Disability,60,80,18,8,26
Meghalaya,North Garo Hills,Intellectual Disability,0,6,2,1,3
Meghalaya,North Garo Hills,Intellectual Disability,6,15,23,15,38
Meghalaya,North Garo Hills,Intellectual Disability,15,35,63,72,135
Meghalaya,North Garo Hills,Intellectual Disability,35,60,24,15,39
Meghalaya,North Garo Hills,Intellectual Disability,60,80,1,0,1
Delhi,North East,Intellectual Disability,0,6,37,19,56
Delhi,North East,Intellectual Disability,6,15,313,216,529
Delhi,North East,Intellectual Disability,15,35,490,240,730
Delhi,North East,Intellectual Disability,35,60,67,26,93
Delhi,North East,Intellectual Disability,60,80,2,0,2
Andaman And Nicobar Islands,North And Middle Andaman,Intellectual Disability,0,6,3,2,5
Andaman And Nicobar Islands,North And Middle Andaman,Intellectual Disability,6,15,21,19,40
Andaman And Nicobar Islands,North And Middle Andaman,Intellectual Disability,15,35,41,24,65
Andaman And Nicobar Islands,North And Middle Andaman,Intellectual Disability,35,60,7,9,16
Andaman And Nicobar Islands,North And Middle Andaman,Intellectual Disability,60,80,1,0,1
Delhi,North,Intellectual Disability,0,6,10,8,18
Delhi,North,Intellectual Disability,6,15,83,54,137
Delhi,North,Intellectual Disability,15,35,88,53,141
Delhi,North,Intellectual Disability,35,60,14,6,20
Delhi,North,Intellectual Disability,60,80,1,0,1
Manipur,Noney,Intellectual Disability,6,15,5,1,6
Manipur,Noney,Intellectual Disability,15,35,7,5,12
Manipur,Noney,Intellectual Disability,35,60,1,0,1
Manipur,Noney,Intellectual Disability,60,80,0,2,2
Telangana,Nizamabad,Intellectual Disability,0,6,0,1,1
Telangana,Nizamabad,Intellectual Disability,6,15,169,138,307
Telangana,Nizamabad,Intellectual Disability,15,35,895,766,1661
Telangana,Nizamabad,Intellectual Disability,35,60,381,362,743
Telangana,Nizamabad,Intellectual Disability,60,80,31,20,51
Telangana,Nizamabad,Intellectual Disability,80,100,1,2,3
Madhya Pradesh,Niwari,Intellectual Disability,6,15,5,3,8
Madhya Pradesh,Niwari,Intellectual Disability,15,35,40,25,65
Madhya Pradesh,Niwari,Intellectual Disability,35,60,42,17,59
Madhya Pradesh,Niwari,Intellectual Disability,60,80,9,2,11
Telangana,Nirmal,Intellectual Disability,6,15,15,7,22
Telangana,Nirmal,Intellectual Disability,15,35,153,113,266
Telangana,Nirmal,Intellectual Disability,35,60,53,48,101
Telangana,Nirmal,Intellectual Disability,60,80,5,7,12
Telangana,Nirmal,Intellectual Disability,80,100,1,0,1
Andaman And Nicobar Islands,Nicobars,Intellectual Disability,6,15,2,4,6
Andaman And Nicobar Islands,Nicobars,Intellectual Disability,15,35,2,3,5
Andaman And Nicobar Islands,Nicobars,Intellectual Disability,35,60,1,2,3
Delhi,New Delhi,Intellectual Disability,0,6,2,1,3
Delhi,New Delhi,Intellectual Disability,6,15,11,16,27
Delhi,New Delhi,Intellectual Disability,15,35,25,14,39
Delhi,New Delhi,Intellectual Disability,35,60,3,0,3
Delhi,New Delhi,Intellectual Disability,60,80,1,0,1
Madhya Pradesh,Neemuch,Intellectual Disability,0,6,8,1,9
Madhya Pradesh,Neemuch,Intellectual Disability,6,15,59,37,96
Madhya Pradesh,Neemuch,Intellectual Disability,15,35,116,70,186
Madhya Pradesh,Neemuch,Intellectual Disability,35,60,90,35,125
Madhya Pradesh,Neemuch,Intellectual Disability,60,80,9,0,9
Odisha,Nayagarh,Intellectual Disability,0,6,23,21,44
Odisha,Nayagarh,Intellectual Disability,6,15,102,73,175
Odisha,Nayagarh,Intellectual Disability,15,35,99,76,175
Odisha,Nayagarh,Intellectual Disability,35,60,67,41,108
Odisha,Nayagarh,Intellectual Disability,60,80,12,7,19
Odisha,Nayagarh,Intellectual Disability,80,100,3,1,4
Bihar,Nawada,Intellectual Disability,0,6,6,1,7
Bihar,Nawada,Intellectual Disability,6,15,38,43,81
Bihar,Nawada,Intellectual Disability,15,35,40,20,60
Bihar,Nawada,Intellectual Disability,35,60,16,5,21
Gujarat,Navsari,Intellectual Disability,0,6,35,26,61
Gujarat,Navsari,Intellectual Disability,6,15,399,260,659
Gujarat,Navsari,Intellectual Disability,15,35,397,263,660
Gujarat,Navsari,Intellectual Disability,35,60,54,38,92
Gujarat,Navsari,Intellectual Disability,60,80,2,6,8
Maharashtra,Nashik,Intellectual Disability,0,6,107,54,161
Maharashtra,Nashik,Intellectual Disability,6,15,1291,809,2100
Maharashtra,Nashik,Intellectual Disability,15,35,1724,1005,2729
Maharashtra,Nashik,Intellectual Disability,35,60,453,294,747
Maharashtra,Nashik,Intellectual Disability,60,80,17,12,29
Maharashtra,Nashik,Intellectual Disability,80,100,1,0,1
Madhya Pradesh,Narsinghpur,Intellectual Disability,0,6,16,8,24
Madhya Pradesh,Narsinghpur,Intellectual Disability,6,15,126,80,206
Madhya Pradesh,Narsinghpur,Intellectual Disability,15,35,275,141,416
Madhya Pradesh,Narsinghpur,Intellectual Disability,35,60,236,86,322
Madhya Pradesh,Narsinghpur,Intellectual Disability,60,80,27,14,41
Madhya Pradesh,Narsinghpur,Intellectual Disability,80,100,3,0,3
Madhya Pradesh,Narmadapuram,Intellectual Disability,0,6,6,3,9
Madhya Pradesh,Narmadapuram,Intellectual Disability,6,15,113,67,180
Madhya Pradesh,Narmadapuram,Intellectual Disability,15,35,608,344,952
Madhya Pradesh,Narmadapuram,Intellectual Disability,35,60,286,146,432
Madhya Pradesh,Narmadapuram,Intellectual Disability,60,80,37,14,51
Madhya Pradesh,Narmadapuram,Intellectual Disability,80,100,3,0,3
Gujarat,Narmada,Intellectual Disability,0,6,30,10,40
Gujarat,Narmada,Intellectual Disability,6,15,309,226,535
Gujarat,Narmada,Intellectual Disability,15,35,202,129,331
Gujarat,Narmada,Intellectual Disability,35,60,20,20,40
Gujarat,Narmada,Intellectual Disability,60,80,1,2,3
Gujarat,Narmada,Intellectual Disability,80,100,1,0,1
Chhattisgarh,Narayanpur,Intellectual Disability,0,6,1,0,1
Chhattisgarh,Narayanpur,Intellectual Disability,6,15,1,6,7
Chhattisgarh,Narayanpur,Intellectual Disability,15,35,2,9,11
Telangana,Narayanpet,Intellectual Disability,35,60,1,0,1
Maharashtra,Nandurbar,Intellectual Disability,0,6,14,7,21
Maharashtra,Nandurbar,Intellectual Disability,6,15,146,119,265
Maharashtra,Nandurbar,Intellectual Disability,15,35,130,92,222
Maharashtra,Nandurbar,Intellectual Disability,35,60,36,28,64
Maharashtra,Nandurbar,Intellectual Disability,60,80,2,0,2
Maharashtra,Nanded,Intellectual Disability,0,6,27,14,41
Maharashtra,Nanded,Intellectual Disability,6,15,493,269,762
Maharashtra,Nanded,Intellectual Disability,15,35,719,477,1196
Maharashtra,Nanded,Intellectual Disability,35,60,146,87,233
Maharashtra,Nanded,Intellectual Disability,60,80,11,8,19
Arunachal Pradesh,Namsai,Intellectual Disability,0,6,0,1,1
Arunachal Pradesh,Namsai,Intellectual Disability,6,15,2,1,3
Arunachal Pradesh,Namsai,Intellectual Disability,15,35,0,4,4
Arunachal Pradesh,Namsai,Intellectual Disability,35,60,1,1,2
Sikkim,Namchi,Intellectual Disability,0,6,2,2,4
Sikkim,Namchi,Intellectual Disability,6,15,31,15,46
Sikkim,Namchi,Intellectual Disability,15,35,68,48,116
Sikkim,Namchi,Intellectual Disability,35,60,82,75,157
Sikkim,Namchi,Intellectual Disability,60,80,23,12,35
Sikkim,Namchi,Intellectual Disability,80,100,1,0,1
Tamil Nadu,Namakkal,Intellectual Disability,0,6,41,26,67
Tamil Nadu,Namakkal,Intellectual Disability,6,15,471,309,780
Tamil Nadu,Namakkal,Intellectual Disability,15,35,1033,668,1701
Tamil Nadu,Namakkal,Intellectual Disability,35,60,394,281,675
Tamil Nadu,Namakkal,Intellectual Disability,60,80,32,24,56
Tamil Nadu,Namakkal,Intellectual Disability,80,100,3,3,6
Telangana,Nalgonda,Intellectual Disability,6,15,236,194,430
Telangana,Nalgonda,Intellectual Disability,15,35,1265,956,2221
Telangana,Nalgonda,Intellectual Disability,35,60,232,213,445
Telangana,Nalgonda,Intellectual Disability,60,80,6,5,11
Telangana,Nalgonda,Intellectual Disability,80,100,0,5,5
Assam,Nalbari,Intellectual Disability,0,6,5,3,8
Assam,Nalbari,Intellectual Disability,6,15,36,31,67
Assam,Nalbari,Intellectual Disability,15,35,96,74,170
Assam,Nalbari,Intellectual Disability,35,60,19,24,43
Assam,Nalbari,Intellectual Disability,60,80,0,1,1
Bihar,Nalanda,Intellectual Disability,0,6,9,5,14
Bihar,Nalanda,Intellectual Disability,6,15,71,28,99
Bihar,Nalanda,Intellectual Disability,15,35,79,36,115
Bihar,Nalanda,Intellectual Disability,35,60,18,5,23
Bihar,Nalanda,Intellectual Disability,60,80,4,0,4
Uttarakhand,Nainital,Intellectual Disability,0,6,35,29,64
Uttarakhand,Nainital,Intellectual Disability,6,15,259,137,396
Uttarakhand,Nainital,Intellectual Disability,15,35,428,281,709
Uttarakhand,Nainital,Intellectual Disability,35,60,189,94,283
Uttarakhand,Nainital,Intellectual Disability,60,80,14,12,26
Maharashtra,Nagpur,Intellectual Disability,0,6,156,94,250
Maharashtra,Nagpur,Intellectual Disability,6,15,1510,987,2497
Maharashtra,Nagpur,Intellectual Disability,15,35,2251,1368,3619
Maharashtra,Nagpur,Intellectual Disability,35,60,555,378,933
Maharashtra,Nagpur,Intellectual Disability,60,80,16,9,25
Maharashtra,Nagpur,Intellectual Disability,80,100,1,0,1
Rajasthan,Nagaur,Intellectual Disability,0,6,10,4,14
Rajasthan,Nagaur,Intellectual Disability,6,15,73,42,115
Rajasthan,Nagaur,Intellectual Disability,15,35,100,56,156
Rajasthan,Nagaur,Intellectual Disability,35,60,37,22,59
Rajasthan,Nagaur,Intellectual Disability,60,80,2,1,3
Telangana,Nagarkurnool,Intellectual Disability,6,15,74,57,131
Telangana,Nagarkurnool,Intellectual Disability,15,35,385,305,690
Telangana,Nagarkurnool,Intellectual Disability,35,60,97,66,163
Telangana,Nagarkurnool,Intellectual Disability,60,80,18,2,20
Telangana,Nagarkurnool,Intellectual Disability,80,100,0,2,2
Tamil Nadu,Nagapattinam,Intellectual Disability,0,6,22,16,38
Tamil Nadu,Nagapattinam,Intellectual Disability,6,15,546,341,887
Tamil Nadu,Nagapattinam,Intellectual Disability,15,35,1351,932,2283
Tamil Nadu,Nagapattinam,Intellectual Disability,35,60,391,320,711
Tamil Nadu,Nagapattinam,Intellectual Disability,60,80,24,18,42
Assam,Nagaon,Intellectual Disability,0,6,13,3,16
Assam,Nagaon,Intellectual Disability,6,15,112,82,194
Assam,Nagaon,Intellectual Disability,15,35,178,163,341
Assam,Nagaon,Intellectual Disability,35,60,98,70,168
Assam,Nagaon,Intellectual Disability,60,80,15,8,23
Assam,Nagaon,Intellectual Disability,80,100,3,2,5
West Bengal,Nadia,Intellectual Disability,6,15,1,0,1
West Bengal,Nadia,Intellectual Disability,15,35,0,1,1
Odisha,Nabarangpur,Intellectual Disability,0,6,45,33,78
Odisha,Nabarangpur,Intellectual Disability,6,15,143,78,221
Odisha,Nabarangpur,Intellectual Disability,15,35,58,66,124
Odisha,Nabarangpur,Intellectual Disability,35,60,21,13,34
Odisha,Nabarangpur,Intellectual Disability,60,80,2,3,5
Karnataka,Mysuru,Intellectual Disability,0,6,49,33,82
Karnataka,Mysuru,Intellectual Disability,6,15,559,384,943
Karnataka,Mysuru,Intellectual Disability,15,35,1077,747,1824
Karnataka,Mysuru,Intellectual Disability,35,60,305,293,598
Karnataka,Mysuru,Intellectual Disability,60,80,16,16,32
Bihar,Muzaffarpur,Intellectual Disability,0,6,8,6,14
Bihar,Muzaffarpur,Intellectual Disability,6,15,205,121,326
Bihar,Muzaffarpur,Intellectual Disability,15,35,188,93,281
Bihar,Muzaffarpur,Intellectual Disability,35,60,29,11,40
Bihar,Muzaffarpur,Intellectual Disability,60,80,1,0,1
Uttar Pradesh,Muzaffarnagar,Intellectual Disability,0,6,9,7,16
Uttar Pradesh,Muzaffarnagar,Intellectual Disability,6,15,60,39,99
Uttar Pradesh,Muzaffarnagar,Intellectual Disability,15,35,102,45,147
Uttar Pradesh,Muzaffarnagar,Intellectual Disability,35,60,45,12,57
Uttar Pradesh,Muzaffarnagar,Intellectual Disability,60,80,9,1,10
West Bengal,Murshidabad,Intellectual Disability,35,60,0,1,1
Bihar,Munger,Intellectual Disability,0,6,7,6,13
Bihar,Munger,Intellectual Disability,6,15,103,76,179
Bihar,Munger,Intellectual Disability,15,35,76,52,128
Bihar,Munger,Intellectual Disability,35,60,24,10,34
Bihar,Munger,Intellectual Disability,60,80,1,0,1
Chhattisgarh,Mungeli,Intellectual Disability,0,6,1,1,2
Chhattisgarh,Mungeli,Intellectual Disability,6,15,26,18,44
Chhattisgarh,Mungeli,Intellectual Disability,15,35,53,53,106
Chhattisgarh,Mungeli,Intellectual Disability,35,60,15,9,24
Chhattisgarh,Mungeli,Intellectual Disability,60,80,1,0,1
Maharashtra,Mumbai Suburban,Intellectual Disability,0,6,59,37,96
Maharashtra,Mumbai Suburban,Intellectual Disability,6,15,973,508,1481
Maharashtra,Mumbai Suburban,Intellectual Disability,15,35,1471,815,2286
Maharashtra,Mumbai Suburban,Intellectual Disability,35,60,235,200,435
Maharashtra,Mumbai Suburban,Intellectual Disability,60,80,10,10,20
Maharashtra,Mumbai,Intellectual Disability,0,6,39,20,59
Maharashtra,Mumbai,Intellectual Disability,6,15,616,355,971
Maharashtra,Mumbai,Intellectual Disability,15,35,1351,712,2063
Maharashtra,Mumbai,Intellectual Disability,35,60,276,187,463
Maharashtra,Mumbai,Intellectual Disability,60,80,14,10,24
Telangana,Mulugu,Intellectual Disability,15,35,2,0,2
Madhya Pradesh,Morena,Intellectual Disability,0,6,8,12,20
Madhya Pradesh,Morena,Intellectual Disability,6,15,151,72,223
Madhya Pradesh,Morena,Intellectual Disability,15,35,418,141,559
Madhya Pradesh,Morena,Intellectual Disability,35,60,154,34,188
Madhya Pradesh,Morena,Intellectual Disability,60,80,10,6,16
Madhya Pradesh,Morena,Intellectual Disability,80,100,1,1,2
Gujarat,Morbi,Intellectual Disability,0,6,16,10,26
Gujarat,Morbi,Intellectual Disability,6,15,313,216,529
Gujarat,Morbi,Intellectual Disability,15,35,369,232,601
Gujarat,Morbi,Intellectual Disability,35,60,81,29,110
Gujarat,Morbi,Intellectual Disability,60,80,3,2,5
Gujarat,Morbi,Intellectual Disability,80,100,1,0,1
Uttar Pradesh,Moradabad,Intellectual Disability,0,6,10,7,17
Uttar Pradesh,Moradabad,Intellectual Disability,6,15,126,91,217
Uttar Pradesh,Moradabad,Intellectual Disability,15,35,73,33,106
Uttar Pradesh,Moradabad,Intellectual Disability,35,60,15,5,20
Uttar Pradesh,Moradabad,Intellectual Disability,60,80,1,0,1
Nagaland,Mon,Intellectual Disability,0,6,0,1,1
Nagaland,Mon,Intellectual Disability,6,15,1,0,1
Nagaland,Mon,Intellectual Disability,15,35,0,2,2
Nagaland,Mon,Intellectual Disability,60,80,1,0,1
Nagaland,Mokokchung,Intellectual Disability,6,15,7,7,14
Nagaland,Mokokchung,Intellectual Disability,15,35,19,9,28
Nagaland,Mokokchung,Intellectual Disability,35,60,12,7,19
Nagaland,Mokokchung,Intellectual Disability,60,80,4,1,5
Punjab,Moga,Intellectual Disability,0,6,14,6,20
Punjab,Moga,Intellectual Disability,6,15,166,115,281
Punjab,Moga,Intellectual Disability,15,35,177,106,283
Punjab,Moga,Intellectual Disability,35,60,89,48,137
Punjab,Moga,Intellectual Disability,60,80,8,5,13
Punjab,Moga,Intellectual Disability,80,100,1,0,1
Uttar Pradesh,Mirzapur,Intellectual Disability,0,6,16,10,26
Uttar Pradesh,Mirzapur,Intellectual Disability,6,15,94,65,159
Uttar Pradesh,Mirzapur,Intellectual Disability,15,35,145,91,236
Uttar Pradesh,Mirzapur,Intellectual Disability,35,60,47,26,73
Uttar Pradesh,Mirzapur,Intellectual Disability,60,80,3,2,5
Uttar Pradesh,Meerut,Intellectual Disability,0,6,44,21,65
Uttar Pradesh,Meerut,Intellectual Disability,6,15,426,216,642
Uttar Pradesh,Meerut,Intellectual Disability,15,35,305,124,429
Uttar Pradesh,Meerut,Intellectual Disability,35,60,79,23,102
Uttar Pradesh,Meerut,Intellectual Disability,60,80,5,4,9
Telangana,Medchal Malkajgiri,Intellectual Disability,0,6,1,1,2
Telangana,Medchal Malkajgiri,Intellectual Disability,6,15,265,172,437
Telangana,Medchal Malkajgiri,Intellectual Disability,15,35,1201,790,1991
Telangana,Medchal Malkajgiri,Intellectual Disability,35,60,473,324,797
Telangana,Medchal Malkajgiri,Intellectual Disability,60,80,36,20,56
Telangana,Medak,Intellectual Disability,6,15,87,53,140
Telangana,Medak,Intellectual Disability,15,35,558,413,971
Telangana,Medak,Intellectual Disability,35,60,148,129,277
Telangana,Medak,Intellectual Disability,60,80,8,9,17
Telangana,Medak,Intellectual Disability,80,100,1,1,2
Odisha,Mayurbhanj,Intellectual Disability,0,6,110,48,158
Odisha,Mayurbhanj,Intellectual Disability,6,15,822,621,1443
Odisha,Mayurbhanj,Intellectual Disability,15,35,1082,913,1995
Odisha,Mayurbhanj,Intellectual Disability,35,60,236,228,464
Odisha,Mayurbhanj,Intellectual Disability,60,80,15,7,22
Odisha,Mayurbhanj,Intellectual Disability,80,100,1,1,2
Tamil Nadu,Mayiladuthurai,Intellectual Disability,0,6,21,12,33
Tamil Nadu,Mayiladuthurai,Intellectual Disability,6,15,174,114,288
Tamil Nadu,Mayiladuthurai,Intellectual Disability,15,35,200,141,341
Tamil Nadu,Mayiladuthurai,Intellectual Disability,35,60,51,39,90
Tamil Nadu,Mayiladuthurai,Intellectual Disability,60,80,0,1,1
Uttar Pradesh,Mau,Intellectual Disability,0,6,1,1,2
Uttar Pradesh,Mau,Intellectual Disability,6,15,16,13,29
Uttar Pradesh,Mau,Intellectual Disability,15,35,71,46,117
Uttar Pradesh,Mau,Intellectual Disability,35,60,22,10,32
Uttar Pradesh,Mau,Intellectual Disability,60,80,3,0,3
Uttar Pradesh,Mau,Intellectual Disability,80,100,1,0,1
Uttar Pradesh,Mathura,Intellectual Disability,0,6,11,2,13
Uttar Pradesh,Mathura,Intellectual Disability,6,15,82,37,119
Uttar Pradesh,Mathura,Intellectual Disability,15,35,109,45,154
Uttar Pradesh,Mathura,Intellectual Disability,35,60,24,11,35
Uttar Pradesh,Mathura,Intellectual Disability,60,80,2,0,2
Assam,Marigaon,Intellectual Disability,0,6,4,2,6
Assam,Marigaon,Intellectual Disability,6,15,32,22,54
Assam,Marigaon,Intellectual Disability,15,35,53,38,91
Assam,Marigaon,Intellectual Disability,35,60,7,8,15
Assam,Marigaon,Intellectual Disability,60,80,0,1,1
Punjab,Mansa,Intellectual Disability,0,6,17,13,30
Punjab,Mansa,Intellectual Disability,6,15,114,78,192
Punjab,Mansa,Intellectual Disability,15,35,149,69,218
Punjab,Mansa,Intellectual Disability,35,60,55,32,87
Punjab,Mansa,Intellectual Disability,60,80,5,2,7
Sikkim,Mangan,Intellectual Disability,0,6,1,0,1
Sikkim,Mangan,Intellectual Disability,6,15,1,2,3
Sikkim,Mangan,Intellectual Disability,15,35,6,6,12
Sikkim,Mangan,Intellectual Disability,35,60,6,8,14
Sikkim,Mangan,Intellectual Disability,60,80,0,1,1
Karnataka,Mandya,Intellectual Disability,0,6,66,36,102
Karnataka,Mandya,Intellectual Disability,6,15,485,305,790
Karnataka,Mandya,Intellectual Disability,15,35,947,690,1637
Karnataka,Mandya,Intellectual Disability,35,60,391,364,755
Karnataka,Mandya,Intellectual Disability,60,80,19,23,42
Madhya Pradesh,Mandsaur,Intellectual Disability,0,6,20,5,25
Madhya Pradesh,Mandsaur,Intellectual Disability,6,15,88,55,143
Madhya Pradesh,Mandsaur,Intellectual Disability,15,35,121,81,202
Madhya Pradesh,Mandsaur,Intellectual Disability,35,60,76,43,119
Madhya Pradesh,Mandsaur,Intellectual Disability,60,80,4,3,7
Madhya Pradesh,Mandsaur,Intellectual Disability,80,100,1,0,1
Madhya Pradesh,Mandla,Intellectual Disability,0,6,4,7,11
Madhya Pradesh,Mandla,Intellectual Disability,6,15,88,74,162
Madhya Pradesh,Mandla,Intellectual Disability,15,35,190,150,340
Madhya Pradesh,Mandla,Intellectual Disability,35,60,102,76,178
Madhya Pradesh,Mandla,Intellectual Disability,60,80,18,10,28
Madhya Pradesh,Mandla,Intellectual Disability,80,100,0,1,1
Himachal Pradesh,Mandi,Intellectual Disability,0,6,26,21,47
Himachal Pradesh,Mandi,Intellectual Disability,6,15,188,142,330
Himachal Pradesh,Mandi,Intellectual Disability,15,35,443,263,706
Himachal Pradesh,Mandi,Intellectual Disability,35,60,139,72,211
Himachal Pradesh,Mandi,Intellectual Disability,60,80,11,7,18
Himachal Pradesh,Mandi,Intellectual Disability,80,100,1,0,1
Telangana,Mancherial,Intellectual Disability,6,15,86,64,150
Telangana,Mancherial,Intellectual Disability,15,35,488,405,893
Telangana,Mancherial,Intellectual Disability,35,60,208,167,375
Telangana,Mancherial,Intellectual Disability,60,80,10,13,23
Telangana,Mancherial,Intellectual Disability,80,100,0,2,2
Mizoram,Mamit,Intellectual Disability,0,6,0,1,1
Mizoram,Mamit,Intellectual Disability,6,15,4,2,6
Mizoram,Mamit,Intellectual Disability,15,35,8,9,17
Mizoram,Mamit,Intellectual Disability,35,60,5,3,8
Mizoram,Mamit,Intellectual Disability,60,80,1,1,2
Odisha,Malkangiri,Intellectual Disability,0,6,10,11,21
Odisha,Malkangiri,Intellectual Disability,6,15,41,37,78
Odisha,Malkangiri,Intellectual Disability,15,35,40,29,69
Odisha,Malkangiri,Intellectual Disability,35,60,21,12,33
Odisha,Malkangiri,Intellectual Disability,60,80,1,1,2
Punjab,Malerkotla,Intellectual Disability,0,6,1,0,1
Punjab,Malerkotla,Intellectual Disability,6,15,21,17,38
Punjab,Malerkotla,Intellectual Disability,15,35,26,16,42
Punjab,Malerkotla,Intellectual Disability,35,60,9,3,12
Punjab,Malerkotla,Intellectual Disability,60,80,2,1,3
Kerala,Malappuram,Intellectual Disability,0,6,194,142,336
Kerala,Malappuram,Intellectual Disability,6,15,1194,753,1947
Kerala,Malappuram,Intellectual Disability,15,35,3117,1926,5043
Kerala,Malappuram,Intellectual Disability,35,60,1261,1101,2362
Kerala,Malappuram,Intellectual Disability,60,80,117,82,199
Kerala,Malappuram,Intellectual Disability,80,100,5,7,12
Assam,Majuli,Intellectual Disability,0,6,2,1,3
Assam,Majuli,Intellectual Disability,6,15,8,6,14
Assam,Majuli,Intellectual Disability,15,35,12,10,22
Assam,Majuli,Intellectual Disability,35,60,4,3,7
Uttar Pradesh,Mainpuri,Intellectual Disability,0,6,3,0,3
Uttar Pradesh,Mainpuri,Intellectual Disability,6,15,116,77,193
Uttar Pradesh,Mainpuri,Intellectual Disability,15,35,69,42,111
Uttar Pradesh,Mainpuri,Intellectual Disability,35,60,35,9,44
Uttar Pradesh,Mainpuri,Intellectual Disability,60,80,13,1,14
Uttar Pradesh,Mahoba,Intellectual Disability,0,6,1,0,1
Uttar Pradesh,Mahoba,Intellectual Disability,6,15,14,22,36
Uttar Pradesh,Mahoba,Intellectual Disability,15,35,24,7,31
Uttar Pradesh,Mahoba,Intellectual Disability,35,60,19,4,23
Uttar Pradesh,Mahoba,Intellectual Disability,60,80,7,1,8
Gujarat,Mahisagar,Intellectual Disability,0,6,20,13,33
Gujarat,Mahisagar,Intellectual Disability,6,15,737,440,1177
Gujarat,Mahisagar,Intellectual Disability,15,35,632,314,946
Gujarat,Mahisagar,Intellectual Disability,35,60,77,41,118
Gujarat,Mahisagar,Intellectual Disability,60,80,7,1,8
Gujarat,Mahisagar,Intellectual Disability,80,100,2,0,2
Gujarat,Mahesana,Intellectual Disability,0,6,34,22,56
Gujarat,Mahesana,Intellectual Disability,6,15,572,345,917
Gujarat,Mahesana,Intellectual Disability,15,35,801,372,1173
Gujarat,Mahesana,Intellectual Disability,35,60,189,120,309
Gujarat,Mahesana,Intellectual Disability,60,80,8,6,14
Haryana,Mahendragarh,Intellectual Disability,0,6,12,4,16
Haryana,Mahendragarh,Intellectual Disability,6,15,115,60,175
Haryana,Mahendragarh,Intellectual Disability,15,35,135,59,194
Haryana,Mahendragarh,Intellectual Disability,35,60,69,20,89
Haryana,Mahendragarh,Intellectual Disability,60,80,4,1,5
Puducherry,Mahe,Intellectual Disability,6,15,6,4,10
Puducherry,Mahe,Intellectual Disability,15,35,26,11,37
Puducherry,Mahe,Intellectual Disability,35,60,19,13,32
Puducherry,Mahe,Intellectual Disability,60,80,3,3,6
Chhattisgarh,Mahasamund,Intellectual Disability,0,6,1,7,8
Chhattisgarh,Mahasamund,Intellectual Disability,6,15,217,140,357
Chhattisgarh,Mahasamund,Intellectual Disability,15,35,221,187,408
Chhattisgarh,Mahasamund,Intellectual Disability,35,60,52,47,99
Chhattisgarh,Mahasamund,Intellectual Disability,60,80,1,5,6
Uttar Pradesh,Maharajganj,Intellectual Disability,0,6,3,2,5
Uttar Pradesh,Maharajganj,Intellectual Disability,6,15,31,19,50
Uttar Pradesh,Maharajganj,Intellectual Disability,15,35,132,59,191
Uttar Pradesh,Maharajganj,Intellectual Disability,35,60,39,14,53
Uttar Pradesh,Maharajganj,Intellectual Disability,60,80,6,2,8
Telangana,Mahabubnagar,Intellectual Disability,6,15,167,109,276
Telangana,Mahabubnagar,Intellectual Disability,15,35,778,640,1418
Telangana,Mahabubnagar,Intellectual Disability,35,60,171,148,319
Telangana,Mahabubnagar,Intellectual Disability,60,80,10,10,20
Telangana,Mahabubnagar,Intellectual Disability,80,100,2,0,2
Telangana,Mahabubabad,Intellectual Disability,6,15,38,27,65
Telangana,Mahabubabad,Intellectual Disability,15,35,510,417,927
Telangana,Mahabubabad,Intellectual Disability,35,60,194,196,390
Telangana,Mahabubabad,Intellectual Disability,60,80,18,7,25
Telangana,Mahabubabad,Intellectual Disability,80,100,2,1,3
Tamil Nadu,Madurai,Intellectual Disability,0,6,67,44,111
Tamil Nadu,Madurai,Intellectual Disability,6,15,862,554,1416
Tamil Nadu,Madurai,Intellectual Disability,15,35,1802,1143,2945
Tamil Nadu,Madurai,Intellectual Disability,35,60,469,361,830
Tamil Nadu,Madurai,Intellectual Disability,60,80,28,28,56
Tamil Nadu,Madurai,Intellectual Disability,80,100,1,0,1
Bihar,Madhubani,Intellectual Disability,0,6,1,0,1
Bihar,Madhubani,Intellectual Disability,6,15,33,17,50
Bihar,Madhubani,Intellectual Disability,15,35,38,19,57
Bihar,Madhubani,Intellectual Disability,35,60,10,7,17
Bihar,Madhubani,Intellectual Disability,60,80,2,0,2
Bihar,Madhepura,Intellectual Disability,0,6,2,0,2
Bihar,Madhepura,Intellectual Disability,6,15,4,4,8
Bihar,Madhepura,Intellectual Disability,15,35,26,6,32
Bihar,Madhepura,Intellectual Disability,35,60,11,4,15
Bihar,Madhepura,Intellectual Disability,60,80,3,0,3
Bihar,Madhepura,Intellectual Disability,80,100,0,1,1
Mizoram,Lunglei,Intellectual Disability,0,6,0,2,2
Mizoram,Lunglei,Intellectual Disability,6,15,3,4,7
Mizoram,Lunglei,Intellectual Disability,15,35,14,7,21
Mizoram,Lunglei,Intellectual Disability,35,60,10,5,15
Mizoram,Lunglei,Intellectual Disability,60,80,2,0,2
Punjab,Ludhiana,Intellectual Disability,0,6,112,55,167
Punjab,Ludhiana,Intellectual Disability,6,15,938,557,1495
Punjab,Ludhiana,Intellectual Disability,15,35,1212,616,1828
Punjab,Ludhiana,Intellectual Disability,35,60,464,269,733
Punjab,Ludhiana,Intellectual Disability,60,80,69,26,95
Punjab,Ludhiana,Intellectual Disability,80,100,2,2,4
Uttar Pradesh,Lucknow,Intellectual Disability,0,6,10,7,17
Uttar Pradesh,Lucknow,Intellectual Disability,6,15,180,124,304
Uttar Pradesh,Lucknow,Intellectual Disability,15,35,250,132,382
Uttar Pradesh,Lucknow,Intellectual Disability,35,60,111,53,164
Uttar Pradesh,Lucknow,Intellectual Disability,60,80,27,4,31
Arunachal Pradesh,Lower Dibang Valley,Intellectual Disability,0,6,0,1,1
Arunachal Pradesh,Lower Dibang Valley,Intellectual Disability,6,15,17,12,29
Arunachal Pradesh,Lower Dibang Valley,Intellectual Disability,15,35,10,7,17
Arunachal Pradesh,Lower Dibang Valley,Intellectual Disability,35,60,5,3,8
Arunachal Pradesh,Longding,Intellectual Disability,35,60,1,0,1
Arunachal Pradesh,Lohit,Intellectual Disability,15,35,0,1,1
Jharkhand,Lohardaga,Intellectual Disability,0,6,0,6,6
Jharkhand,Lohardaga,Intellectual Disability,6,15,58,38,96
Jharkhand,Lohardaga,Intellectual Disability,15,35,93,65,158
Jharkhand,Lohardaga,Intellectual Disability,35,60,34,14,48
Jharkhand,Lohardaga,Intellectual Disability,60,80,3,3,6
Jharkhand,Lohardaga,Intellectual Disability,80,100,0,2,2
Ladakh,Leh Ladakh,Intellectual Disability,0,6,4,4,8
Ladakh,Leh Ladakh,Intellectual Disability,6,15,17,8,25
Ladakh,Leh Ladakh,Intellectual Disability,15,35,24,21,45
Ladakh,Leh Ladakh,Intellectual Disability,35,60,10,15,25
Mizoram,Lawngtlai,Intellectual Disability,6,15,1,0,1
Mizoram,Lawngtlai,Intellectual Disability,15,35,0,2,2
Maharashtra,Latur,Intellectual Disability,0,6,7,5,12
Maharashtra,Latur,Intellectual Disability,6,15,231,132,363
Maharashtra,Latur,Intellectual Disability,15,35,612,301,913
Maharashtra,Latur,Intellectual Disability,35,60,146,104,250
Maharashtra,Latur,Intellectual Disability,60,80,13,10,23
Maharashtra,Latur,Intellectual Disability,80,100,2,0,2
Jharkhand,Latehar,Intellectual Disability,0,6,3,1,4
Jharkhand,Latehar,Intellectual Disability,6,15,36,29,65
Jharkhand,Latehar,Intellectual Disability,15,35,46,27,73
Jharkhand,Latehar,Intellectual Disability,35,60,10,8,18
Jharkhand,Latehar,Intellectual Disability,60,80,3,1,4
Uttar Pradesh,Lalitpur,Intellectual Disability,0,6,2,1,3
Uttar Pradesh,Lalitpur,Intellectual Disability,6,15,27,24,51
Uttar Pradesh,Lalitpur,Intellectual Disability,15,35,21,11,32
Uttar Pradesh,Lalitpur,Intellectual Disability,35,60,11,6,17
Uttar Pradesh,Lalitpur,Intellectual Disability,60,80,1,0,1
Lakshadweep,Lakshadweep District,Intellectual Disability,0,6,3,0,3
Lakshadweep,Lakshadweep District,Intellectual Disability,6,15,23,22,45
Lakshadweep,Lakshadweep District,Intellectual Disability,15,35,97,51,148
Lakshadweep,Lakshadweep District,Intellectual Disability,35,60,37,19,56
Lakshadweep,Lakshadweep District,Intellectual Disability,60,80,1,1,2
Bihar,Lakhisarai,Intellectual Disability,6,15,12,5,17
Bihar,Lakhisarai,Intellectual Disability,15,35,13,5,18
Bihar,Lakhisarai,Intellectual Disability,35,60,6,1,7
Bihar,Lakhisarai,Intellectual Disability,60,80,2,0,2
Assam,Lakhimpur,Intellectual Disability,0,6,13,6,19
Assam,Lakhimpur,Intellectual Disability,6,15,74,59,133
Assam,Lakhimpur,Intellectual Disability,15,35,104,117,221
Assam,Lakhimpur,Intellectual Disability,35,60,42,39,81
Assam,Lakhimpur,Intellectual Disability,60,80,4,0,4
Himachal Pradesh,Lahul And Spiti,Intellectual Disability,6,15,2,1,3
Himachal Pradesh,Lahul And Spiti,Intellectual Disability,15,35,2,3,5
Himachal Pradesh,Lahul And Spiti,Intellectual Disability,35,60,1,2,3
Himachal Pradesh,Lahul And Spiti,Intellectual Disability,60,80,0,1,1
Uttar Pradesh,Kushi Nagar,Intellectual Disability,0,6,3,2,5
Uttar Pradesh,Kushi Nagar,Intellectual Disability,6,15,32,33,65
Uttar Pradesh,Kushi Nagar,Intellectual Disability,15,35,124,61,185
Uttar Pradesh,Kushi Nagar,Intellectual Disability,35,60,37,9,46
Uttar Pradesh,Kushi Nagar,Intellectual Disability,60,80,4,0,4
Haryana,Kurukshetra,Intellectual Disability,0,6,53,15,68
Haryana,Kurukshetra,Intellectual Disability,6,15,301,159,460
Haryana,Kurukshetra,Intellectual Disability,15,35,448,224,672
Haryana,Kurukshetra,Intellectual Disability,35,60,181,90,271
Haryana,Kurukshetra,Intellectual Disability,60,80,8,3,11
Andhra Pradesh,Kurnool,Intellectual Disability,0,6,107,73,180
Andhra Pradesh,Kurnool,Intellectual Disability,6,15,896,626,1522
Andhra Pradesh,Kurnool,Intellectual Disability,15,35,1212,938,2150
Andhra Pradesh,Kurnool,Intellectual Disability,35,60,419,316,735
Andhra Pradesh,Kurnool,Intellectual Disability,60,80,35,21,56
Andhra Pradesh,Kurnool,Intellectual Disability,80,100,3,0,3
Jammu And Kashmir,Kupwara,Intellectual Disability,0,6,12,14,26
Jammu And Kashmir,Kupwara,Intellectual Disability,6,15,128,98,226
Jammu And Kashmir,Kupwara,Intellectual Disability,15,35,208,174,382
Jammu And Kashmir,Kupwara,Intellectual Disability,35,60,90,66,156
Jammu And Kashmir,Kupwara,Intellectual Disability,60,80,5,7,12
Telangana,Kumuram Bheem Asifabad,Intellectual Disability,6,15,57,50,107
Telangana,Kumuram Bheem Asifabad,Intellectual Disability,15,35,211,205,416
Telangana,Kumuram Bheem Asifabad,Intellectual Disability,35,60,52,52,104
Telangana,Kumuram Bheem Asifabad,Intellectual Disability,60,80,4,4,8
Himachal Pradesh,Kullu,Intellectual Disability,0,6,14,7,21
Himachal Pradesh,Kullu,Intellectual Disability,6,15,90,59,149
Himachal Pradesh,Kullu,Intellectual Disability,15,35,179,148,327
Himachal Pradesh,Kullu,Intellectual Disability,35,60,70,65,135
Himachal Pradesh,Kullu,Intellectual Disability,60,80,1,7,8
Jammu And Kashmir,Kulgam,Intellectual Disability,0,6,25,12,37
Jammu And Kashmir,Kulgam,Intellectual Disability,6,15,60,52,112
Jammu And Kashmir,Kulgam,Intellectual Disability,15,35,157,159,316
Jammu And Kashmir,Kulgam,Intellectual Disability,35,60,67,72,139
Jammu And Kashmir,Kulgam,Intellectual Disability,60,80,5,2,7
Tamil Nadu,Krishnagiri,Intellectual Disability,0,6,45,18,63
Tamil Nadu,Krishnagiri,Intellectual Disability,6,15,795,489,1284
Tamil Nadu,Krishnagiri,Intellectual Disability,15,35,1084,725,1809
Tamil Nadu,Krishnagiri,Intellectual Disability,35,60,262,187,449
Tamil Nadu,Krishnagiri,Intellectual Disability,60,80,23,13,36
Tamil Nadu,Krishnagiri,Intellectual Disability,80,100,1,2,3
Andhra Pradesh,Krishna,Intellectual Disability,0,6,34,22,56
Andhra Pradesh,Krishna,Intellectual Disability,6,15,414,265,679
Andhra Pradesh,Krishna,Intellectual Disability,15,35,448,324,772
Andhra Pradesh,Krishna,Intellectual Disability,35,60,212,99,311
Andhra Pradesh,Krishna,Intellectual Disability,60,80,13,5,18
Andhra Pradesh,Krishna,Intellectual Disability,80,100,1,0,1
Kerala,Kozhikode,Intellectual Disability,0,6,42,34,76
Kerala,Kozhikode,Intellectual Disability,6,15,659,422,1081
Kerala,Kozhikode,Intellectual Disability,15,35,2566,1601,4167
Kerala,Kozhikode,Intellectual Disability,35,60,1405,1261,2666
Kerala,Kozhikode,Intellectual Disability,60,80,113,134,247
Kerala,Kozhikode,Intellectual Disability,80,100,4,3,7
Kerala,Kottayam,Intellectual Disability,0,6,11,20,31
Kerala,Kottayam,Intellectual Disability,6,15,287,192,479
Kerala,Kottayam,Intellectual Disability,15,35,1240,873,2113
Kerala,Kottayam,Intellectual Disability,35,60,618,537,1155
Kerala,Kottayam,Intellectual Disability,60,80,73,55,128
Kerala,Kottayam,Intellectual Disability,80,100,3,2,5
Rajasthan,Kota,Intellectual Disability,6,15,20,16,36
Rajasthan,Kota,Intellectual Disability,15,35,87,60,147
Rajasthan,Kota,Intellectual Disability,35,60,23,17,40
Rajasthan,Kota,Intellectual Disability,60,80,2,1,3
Chhattisgarh,Korea,Intellectual Disability,0,6,1,1,2
Chhattisgarh,Korea,Intellectual Disability,6,15,56,51,107
Chhattisgarh,Korea,Intellectual Disability,15,35,77,50,127
Chhattisgarh,Korea,Intellectual Disability,35,60,25,13,38
Chhattisgarh,Korea,Intellectual Disability,60,80,3,1,4
Chhattisgarh,Korba,Intellectual Disability,0,6,3,0,3
Chhattisgarh,Korba,Intellectual Disability,6,15,9,15,24
Chhattisgarh,Korba,Intellectual Disability,15,35,18,11,29
Chhattisgarh,Korba,Intellectual Disability,35,60,5,4,9
Odisha,Koraput,Intellectual Disability,0,6,45,27,72
Odisha,Koraput,Intellectual Disability,6,15,370,267,637
Odisha,Koraput,Intellectual Disability,15,35,437,400,837
Odisha,Koraput,Intellectual Disability,35,60,113,92,205
Odisha,Koraput,Intellectual Disability,60,80,15,5,20
Odisha,Koraput,Intellectual Disability,80,100,1,0,1
Karnataka,Koppal,Intellectual Disability,0,6,132,107,239
Karnataka,Koppal,Intellectual Disability,6,15,492,308,800
Karnataka,Koppal,Intellectual Disability,15,35,400,302,702
Karnataka,Koppal,Intellectual Disability,35,60,51,48,99
Karnataka,Koppal,Intellectual Disability,60,80,6,0,6
Karnataka,Koppal,Intellectual Disability,80,100,1,0,1
Chhattisgarh,Kondagaon,Intellectual Disability,0,6,2,1,3
Chhattisgarh,Kondagaon,Intellectual Disability,6,15,22,16,38
Chhattisgarh,Kondagaon,Intellectual Disability,15,35,13,10,23
Chhattisgarh,Kondagaon,Intellectual Disability,35,60,3,6,9
Chhattisgarh,Kondagaon,Intellectual Disability,60,80,4,1,5
Kerala,Kollam,Intellectual Disability,0,6,23,24,47
Kerala,Kollam,Intellectual Disability,6,15,338,223,561
Kerala,Kollam,Intellectual Disability,15,35,1350,722,2072
Kerala,Kollam,Intellectual Disability,35,60,570,438,1008
Kerala,Kollam,Intellectual Disability,60,80,84,59,143
Kerala,Kollam,Intellectual Disability,80,100,3,2,5
West Bengal,Kolkata,Intellectual Disability,6,15,3,0,3
West Bengal,Kolkata,Intellectual Disability,15,35,1,0,1
Maharashtra,Kolhapur,Intellectual Disability,0,6,22,14,36
Maharashtra,Kolhapur,Intellectual Disability,6,15,816,512,1328
Maharashtra,Kolhapur,Intellectual Disability,15,35,1751,968,2719
Maharashtra,Kolhapur,Intellectual Disability,35,60,395,280,675
Maharashtra,Kolhapur,Intellectual Disability,60,80,12,6,18
Mizoram,Kolasib,Intellectual Disability,0,6,3,1,4
Mizoram,Kolasib,Intellectual Disability,6,15,6,4,10
Mizoram,Kolasib,Intellectual Disability,15,35,13,9,22
Mizoram,Kolasib,Intellectual Disability,35,60,5,7,12
Mizoram,Kolasib,Intellectual Disability,60,80,1,2,3
Karnataka,Kolar,Intellectual Disability,0,6,43,35,78
Karnataka,Kolar,Intellectual Disability,6,15,311,255,566
Karnataka,Kolar,Intellectual Disability,15,35,672,567,1239
Karnataka,Kolar,Intellectual Disability,35,60,256,212,468
Karnataka,Kolar,Intellectual Disability,60,80,19,12,31
Assam,Kokrajhar,Intellectual Disability,0,6,17,7,24
Assam,Kokrajhar,Intellectual Disability,6,15,107,81,188
Assam,Kokrajhar,Intellectual Disability,15,35,142,133,275
Assam,Kokrajhar,Intellectual Disability,35,60,49,38,87
Assam,Kokrajhar,Intellectual Disability,60,80,3,2,5
Nagaland,Kohima,Intellectual Disability,0,6,1,0,1
Nagaland,Kohima,Intellectual Disability,6,15,14,11,25
Nagaland,Kohima,Intellectual Disability,15,35,34,28,62
Nagaland,Kohima,Intellectual Disability,35,60,2,7,9
Nagaland,Kohima,Intellectual Disability,60,80,1,0,1
Jharkhand,Koderma,Intellectual Disability,0,6,0,2,2
Jharkhand,Koderma,Intellectual Disability,6,15,23,11,34
Jharkhand,Koderma,Intellectual Disability,15,35,45,28,73
Jharkhand,Koderma,Intellectual Disability,35,60,29,10,39
Jharkhand,Koderma,Intellectual Disability,60,80,5,1,6
Karnataka,Kodagu,Intellectual Disability,0,6,16,14,30
Karnataka,Kodagu,Intellectual Disability,6,15,126,84,210
Karnataka,Kodagu,Intellectual Disability,15,35,349,229,578
Karnataka,Kodagu,Intellectual Disability,35,60,114,119,233
Karnataka,Kodagu,Intellectual Disability,60,80,8,14,22
Jammu And Kashmir,Kishtwar,Intellectual Disability,0,6,1,0,1
Jammu And Kashmir,Kishtwar,Intellectual Disability,6,15,1,2,3
Jammu And Kashmir,Kishtwar,Intellectual Disability,15,35,15,7,22
Jammu And Kashmir,Kishtwar,Intellectual Disability,35,60,6,14,20
Jammu And Kashmir,Kishtwar,Intellectual Disability,60,80,1,1,2
Bihar,Kishanganj,Intellectual Disability,6,15,12,7,19
Bihar,Kishanganj,Intellectual Disability,15,35,50,29,79
Bihar,Kishanganj,Intellectual Disability,35,60,5,4,9
Bihar,Kishanganj,Intellectual Disability,60,80,3,0,3
Nagaland,Kiphire,Intellectual Disability,6,15,1,0,1
Nagaland,Kiphire,Intellectual Disability,35,60,1,0,1
Himachal Pradesh,Kinnaur,Intellectual Disability,0,6,0,1,1
Himachal Pradesh,Kinnaur,Intellectual Disability,6,15,2,3,5
Himachal Pradesh,Kinnaur,Intellectual Disability,15,35,2,1,3
Himachal Pradesh,Kinnaur,Intellectual Disability,35,60,0,2,2
Jharkhand,Khunti,Intellectual Disability,0,6,0,1,1
Jharkhand,Khunti,Intellectual Disability,6,15,16,13,29
Jharkhand,Khunti,Intellectual Disability,15,35,18,15,33
Jharkhand,Khunti,Intellectual Disability,35,60,7,4,11
Jharkhand,Khunti,Intellectual Disability,60,80,1,0,1
Tripura,Khowai,Intellectual Disability,0,6,2,4,6
Tripura,Khowai,Intellectual Disability,6,15,69,53,122
Tripura,Khowai,Intellectual Disability,15,35,107,90,197
Tripura,Khowai,Intellectual Disability,35,60,30,25,55
Tripura,Khowai,Intellectual Disability,60,80,2,1,3
Odisha,Khordha,Intellectual Disability,0,6,59,35,94
Odisha,Khordha,Intellectual Disability,6,15,471,264,735
Odisha,Khordha,Intellectual Disability,15,35,941,602,1543
Odisha,Khordha,Intellectual Disability,35,60,466,289,755
Odisha,Khordha,Intellectual Disability,60,80,40,27,67
Odisha,Khordha,Intellectual Disability,80,100,2,0,2
Uttar Pradesh,Kheri,Intellectual Disability,0,6,13,13,26
Uttar Pradesh,Kheri,Intellectual Disability,6,15,319,256,575
Uttar Pradesh,Kheri,Intellectual Disability,15,35,79,35,114
Uttar Pradesh,Kheri,Intellectual Disability,35,60,36,18,54
Uttar Pradesh,Kheri,Intellectual Disability,60,80,7,3,10
Uttar Pradesh,Kheri,Intellectual Disability,80,100,1,0,1
Gujarat,Kheda,Intellectual Disability,0,6,61,27,88
Gujarat,Kheda,Intellectual Disability,6,15,898,603,1501
Gujarat,Kheda,Intellectual Disability,15,35,997,549,1546
Gujarat,Kheda,Intellectual Disability,35,60,146,89,235
Gujarat,Kheda,Intellectual Disability,60,80,12,6,18
Gujarat,Kheda,Intellectual Disability,80,100,1,0,1
Mizoram,Khawzawl,Intellectual Disability,0,6,1,1,2
Mizoram,Khawzawl,Intellectual Disability,6,15,2,1,3
Mizoram,Khawzawl,Intellectual Disability,15,35,2,2,4
Mizoram,Khawzawl,Intellectual Disability,35,60,2,5,7
Mizoram,Khawzawl,Intellectual Disability,60,80,2,0,2
Madhya Pradesh,Khargone,Intellectual Disability,0,6,8,7,15
Madhya Pradesh,Khargone,Intellectual Disability,6,15,87,62,149
Madhya Pradesh,Khargone,Intellectual Disability,15,35,427,269,696
Madhya Pradesh,Khargone,Intellectual Disability,35,60,247,165,412
Madhya Pradesh,Khargone,Intellectual Disability,60,80,40,21,61
Madhya Pradesh,Khargone,Intellectual Disability,80,100,0,2,2
Telangana,Khammam,Intellectual Disability,0,6,0,1,1
Telangana,Khammam,Intellectual Disability,6,15,251,190,441
Telangana,Khammam,Intellectual Disability,15,35,1170,899,2069
Telangana,Khammam,Intellectual Disability,35,60,643,499,1142
Telangana,Khammam,Intellectual Disability,60,80,148,88,236
Telangana,Khammam,Intellectual Disability,80,100,10,6,16
Bihar,Khagaria,Intellectual Disability,6,15,8,12,20
Bihar,Khagaria,Intellectual Disability,15,35,17,11,28
Bihar,Khagaria,Intellectual Disability,35,60,8,1,9
Bihar,Khagaria,Intellectual Disability,60,80,1,1,2
Odisha,Kendujhar,Intellectual Disability,0,6,20,10,30
Odisha,Kendujhar,Intellectual Disability,6,15,290,211,501
Odisha,Kendujhar,Intellectual Disability,15,35,331,253,584
Odisha,Kendujhar,Intellectual Disability,35,60,73,60,133
Odisha,Kendujhar,Intellectual Disability,60,80,3,3,6
Odisha,Kendujhar,Intellectual Disability,80,100,1,0,1
Odisha,Kendrapara,Intellectual Disability,0,6,40,23,63
Odisha,Kendrapara,Intellectual Disability,6,15,136,88,224
Odisha,Kendrapara,Intellectual Disability,15,35,200,132,332
Odisha,Kendrapara,Intellectual Disability,35,60,136,82,218
Odisha,Kendrapara,Intellectual Disability,60,80,11,5,16
Odisha,Kendrapara,Intellectual Disability,80,100,1,0,1
Uttar Pradesh,Kaushambi,Intellectual Disability,0,6,3,1,4
Uttar Pradesh,Kaushambi,Intellectual Disability,6,15,93,65,158
Uttar Pradesh,Kaushambi,Intellectual Disability,15,35,117,43,160
Uttar Pradesh,Kaushambi,Intellectual Disability,35,60,21,11,32
Uttar Pradesh,Kaushambi,Intellectual Disability,60,80,2,1,3
Madhya Pradesh,Katni,Intellectual Disability,0,6,6,4,10
Madhya Pradesh,Katni,Intellectual Disability,6,15,69,49,118
Madhya Pradesh,Katni,Intellectual Disability,15,35,429,276,705
Madhya Pradesh,Katni,Intellectual Disability,35,60,145,74,219
Madhya Pradesh,Katni,Intellectual Disability,60,80,19,16,35
Madhya Pradesh,Katni,Intellectual Disability,80,100,2,0,2
Bihar,Katihar,Intellectual Disability,0,6,37,27,64
Bihar,Katihar,Intellectual Disability,6,15,420,345,765
Bihar,Katihar,Intellectual Disability,15,35,376,244,620
Bihar,Katihar,Intellectual Disability,35,60,107,76,183
Bihar,Katihar,Intellectual Disability,60,80,13,10,23
Bihar,Katihar,Intellectual Disability,80,100,0,1,1
Jammu And Kashmir,Kathua,Intellectual Disability,0,6,2,0,2
Jammu And Kashmir,Kathua,Intellectual Disability,6,15,20,10,30
Jammu And Kashmir,Kathua,Intellectual Disability,15,35,52,19,71
Jammu And Kashmir,Kathua,Intellectual Disability,35,60,39,15,54
Jammu And Kashmir,Kathua,Intellectual Disability,60,80,8,0,8
Uttar Pradesh,Kasganj,Intellectual Disability,6,15,6,3,9
Uttar Pradesh,Kasganj,Intellectual Disability,15,35,23,5,28
Uttar Pradesh,Kasganj,Intellectual Disability,35,60,21,0,21
Uttar Pradesh,Kasganj,Intellectual Disability,60,80,3,1,4
Kerala,Kasaragod,Intellectual Disability,0,6,41,27,68
Kerala,Kasaragod,Intellectual Disability,6,15,377,236,613
Kerala,Kasaragod,Intellectual Disability,15,35,994,690,1684
Kerala,Kasaragod,Intellectual Disability,35,60,538,445,983
Kerala,Kasaragod,Intellectual Disability,60,80,58,27,85
Tamil Nadu,Karur,Intellectual Disability,0,6,34,23,57
Tamil Nadu,Karur,Intellectual Disability,6,15,503,312,815
Tamil Nadu,Karur,Intellectual Disability,15,35,985,674,1659
Tamil Nadu,Karur,Intellectual Disability,35,60,275,269,544
Tamil Nadu,Karur,Intellectual Disability,60,80,14,12,26
Haryana,Karnal,Intellectual Disability,0,6,16,10,26
Haryana,Karnal,Intellectual Disability,6,15,265,178,443
Haryana,Karnal,Intellectual Disability,15,35,318,141,459
Haryana,Karnal,Intellectual Disability,35,60,55,27,82
Haryana,Karnal,Intellectual Disability,60,80,7,3,10
Telangana,Karimnagar,Intellectual Disability,6,15,91,82,173
Telangana,Karimnagar,Intellectual Disability,15,35,598,448,1046
Telangana,Karimnagar,Intellectual Disability,35,60,305,240,545
Telangana,Karimnagar,Intellectual Disability,60,80,55,30,85
Telangana,Karimnagar,Intellectual Disability,80,100,4,1,5
Assam,Karimganj,Intellectual Disability,0,6,11,3,14
Assam,Karimganj,Intellectual Disability,6,15,153,117,270
Assam,Karimganj,Intellectual Disability,15,35,319,229,548
Assam,Karimganj,Intellectual Disability,35,60,67,49,116
Assam,Karimganj,Intellectual Disability,60,80,4,5,9
Ladakh,Kargil,Intellectual Disability,0,6,13,4,17
Ladakh,Kargil,Intellectual Disability,6,15,37,19,56
Ladakh,Kargil,Intellectual Disability,15,35,69,71,140
Ladakh,Kargil,Intellectual Disability,35,60,29,33,62
Ladakh,Kargil,Intellectual Disability,60,80,4,5,9
Ladakh,Kargil,Intellectual Disability,80,100,0,1,1
Assam,Karbi Anglong,Intellectual Disability,0,6,4,0,4
Assam,Karbi Anglong,Intellectual Disability,6,15,16,19,35
Assam,Karbi Anglong,Intellectual Disability,15,35,37,24,61
Assam,Karbi Anglong,Intellectual Disability,35,60,10,9,19
Assam,Karbi Anglong,Intellectual Disability,60,80,1,0,1
Rajasthan,Karauli,Intellectual Disability,0,6,1,1,2
Rajasthan,Karauli,Intellectual Disability,6,15,37,27,64
Rajasthan,Karauli,Intellectual Disability,15,35,63,29,92
Rajasthan,Karauli,Intellectual Disability,35,60,14,6,20
Rajasthan,Karauli,Intellectual Disability,60,80,0,1,1
Puducherry,Karaikal,Intellectual Disability,0,6,0,3,3
Puducherry,Karaikal,Intellectual Disability,6,15,14,12,26
Puducherry,Karaikal,Intellectual Disability,15,35,61,39,100
Puducherry,Karaikal,Intellectual Disability,35,60,35,23,58
Puducherry,Karaikal,Intellectual Disability,60,80,1,2,3
Punjab,Kapurthala,Intellectual Disability,0,6,26,12,38
Punjab,Kapurthala,Intellectual Disability,6,15,100,64,164
Punjab,Kapurthala,Intellectual Disability,15,35,147,71,218
Punjab,Kapurthala,Intellectual Disability,35,60,45,44,89
Punjab,Kapurthala,Intellectual Disability,60,80,8,0,8
Uttar Pradesh,Kanpur Nagar,Intellectual Disability,0,6,16,11,27
Uttar Pradesh,Kanpur Nagar,Intellectual Disability,6,15,184,125,309
Uttar Pradesh,Kanpur Nagar,Intellectual Disability,15,35,213,106,319
Uttar Pradesh,Kanpur Nagar,Intellectual Disability,35,60,61,37,98
Uttar Pradesh,Kanpur Nagar,Intellectual Disability,60,80,9,4,13
Uttar Pradesh,Kanpur Dehat,Intellectual Disability,0,6,2,2,4
Uttar Pradesh,Kanpur Dehat,Intellectual Disability,6,15,18,7,25
Uttar Pradesh,Kanpur Dehat,Intellectual Disability,15,35,47,27,74
Uttar Pradesh,Kanpur Dehat,Intellectual Disability,35,60,26,13,39
Uttar Pradesh,Kanpur Dehat,Intellectual Disability,60,80,5,1,6
Uttar Pradesh,Kanpur Dehat,Intellectual Disability,80,100,0,1,1
Kerala,Kannur,Intellectual Disability,0,6,58,34,92
Kerala,Kannur,Intellectual Disability,6,15,402,245,647
Kerala,Kannur,Intellectual Disability,15,35,1430,873,2303
Kerala,Kannur,Intellectual Disability,35,60,695,593,1288
Kerala,Kannur,Intellectual Disability,60,80,63,68,131
Kerala,Kannur,Intellectual Disability,80,100,1,5,6
Tamil Nadu,Kanniyakumari,Intellectual Disability,0,6,50,33,83
Tamil Nadu,Kanniyakumari,Intellectual Disability,6,15,888,479,1367
Tamil Nadu,Kanniyakumari,Intellectual Disability,15,35,1790,1227,3017
Tamil Nadu,Kanniyakumari,Intellectual Disability,35,60,716,595,1311
Tamil Nadu,Kanniyakumari,Intellectual Disability,60,80,47,33,80
Tamil Nadu,Kanniyakumari,Intellectual Disability,80,100,3,2,5
Uttar Pradesh,Kannauj,Intellectual Disability,6,15,27,13,40
Uttar Pradesh,Kannauj,Intellectual Disability,15,35,81,27,108
Uttar Pradesh,Kannauj,Intellectual Disability,35,60,21,10,31
Uttar Pradesh,Kannauj,Intellectual Disability,60,80,4,0,4
Chhattisgarh,Kanker,Intellectual Disability,0,6,8,6,14
Chhattisgarh,Kanker,Intellectual Disability,6,15,117,71,188
Chhattisgarh,Kanker,Intellectual Disability,15,35,87,87,174
Chhattisgarh,Kanker,Intellectual Disability,35,60,21,35,56
Chhattisgarh,Kanker,Intellectual Disability,60,80,3,1,4
Chhattisgarh,Kanker,Intellectual Disability,80,100,0,1,1
Himachal Pradesh,Kangra,Intellectual Disability,0,6,55,40,95
Himachal Pradesh,Kangra,Intellectual Disability,6,15,259,152,411
Himachal Pradesh,Kangra,Intellectual Disability,15,35,484,286,770
Himachal Pradesh,Kangra,Intellectual Disability,35,60,299,145,444
Himachal Pradesh,Kangra,Intellectual Disability,60,80,27,15,42
Manipur,Kangpokpi,Intellectual Disability,0,6,1,0,1
Manipur,Kangpokpi,Intellectual Disability,6,15,3,6,9
Manipur,Kangpokpi,Intellectual Disability,15,35,6,10,16
Manipur,Kangpokpi,Intellectual Disability,35,60,2,3,5
Manipur,Kangpokpi,Intellectual Disability,60,80,1,1,2
Odisha,Kandhamal,Intellectual Disability,0,6,29,34,63
Odisha,Kandhamal,Intellectual Disability,6,15,191,135,326
Odisha,Kandhamal,Intellectual Disability,15,35,192,146,338
Odisha,Kandhamal,Intellectual Disability,35,60,59,38,97
Odisha,Kandhamal,Intellectual Disability,60,80,10,9,19
Tamil Nadu,Kanchipuram,Intellectual Disability,0,6,35,13,48
Tamil Nadu,Kanchipuram,Intellectual Disability,6,15,515,298,813
Tamil Nadu,Kanchipuram,Intellectual Disability,15,35,1051,707,1758
Tamil Nadu,Kanchipuram,Intellectual Disability,35,60,286,208,494
Tamil Nadu,Kanchipuram,Intellectual Disability,60,80,16,13,29
Assam,Kamrup Metro,Intellectual Disability,0,6,27,10,37
Assam,Kamrup Metro,Intellectual Disability,6,15,188,120,308
Assam,Kamrup Metro,Intellectual Disability,15,35,269,168,437
Assam,Kamrup Metro,Intellectual Disability,35,60,37,31,68
Assam,Kamrup Metro,Intellectual Disability,60,80,2,1,3
Assam,Kamrup,Intellectual Disability,0,6,29,23,52
Assam,Kamrup,Intellectual Disability,6,15,291,205,496
Assam,Kamrup,Intellectual Disability,15,35,458,336,794
Assam,Kamrup,Intellectual Disability,35,60,132,95,227
Assam,Kamrup,Intellectual Disability,60,80,8,3,11
Manipur,Kamjong,Intellectual Disability,6,15,1,2,3
Manipur,Kamjong,Intellectual Disability,15,35,2,1,3
Telangana,Kamareddy,Intellectual Disability,6,15,98,47,145
Telangana,Kamareddy,Intellectual Disability,15,35,451,358,809
Telangana,Kamareddy,Intellectual Disability,35,60,109,117,226
Telangana,Kamareddy,Intellectual Disability,60,80,11,8,19
Telangana,Kamareddy,Intellectual Disability,80,100,0,1,1
Tamil Nadu,Kallakurichi,Intellectual Disability,0,6,22,14,36
Tamil Nadu,Kallakurichi,Intellectual Disability,6,15,226,145,371
Tamil Nadu,Kallakurichi,Intellectual Disability,15,35,184,136,320
Tamil Nadu,Kallakurichi,Intellectual Disability,35,60,60,50,110
Tamil Nadu,Kallakurichi,Intellectual Disability,60,80,20,9,29
Tamil Nadu,Kallakurichi,Intellectual Disability,80,100,1,0,1
Odisha,Kalahandi,Intellectual Disability,0,6,18,19,37
Odisha,Kalahandi,Intellectual Disability,6,15,250,179,429
Odisha,Kalahandi,Intellectual Disability,15,35,403,274,677
Odisha,Kalahandi,Intellectual Disability,35,60,97,75,172
Odisha,Kalahandi,Intellectual Disability,60,80,4,3,7
Karnataka,Kalaburagi,Intellectual Disability,0,6,64,41,105
Karnataka,Kalaburagi,Intellectual Disability,6,15,533,390,923
Karnataka,Kalaburagi,Intellectual Disability,15,35,678,495,1173
Karnataka,Kalaburagi,Intellectual Disability,35,60,122,93,215
Karnataka,Kalaburagi,Intellectual Disability,60,80,3,0,3
Manipur,Kakching,Intellectual Disability,0,6,1,2,3
Manipur,Kakching,Intellectual Disability,6,15,15,20,35
Manipur,Kakching,Intellectual Disability,15,35,28,24,52
Manipur,Kakching,Intellectual Disability,35,60,10,11,21
Haryana,Kaithal,Intellectual Disability,0,6,17,10,27
Haryana,Kaithal,Intellectual Disability,6,15,104,77,181
Haryana,Kaithal,Intellectual Disability,15,35,127,62,189
Haryana,Kaithal,Intellectual Disability,35,60,35,12,47
Haryana,Kaithal,Intellectual Disability,60,80,5,0,5
Bihar,Kaimur (Bhabua),Intellectual Disability,0,6,10,2,12
Bihar,Kaimur (Bhabua),Intellectual Disability,6,15,83,40,123
Bihar,Kaimur (Bhabua),Intellectual Disability,15,35,99,45,144
Bihar,Kaimur (Bhabua),Intellectual Disability,35,60,26,10,36
Bihar,Kaimur (Bhabua),Intellectual Disability,60,80,5,2,7
Gujarat,Kachchh,Intellectual Disability,0,6,51,31,82
Gujarat,Kachchh,Intellectual Disability,6,15,725,491,1216
Gujarat,Kachchh,Intellectual Disability,15,35,949,498,1447
Gujarat,Kachchh,Intellectual Disability,35,60,159,106,265
Gujarat,Kachchh,Intellectual Disability,60,80,10,9,19
Gujarat,Kachchh,Intellectual Disability,80,100,0,1,1
Chhattisgarh,Kabirdham,Intellectual Disability,0,6,4,4,8
Chhattisgarh,Kabirdham,Intellectual Disability,6,15,49,34,83
Chhattisgarh,Kabirdham,Intellectual Disability,15,35,68,50,118
Chhattisgarh,Kabirdham,Intellectual Disability,35,60,7,7,14
Chhattisgarh,Kabirdham,Intellectual Disability,60,80,6,2,8
Gujarat,Junagadh,Intellectual Disability,0,6,19,15,34
Gujarat,Junagadh,Intellectual Disability,6,15,450,279,729
Gujarat,Junagadh,Intellectual Disability,15,35,787,400,1187
Gujarat,Junagadh,Intellectual Disability,35,60,170,97,267
Gujarat,Junagadh,Intellectual Disability,60,80,8,7,15
Assam,Jorhat,Intellectual Disability,0,6,12,7,19
Assam,Jorhat,Intellectual Disability,6,15,143,72,215
Assam,Jorhat,Intellectual Disability,15,35,221,177,398
Assam,Jorhat,Intellectual Disability,35,60,76,64,140
Assam,Jorhat,Intellectual Disability,60,80,1,6,7
Telangana,Jogulamba Gadwal,Intellectual Disability,6,15,110,109,219
Telangana,Jogulamba Gadwal,Intellectual Disability,15,35,278,192,470
Telangana,Jogulamba Gadwal,Intellectual Disability,35,60,13,15,28
Rajasthan,Jodhpur,Intellectual Disability,0,6,7,12,19
Rajasthan,Jodhpur,Intellectual Disability,6,15,160,112,272
Rajasthan,Jodhpur,Intellectual Disability,15,35,383,183,566
Rajasthan,Jodhpur,Intellectual Disability,35,60,130,63,193
Rajasthan,Jodhpur,Intellectual Disability,60,80,7,3,10
Manipur,Jiribam,Intellectual Disability,0,6,3,2,5
Manipur,Jiribam,Intellectual Disability,6,15,12,12,24
Manipur,Jiribam,Intellectual Disability,15,35,12,15,27
Manipur,Jiribam,Intellectual Disability,35,60,4,1,5
Haryana,Jind,Intellectual Disability,0,6,8,7,15
Haryana,Jind,Intellectual Disability,6,15,206,143,349
Haryana,Jind,Intellectual Disability,15,35,273,141,414
Haryana,Jind,Intellectual Disability,35,60,55,18,73
Haryana,Jind,Intellectual Disability,60,80,3,0,3
Rajasthan,Jhunjhunu,Intellectual Disability,0,6,1,0,1
Rajasthan,Jhunjhunu,Intellectual Disability,6,15,27,12,39
Rajasthan,Jhunjhunu,Intellectual Disability,15,35,77,29,106
Rajasthan,Jhunjhunu,Intellectual Disability,35,60,16,9,25
Rajasthan,Jhunjhunu,Intellectual Disability,60,80,1,0,1
Uttar Pradesh,Jhunjhunu,Intellectual Disability,0,6,1,0,1
Odisha,Jharsuguda,Intellectual Disability,0,6,9,9,18
Odisha,Jharsuguda,Intellectual Disability,6,15,77,49,126
Odisha,Jharsuguda,Intellectual Disability,15,35,114,88,202
Odisha,Jharsuguda,Intellectual Disability,35,60,18,29,47
Odisha,Jharsuguda,Intellectual Disability,60,80,2,2,4
Uttar Pradesh,Jhansi,Intellectual Disability,0,6,6,7,13
Uttar Pradesh,Jhansi,Intellectual Disability,6,15,59,60,119
Uttar Pradesh,Jhansi,Intellectual Disability,15,35,100,48,148
Uttar Pradesh,Jhansi,Intellectual Disability,35,60,38,14,52
Uttar Pradesh,Jhansi,Intellectual Disability,60,80,5,1,6
Rajasthan,Jhalawar,Intellectual Disability,0,6,2,1,3
Rajasthan,Jhalawar,Intellectual Disability,6,15,21,11,32
Rajasthan,Jhalawar,Intellectual Disability,15,35,25,10,35
Rajasthan,Jhalawar,Intellectual Disability,35,60,7,3,10
Rajasthan,Jhalawar,Intellectual Disability,60,80,0,1,1
Haryana,Jhajjar,Intellectual Disability,0,6,25,9,34
Haryana,Jhajjar,Intellectual Disability,6,15,138,65,203
Haryana,Jhajjar,Intellectual Disability,15,35,217,107,324
Haryana,Jhajjar,Intellectual Disability,35,60,54,18,72
Haryana,Jhajjar,Intellectual Disability,60,80,3,1,4
Madhya Pradesh,Jhabua,Intellectual Disability,0,6,0,1,1
Madhya Pradesh,Jhabua,Intellectual Disability,6,15,11,13,24
Madhya Pradesh,Jhabua,Intellectual Disability,15,35,62,38,100
Madhya Pradesh,Jhabua,Intellectual Disability,35,60,37,26,63
Madhya Pradesh,Jhabua,Intellectual Disability,60,80,7,6,13
Bihar,Jehanabad,Intellectual Disability,0,6,1,0,1
Bihar,Jehanabad,Intellectual Disability,6,15,39,13,52
Bihar,Jehanabad,Intellectual Disability,15,35,80,41,121
Bihar,Jehanabad,Intellectual Disability,35,60,36,13,49
Bihar,Jehanabad,Intellectual Disability,60,80,8,2,10
Telangana,Jayashankar Bhupalapally,Intellectual Disability,6,15,40,28,68
Telangana,Jayashankar Bhupalapally,Intellectual Disability,15,35,483,410,893
Telangana,Jayashankar Bhupalapally,Intellectual Disability,35,60,204,198,402
Telangana,Jayashankar Bhupalapally,Intellectual Disability,60,80,12,14,26
Telangana,Jayashankar Bhupalapally,Intellectual Disability,80,100,1,0,1
Uttar Pradesh,Jaunpur,Intellectual Disability,0,6,7,3,10
Uttar Pradesh,Jaunpur,Intellectual Disability,6,15,226,115,341
Uttar Pradesh,Jaunpur,Intellectual Disability,15,35,156,81,237
Uttar Pradesh,Jaunpur,Intellectual Disability,35,60,56,17,73
Uttar Pradesh,Jaunpur,Intellectual Disability,60,80,6,2,8
Chhattisgarh,Jashpur,Intellectual Disability,0,6,0,3,3
Chhattisgarh,Jashpur,Intellectual Disability,6,15,43,36,79
Chhattisgarh,Jashpur,Intellectual Disability,15,35,82,79,161
Chhattisgarh,Jashpur,Intellectual Disability,35,60,16,23,39
Chhattisgarh,Jashpur,Intellectual Disability,60,80,1,0,1
Chhattisgarh,Janjgir-Champa,Intellectual Disability,0,6,2,2,4
Chhattisgarh,Janjgir-Champa,Intellectual Disability,6,15,41,18,59
Chhattisgarh,Janjgir-Champa,Intellectual Disability,15,35,25,16,41
Chhattisgarh,Janjgir-Champa,Intellectual Disability,35,60,5,2,7
Chhattisgarh,Janjgir-Champa,Intellectual Disability,60,80,0,1,1
Telangana,Jangoan,Intellectual Disability,6,15,34,30,64
Telangana,Jangoan,Intellectual Disability,15,35,440,334,774
Telangana,Jangoan,Intellectual Disability,35,60,188,150,338
Telangana,Jangoan,Intellectual Disability,60,80,14,9,23
Bihar,Jamui,Intellectual Disability,0,6,2,0,2
Bihar,Jamui,Intellectual Disability,6,15,11,12,23
Bihar,Jamui,Intellectual Disability,15,35,68,22,90
Bihar,Jamui,Intellectual Disability,35,60,29,14,43
Bihar,Jamui,Intellectual Disability,60,80,5,1,6
Jharkhand,Jamtara,Intellectual Disability,0,6,4,0,4
Jharkhand,Jamtara,Intellectual Disability,6,15,30,31,61
Jharkhand,Jamtara,Intellectual Disability,15,35,63,37,100
Jharkhand,Jamtara,Intellectual Disability,35,60,30,14,44
Jharkhand,Jamtara,Intellectual Disability,60,80,1,0,1
Gujarat,Jamnagar,Intellectual Disability,0,6,29,17,46
Gujarat,Jamnagar,Intellectual Disability,6,15,305,175,480
Gujarat,Jamnagar,Intellectual Disability,15,35,532,287,819
Gujarat,Jamnagar,Intellectual Disability,35,60,150,115,265
Gujarat,Jamnagar,Intellectual Disability,60,80,9,8,17
Jammu And Kashmir,Jammu,Intellectual Disability,0,6,9,5,14
Jammu And Kashmir,Jammu,Intellectual Disability,6,15,48,29,77
Jammu And Kashmir,Jammu,Intellectual Disability,15,35,93,51,144
Jammu And Kashmir,Jammu,Intellectual Disability,35,60,50,25,75
Jammu And Kashmir,Jammu,Intellectual Disability,60,80,7,2,9
Rajasthan,Jalore,Intellectual Disability,0,6,0,2,2
Rajasthan,Jalore,Intellectual Disability,6,15,37,18,55
Rajasthan,Jalore,Intellectual Disability,15,35,165,67,232
Rajasthan,Jalore,Intellectual Disability,35,60,75,28,103
Rajasthan,Jalore,Intellectual Disability,60,80,5,2,7
Maharashtra,Jalna,Intellectual Disability,0,6,80,56,136
Maharashtra,Jalna,Intellectual Disability,6,15,550,376,926
Maharashtra,Jalna,Intellectual Disability,15,35,748,462,1210
Maharashtra,Jalna,Intellectual Disability,35,60,148,115,263
Maharashtra,Jalna,Intellectual Disability,60,80,8,2,10
Maharashtra,Jalna,Intellectual Disability,80,100,1,0,1
Maharashtra,Jalgaon,Intellectual Disability,0,6,53,39,92
Maharashtra,Jalgaon,Intellectual Disability,6,15,585,299,884
Maharashtra,Jalgaon,Intellectual Disability,15,35,1085,525,1610
Maharashtra,Jalgaon,Intellectual Disability,35,60,340,244,584
Maharashtra,Jalgaon,Intellectual Disability,60,80,15,7,22
Maharashtra,Jalgaon,Intellectual Disability,80,100,1,1,2
Uttar Pradesh,Jalaun,Intellectual Disability,0,6,4,0,4
Uttar Pradesh,Jalaun,Intellectual Disability,6,15,19,12,31
Uttar Pradesh,Jalaun,Intellectual Disability,15,35,24,7,31
Uttar Pradesh,Jalaun,Intellectual Disability,35,60,24,12,36
Uttar Pradesh,Jalaun,Intellectual Disability,60,80,9,0,9
Uttar Pradesh,Jalaun,Intellectual Disability,80,100,1,0,1
Punjab,Jalandhar,Intellectual Disability,0,6,111,60,171
Punjab,Jalandhar,Intellectual Disability,6,15,613,352,965
Punjab,Jalandhar,Intellectual Disability,15,35,649,367,1016
Punjab,Jalandhar,Intellectual Disability,35,60,320,147,467
Punjab,Jalandhar,Intellectual Disability,60,80,13,3,16
Odisha,Jajapur,Intellectual Disability,0,6,14,13,27
Odisha,Jajapur,Intellectual Disability,6,15,95,85,180
Odisha,Jajapur,Intellectual Disability,15,35,192,137,329
Odisha,Jajapur,Intellectual Disability,35,60,105,74,179
Odisha,Jajapur,Intellectual Disability,60,80,12,4,16
Rajasthan,Jaisalmer,Intellectual Disability,6,15,2,2,4
Rajasthan,Jaisalmer,Intellectual Disability,15,35,6,2,8
Rajasthan,Jaisalmer,Intellectual Disability,35,60,2,1,3
Rajasthan,Jaipur,Intellectual Disability,0,6,14,10,24
Rajasthan,Jaipur,Intellectual Disability,6,15,236,114,350
Rajasthan,Jaipur,Intellectual Disability,15,35,599,256,855
Rajasthan,Jaipur,Intellectual Disability,35,60,134,53,187
Rajasthan,Jaipur,Intellectual Disability,60,80,10,4,14
Rajasthan,Jaipur,Intellectual Disability,80,100,0,1,1
Telangana,Jagitial,Intellectual Disability,6,15,96,81,177
Telangana,Jagitial,Intellectual Disability,15,35,337,258,595
Telangana,Jagitial,Intellectual Disability,35,60,111,140,251
Telangana,Jagitial,Intellectual Disability,60,80,15,11,26
Telangana,Jagitial,Intellectual Disability,80,100,0,1,1
Odisha,Jagatsinghapur,Intellectual Disability,0,6,39,27,66
Odisha,Jagatsinghapur,Intellectual Disability,6,15,266,177,443
Odisha,Jagatsinghapur,Intellectual Disability,15,35,288,208,496
Odisha,Jagatsinghapur,Intellectual Disability,35,60,158,106,264
Odisha,Jagatsinghapur,Intellectual Disability,60,80,10,9,19
Madhya Pradesh,Jabalpur,Intellectual Disability,0,6,38,24,62
Madhya Pradesh,Jabalpur,Intellectual Disability,6,15,478,291,769
Madhya Pradesh,Jabalpur,Intellectual Disability,15,35,1532,1077,2609
Madhya Pradesh,Jabalpur,Intellectual Disability,35,60,800,432,1232
Madhya Pradesh,Jabalpur,Intellectual Disability,60,80,97,26,123
Madhya Pradesh,Jabalpur,Intellectual Disability,80,100,0,1,1
Madhya Pradesh,Indore,Intellectual Disability,0,6,19,13,32
Madhya Pradesh,Indore,Intellectual Disability,6,15,485,285,770
Madhya Pradesh,Indore,Intellectual Disability,15,35,1055,718,1773
Madhya Pradesh,Indore,Intellectual Disability,35,60,311,246,557
Madhya Pradesh,Indore,Intellectual Disability,60,80,28,19,47
Manipur,Imphal West,Intellectual Disability,0,6,9,4,13
Manipur,Imphal West,Intellectual Disability,6,15,53,32,85
Manipur,Imphal West,Intellectual Disability,15,35,96,77,173
Manipur,Imphal West,Intellectual Disability,35,60,70,82,152
Manipur,Imphal West,Intellectual Disability,60,80,6,8,14
Manipur,Imphal West,Intellectual Disability,80,100,0,2,2
Manipur,Imphal East,Intellectual Disability,0,6,8,4,12
Manipur,Imphal East,Intellectual Disability,6,15,61,53,114
Manipur,Imphal East,Intellectual Disability,15,35,85,90,175
Manipur,Imphal East,Intellectual Disability,35,60,44,51,95
Manipur,Imphal East,Intellectual Disability,60,80,6,3,9
Manipur,Imphal East,Intellectual Disability,80,100,1,0,1
Kerala,Idukki,Intellectual Disability,0,6,8,6,14
Kerala,Idukki,Intellectual Disability,6,15,134,84,218
Kerala,Idukki,Intellectual Disability,15,35,635,430,1065
Kerala,Idukki,Intellectual Disability,35,60,260,230,490
Kerala,Idukki,Intellectual Disability,60,80,37,26,63
Telangana,Hyderabad,Intellectual Disability,6,15,456,318,774
Telangana,Hyderabad,Intellectual Disability,15,35,2020,1288,3308
Telangana,Hyderabad,Intellectual Disability,35,60,847,569,1416
Telangana,Hyderabad,Intellectual Disability,60,80,44,32,76
West Bengal,Howrah,Intellectual Disability,0,6,1,1,2
West Bengal,Howrah,Intellectual Disability,6,15,4,1,5
West Bengal,Howrah,Intellectual Disability,15,35,1,1,2
West Bengal,Howrah,Intellectual Disability,35,60,2,1,3
Punjab,Hoshiarpur,Intellectual Disability,0,6,20,25,45
Punjab,Hoshiarpur,Intellectual Disability,6,15,321,239,560
Punjab,Hoshiarpur,Intellectual Disability,15,35,722,366,1088
Punjab,Hoshiarpur,Intellectual Disability,35,60,376,177,553
Punjab,Hoshiarpur,Intellectual Disability,60,80,52,11,63
Punjab,Hoshiarpur,Intellectual Disability,80,100,0,1,1
West Bengal,Hooghly,Intellectual Disability,35,60,1,0,1
Assam,Hojai,Intellectual Disability,0,6,4,1,5
Assam,Hojai,Intellectual Disability,6,15,36,36,72
Assam,Hojai,Intellectual Disability,15,35,59,45,104
Assam,Hojai,Intellectual Disability,35,60,31,13,44
Assam,Hojai,Intellectual Disability,60,80,2,1,3
Mizoram,Hnahthial,Intellectual Disability,15,35,5,1,6
Mizoram,Hnahthial,Intellectual Disability,35,60,2,1,3
Mizoram,Hnahthial,Intellectual Disability,60,80,1,0,1
Haryana,Hisar,Intellectual Disability,0,6,78,47,125
Haryana,Hisar,Intellectual Disability,6,15,505,320,825
Haryana,Hisar,Intellectual Disability,15,35,714,371,1085
Haryana,Hisar,Intellectual Disability,35,60,227,74,301
Haryana,Hisar,Intellectual Disability,60,80,10,4,14
Maharashtra,Hingoli,Intellectual Disability,0,6,22,20,42
Maharashtra,Hingoli,Intellectual Disability,6,15,372,203,575
Maharashtra,Hingoli,Intellectual Disability,15,35,418,261,679
Maharashtra,Hingoli,Intellectual Disability,35,60,74,58,132
Maharashtra,Hingoli,Intellectual Disability,60,80,3,6,9
Jharkhand,Hazaribagh,Intellectual Disability,0,6,7,1,8
Jharkhand,Hazaribagh,Intellectual Disability,6,15,166,111,277
Jharkhand,Hazaribagh,Intellectual Disability,15,35,135,95,230
Jharkhand,Hazaribagh,Intellectual Disability,35,60,92,33,125
Jharkhand,Hazaribagh,Intellectual Disability,60,80,12,5,17
Jharkhand,Hazaribagh,Intellectual Disability,80,100,1,0,1
Karnataka,Haveri,Intellectual Disability,0,6,116,87,203
Karnataka,Haveri,Intellectual Disability,6,15,624,376,1000
Karnataka,Haveri,Intellectual Disability,15,35,812,531,1343
Karnataka,Haveri,Intellectual Disability,35,60,196,161,357
Karnataka,Haveri,Intellectual Disability,60,80,15,14,29
Karnataka,Haveri,Intellectual Disability,80,100,2,0,2
Uttar Pradesh,Hathras,Intellectual Disability,0,6,2,0,2
Uttar Pradesh,Hathras,Intellectual Disability,6,15,27,12,39
Uttar Pradesh,Hathras,Intellectual Disability,15,35,12,6,18
Uttar Pradesh,Hathras,Intellectual Disability,35,60,7,3,10
Uttar Pradesh,Hathras,Intellectual Disability,60,80,2,0,2
Uttar Pradesh,Hathras,Intellectual Disability,80,100,1,0,1
Karnataka,Hassan,Intellectual Disability,0,6,39,27,66
Karnataka,Hassan,Intellectual Disability,6,15,248,183,431
Karnataka,Hassan,Intellectual Disability,15,35,645,453,1098
Karnataka,Hassan,Intellectual Disability,35,60,295,231,526
Karnataka,Hassan,Intellectual Disability,60,80,16,13,29
Uttarakhand,Haridwar,Intellectual Disability,0,6,37,16,53
Uttarakhand,Haridwar,Intellectual Disability,6,15,191,92,283
Uttarakhand,Haridwar,Intellectual Disability,15,35,396,191,587
Uttarakhand,Haridwar,Intellectual Disability,35,60,144,55,199
Uttarakhand,Haridwar,Intellectual Disability,60,80,10,2,12
Uttar Pradesh,Hardoi,Intellectual Disability,0,6,0,2,2
Uttar Pradesh,Hardoi,Intellectual Disability,6,15,22,14,36
Uttar Pradesh,Hardoi,Intellectual Disability,15,35,74,38,112
Uttar Pradesh,Hardoi,Intellectual Disability,35,60,34,19,53
Uttar Pradesh,Hardoi,Intellectual Disability,60,80,4,2,6
Madhya Pradesh,Harda,Intellectual Disability,0,6,2,1,3
Madhya Pradesh,Harda,Intellectual Disability,6,15,94,52,146
Madhya Pradesh,Harda,Intellectual Disability,15,35,350,210,560
Madhya Pradesh,Harda,Intellectual Disability,35,60,100,64,164
Madhya Pradesh,Harda,Intellectual Disability,60,80,16,5,21
Madhya Pradesh,Harda,Intellectual Disability,80,100,1,3,4
Uttar Pradesh,Hapur,Intellectual Disability,0,6,2,2,4
Uttar Pradesh,Hapur,Intellectual Disability,6,15,30,17,47
Uttar Pradesh,Hapur,Intellectual Disability,15,35,35,7,42
Uttar Pradesh,Hapur,Intellectual Disability,35,60,23,4,27
Uttar Pradesh,Hapur,Intellectual Disability,60,80,1,0,1
Rajasthan,Hanumangarh,Intellectual Disability,0,6,9,3,12
Rajasthan,Hanumangarh,Intellectual Disability,6,15,100,65,165
Rajasthan,Hanumangarh,Intellectual Disability,15,35,97,57,154
Rajasthan,Hanumangarh,Intellectual Disability,35,60,19,9,28
Rajasthan,Hanumangarh,Intellectual Disability,60,80,1,0,1
Telangana,Hanumakonda,Intellectual Disability,6,15,53,34,87
Telangana,Hanumakonda,Intellectual Disability,15,35,663,512,1175
Telangana,Hanumakonda,Intellectual Disability,35,60,361,287,648
Telangana,Hanumakonda,Intellectual Disability,60,80,39,20,59
Telangana,Hanumakonda,Intellectual Disability,80,100,4,1,5
Himachal Pradesh,Hamirpur,Intellectual Disability,0,6,18,12,30
Himachal Pradesh,Hamirpur,Intellectual Disability,6,15,104,59,163
Himachal Pradesh,Hamirpur,Intellectual Disability,15,35,194,107,301
Himachal Pradesh,Hamirpur,Intellectual Disability,35,60,114,54,168
Himachal Pradesh,Hamirpur,Intellectual Disability,60,80,16,5,21
Uttar Pradesh,Hamirpur,Intellectual Disability,0,6,1,0,1
Uttar Pradesh,Hamirpur,Intellectual Disability,6,15,6,7,13
Uttar Pradesh,Hamirpur,Intellectual Disability,15,35,21,3,24
Uttar Pradesh,Hamirpur,Intellectual Disability,35,60,27,10,37
Uttar Pradesh,Hamirpur,Intellectual Disability,60,80,10,2,12
Uttar Pradesh,Hamirpur,Intellectual Disability,80,100,1,0,1
Assam,Hailakandi,Intellectual Disability,0,6,8,1,9
Assam,Hailakandi,Intellectual Disability,6,15,64,67,131
Assam,Hailakandi,Intellectual Disability,15,35,134,110,244
Assam,Hailakandi,Intellectual Disability,35,60,32,26,58
Assam,Hailakandi,Intellectual Disability,60,80,1,2,3
Sikkim,Gyalshing,Intellectual Disability,0,6,2,2,4
Sikkim,Gyalshing,Intellectual Disability,6,15,22,12,34
Sikkim,Gyalshing,Intellectual Disability,15,35,45,39,84
Sikkim,Gyalshing,Intellectual Disability,35,60,46,41,87
Sikkim,Gyalshing,Intellectual Disability,60,80,12,8,20
Madhya Pradesh,Gwalior,Intellectual Disability,0,6,31,13,44
Madhya Pradesh,Gwalior,Intellectual Disability,6,15,356,196,552
Madhya Pradesh,Gwalior,Intellectual Disability,15,35,1405,681,2086
Madhya Pradesh,Gwalior,Intellectual Disability,35,60,325,132,457
Madhya Pradesh,Gwalior,Intellectual Disability,60,80,19,10,29
Madhya Pradesh,Gwalior,Intellectual Disability,80,100,1,2,3
Haryana,Gurugram,Intellectual Disability,0,6,19,7,26
Haryana,Gurugram,Intellectual Disability,6,15,256,145,401
Haryana,Gurugram,Intellectual Disability,15,35,398,195,593
Haryana,Gurugram,Intellectual Disability,35,60,76,29,105
Haryana,Gurugram,Intellectual Disability,60,80,1,2,3
Haryana,Gurugram,Intellectual Disability,80,100,0,1,1
Punjab,Gurdaspur,Intellectual Disability,0,6,59,38,97
Punjab,Gurdaspur,Intellectual Disability,6,15,274,170,444
Punjab,Gurdaspur,Intellectual Disability,15,35,305,153,458
Punjab,Gurdaspur,Intellectual Disability,35,60,139,63,202
Punjab,Gurdaspur,Intellectual Disability,60,80,16,3,19
Punjab,Gurdaspur,Intellectual Disability,80,100,1,0,1
Andhra Pradesh,Guntur,Intellectual Disability,0,6,49,41,90
Andhra Pradesh,Guntur,Intellectual Disability,6,15,799,531,1330
Andhra Pradesh,Guntur,Intellectual Disability,15,35,1505,1142,2647
Andhra Pradesh,Guntur,Intellectual Disability,35,60,586,432,1018
Andhra Pradesh,Guntur,Intellectual Disability,60,80,32,15,47
Andhra Pradesh,Guntur,Intellectual Disability,80,100,1,1,2
Madhya Pradesh,Guna,Intellectual Disability,0,6,23,15,38
Madhya Pradesh,Guna,Intellectual Disability,6,15,265,170,435
Madhya Pradesh,Guna,Intellectual Disability,15,35,499,254,753
Madhya Pradesh,Guna,Intellectual Disability,35,60,125,38,163
Madhya Pradesh,Guna,Intellectual Disability,60,80,8,5,13
Jharkhand,Gumla,Intellectual Disability,0,6,7,6,13
Jharkhand,Gumla,Intellectual Disability,6,15,142,118,260
Jharkhand,Gumla,Intellectual Disability,15,35,170,168,338
Jharkhand,Gumla,Intellectual Disability,35,60,68,68,136
Jharkhand,Gumla,Intellectual Disability,60,80,20,10,30
Jharkhand,Gumla,Intellectual Disability,80,100,1,0,1
Uttar Pradesh,Gorakhpur,Intellectual Disability,0,6,34,13,47
Uttar Pradesh,Gorakhpur,Intellectual Disability,6,15,362,253,615
Uttar Pradesh,Gorakhpur,Intellectual Disability,15,35,322,167,489
Uttar Pradesh,Gorakhpur,Intellectual Disability,35,60,156,40,196
Uttar Pradesh,Gorakhpur,Intellectual Disability,60,80,20,5,25
Uttar Pradesh,Gorakhpur,Intellectual Disability,80,100,1,1,2
Bihar,Gopalganj,Intellectual Disability,0,6,6,4,10
Bihar,Gopalganj,Intellectual Disability,6,15,136,70,206
Bihar,Gopalganj,Intellectual Disability,15,35,157,78,235
Bihar,Gopalganj,Intellectual Disability,35,60,43,13,56
Bihar,Gopalganj,Intellectual Disability,60,80,3,0,3
Maharashtra,Gondia,Intellectual Disability,0,6,11,7,18
Maharashtra,Gondia,Intellectual Disability,6,15,208,161,369
Maharashtra,Gondia,Intellectual Disability,15,35,374,266,640
Maharashtra,Gondia,Intellectual Disability,35,60,95,84,179
Maharashtra,Gondia,Intellectual Disability,60,80,4,2,6
Uttar Pradesh,Gonda,Intellectual Disability,0,6,9,8,17
Uttar Pradesh,Gonda,Intellectual Disability,6,15,145,105,250
Uttar Pradesh,Gonda,Intellectual Disability,15,35,73,31,104
Uttar Pradesh,Gonda,Intellectual Disability,35,60,48,8,56
Uttar Pradesh,Gonda,Intellectual Disability,60,80,8,2,10
Uttar Pradesh,Gonda,Intellectual Disability,80,100,1,0,1
Tripura,Gomati,Intellectual Disability,0,6,12,8,20
Tripura,Gomati,Intellectual Disability,6,15,143,93,236
Tripura,Gomati,Intellectual Disability,15,35,177,143,320
Tripura,Gomati,Intellectual Disability,35,60,60,38,98
Tripura,Gomati,Intellectual Disability,60,80,9,2,11
Assam,Golaghat,Intellectual Disability,0,6,3,5,8
Assam,Golaghat,Intellectual Disability,6,15,59,51,110
Assam,Golaghat,Intellectual Disability,15,35,135,128,263
Assam,Golaghat,Intellectual Disability,35,60,45,43,88
Assam,Golaghat,Intellectual Disability,60,80,1,6,7
Jharkhand,Godda,Intellectual Disability,0,6,0,2,2
Jharkhand,Godda,Intellectual Disability,6,15,17,6,23
Jharkhand,Godda,Intellectual Disability,15,35,59,46,105
Jharkhand,Godda,Intellectual Disability,35,60,35,17,52
Jharkhand,Godda,Intellectual Disability,60,80,12,5,17
Jharkhand,Godda,Intellectual Disability,80,100,4,2,6
Assam,Goalpara,Intellectual Disability,0,6,19,11,30
Assam,Goalpara,Intellectual Disability,6,15,106,66,172
Assam,Goalpara,Intellectual Disability,15,35,152,134,286
Assam,Goalpara,Intellectual Disability,35,60,59,50,109
Assam,Goalpara,Intellectual Disability,60,80,6,5,11
Assam,Goalpara,Intellectual Disability,80,100,0,1,1
Jharkhand,Giridih,Intellectual Disability,0,6,4,0,4
Jharkhand,Giridih,Intellectual Disability,6,15,107,42,149
Jharkhand,Giridih,Intellectual Disability,15,35,125,77,202
Jharkhand,Giridih,Intellectual Disability,35,60,31,19,50
Jharkhand,Giridih,Intellectual Disability,60,80,7,1,8
Gujarat,Gir Somnath,Intellectual Disability,0,6,36,26,62
Gujarat,Gir Somnath,Intellectual Disability,6,15,361,216,577
Gujarat,Gir Somnath,Intellectual Disability,15,35,380,224,604
Gujarat,Gir Somnath,Intellectual Disability,35,60,62,58,120
Gujarat,Gir Somnath,Intellectual Disability,60,80,4,0,4
Uttar Pradesh,Ghazipur,Intellectual Disability,0,6,4,5,9
Uttar Pradesh,Ghazipur,Intellectual Disability,6,15,112,70,182
Uttar Pradesh,Ghazipur,Intellectual Disability,15,35,253,139,392
Uttar Pradesh,Ghazipur,Intellectual Disability,35,60,83,19,102
Uttar Pradesh,Ghazipur,Intellectual Disability,60,80,7,1,8
Uttar Pradesh,Ghaziabad,Intellectual Disability,0,6,20,8,28
Uttar Pradesh,Ghaziabad,Intellectual Disability,6,15,177,86,263
Uttar Pradesh,Ghaziabad,Intellectual Disability,15,35,322,146,468
Uttar Pradesh,Ghaziabad,Intellectual Disability,35,60,82,34,116
Uttar Pradesh,Ghaziabad,Intellectual Disability,60,80,2,0,2
Bihar,Gaya,Intellectual Disability,0,6,31,18,49
Bihar,Gaya,Intellectual Disability,6,15,334,201,535
Bihar,Gaya,Intellectual Disability,15,35,374,259,633
Bihar,Gaya,Intellectual Disability,35,60,74,28,102
Bihar,Gaya,Intellectual Disability,60,80,3,5,8
Uttar Pradesh,Gautam Buddha Nagar,Intellectual Disability,0,6,18,11,29
Uttar Pradesh,Gautam Buddha Nagar,Intellectual Disability,6,15,121,81,202
Uttar Pradesh,Gautam Buddha Nagar,Intellectual Disability,15,35,135,58,193
Uttar Pradesh,Gautam Buddha Nagar,Intellectual Disability,35,60,20,10,30
Uttar Pradesh,Gautam Buddha Nagar,Intellectual Disability,60,80,3,2,5
Uttar Pradesh,Gautam Buddha Nagar,Intellectual Disability,80,100,0,1,1
Chhattisgarh,Gaurella Pendra Marwahi,Intellectual Disability,6,15,0,1,1
Chhattisgarh,Gaurella Pendra Marwahi,Intellectual Disability,15,35,3,0,3
Chhattisgarh,Gaurella Pendra Marwahi,Intellectual Disability,35,60,1,0,1
Chhattisgarh,Gariyaband,Intellectual Disability,0,6,7,4,11
Chhattisgarh,Gariyaband,Intellectual Disability,6,15,39,31,70
Chhattisgarh,Gariyaband,Intellectual Disability,15,35,39,26,65
Chhattisgarh,Gariyaband,Intellectual Disability,35,60,5,6,11
Chhattisgarh,Gariyaband,Intellectual Disability,60,80,1,0,1
Jharkhand,Garhwa,Intellectual Disability,0,6,2,0,2
Jharkhand,Garhwa,Intellectual Disability,6,15,36,18,54
Jharkhand,Garhwa,Intellectual Disability,15,35,51,38,89
Jharkhand,Garhwa,Intellectual Disability,35,60,30,8,38
Jharkhand,Garhwa,Intellectual Disability,60,80,3,1,4
Odisha,Ganjam,Intellectual Disability,0,6,172,113,285
Odisha,Ganjam,Intellectual Disability,6,15,1498,835,2333
Odisha,Ganjam,Intellectual Disability,15,35,1463,991,2454
Odisha,Ganjam,Intellectual Disability,35,60,424,240,664
Odisha,Ganjam,Intellectual Disability,60,80,18,16,34
Sikkim,Gangtok,Intellectual Disability,0,6,1,4,5
Sikkim,Gangtok,Intellectual Disability,6,15,37,32,69
Sikkim,Gangtok,Intellectual Disability,15,35,75,62,137
Sikkim,Gangtok,Intellectual Disability,35,60,62,47,109
Sikkim,Gangtok,Intellectual Disability,60,80,11,9,20
Rajasthan,Ganganagar,Intellectual Disability,6,15,26,11,37
Rajasthan,Ganganagar,Intellectual Disability,15,35,18,9,27
Rajasthan,Ganganagar,Intellectual Disability,35,60,6,3,9
Rajasthan,Ganganagar,Intellectual Disability,60,80,0,1,1
Gujarat,Gandhinagar,Intellectual Disability,0,6,20,18,38
Gujarat,Gandhinagar,Intellectual Disability,6,15,420,222,642
Gujarat,Gandhinagar,Intellectual Disability,15,35,462,199,661
Gujarat,Gandhinagar,Intellectual Disability,35,60,92,67,159
Gujarat,Gandhinagar,Intellectual Disability,60,80,4,8,12
Jammu And Kashmir,Ganderbal,Intellectual Disability,0,6,3,1,4
Jammu And Kashmir,Ganderbal,Intellectual Disability,6,15,36,27,63
Jammu And Kashmir,Ganderbal,Intellectual Disability,15,35,70,61,131
Jammu And Kashmir,Ganderbal,Intellectual Disability,35,60,34,26,60
Jammu And Kashmir,Ganderbal,Intellectual Disability,60,80,2,0,2
Odisha,Gajapati,Intellectual Disability,0,6,4,5,9
Odisha,Gajapati,Intellectual Disability,6,15,20,8,28
Odisha,Gajapati,Intellectual Disability,15,35,34,22,56
Odisha,Gajapati,Intellectual Disability,35,60,7,12,19
Odisha,Gajapati,Intellectual Disability,60,80,1,1,2
Maharashtra,Gadchiroli,Intellectual Disability,0,6,99,68,167
Maharashtra,Gadchiroli,Intellectual Disability,6,15,454,343,797
Maharashtra,Gadchiroli,Intellectual Disability,15,35,477,398,875
Maharashtra,Gadchiroli,Intellectual Disability,35,60,86,78,164
Maharashtra,Gadchiroli,Intellectual Disability,60,80,9,2,11
Maharashtra,Gadchiroli,Intellectual Disability,80,100,0,1,1
Karnataka,Gadag,Intellectual Disability,0,6,88,47,135
Karnataka,Gadag,Intellectual Disability,6,15,481,325,806
Karnataka,Gadag,Intellectual Disability,15,35,691,453,1144
Karnataka,Gadag,Intellectual Disability,35,60,157,151,308
Karnataka,Gadag,Intellectual Disability,60,80,8,5,13
Uttar Pradesh,Firozabad,Intellectual Disability,0,6,20,11,31
Uttar Pradesh,Firozabad,Intellectual Disability,6,15,284,188,472
Uttar Pradesh,Firozabad,Intellectual Disability,15,35,106,28,134
Uttar Pradesh,Firozabad,Intellectual Disability,35,60,30,6,36
Uttar Pradesh,Firozabad,Intellectual Disability,60,80,4,0,4
Punjab,Ferozepur,Intellectual Disability,0,6,48,30,78
Punjab,Ferozepur,Intellectual Disability,6,15,491,345,836
Punjab,Ferozepur,Intellectual Disability,15,35,416,230,646
Punjab,Ferozepur,Intellectual Disability,35,60,85,67,152
Punjab,Ferozepur,Intellectual Disability,60,80,4,1,5
Punjab,Fazilka,Intellectual Disability,0,6,34,20,54
Punjab,Fazilka,Intellectual Disability,6,15,450,295,745
Punjab,Fazilka,Intellectual Disability,15,35,472,267,739
Punjab,Fazilka,Intellectual Disability,35,60,127,70,197
Punjab,Fazilka,Intellectual Disability,60,80,6,4,10
Punjab,Fazilka,Intellectual Disability,80,100,1,0,1
Uttar Pradesh,Fatehpur,Intellectual Disability,0,6,6,8,14
Uttar Pradesh,Fatehpur,Intellectual Disability,6,15,132,89,221
Uttar Pradesh,Fatehpur,Intellectual Disability,15,35,103,65,168
Uttar Pradesh,Fatehpur,Intellectual Disability,35,60,90,14,104
Uttar Pradesh,Fatehpur,Intellectual Disability,60,80,32,6,38
Uttar Pradesh,Fatehpur,Intellectual Disability,80,100,2,0,2
Punjab,Fatehgarh Sahib,Intellectual Disability,0,6,20,9,29
Punjab,Fatehgarh Sahib,Intellectual Disability,6,15,195,128,323
Punjab,Fatehgarh Sahib,Intellectual Disability,15,35,174,106,280
Punjab,Fatehgarh Sahib,Intellectual Disability,35,60,46,27,73
Punjab,Fatehgarh Sahib,Intellectual Disability,60,80,4,2,6
Haryana,Fatehabad,Intellectual Disability,0,6,31,19,50
Haryana,Fatehabad,Intellectual Disability,6,15,219,153,372
Haryana,Fatehabad,Intellectual Disability,15,35,223,122,345
Haryana,Fatehabad,Intellectual Disability,35,60,70,19,89
Haryana,Fatehabad,Intellectual Disability,60,80,2,1,3
Uttar Pradesh,Farrukhabad,Intellectual Disability,0,6,2,3,5
Uttar Pradesh,Farrukhabad,Intellectual Disability,6,15,28,25,53
Uttar Pradesh,Farrukhabad,Intellectual Disability,15,35,66,32,98
Uttar Pradesh,Farrukhabad,Intellectual Disability,35,60,51,15,66
Uttar Pradesh,Farrukhabad,Intellectual Disability,60,80,9,2,11
Uttar Pradesh,Farrukhabad,Intellectual Disability,80,100,1,0,1
Punjab,Faridkot,Intellectual Disability,0,6,25,17,42
Punjab,Faridkot,Intellectual Disability,6,15,461,274,735
Punjab,Faridkot,Intellectual Disability,15,35,389,245,634
Punjab,Faridkot,Intellectual Disability,35,60,122,71,193
Punjab,Faridkot,Intellectual Disability,60,80,10,1,11
Punjab,Faridkot,Intellectual Disability,80,100,0,1,1
Haryana,Faridabad,Intellectual Disability,0,6,46,13,59
Haryana,Faridabad,Intellectual Disability,6,15,335,166,501
Haryana,Faridabad,Intellectual Disability,15,35,484,225,709
Haryana,Faridabad,Intellectual Disability,35,60,109,46,155
Haryana,Faridabad,Intellectual Disability,60,80,1,1,2
Haryana,Faridabad,Intellectual Disability,80,100,1,1,2
Uttar Pradesh,Etawah,Intellectual Disability,6,15,22,14,36
Uttar Pradesh,Etawah,Intellectual Disability,15,35,51,14,65
Uttar Pradesh,Etawah,Intellectual Disability,35,60,48,9,57
Uttar Pradesh,Etawah,Intellectual Disability,60,80,11,2,13
Uttar Pradesh,Etawah,Intellectual Disability,80,100,1,0,1
Uttar Pradesh,Etah,Intellectual Disability,0,6,4,1,5
Uttar Pradesh,Etah,Intellectual Disability,6,15,19,16,35
Uttar Pradesh,Etah,Intellectual Disability,15,35,53,5,58
Uttar Pradesh,Etah,Intellectual Disability,35,60,25,5,30
Uttar Pradesh,Etah,Intellectual Disability,60,80,5,0,5
Tamil Nadu,Erode,Intellectual Disability,0,6,84,60,144
Tamil Nadu,Erode,Intellectual Disability,6,15,931,536,1467
Tamil Nadu,Erode,Intellectual Disability,15,35,1455,897,2352
Tamil Nadu,Erode,Intellectual Disability,35,60,443,333,776
Tamil Nadu,Erode,Intellectual Disability,60,80,36,22,58
Tamil Nadu,Erode,Intellectual Disability,80,100,1,1,2
Kerala,Ernakulam,Intellectual Disability,0,6,40,20,60
Kerala,Ernakulam,Intellectual Disability,6,15,412,253,665
Kerala,Ernakulam,Intellectual Disability,15,35,1735,1086,2821
Kerala,Ernakulam,Intellectual Disability,35,60,866,757,1623
Kerala,Ernakulam,Intellectual Disability,60,80,112,81,193
Kerala,Ernakulam,Intellectual Disability,80,100,3,4,7
Meghalaya,Eastern West Khasi Hills,Intellectual Disability,0,6,16,10,26
Meghalaya,Eastern West Khasi Hills,Intellectual Disability,6,15,98,68,166
Meghalaya,Eastern West Khasi Hills,Intellectual Disability,15,35,135,127,262
Meghalaya,Eastern West Khasi Hills,Intellectual Disability,35,60,30,29,59
Meghalaya,Eastern West Khasi Hills,Intellectual Disability,60,80,1,2,3
Jharkhand,East Singhbum,Intellectual Disability,0,6,34,27,61
Jharkhand,East Singhbum,Intellectual Disability,6,15,262,200,462
Jharkhand,East Singhbum,Intellectual Disability,15,35,321,223,544
Jharkhand,East Singhbum,Intellectual Disability,35,60,113,90,203
Jharkhand,East Singhbum,Intellectual Disability,60,80,12,6,18
Arunachal Pradesh,East Siang,Intellectual Disability,6,15,3,1,4
Arunachal Pradesh,East Siang,Intellectual Disability,15,35,2,2,4
Madhya Pradesh,East Nimar,Intellectual Disability,6,15,33,29,62
Madhya Pradesh,East Nimar,Intellectual Disability,15,35,165,106,271
Madhya Pradesh,East Nimar,Intellectual Disability,35,60,103,29,132
Madhya Pradesh,East Nimar,Intellectual Disability,60,80,12,7,19
Meghalaya,East Khasi Hills,Intellectual Disability,0,6,27,12,39
Meghalaya,East Khasi Hills,Intellectual Disability,6,15,411,251,662
Meghalaya,East Khasi Hills,Intellectual Disability,15,35,773,574,1347
Meghalaya,East Khasi Hills,Intellectual Disability,35,60,198,169,367
Meghalaya,East Khasi Hills,Intellectual Disability,60,80,6,12,18
Meghalaya,East Khasi Hills,Intellectual Disability,80,100,0,1,1
Arunachal Pradesh,East Kameng,Intellectual Disability,6,15,1,0,1
Arunachal Pradesh,East Kameng,Intellectual Disability,15,35,1,1,2
Arunachal Pradesh,East Kameng,Intellectual Disability,35,60,0,1,1
Meghalaya,East Jaintia Hills,Intellectual Disability,0,6,6,3,9
Meghalaya,East Jaintia Hills,Intellectual Disability,6,15,59,52,111
Meghalaya,East Jaintia Hills,Intellectual Disability,15,35,107,85,192
Meghalaya,East Jaintia Hills,Intellectual Disability,35,60,17,14,31
Meghalaya,East Jaintia Hills,Intellectual Disability,60,80,2,1,3
Andhra Pradesh,East Godavari,Intellectual Disability,0,6,44,35,79
Andhra Pradesh,East Godavari,Intellectual Disability,6,15,711,479,1190
Andhra Pradesh,East Godavari,Intellectual Disability,15,35,759,575,1334
Andhra Pradesh,East Godavari,Intellectual Disability,35,60,217,110,327
Andhra Pradesh,East Godavari,Intellectual Disability,60,80,11,4,15
Meghalaya,East Garo Hills,Intellectual Disability,0,6,2,0,2
Meghalaya,East Garo Hills,Intellectual Disability,6,15,17,16,33
Meghalaya,East Garo Hills,Intellectual Disability,15,35,17,21,38
Meghalaya,East Garo Hills,Intellectual Disability,35,60,3,4,7
Meghalaya,East Garo Hills,Intellectual Disability,60,80,0,1,1
Delhi,East,Intellectual Disability,0,6,45,21,66
Delhi,East,Intellectual Disability,6,15,251,216,467
Delhi,East,Intellectual Disability,15,35,266,156,422
Delhi,East,Intellectual Disability,35,60,31,25,56
Delhi,East,Intellectual Disability,60,80,1,0,1
Chhattisgarh,Durg,Intellectual Disability,0,6,25,17,42
Chhattisgarh,Durg,Intellectual Disability,6,15,130,77,207
Chhattisgarh,Durg,Intellectual Disability,15,35,125,82,207
Chhattisgarh,Durg,Intellectual Disability,35,60,41,21,62
Chhattisgarh,Durg,Intellectual Disability,60,80,0,5,5
Rajasthan,Dungarpur,Intellectual Disability,6,15,4,1,5
Rajasthan,Dungarpur,Intellectual Disability,15,35,9,12,21
Rajasthan,Dungarpur,Intellectual Disability,35,60,7,1,8
Rajasthan,Dungarpur,Intellectual Disability,60,80,0,1,1
Jharkhand,Dumka,Intellectual Disability,0,6,8,7,15
Jharkhand,Dumka,Intellectual Disability,6,15,114,80,194
Jharkhand,Dumka,Intellectual Disability,15,35,88,87,175
Jharkhand,Dumka,Intellectual Disability,35,60,33,13,46
Jharkhand,Dumka,Intellectual Disability,60,80,1,0,1
Jharkhand,Dumka,Intellectual Disability,80,100,2,0,2
Gujarat,Dohad,Intellectual Disability,0,6,16,7,23
Gujarat,Dohad,Intellectual Disability,6,15,408,302,710
Gujarat,Dohad,Intellectual Disability,15,35,426,255,681
Gujarat,Dohad,Intellectual Disability,35,60,42,30,72
Gujarat,Dohad,Intellectual Disability,60,80,0,3,3
Jammu And Kashmir,Doda,Intellectual Disability,0,6,4,9,13
Jammu And Kashmir,Doda,Intellectual Disability,6,15,12,19,31
Jammu And Kashmir,Doda,Intellectual Disability,15,35,82,42,124
Jammu And Kashmir,Doda,Intellectual Disability,35,60,46,31,77
Jammu And Kashmir,Doda,Intellectual Disability,60,80,4,3,7
Dadra Nagar Haveli And Daman And Diu,Diu,Intellectual Disability,0,6,2,1,3
Dadra Nagar Haveli And Daman And Diu,Diu,Intellectual Disability,6,15,15,12,27
Dadra Nagar Haveli And Daman And Diu,Diu,Intellectual Disability,15,35,43,24,67
Dadra Nagar Haveli And Daman And Diu,Diu,Intellectual Disability,35,60,12,17,29
Dadra Nagar Haveli And Daman And Diu,Diu,Intellectual Disability,60,80,0,5,5
Madhya Pradesh,Dindori,Intellectual Disability,0,6,4,2,6
Madhya Pradesh,Dindori,Intellectual Disability,6,15,22,17,39
Madhya Pradesh,Dindori,Intellectual Disability,15,35,120,115,235
Madhya Pradesh,Dindori,Intellectual Disability,35,60,54,52,106
Madhya Pradesh,Dindori,Intellectual Disability,60,80,8,2,10
Tamil Nadu,Dindigul,Intellectual Disability,0,6,85,40,125
Tamil Nadu,Dindigul,Intellectual Disability,6,15,722,459,1181
Tamil Nadu,Dindigul,Intellectual Disability,15,35,1338,885,2223
Tamil Nadu,Dindigul,Intellectual Disability,35,60,461,379,840
Tamil Nadu,Dindigul,Intellectual Disability,60,80,29,20,49
Tamil Nadu,Dindigul,Intellectual Disability,80,100,3,1,4
Nagaland,Dimapur,Intellectual Disability,0,6,4,0,4
Nagaland,Dimapur,Intellectual Disability,6,15,11,8,19
Nagaland,Dimapur,Intellectual Disability,15,35,11,12,23
Nagaland,Dimapur,Intellectual Disability,35,60,2,1,3
Nagaland,Dimapur,Intellectual Disability,60,80,1,0,1
Assam,Dima Hasao,Intellectual Disability,6,15,1,1,2
Assam,Dima Hasao,Intellectual Disability,15,35,4,5,9
Assam,Dima Hasao,Intellectual Disability,35,60,2,1,3
Assam,Dibrugarh,Intellectual Disability,0,6,11,6,17
Assam,Dibrugarh,Intellectual Disability,6,15,92,63,155
Assam,Dibrugarh,Intellectual Disability,15,35,139,131,270
Assam,Dibrugarh,Intellectual Disability,35,60,44,40,84
Assam,Dibrugarh,Intellectual Disability,60,80,2,1,3
Maharashtra,Dhule,Intellectual Disability,0,6,32,20,52
Maharashtra,Dhule,Intellectual Disability,6,15,336,214,550
Maharashtra,Dhule,Intellectual Disability,15,35,465,301,766
Maharashtra,Dhule,Intellectual Disability,35,60,154,98,252
Maharashtra,Dhule,Intellectual Disability,60,80,10,3,13
Assam,Dhubri,Intellectual Disability,0,6,12,10,22
Assam,Dhubri,Intellectual Disability,6,15,92,68,160
Assam,Dhubri,Intellectual Disability,15,35,137,103,240
Assam,Dhubri,Intellectual Disability,35,60,47,27,74
Assam,Dhubri,Intellectual Disability,60,80,5,3,8
Rajasthan,Dholpur,Intellectual Disability,0,6,2,3,5
Rajasthan,Dholpur,Intellectual Disability,6,15,45,30,75
Rajasthan,Dholpur,Intellectual Disability,15,35,71,27,98
Rajasthan,Dholpur,Intellectual Disability,35,60,8,6,14
Rajasthan,Dholpur,Intellectual Disability,60,80,1,0,1
Odisha,Dhenkanal,Intellectual Disability,0,6,38,27,65
Odisha,Dhenkanal,Intellectual Disability,6,15,238,109,347
Odisha,Dhenkanal,Intellectual Disability,15,35,250,162,412
Odisha,Dhenkanal,Intellectual Disability,35,60,119,64,183
Odisha,Dhenkanal,Intellectual Disability,60,80,6,6,12
Odisha,Dhenkanal,Intellectual Disability,80,100,0,1,1
Assam,Dhemaji,Intellectual Disability,0,6,4,0,4
Assam,Dhemaji,Intellectual Disability,6,15,26,21,47
Assam,Dhemaji,Intellectual Disability,15,35,49,54,103
Assam,Dhemaji,Intellectual Disability,35,60,18,7,25
Assam,Dhemaji,Intellectual Disability,60,80,0,3,3
Karnataka,Dharwad,Intellectual Disability,0,6,80,52,132
Karnataka,Dharwad,Intellectual Disability,6,15,505,298,803
Karnataka,Dharwad,Intellectual Disability,15,35,675,485,1160
Karnataka,Dharwad,Intellectual Disability,35,60,176,171,347
Karnataka,Dharwad,Intellectual Disability,60,80,9,16,25
Karnataka,Dharwad,Intellectual Disability,80,100,1,0,1
Tamil Nadu,Dharmapuri,Intellectual Disability,0,6,93,58,151
Tamil Nadu,Dharmapuri,Intellectual Disability,6,15,779,517,1296
Tamil Nadu,Dharmapuri,Intellectual Disability,15,35,1377,860,2237
Tamil Nadu,Dharmapuri,Intellectual Disability,35,60,391,318,709
Tamil Nadu,Dharmapuri,Intellectual Disability,60,80,24,19,43
Tamil Nadu,Dharmapuri,Intellectual Disability,80,100,1,0,1
Madhya Pradesh,Dhar,Intellectual Disability,0,6,1,3,4
Madhya Pradesh,Dhar,Intellectual Disability,6,15,70,39,109
Madhya Pradesh,Dhar,Intellectual Disability,15,35,232,181,413
Madhya Pradesh,Dhar,Intellectual Disability,35,60,143,78,221
Madhya Pradesh,Dhar,Intellectual Disability,60,80,14,7,21
Madhya Pradesh,Dhar,Intellectual Disability,80,100,2,1,3
Jharkhand,Dhanbad,Intellectual Disability,6,15,24,13,37
Jharkhand,Dhanbad,Intellectual Disability,15,35,70,35,105
Jharkhand,Dhanbad,Intellectual Disability,35,60,28,18,46
Jharkhand,Dhanbad,Intellectual Disability,60,80,8,1,9
Jharkhand,Dhanbad,Intellectual Disability,80,100,1,0,1
Chhattisgarh,Dhamtari,Intellectual Disability,0,6,13,11,24
Chhattisgarh,Dhamtari,Intellectual Disability,6,15,53,78,131
Chhattisgarh,Dhamtari,Intellectual Disability,15,35,49,39,88
Chhattisgarh,Dhamtari,Intellectual Disability,35,60,12,18,30
Chhattisgarh,Dhamtari,Intellectual Disability,60,80,1,0,1
Tripura,Dhalai,Intellectual Disability,0,6,2,0,2
Tripura,Dhalai,Intellectual Disability,6,15,70,55,125
Tripura,Dhalai,Intellectual Disability,15,35,177,131,308
Tripura,Dhalai,Intellectual Disability,35,60,67,47,114
Tripura,Dhalai,Intellectual Disability,60,80,5,3,8
Tripura,Dhalai,Intellectual Disability,80,100,0,1,1
Madhya Pradesh,Dewas,Intellectual Disability,0,6,9,3,12
Madhya Pradesh,Dewas,Intellectual Disability,6,15,123,80,203
Madhya Pradesh,Dewas,Intellectual Disability,15,35,404,235,639
Madhya Pradesh,Dewas,Intellectual Disability,35,60,190,74,264
Madhya Pradesh,Dewas,Intellectual Disability,60,80,21,6,27
Madhya Pradesh,Dewas,Intellectual Disability,80,100,0,2,2
Gujarat,Devbhumi Dwarka,Intellectual Disability,0,6,33,16,49
Gujarat,Devbhumi Dwarka,Intellectual Disability,6,15,223,158,381
Gujarat,Devbhumi Dwarka,Intellectual Disability,15,35,307,142,449
Gujarat,Devbhumi Dwarka,Intellectual Disability,35,60,69,47,116
Gujarat,Devbhumi Dwarka,Intellectual Disability,60,80,7,2,9
Uttar Pradesh,Deoria,Intellectual Disability,0,6,6,3,9
Uttar Pradesh,Deoria,Intellectual Disability,6,15,46,28,74
Uttar Pradesh,Deoria,Intellectual Disability,15,35,93,43,136
Uttar Pradesh,Deoria,Intellectual Disability,35,60,44,4,48
Uttar Pradesh,Deoria,Intellectual Disability,60,80,8,4,12
Jharkhand,Deoghar,Intellectual Disability,0,6,1,0,1
Jharkhand,Deoghar,Intellectual Disability,6,15,11,7,18
Jharkhand,Deoghar,Intellectual Disability,15,35,30,15,45
Jharkhand,Deoghar,Intellectual Disability,35,60,20,5,25
Jharkhand,Deoghar,Intellectual Disability,60,80,1,1,2
Odisha,Deogarh,Intellectual Disability,0,6,1,3,4
Odisha,Deogarh,Intellectual Disability,6,15,34,30,64
Odisha,Deogarh,Intellectual Disability,15,35,43,29,72
Odisha,Deogarh,Intellectual Disability,35,60,9,6,15
Odisha,Deogarh,Intellectual Disability,60,80,1,0,1
Uttarakhand,Dehradun,Intellectual Disability,0,6,54,37,91
Uttarakhand,Dehradun,Intellectual Disability,6,15,348,159,507
Uttarakhand,Dehradun,Intellectual Disability,15,35,532,341,873
Uttarakhand,Dehradun,Intellectual Disability,35,60,208,117,325
Uttarakhand,Dehradun,Intellectual Disability,60,80,16,10,26
Uttarakhand,Dehradun,Intellectual Disability,80,100,2,0,2
Karnataka,Davangere,Intellectual Disability,0,6,101,75,176
Karnataka,Davangere,Intellectual Disability,6,15,577,381,958
Karnataka,Davangere,Intellectual Disability,15,35,972,665,1637
Karnataka,Davangere,Intellectual Disability,35,60,340,286,626
Karnataka,Davangere,Intellectual Disability,60,80,24,7,31
Rajasthan,Dausa,Intellectual Disability,0,6,3,3,6
Rajasthan,Dausa,Intellectual Disability,6,15,27,18,45
Rajasthan,Dausa,Intellectual Disability,15,35,39,24,63
Rajasthan,Dausa,Intellectual Disability,35,60,12,2,14
Madhya Pradesh,Datia,Intellectual Disability,0,6,5,2,7
Madhya Pradesh,Datia,Intellectual Disability,6,15,100,48,148
Madhya Pradesh,Datia,Intellectual Disability,15,35,236,130,366
Madhya Pradesh,Datia,Intellectual Disability,35,60,86,31,117
Madhya Pradesh,Datia,Intellectual Disability,60,80,12,4,16
Madhya Pradesh,Datia,Intellectual Disability,80,100,1,0,1
Assam,Darrang,Intellectual Disability,0,6,8,2,10
Assam,Darrang,Intellectual Disability,6,15,84,45,129
Assam,Darrang,Intellectual Disability,15,35,105,76,181
Assam,Darrang,Intellectual Disability,35,60,55,39,94
Assam,Darrang,Intellectual Disability,60,80,8,1,9
West Bengal,Darjeeling,Intellectual Disability,6,15,0,2,2
West Bengal,Darjeeling,Intellectual Disability,15,35,1,0,1
Bihar,Darbhanga,Intellectual Disability,0,6,2,0,2
Bihar,Darbhanga,Intellectual Disability,6,15,22,12,34
Bihar,Darbhanga,Intellectual Disability,15,35,52,23,75
Bihar,Darbhanga,Intellectual Disability,35,60,17,7,24
Bihar,Darbhanga,Intellectual Disability,60,80,2,3,5
Chhattisgarh,Dantewada,Intellectual Disability,0,6,3,1,4
Chhattisgarh,Dantewada,Intellectual Disability,6,15,20,9,29
Chhattisgarh,Dantewada,Intellectual Disability,15,35,6,4,10
Chhattisgarh,Dantewada,Intellectual Disability,35,60,2,1,3
Gujarat,Dang,Intellectual Disability,0,6,8,2,10
Gujarat,Dang,Intellectual Disability,6,15,136,99,235
Gujarat,Dang,Intellectual Disability,15,35,96,70,166
Gujarat,Dang,Intellectual Disability,35,60,4,6,10
Madhya Pradesh,Damoh,Intellectual Disability,0,6,1,4,5
Madhya Pradesh,Damoh,Intellectual Disability,6,15,27,14,41
Madhya Pradesh,Damoh,Intellectual Disability,15,35,111,74,185
Madhya Pradesh,Damoh,Intellectual Disability,35,60,102,51,153
Madhya Pradesh,Damoh,Intellectual Disability,60,80,19,8,27
Madhya Pradesh,Damoh,Intellectual Disability,80,100,0,1,1
Dadra Nagar Haveli And Daman And Diu,Daman,Intellectual Disability,0,6,8,4,12
Dadra Nagar Haveli And Daman And Diu,Daman,Intellectual Disability,6,15,41,18,59
Dadra Nagar Haveli And Daman And Diu,Daman,Intellectual Disability,15,35,54,28,82
Dadra Nagar Haveli And Daman And Diu,Daman,Intellectual Disability,35,60,10,19,29
Dadra Nagar Haveli And Daman And Diu,Daman,Intellectual Disability,60,80,0,1,1
Karnataka,Dakshina Kannada,Intellectual Disability,0,6,29,22,51
Karnataka,Dakshina Kannada,Intellectual Disability,6,15,745,408,1153
Karnataka,Dakshina Kannada,Intellectual Disability,15,35,1676,1126,2802
Karnataka,Dakshina Kannada,Intellectual Disability,35,60,539,543,1082
Karnataka,Dakshina Kannada,Intellectual Disability,60,80,37,34,71
Karnataka,Dakshina Kannada,Intellectual Disability,80,100,0,4,4
Dadra Nagar Haveli And Daman And Diu,Dadra And Nagar Haveli,Intellectual Disability,0,6,7,4,11
Dadra Nagar Haveli And Daman And Diu,Dadra And Nagar Haveli,Intellectual Disability,6,15,122,76,198
Dadra Nagar Haveli And Daman And Diu,Dadra And Nagar Haveli,Intellectual Disability,15,35,95,62,157
Dadra Nagar Haveli And Daman And Diu,Dadra And Nagar Haveli,Intellectual Disability,35,60,4,7,11
Odisha,Cuttack,Intellectual Disability,0,6,31,14,45
Odisha,Cuttack,Intellectual Disability,6,15,228,147,375
Odisha,Cuttack,Intellectual Disability,15,35,414,231,645
Odisha,Cuttack,Intellectual Disability,35,60,205,140,345
Odisha,Cuttack,Intellectual Disability,60,80,21,10,31
Tamil Nadu,Cuddalore,Intellectual Disability,0,6,123,79,202
Tamil Nadu,Cuddalore,Intellectual Disability,6,15,1184,689,1873
Tamil Nadu,Cuddalore,Intellectual Disability,15,35,1730,1167,2897
Tamil Nadu,Cuddalore,Intellectual Disability,35,60,409,330,739
Tamil Nadu,Cuddalore,Intellectual Disability,60,80,28,14,42
Tamil Nadu,Cuddalore,Intellectual Disability,80,100,3,0,3
Tamil Nadu,Coimbatore,Intellectual Disability,0,6,62,36,98
Tamil Nadu,Coimbatore,Intellectual Disability,6,15,1200,754,1954
Tamil Nadu,Coimbatore,Intellectual Disability,15,35,1669,1119,2788
Tamil Nadu,Coimbatore,Intellectual Disability,35,60,332,303,635
Tamil Nadu,Coimbatore,Intellectual Disability,60,80,15,20,35
Rajasthan,Churu,Intellectual Disability,0,6,0,1,1
Rajasthan,Churu,Intellectual Disability,6,15,15,5,20
Rajasthan,Churu,Intellectual Disability,15,35,15,14,29
Rajasthan,Churu,Intellectual Disability,35,60,10,3,13
Manipur,Churachandpur,Intellectual Disability,0,6,3,2,5
Manipur,Churachandpur,Intellectual Disability,6,15,41,32,73
Manipur,Churachandpur,Intellectual Disability,15,35,54,31,85
Manipur,Churachandpur,Intellectual Disability,35,60,13,19,32
Manipur,Churachandpur,Intellectual Disability,60,80,3,2,5
Rajasthan,Chittorgarh,Intellectual Disability,6,15,18,17,35
Rajasthan,Chittorgarh,Intellectual Disability,15,35,55,45,100
Rajasthan,Chittorgarh,Intellectual Disability,35,60,39,18,57
Rajasthan,Chittorgarh,Intellectual Disability,60,80,2,0,2
Andhra Pradesh,Chittoor,Intellectual Disability,0,6,43,29,72
Andhra Pradesh,Chittoor,Intellectual Disability,6,15,870,577,1447
Andhra Pradesh,Chittoor,Intellectual Disability,15,35,1417,1012,2429
Andhra Pradesh,Chittoor,Intellectual Disability,35,60,353,226,579
Andhra Pradesh,Chittoor,Intellectual Disability,60,80,40,20,60
Andhra Pradesh,Chittoor,Intellectual Disability,80,100,0,1,1
Uttar Pradesh,Chitrakoot,Intellectual Disability,0,6,12,1,13
Uttar Pradesh,Chitrakoot,Intellectual Disability,6,15,26,17,43
Uttar Pradesh,Chitrakoot,Intellectual Disability,15,35,46,14,60
Uttar Pradesh,Chitrakoot,Intellectual Disability,35,60,27,4,31
Uttar Pradesh,Chitrakoot,Intellectual Disability,60,80,10,3,13
Karnataka,Chitradurga,Intellectual Disability,0,6,18,18,36
Karnataka,Chitradurga,Intellectual Disability,6,15,263,175,438
Karnataka,Chitradurga,Intellectual Disability,15,35,253,193,446
Karnataka,Chitradurga,Intellectual Disability,35,60,74,54,128
Karnataka,Chitradurga,Intellectual Disability,60,80,7,5,12
Assam,Chirang,Intellectual Disability,0,6,1,3,4
Assam,Chirang,Intellectual Disability,6,15,25,18,43
Assam,Chirang,Intellectual Disability,15,35,62,47,109
Assam,Chirang,Intellectual Disability,35,60,25,10,35
Assam,Chirang,Intellectual Disability,60,80,2,2,4
Karnataka,Chikkamagaluru,Intellectual Disability,0,6,22,20,42
Karnataka,Chikkamagaluru,Intellectual Disability,6,15,187,102,289
Karnataka,Chikkamagaluru,Intellectual Disability,15,35,388,290,678
Karnataka,Chikkamagaluru,Intellectual Disability,35,60,206,150,356
Karnataka,Chikkamagaluru,Intellectual Disability,60,80,21,7,28
Karnataka,Chikkaballapura,Intellectual Disability,0,6,39,19,58
Karnataka,Chikkaballapura,Intellectual Disability,6,15,298,219,517
Karnataka,Chikkaballapura,Intellectual Disability,15,35,503,409,912
Karnataka,Chikkaballapura,Intellectual Disability,35,60,272,235,507
Karnataka,Chikkaballapura,Intellectual Disability,60,80,25,13,38
Gujarat,Chhotaudepur,Intellectual Disability,0,6,12,14,26
Gujarat,Chhotaudepur,Intellectual Disability,6,15,337,247,584
Gujarat,Chhotaudepur,Intellectual Disability,15,35,334,245,579
Gujarat,Chhotaudepur,Intellectual Disability,35,60,35,21,56
Gujarat,Chhotaudepur,Intellectual Disability,60,80,2,1,3
Madhya Pradesh,Chhindwara,Intellectual Disability,0,6,19,11,30
Madhya Pradesh,Chhindwara,Intellectual Disability,6,15,167,109,276
Madhya Pradesh,Chhindwara,Intellectual Disability,15,35,594,379,973
Madhya Pradesh,Chhindwara,Intellectual Disability,35,60,243,189,432
Madhya Pradesh,Chhindwara,Intellectual Disability,60,80,36,16,52
Madhya Pradesh,Chhindwara,Intellectual Disability,80,100,0,2,2
Madhya Pradesh,Chhatarpur,Intellectual Disability,0,6,14,8,22
Madhya Pradesh,Chhatarpur,Intellectual Disability,6,15,167,97,264
Madhya Pradesh,Chhatarpur,Intellectual Disability,15,35,464,202,666
Madhya Pradesh,Chhatarpur,Intellectual Disability,35,60,149,79,228
Madhya Pradesh,Chhatarpur,Intellectual Disability,60,80,16,9,25
Madhya Pradesh,Chhatarpur,Intellectual Disability,80,100,0,1,1
Tamil Nadu,Chennai,Intellectual Disability,0,6,112,68,180
Tamil Nadu,Chennai,Intellectual Disability,6,15,1247,709,1956
Tamil Nadu,Chennai,Intellectual Disability,15,35,2808,1533,4341
Tamil Nadu,Chennai,Intellectual Disability,35,60,727,473,1200
Tamil Nadu,Chennai,Intellectual Disability,60,80,38,45,83
Tamil Nadu,Chennai,Intellectual Disability,80,100,1,2,3
Tamil Nadu,Chengalpattu,Intellectual Disability,0,6,39,42,81
Tamil Nadu,Chengalpattu,Intellectual Disability,6,15,401,255,656
Tamil Nadu,Chengalpattu,Intellectual Disability,15,35,777,526,1303
Tamil Nadu,Chengalpattu,Intellectual Disability,35,60,261,240,501
Tamil Nadu,Chengalpattu,Intellectual Disability,60,80,18,14,32
Jharkhand,Chatra,Intellectual Disability,0,6,3,2,5
Jharkhand,Chatra,Intellectual Disability,6,15,22,20,42
Jharkhand,Chatra,Intellectual Disability,15,35,38,13,51
Jharkhand,Chatra,Intellectual Disability,35,60,14,3,17
Jharkhand,Chatra,Intellectual Disability,60,80,1,1,2
Haryana,Charki Dadri,Intellectual Disability,0,6,14,6,20
Haryana,Charki Dadri,Intellectual Disability,6,15,85,50,135
Haryana,Charki Dadri,Intellectual Disability,15,35,148,59,207
Haryana,Charki Dadri,Intellectual Disability,35,60,29,13,42
Haryana,Charki Dadri,Intellectual Disability,60,80,3,1,4
Assam,Charaideo,Intellectual Disability,0,6,1,0,1
Assam,Charaideo,Intellectual Disability,6,15,6,11,17
Assam,Charaideo,Intellectual Disability,15,35,23,5,28
Assam,Charaideo,Intellectual Disability,35,60,7,3,10
Assam,Charaideo,Intellectual Disability,60,80,1,0,1
Arunachal Pradesh,Changlang,Intellectual Disability,0,6,1,1,2
Arunachal Pradesh,Changlang,Intellectual Disability,6,15,5,7,12
Arunachal Pradesh,Changlang,Intellectual Disability,15,35,21,8,29
Arunachal Pradesh,Changlang,Intellectual Disability,35,60,4,1,5
Arunachal Pradesh,Changlang,Intellectual Disability,60,80,0,2,2
Maharashtra,Chandrapur,Intellectual Disability,0,6,23,15,38
Maharashtra,Chandrapur,Intellectual Disability,6,15,429,305,734
Maharashtra,Chandrapur,Intellectual Disability,15,35,541,352,893
Maharashtra,Chandrapur,Intellectual Disability,35,60,126,163,289
Maharashtra,Chandrapur,Intellectual Disability,60,80,4,2,6
Chandigarh,Chandigarh,Intellectual Disability,0,6,45,20,65
Chandigarh,Chandigarh,Intellectual Disability,6,15,365,229,594
Chandigarh,Chandigarh,Intellectual Disability,15,35,595,347,942
Chandigarh,Chandigarh,Intellectual Disability,35,60,130,74,204
Chandigarh,Chandigarh,Intellectual Disability,60,80,11,8,19
Manipur,Chandel,Intellectual Disability,0,6,1,0,1
Manipur,Chandel,Intellectual Disability,6,15,4,3,7
Manipur,Chandel,Intellectual Disability,15,35,4,10,14
Manipur,Chandel,Intellectual Disability,35,60,2,6,8
Uttar Pradesh,Chandauli,Intellectual Disability,0,6,9,7,16
Uttar Pradesh,Chandauli,Intellectual Disability,6,15,88,53,141
Uttar Pradesh,Chandauli,Intellectual Disability,15,35,165,85,250
Uttar Pradesh,Chandauli,Intellectual Disability,35,60,52,20,72
Uttar Pradesh,Chandauli,Intellectual Disability,60,80,3,1,4
Mizoram,Champhai,Intellectual Disability,0,6,0,2,2
Mizoram,Champhai,Intellectual Disability,6,15,2,3,5
Mizoram,Champhai,Intellectual Disability,15,35,2,4,6
Mizoram,Champhai,Intellectual Disability,35,60,1,2,3
Mizoram,Champhai,Intellectual Disability,60,80,0,1,1
Uttarakhand,Champawat,Intellectual Disability,0,6,8,1,9
Uttarakhand,Champawat,Intellectual Disability,6,15,29,17,46
Uttarakhand,Champawat,Intellectual Disability,15,35,106,59,165
Uttarakhand,Champawat,Intellectual Disability,35,60,86,17,103
Uttarakhand,Champawat,Intellectual Disability,60,80,5,4,9
Uttarakhand,Chamoli,Intellectual Disability,0,6,7,3,10
Uttarakhand,Chamoli,Intellectual Disability,6,15,32,10,42
Uttarakhand,Chamoli,Intellectual Disability,15,35,48,28,76
Uttarakhand,Chamoli,Intellectual Disability,35,60,29,13,42
Uttarakhand,Chamoli,Intellectual Disability,60,80,0,1,1
Himachal Pradesh,Chamba,Intellectual Disability,0,6,5,2,7
Himachal Pradesh,Chamba,Intellectual Disability,6,15,28,21,49
Himachal Pradesh,Chamba,Intellectual Disability,15,35,50,34,84
Himachal Pradesh,Chamba,Intellectual Disability,35,60,14,10,24
Karnataka,Chamarajanagara,Intellectual Disability,0,6,9,8,17
Karnataka,Chamarajanagara,Intellectual Disability,6,15,134,101,235
Karnataka,Chamarajanagara,Intellectual Disability,15,35,344,245,589
Karnataka,Chamarajanagara,Intellectual Disability,35,60,116,103,219
Karnataka,Chamarajanagara,Intellectual Disability,60,80,7,2,9
Delhi,Central,Intellectual Disability,0,6,8,6,14
Delhi,Central,Intellectual Disability,6,15,75,63,138
Delhi,Central,Intellectual Disability,15,35,88,39,127
Delhi,Central,Intellectual Disability,35,60,9,6,15
Delhi,Central,Intellectual Disability,60,80,1,0,1
Assam,Cachar,Intellectual Disability,0,6,72,39,111
Assam,Cachar,Intellectual Disability,6,15,274,203,477
Assam,Cachar,Intellectual Disability,15,35,359,277,636
Assam,Cachar,Intellectual Disability,35,60,119,65,184
Assam,Cachar,Intellectual Disability,60,80,5,3,8
Bihar,Buxar,Intellectual Disability,0,6,5,2,7
Bihar,Buxar,Intellectual Disability,6,15,146,78,224
Bihar,Buxar,Intellectual Disability,15,35,126,56,182
Bihar,Buxar,Intellectual Disability,35,60,45,12,57
Bihar,Buxar,Intellectual Disability,60,80,5,2,7
Madhya Pradesh,Burhanpur,Intellectual Disability,0,6,5,2,7
Madhya Pradesh,Burhanpur,Intellectual Disability,6,15,35,25,60
Madhya Pradesh,Burhanpur,Intellectual Disability,15,35,174,116,290
Madhya Pradesh,Burhanpur,Intellectual Disability,35,60,68,41,109
Madhya Pradesh,Burhanpur,Intellectual Disability,60,80,10,9,19
Madhya Pradesh,Burhanpur,Intellectual Disability,80,100,2,0,2
Rajasthan,Bundi,Intellectual Disability,0,6,5,9,14
Rajasthan,Bundi,Intellectual Disability,6,15,130,66,196
Rajasthan,Bundi,Intellectual Disability,15,35,166,90,256
Rajasthan,Bundi,Intellectual Disability,35,60,53,25,78
Maharashtra,Buldhana,Intellectual Disability,0,6,16,14,30
Maharashtra,Buldhana,Intellectual Disability,6,15,410,256,666
Maharashtra,Buldhana,Intellectual Disability,15,35,827,441,1268
Maharashtra,Buldhana,Intellectual Disability,35,60,181,160,341
Maharashtra,Buldhana,Intellectual Disability,60,80,8,4,12
Uttar Pradesh,Bulandshahr,Intellectual Disability,0,6,3,1,4
Uttar Pradesh,Bulandshahr,Intellectual Disability,6,15,56,34,90
Uttar Pradesh,Bulandshahr,Intellectual Disability,15,35,68,14,82
Uttar Pradesh,Bulandshahr,Intellectual Disability,35,60,36,3,39
Uttar Pradesh,Bulandshahr,Intellectual Disability,60,80,10,2,12
Uttar Pradesh,Bulandshahr,Intellectual Disability,80,100,1,0,1
Jammu And Kashmir,Budgam,Intellectual Disability,0,6,9,4,13
Jammu And Kashmir,Budgam,Intellectual Disability,6,15,62,62,124
Jammu And Kashmir,Budgam,Intellectual Disability,15,35,121,91,212
Jammu And Kashmir,Budgam,Intellectual Disability,35,60,63,41,104
Jammu And Kashmir,Budgam,Intellectual Disability,60,80,0,2,2
Uttar Pradesh,Budaun,Intellectual Disability,0,6,3,4,7
Uttar Pradesh,Budaun,Intellectual Disability,6,15,111,69,180
Uttar Pradesh,Budaun,Intellectual Disability,15,35,59,31,90
Uttar Pradesh,Budaun,Intellectual Disability,35,60,18,1,19
Uttar Pradesh,Budaun,Intellectual Disability,60,80,1,0,1
Uttar Pradesh,Budaun,Intellectual Disability,80,100,1,0,1
Odisha,Boudh,Intellectual Disability,0,6,5,2,7
Odisha,Boudh,Intellectual Disability,6,15,82,44,126
Odisha,Boudh,Intellectual Disability,15,35,47,31,78
Odisha,Boudh,Intellectual Disability,35,60,17,6,23
Odisha,Boudh,Intellectual Disability,60,80,2,1,3
Gujarat,Botad,Intellectual Disability,0,6,13,11,24
Gujarat,Botad,Intellectual Disability,6,15,194,127,321
Gujarat,Botad,Intellectual Disability,15,35,301,182,483
Gujarat,Botad,Intellectual Disability,35,60,46,47,93
Gujarat,Botad,Intellectual Disability,60,80,2,1,3
Assam,Bongaigaon,Intellectual Disability,0,6,5,3,8
Assam,Bongaigaon,Intellectual Disability,6,15,60,56,116
Assam,Bongaigaon,Intellectual Disability,15,35,130,91,221
Assam,Bongaigaon,Intellectual Disability,35,60,25,10,35
Assam,Bongaigaon,Intellectual Disability,60,80,1,0,1
Jharkhand,Bokaro,Intellectual Disability,0,6,1,0,1
Jharkhand,Bokaro,Intellectual Disability,6,15,15,9,24
Jharkhand,Bokaro,Intellectual Disability,15,35,77,50,127
Jharkhand,Bokaro,Intellectual Disability,35,60,42,21,63
Jharkhand,Bokaro,Intellectual Disability,60,80,6,0,6
Assam,Biswanath,Intellectual Disability,0,6,1,1,2
Assam,Biswanath,Intellectual Disability,6,15,21,12,33
Assam,Biswanath,Intellectual Disability,15,35,29,29,58
Assam,Biswanath,Intellectual Disability,35,60,2,2,4
Manipur,Bishnupur,Intellectual Disability,0,6,11,10,21
Manipur,Bishnupur,Intellectual Disability,6,15,66,41,107
Manipur,Bishnupur,Intellectual Disability,15,35,97,91,188
Manipur,Bishnupur,Intellectual Disability,35,60,63,74,137
Manipur,Bishnupur,Intellectual Disability,60,80,6,6,12
Manipur,Bishnupur,Intellectual Disability,80,100,0,1,1
Chhattisgarh,Bilaspur,Intellectual Disability,0,6,7,13,20
Chhattisgarh,Bilaspur,Intellectual Disability,6,15,162,136,298
Chhattisgarh,Bilaspur,Intellectual Disability,15,35,318,235,553
Chhattisgarh,Bilaspur,Intellectual Disability,35,60,89,59,148
Chhattisgarh,Bilaspur,Intellectual Disability,60,80,13,3,16
Chhattisgarh,Bilaspur,Intellectual Disability,80,100,1,0,1
Himachal Pradesh,Bilaspur,Intellectual Disability,0,6,13,11,24
Himachal Pradesh,Bilaspur,Intellectual Disability,6,15,75,65,140
Himachal Pradesh,Bilaspur,Intellectual Disability,15,35,163,97,260
Himachal Pradesh,Bilaspur,Intellectual Disability,35,60,104,31,135
Himachal Pradesh,Bilaspur,Intellectual Disability,60,80,7,0,7
Rajasthan,Bikaner,Intellectual Disability,0,6,3,1,4
Rajasthan,Bikaner,Intellectual Disability,6,15,116,83,199
Rajasthan,Bikaner,Intellectual Disability,15,35,267,148,415
Rajasthan,Bikaner,Intellectual Disability,35,60,79,34,113
Rajasthan,Bikaner,Intellectual Disability,60,80,1,3,4
Uttar Pradesh,Bijnor,Intellectual Disability,0,6,1,0,1
Uttar Pradesh,Bijnor,Intellectual Disability,6,15,26,22,48
Uttar Pradesh,Bijnor,Intellectual Disability,15,35,109,52,161
Uttar Pradesh,Bijnor,Intellectual Disability,35,60,52,14,66
Uttar Pradesh,Bijnor,Intellectual Disability,60,80,5,4,9
Uttar Pradesh,Bijnor,Intellectual Disability,80,100,1,0,1
Chhattisgarh,Bijapur,Intellectual Disability,0,6,1,0,1
Chhattisgarh,Bijapur,Intellectual Disability,6,15,15,10,25
Chhattisgarh,Bijapur,Intellectual Disability,15,35,17,13,30
Chhattisgarh,Bijapur,Intellectual Disability,35,60,2,4,6
Chhattisgarh,Bijapur,Intellectual Disability,60,80,1,0,1
Karnataka,Bidar,Intellectual Disability,0,6,35,21,56
Karnataka,Bidar,Intellectual Disability,6,15,157,101,258
Karnataka,Bidar,Intellectual Disability,15,35,197,102,299
Karnataka,Bidar,Intellectual Disability,35,60,46,40,86
Karnataka,Bidar,Intellectual Disability,60,80,1,4,5
Karnataka,Bidar,Intellectual Disability,80,100,0,1,1
Madhya Pradesh,Bhopal,Intellectual Disability,0,6,36,25,61
Madhya Pradesh,Bhopal,Intellectual Disability,6,15,321,194,515
Madhya Pradesh,Bhopal,Intellectual Disability,15,35,1017,567,1584
Madhya Pradesh,Bhopal,Intellectual Disability,35,60,361,216,577
Madhya Pradesh,Bhopal,Intellectual Disability,60,80,45,19,64
Madhya Pradesh,Bhopal,Intellectual Disability,80,100,3,3,6
Bihar,Bhojpur,Intellectual Disability,0,6,9,7,16
Bihar,Bhojpur,Intellectual Disability,6,15,142,86,228
Bihar,Bhojpur,Intellectual Disability,15,35,139,69,208
Bihar,Bhojpur,Intellectual Disability,35,60,47,15,62
Bihar,Bhojpur,Intellectual Disability,60,80,4,0,4
Haryana,Bhiwani,Intellectual Disability,0,6,11,9,20
Haryana,Bhiwani,Intellectual Disability,6,15,195,117,312
Haryana,Bhiwani,Intellectual Disability,15,35,271,141,412
Haryana,Bhiwani,Intellectual Disability,35,60,96,35,131
Haryana,Bhiwani,Intellectual Disability,60,80,10,1,11
Madhya Pradesh,Bhind,Intellectual Disability,0,6,16,16,32
Madhya Pradesh,Bhind,Intellectual Disability,6,15,137,64,201
Madhya Pradesh,Bhind,Intellectual Disability,15,35,486,180,666
Madhya Pradesh,Bhind,Intellectual Disability,35,60,183,58,241
Madhya Pradesh,Bhind,Intellectual Disability,60,80,23,18,41
Madhya Pradesh,Bhind,Intellectual Disability,80,100,3,1,4
Rajasthan,Bhilwara,Intellectual Disability,0,6,8,7,15
Rajasthan,Bhilwara,Intellectual Disability,6,15,264,171,435
Rajasthan,Bhilwara,Intellectual Disability,15,35,507,261,768
Rajasthan,Bhilwara,Intellectual Disability,35,60,140,82,222
Rajasthan,Bhilwara,Intellectual Disability,60,80,12,8,20
Rajasthan,Bhilwara,Intellectual Disability,80,100,0,1,1
Gujarat,Bhavnagar,Intellectual Disability,0,6,35,43,78
Gujarat,Bhavnagar,Intellectual Disability,6,15,489,353,842
Gujarat,Bhavnagar,Intellectual Disability,15,35,695,330,1025
Gujarat,Bhavnagar,Intellectual Disability,35,60,109,77,186
Gujarat,Bhavnagar,Intellectual Disability,60,80,4,12,16
Gujarat,Bharuch,Intellectual Disability,0,6,21,22,43
Gujarat,Bharuch,Intellectual Disability,6,15,354,209,563
Gujarat,Bharuch,Intellectual Disability,15,35,406,168,574
Gujarat,Bharuch,Intellectual Disability,35,60,48,38,86
Gujarat,Bharuch,Intellectual Disability,60,80,1,1,2
Rajasthan,Bharatpur,Intellectual Disability,0,6,4,2,6
Rajasthan,Bharatpur,Intellectual Disability,6,15,96,41,137
Rajasthan,Bharatpur,Intellectual Disability,15,35,142,53,195
Rajasthan,Bharatpur,Intellectual Disability,35,60,25,14,39
Rajasthan,Bharatpur,Intellectual Disability,60,80,1,1,2
Maharashtra,Bhandara,Intellectual Disability,0,6,73,40,113
Maharashtra,Bhandara,Intellectual Disability,6,15,548,353,901
Maharashtra,Bhandara,Intellectual Disability,15,35,786,540,1326
Maharashtra,Bhandara,Intellectual Disability,35,60,211,149,360
Maharashtra,Bhandara,Intellectual Disability,60,80,11,5,16
Bihar,Bhagalpur,Intellectual Disability,0,6,5,2,7
Bihar,Bhagalpur,Intellectual Disability,6,15,97,79,176
Bihar,Bhagalpur,Intellectual Disability,15,35,47,38,85
Bihar,Bhagalpur,Intellectual Disability,35,60,11,5,16
Bihar,Bhagalpur,Intellectual Disability,60,80,1,1,2
Odisha,Bhadrak,Intellectual Disability,0,6,24,20,44
Odisha,Bhadrak,Intellectual Disability,6,15,284,167,451
Odisha,Bhadrak,Intellectual Disability,15,35,338,262,600
Odisha,Bhadrak,Intellectual Disability,35,60,120,107,227
Odisha,Bhadrak,Intellectual Disability,60,80,12,6,18
Odisha,Bhadrak,Intellectual Disability,80,100,1,0,1
Telangana,Bhadradri Kothagudem,Intellectual Disability,0,6,1,1,2
Telangana,Bhadradri Kothagudem,Intellectual Disability,6,15,180,122,302
Telangana,Bhadradri Kothagudem,Intellectual Disability,15,35,636,545,1181
Telangana,Bhadradri Kothagudem,Intellectual Disability,35,60,303,238,541
Telangana,Bhadradri Kothagudem,Intellectual Disability,60,80,33,34,67
Telangana,Bhadradri Kothagudem,Intellectual Disability,80,100,3,0,3
Uttar Pradesh,Bhadohi,Intellectual Disability,0,6,2,1,3
Uttar Pradesh,Bhadohi,Intellectual Disability,6,15,49,18,67
Uttar Pradesh,Bhadohi,Intellectual Disability,15,35,77,40,117
Uttar Pradesh,Bhadohi,Intellectual Disability,35,60,16,11,27
Madhya Pradesh,Betul,Intellectual Disability,0,6,31,21,52
Madhya Pradesh,Betul,Intellectual Disability,6,15,358,251,609
Madhya Pradesh,Betul,Intellectual Disability,15,35,617,460,1077
Madhya Pradesh,Betul,Intellectual Disability,35,60,345,197,542
Madhya Pradesh,Betul,Intellectual Disability,60,80,54,28,82
Madhya Pradesh,Betul,Intellectual Disability,80,100,4,5,9
Karnataka,Bengaluru Urban,Intellectual Disability,0,6,179,116,295
Karnataka,Bengaluru Urban,Intellectual Disability,6,15,1267,803,2070
Karnataka,Bengaluru Urban,Intellectual Disability,15,35,2196,1188,3384
Karnataka,Bengaluru Urban,Intellectual Disability,35,60,474,360,834
Karnataka,Bengaluru Urban,Intellectual Disability,60,80,34,15,49
Karnataka,Bengaluru Urban,Intellectual Disability,80,100,1,1,2
Karnataka,Bengaluru Rural,Intellectual Disability,0,6,44,34,78
Karnataka,Bengaluru Rural,Intellectual Disability,6,15,251,156,407
Karnataka,Bengaluru Rural,Intellectual Disability,15,35,359,282,641
Karnataka,Bengaluru Rural,Intellectual Disability,35,60,169,139,308
Karnataka,Bengaluru Rural,Intellectual Disability,60,80,11,11,22
Karnataka,Bengaluru Rural,Intellectual Disability,80,100,1,0,1
Chhattisgarh,Bemetara,Intellectual Disability,6,15,11,3,14
Chhattisgarh,Bemetara,Intellectual Disability,15,35,12,4,16
Chhattisgarh,Bemetara,Intellectual Disability,35,60,1,2,3
Karnataka,Belagavi,Intellectual Disability,0,6,165,105,270
Karnataka,Belagavi,Intellectual Disability,6,15,1204,805,2009
Karnataka,Belagavi,Intellectual Disability,15,35,2141,1391,3532
Karnataka,Belagavi,Intellectual Disability,35,60,792,648,1440
Karnataka,Belagavi,Intellectual Disability,60,80,45,35,80
Karnataka,Belagavi,Intellectual Disability,80,100,1,2,3
Bihar,Begusarai,Intellectual Disability,0,6,39,30,69
Bihar,Begusarai,Intellectual Disability,6,15,355,242,597
Bihar,Begusarai,Intellectual Disability,15,35,165,96,261
Bihar,Begusarai,Intellectual Disability,35,60,34,11,45
Bihar,Begusarai,Intellectual Disability,60,80,3,0,3
Maharashtra,Beed,Intellectual Disability,0,6,58,36,94
Maharashtra,Beed,Intellectual Disability,6,15,664,353,1017
Maharashtra,Beed,Intellectual Disability,15,35,656,343,999
Maharashtra,Beed,Intellectual Disability,35,60,129,81,210
Maharashtra,Beed,Intellectual Disability,60,80,7,2,9
Punjab,Bathinda,Intellectual Disability,0,6,39,22,61
Punjab,Bathinda,Intellectual Disability,6,15,649,438,1087
Punjab,Bathinda,Intellectual Disability,15,35,711,393,1104
Punjab,Bathinda,Intellectual Disability,35,60,299,126,425
Punjab,Bathinda,Intellectual Disability,60,80,25,4,29
Uttar Pradesh,Basti,Intellectual Disability,0,6,9,3,12
Uttar Pradesh,Basti,Intellectual Disability,6,15,54,29,83
Uttar Pradesh,Basti,Intellectual Disability,15,35,104,29,133
Uttar Pradesh,Basti,Intellectual Disability,35,60,29,5,34
Uttar Pradesh,Basti,Intellectual Disability,60,80,5,3,8
Chhattisgarh,Bastar,Intellectual Disability,0,6,8,10,18
Chhattisgarh,Bastar,Intellectual Disability,6,15,109,76,185
Chhattisgarh,Bastar,Intellectual Disability,15,35,131,103,234
Chhattisgarh,Bastar,Intellectual Disability,35,60,27,16,43
Chhattisgarh,Bastar,Intellectual Disability,60,80,2,2,4
Madhya Pradesh,Barwani,Intellectual Disability,0,6,12,7,19
Madhya Pradesh,Barwani,Intellectual Disability,6,15,126,93,219
Madhya Pradesh,Barwani,Intellectual Disability,15,35,333,237,570
Madhya Pradesh,Barwani,Intellectual Disability,35,60,228,145,373
Madhya Pradesh,Barwani,Intellectual Disability,60,80,41,27,68
Madhya Pradesh,Barwani,Intellectual Disability,80,100,2,2,4
Assam,Barpeta,Intellectual Disability,0,6,28,23,51
Assam,Barpeta,Intellectual Disability,6,15,276,194,470
Assam,Barpeta,Intellectual Disability,15,35,322,233,555
Assam,Barpeta,Intellectual Disability,35,60,73,40,113
Assam,Barpeta,Intellectual Disability,60,80,4,1,5
Punjab,Barnala,Intellectual Disability,0,6,28,14,42
Punjab,Barnala,Intellectual Disability,6,15,175,111,286
Punjab,Barnala,Intellectual Disability,15,35,251,128,379
Punjab,Barnala,Intellectual Disability,35,60,126,67,193
Punjab,Barnala,Intellectual Disability,60,80,10,4,14
Rajasthan,Barmer,Intellectual Disability,0,6,12,7,19
Rajasthan,Barmer,Intellectual Disability,6,15,165,93,258
Rajasthan,Barmer,Intellectual Disability,15,35,270,120,390
Rajasthan,Barmer,Intellectual Disability,35,60,119,30,149
Rajasthan,Barmer,Intellectual Disability,60,80,7,1,8
Odisha,Bargarh,Intellectual Disability,0,6,68,42,110
Odisha,Bargarh,Intellectual Disability,6,15,441,293,734
Odisha,Bargarh,Intellectual Disability,15,35,601,492,1093
Odisha,Bargarh,Intellectual Disability,35,60,204,184,388
Odisha,Bargarh,Intellectual Disability,60,80,15,7,22
Odisha,Bargarh,Intellectual Disability,80,100,1,0,1
Uttar Pradesh,Bareilly,Intellectual Disability,0,6,39,19,58
Uttar Pradesh,Bareilly,Intellectual Disability,6,15,342,182,524
Uttar Pradesh,Bareilly,Intellectual Disability,15,35,424,213,637
Uttar Pradesh,Bareilly,Intellectual Disability,35,60,100,50,150
Uttar Pradesh,Bareilly,Intellectual Disability,60,80,9,2,11
Rajasthan,Baran,Intellectual Disability,0,6,0,1,1
Rajasthan,Baran,Intellectual Disability,6,15,6,9,15
Rajasthan,Baran,Intellectual Disability,15,35,9,5,14
Rajasthan,Baran,Intellectual Disability,35,60,3,1,4
Jammu And Kashmir,Baramulla,Intellectual Disability,0,6,4,10,14
Jammu And Kashmir,Baramulla,Intellectual Disability,6,15,46,39,85
Jammu And Kashmir,Baramulla,Intellectual Disability,15,35,58,44,102
Jammu And Kashmir,Baramulla,Intellectual Disability,35,60,20,10,30
Jammu And Kashmir,Baramulla,Intellectual Disability,60,80,4,0,4
Uttar Pradesh,Barabanki,Intellectual Disability,0,6,7,6,13
Uttar Pradesh,Barabanki,Intellectual Disability,6,15,149,102,251
Uttar Pradesh,Barabanki,Intellectual Disability,15,35,149,80,229
Uttar Pradesh,Barabanki,Intellectual Disability,35,60,56,16,72
Uttar Pradesh,Barabanki,Intellectual Disability,60,80,14,0,14
Uttar Pradesh,Barabanki,Intellectual Disability,80,100,1,1,2
Rajasthan,Banswara,Intellectual Disability,0,6,1,0,1
Rajasthan,Banswara,Intellectual Disability,6,15,13,12,25
Rajasthan,Banswara,Intellectual Disability,15,35,11,9,20
Rajasthan,Banswara,Intellectual Disability,35,60,11,4,15
Bihar,Banka,Intellectual Disability,0,6,9,10,19
Bihar,Banka,Intellectual Disability,6,15,198,127,325
Bihar,Banka,Intellectual Disability,15,35,112,59,171
Bihar,Banka,Intellectual Disability,35,60,35,14,49
Bihar,Banka,Intellectual Disability,60,80,3,0,3
Jammu And Kashmir,Bandipora,Intellectual Disability,0,6,6,1,7
Jammu And Kashmir,Bandipora,Intellectual Disability,6,15,19,22,41
Jammu And Kashmir,Bandipora,Intellectual Disability,15,35,39,41,80
Jammu And Kashmir,Bandipora,Intellectual Disability,35,60,32,25,57
Jammu And Kashmir,Bandipora,Intellectual Disability,60,80,1,3,4
Uttar Pradesh,Banda,Intellectual Disability,0,6,1,3,4
Uttar Pradesh,Banda,Intellectual Disability,6,15,77,57,134
Uttar Pradesh,Banda,Intellectual Disability,15,35,35,9,44
Uttar Pradesh,Banda,Intellectual Disability,35,60,8,1,9
Uttar Pradesh,Banda,Intellectual Disability,60,80,4,0,4
Gujarat,Banas Kantha,Intellectual Disability,0,6,45,37,82
Gujarat,Banas Kantha,Intellectual Disability,6,15,1171,704,1875
Gujarat,Banas Kantha,Intellectual Disability,15,35,1009,399,1408
Gujarat,Banas Kantha,Intellectual Disability,35,60,145,92,237
Gujarat,Banas Kantha,Intellectual Disability,60,80,7,2,9
Chhattisgarh,Balrampur,Intellectual Disability,6,15,30,18,48
Chhattisgarh,Balrampur,Intellectual Disability,15,35,28,31,59
Chhattisgarh,Balrampur,Intellectual Disability,35,60,7,3,10
Uttar Pradesh,Balrampur,Intellectual Disability,0,6,2,1,3
Uttar Pradesh,Balrampur,Intellectual Disability,6,15,43,27,70
Uttar Pradesh,Balrampur,Intellectual Disability,15,35,114,52,166
Uttar Pradesh,Balrampur,Intellectual Disability,35,60,60,8,68
Uttar Pradesh,Balrampur,Intellectual Disability,60,80,4,1,5
Uttar Pradesh,Balrampur,Intellectual Disability,80,100,1,0,1
Chhattisgarh,Baloda Bazar,Intellectual Disability,6,15,4,0,4
Chhattisgarh,Baloda Bazar,Intellectual Disability,15,35,14,7,21
Chhattisgarh,Baloda Bazar,Intellectual Disability,35,60,3,4,7
Chhattisgarh,Balod,Intellectual Disability,0,6,4,5,9
Chhattisgarh,Balod,Intellectual Disability,6,15,41,47,88
Chhattisgarh,Balod,Intellectual Disability,15,35,58,46,104
Chhattisgarh,Balod,Intellectual Disability,35,60,7,14,21
Uttar Pradesh,Ballia,Intellectual Disability,0,6,32,16,48
Uttar Pradesh,Ballia,Intellectual Disability,6,15,152,91,243
Uttar Pradesh,Ballia,Intellectual Disability,15,35,202,86,288
Uttar Pradesh,Ballia,Intellectual Disability,35,60,47,16,63
Uttar Pradesh,Ballia,Intellectual Disability,60,80,2,5,7
Karnataka,Ballari,Intellectual Disability,0,6,101,57,158
Karnataka,Ballari,Intellectual Disability,6,15,560,346,906
Karnataka,Ballari,Intellectual Disability,15,35,542,369,911
Karnataka,Ballari,Intellectual Disability,35,60,140,102,242
Karnataka,Ballari,Intellectual Disability,60,80,10,8,18
Karnataka,Ballari,Intellectual Disability,80,100,0,1,1
Odisha,Baleshwar,Intellectual Disability,0,6,38,27,65
Odisha,Baleshwar,Intellectual Disability,6,15,255,163,418
Odisha,Baleshwar,Intellectual Disability,15,35,384,259,643
Odisha,Baleshwar,Intellectual Disability,35,60,323,189,512
Odisha,Baleshwar,Intellectual Disability,60,80,49,38,87
Odisha,Baleshwar,Intellectual Disability,80,100,1,0,1
Odisha,Balangir,Intellectual Disability,0,6,20,10,30
Odisha,Balangir,Intellectual Disability,6,15,121,84,205
Odisha,Balangir,Intellectual Disability,15,35,152,93,245
Odisha,Balangir,Intellectual Disability,35,60,51,29,80
Odisha,Balangir,Intellectual Disability,60,80,3,0,3
Madhya Pradesh,Balaghat,Intellectual Disability,0,6,19,19,38
Madhya Pradesh,Balaghat,Intellectual Disability,6,15,391,309,700
Madhya Pradesh,Balaghat,Intellectual Disability,15,35,1416,1285,2701
Madhya Pradesh,Balaghat,Intellectual Disability,35,60,557,447,1004
Madhya Pradesh,Balaghat,Intellectual Disability,60,80,62,34,96
Madhya Pradesh,Balaghat,Intellectual Disability,80,100,1,1,2
Assam,Baksa,Intellectual Disability,0,6,6,3,9
Assam,Baksa,Intellectual Disability,6,15,41,30,71
Assam,Baksa,Intellectual Disability,15,35,74,76,150
Assam,Baksa,Intellectual Disability,35,60,36,26,62
Assam,Baksa,Intellectual Disability,60,80,2,1,3
Assam,Bajali,Intellectual Disability,0,6,0,1,1
Assam,Bajali,Intellectual Disability,6,15,1,2,3
Assam,Bajali,Intellectual Disability,15,35,1,4,5
Assam,Bajali,Intellectual Disability,35,60,0,5,5
Uttar Pradesh,Bahraich,Intellectual Disability,0,6,5,0,5
Uttar Pradesh,Bahraich,Intellectual Disability,6,15,83,49,132
Uttar Pradesh,Bahraich,Intellectual Disability,15,35,75,39,114
Uttar Pradesh,Bahraich,Intellectual Disability,35,60,28,4,32
Uttar Pradesh,Bahraich,Intellectual Disability,60,80,3,0,3
Uttar Pradesh,Bahraich,Intellectual Disability,80,100,1,0,1
Uttar Pradesh,Baghpat,Intellectual Disability,0,6,5,0,5
Uttar Pradesh,Baghpat,Intellectual Disability,6,15,11,6,17
Uttar Pradesh,Baghpat,Intellectual Disability,15,35,48,12,60
Uttar Pradesh,Baghpat,Intellectual Disability,35,60,23,5,28
Uttar Pradesh,Baghpat,Intellectual Disability,60,80,2,0,2
Uttarakhand,Bageshwar,Intellectual Disability,0,6,3,0,3
Uttarakhand,Bageshwar,Intellectual Disability,6,15,33,18,51
Uttarakhand,Bageshwar,Intellectual Disability,15,35,115,75,190
Uttarakhand,Bageshwar,Intellectual Disability,35,60,170,78,248
Uttarakhand,Bageshwar,Intellectual Disability,60,80,15,4,19
Uttarakhand,Bageshwar,Intellectual Disability,80,100,2,0,2
Karnataka,Bagalkote,Intellectual Disability,0,6,103,60,163
Karnataka,Bagalkote,Intellectual Disability,6,15,715,476,1191
Karnataka,Bagalkote,Intellectual Disability,15,35,908,665,1573
Karnataka,Bagalkote,Intellectual Disability,35,60,200,166,366
Karnataka,Bagalkote,Intellectual Disability,60,80,6,8,14
Uttar Pradesh,Azamgarh,Intellectual Disability,0,6,1,0,1
Uttar Pradesh,Azamgarh,Intellectual Disability,6,15,23,13,36
Uttar Pradesh,Azamgarh,Intellectual Disability,15,35,108,59,167
Uttar Pradesh,Azamgarh,Intellectual Disability,35,60,24,5,29
Uttar Pradesh,Azamgarh,Intellectual Disability,60,80,1,1,2
Uttar Pradesh,Azamgarh,Intellectual Disability,80,100,2,0,2
Uttar Pradesh,Ayodhya,Intellectual Disability,0,6,11,6,17
Uttar Pradesh,Ayodhya,Intellectual Disability,6,15,113,81,194
Uttar Pradesh,Ayodhya,Intellectual Disability,15,35,106,52,158
Uttar Pradesh,Ayodhya,Intellectual Disability,35,60,31,12,43
Uttar Pradesh,Ayodhya,Intellectual Disability,60,80,4,0,4
Bihar,Aurangabad,Intellectual Disability,6,15,4,1,5
Bihar,Aurangabad,Intellectual Disability,15,35,15,10,25
Bihar,Aurangabad,Intellectual Disability,35,60,11,5,16
Bihar,Aurangabad,Intellectual Disability,60,80,4,0,4
Maharashtra,Aurangabad,Intellectual Disability,0,6,36,31,67
Maharashtra,Aurangabad,Intellectual Disability,6,15,731,422,1153
Maharashtra,Aurangabad,Intellectual Disability,15,35,906,499,1405
Maharashtra,Aurangabad,Intellectual Disability,35,60,154,103,257
Maharashtra,Aurangabad,Intellectual Disability,60,80,3,0,3
Uttar Pradesh,Auraiya,Intellectual Disability,0,6,5,1,6
Uttar Pradesh,Auraiya,Intellectual Disability,6,15,27,12,39
Uttar Pradesh,Auraiya,Intellectual Disability,15,35,41,13,54
Uttar Pradesh,Auraiya,Intellectual Disability,35,60,19,7,26
Uttar Pradesh,Auraiya,Intellectual Disability,60,80,5,2,7
Uttar Pradesh,Auraiya,Intellectual Disability,80,100,1,0,1
Madhya Pradesh,Ashoknagar,Intellectual Disability,0,6,16,14,30
Madhya Pradesh,Ashoknagar,Intellectual Disability,6,15,146,80,226
Madhya Pradesh,Ashoknagar,Intellectual Disability,15,35,332,172,504
Madhya Pradesh,Ashoknagar,Intellectual Disability,35,60,112,44,156
Madhya Pradesh,Ashoknagar,Intellectual Disability,60,80,9,5,14
Madhya Pradesh,Ashoknagar,Intellectual Disability,80,100,1,1,2
Bihar,Arwal,Intellectual Disability,6,15,8,6,14
Bihar,Arwal,Intellectual Disability,15,35,37,28,65
Bihar,Arwal,Intellectual Disability,35,60,14,4,18
Bihar,Arwal,Intellectual Disability,60,80,2,0,2
Gujarat,Arvalli,Intellectual Disability,0,6,24,18,42
Gujarat,Arvalli,Intellectual Disability,6,15,507,331,838
Gujarat,Arvalli,Intellectual Disability,15,35,543,277,820
Gujarat,Arvalli,Intellectual Disability,35,60,101,126,227
Gujarat,Arvalli,Intellectual Disability,60,80,4,8,12
Tamil Nadu,Ariyalur,Intellectual Disability,0,6,45,32,77
Tamil Nadu,Ariyalur,Intellectual Disability,6,15,408,268,676
Tamil Nadu,Ariyalur,Intellectual Disability,15,35,819,565,1384
Tamil Nadu,Ariyalur,Intellectual Disability,35,60,246,194,440
Tamil Nadu,Ariyalur,Intellectual Disability,60,80,21,9,30
Tamil Nadu,Ariyalur,Intellectual Disability,80,100,1,1,2
Bihar,Araria,Intellectual Disability,0,6,2,0,2
Bihar,Araria,Intellectual Disability,6,15,6,10,16
Bihar,Araria,Intellectual Disability,15,35,13,8,21
Bihar,Araria,Intellectual Disability,35,60,4,4,8
Bihar,Araria,Intellectual Disability,60,80,1,0,1
Madhya Pradesh,Anuppur,Intellectual Disability,0,6,1,2,3
Madhya Pradesh,Anuppur,Intellectual Disability,6,15,11,12,23
Madhya Pradesh,Anuppur,Intellectual Disability,15,35,88,89,177
Madhya Pradesh,Anuppur,Intellectual Disability,35,60,41,35,76
Madhya Pradesh,Anuppur,Intellectual Disability,60,80,7,3,10
Madhya Pradesh,Anuppur,Intellectual Disability,80,100,1,0,1
Odisha,Anugul,Intellectual Disability,0,6,15,5,20
Odisha,Anugul,Intellectual Disability,6,15,73,46,119
Odisha,Anugul,Intellectual Disability,15,35,120,106,226
Odisha,Anugul,Intellectual Disability,35,60,66,33,99
Odisha,Anugul,Intellectual Disability,60,80,7,4,11
Arunachal Pradesh,Anjaw,Intellectual Disability,6,15,0,1,1
Arunachal Pradesh,Anjaw,Intellectual Disability,15,35,1,0,1
Jammu And Kashmir,Anantnag,Intellectual Disability,0,6,18,16,34
Jammu And Kashmir,Anantnag,Intellectual Disability,6,15,115,78,193
Jammu And Kashmir,Anantnag,Intellectual Disability,15,35,159,132,291
Jammu And Kashmir,Anantnag,Intellectual Disability,35,60,53,49,102
Jammu And Kashmir,Anantnag,Intellectual Disability,60,80,5,3,8
Andhra Pradesh,Anantapur,Intellectual Disability,0,6,55,27,82
Andhra Pradesh,Anantapur,Intellectual Disability,6,15,593,390,983
Andhra Pradesh,Anantapur,Intellectual Disability,15,35,357,272,629
Andhra Pradesh,Anantapur,Intellectual Disability,35,60,86,61,147
Andhra Pradesh,Anantapur,Intellectual Disability,60,80,6,4,10
Gujarat,Anand,Intellectual Disability,0,6,33,25,58
Gujarat,Anand,Intellectual Disability,6,15,666,439,1105
Gujarat,Anand,Intellectual Disability,15,35,980,477,1457
Gujarat,Anand,Intellectual Disability,35,60,139,116,255
Gujarat,Anand,Intellectual Disability,60,80,11,8,19
Uttar Pradesh,Amroha,Intellectual Disability,0,6,5,3,8
Uttar Pradesh,Amroha,Intellectual Disability,6,15,24,17,41
Uttar Pradesh,Amroha,Intellectual Disability,15,35,51,27,78
Uttar Pradesh,Amroha,Intellectual Disability,35,60,27,8,35
Uttar Pradesh,Amroha,Intellectual Disability,60,80,11,3,14
Punjab,Amritsar,Intellectual Disability,0,6,42,37,79
Punjab,Amritsar,Intellectual Disability,6,15,584,318,902
Punjab,Amritsar,Intellectual Disability,15,35,1363,674,2037
Punjab,Amritsar,Intellectual Disability,35,60,372,232,604
Punjab,Amritsar,Intellectual Disability,60,80,27,12,39
Gujarat,Amreli,Intellectual Disability,0,6,28,18,46
Gujarat,Amreli,Intellectual Disability,6,15,354,261,615
Gujarat,Amreli,Intellectual Disability,15,35,390,219,609
Gujarat,Amreli,Intellectual Disability,35,60,104,47,151
Gujarat,Amreli,Intellectual Disability,60,80,6,6,12
Maharashtra,Amravati,Intellectual Disability,0,6,177,96,273
Maharashtra,Amravati,Intellectual Disability,6,15,1122,703,1825
Maharashtra,Amravati,Intellectual Disability,15,35,1521,917,2438
Maharashtra,Amravati,Intellectual Disability,35,60,436,293,729
Maharashtra,Amravati,Intellectual Disability,60,80,26,18,44
Maharashtra,Amravati,Intellectual Disability,80,100,1,0,1
Uttar Pradesh,Amethi,Intellectual Disability,6,15,13,6,19
Uttar Pradesh,Amethi,Intellectual Disability,15,35,54,31,85
Uttar Pradesh,Amethi,Intellectual Disability,35,60,15,7,22
Uttar Pradesh,Amethi,Intellectual Disability,60,80,5,1,6
Uttar Pradesh,Ambedkar Nagar,Intellectual Disability,0,6,5,1,6
Uttar Pradesh,Ambedkar Nagar,Intellectual Disability,6,15,77,48,125
Uttar Pradesh,Ambedkar Nagar,Intellectual Disability,15,35,138,78,216
Uttar Pradesh,Ambedkar Nagar,Intellectual Disability,35,60,36,22,58
Uttar Pradesh,Ambedkar Nagar,Intellectual Disability,60,80,6,0,6
Haryana,Ambala,Intellectual Disability,0,6,44,17,61
Haryana,Ambala,Intellectual Disability,6,15,345,195,540
Haryana,Ambala,Intellectual Disability,15,35,465,299,764
Haryana,Ambala,Intellectual Disability,35,60,156,88,244
Haryana,Ambala,Intellectual Disability,60,80,16,6,22
Haryana,Ambala,Intellectual Disability,80,100,2,0,2
Rajasthan,Alwar,Intellectual Disability,0,6,2,2,4
Rajasthan,Alwar,Intellectual Disability,6,15,67,40,107
Rajasthan,Alwar,Intellectual Disability,15,35,121,71,192
Rajasthan,Alwar,Intellectual Disability,35,60,29,10,39
Rajasthan,Alwar,Intellectual Disability,60,80,2,0,2
Rajasthan,Alwar,Intellectual Disability,80,100,1,0,1
Uttarakhand,Almora,Intellectual Disability,0,6,4,1,5
Uttarakhand,Almora,Intellectual Disability,6,15,51,27,78
Uttarakhand,Almora,Intellectual Disability,15,35,207,106,313
Uttarakhand,Almora,Intellectual Disability,35,60,162,71,233
Uttarakhand,Almora,Intellectual Disability,60,80,15,2,17
Madhya Pradesh,Alirajpur,Intellectual Disability,0,6,1,0,1
Madhya Pradesh,Alirajpur,Intellectual Disability,6,15,3,4,7
Madhya Pradesh,Alirajpur,Intellectual Disability,15,35,27,22,49
Madhya Pradesh,Alirajpur,Intellectual Disability,35,60,22,9,31
Madhya Pradesh,Alirajpur,Intellectual Disability,60,80,3,0,3
Uttar Pradesh,Aligarh,Intellectual Disability,0,6,46,17,63
Uttar Pradesh,Aligarh,Intellectual Disability,6,15,301,155,456
Uttar Pradesh,Aligarh,Intellectual Disability,15,35,221,84,305
Uttar Pradesh,Aligarh,Intellectual Disability,35,60,42,12,54
Uttar Pradesh,Aligarh,Intellectual Disability,60,80,0,1,1
Uttar Pradesh,Aligarh,Intellectual Disability,80,100,1,0,1
Kerala,Alappuzha,Intellectual Disability,0,6,20,18,38
Kerala,Alappuzha,Intellectual Disability,6,15,272,174,446
Kerala,Alappuzha,Intellectual Disability,15,35,1064,649,1713
Kerala,Alappuzha,Intellectual Disability,35,60,495,424,919
Kerala,Alappuzha,Intellectual Disability,60,80,53,40,93
Kerala,Alappuzha,Intellectual Disability,80,100,1,1,2
Maharashtra,Akola,Intellectual Disability,0,6,12,5,17
Maharashtra,Akola,Intellectual Disability,6,15,279,155,434
Maharashtra,Akola,Intellectual Disability,15,35,571,332,903
Maharashtra,Akola,Intellectual Disability,35,60,117,98,215
Maharashtra,Akola,Intellectual Disability,60,80,3,1,4
Rajasthan,Ajmer,Intellectual Disability,0,6,24,18,42
Rajasthan,Ajmer,Intellectual Disability,6,15,244,154,398
Rajasthan,Ajmer,Intellectual Disability,15,35,363,175,538
Rajasthan,Ajmer,Intellectual Disability,35,60,86,29,115
Rajasthan,Ajmer,Intellectual Disability,60,80,1,7,8
Mizoram,Aizawl,Intellectual Disability,0,6,12,4,16
Mizoram,Aizawl,Intellectual Disability,6,15,48,50,98
Mizoram,Aizawl,Intellectual Disability,15,35,129,64,193
Mizoram,Aizawl,Intellectual Disability,35,60,53,55,108
Mizoram,Aizawl,Intellectual Disability,60,80,10,13,23
Maharashtra,Ahmednagar,Intellectual Disability,0,6,128,101,229
Maharashtra,Ahmednagar,Intellectual Disability,6,15,1162,677,1839
Maharashtra,Ahmednagar,Intellectual Disability,15,35,1495,757,2252
Maharashtra,Ahmednagar,Intellectual Disability,35,60,385,242,627
Maharashtra,Ahmednagar,Intellectual Disability,60,80,24,8,32
Maharashtra,Ahmednagar,Intellectual Disability,80,100,1,0,1
Gujarat,Ahmadabad,Intellectual Disability,0,6,128,61,189
Gujarat,Ahmadabad,Intellectual Disability,6,15,1797,1070,2867
Gujarat,Ahmadabad,Intellectual Disability,15,35,2305,1092,3397
Gujarat,Ahmadabad,Intellectual Disability,35,60,469,293,762
Gujarat,Ahmadabad,Intellectual Disability,60,80,19,7,26
Gujarat,Ahmadabad,Intellectual Disability,80,100,0,1,1
Uttar Pradesh,Agra,Intellectual Disability,0,6,47,18,65
Uttar Pradesh,Agra,Intellectual Disability,6,15,478,221,699
Uttar Pradesh,Agra,Intellectual Disability,15,35,480,136,616
Uttar Pradesh,Agra,Intellectual Disability,35,60,75,16,91
Uttar Pradesh,Agra,Intellectual Disability,60,80,2,0,2
Madhya Pradesh,Agar Malwa,Intellectual Disability,0,6,1,0,1
Madhya Pradesh,Agar Malwa,Intellectual Disability,6,15,50,36,86
Madhya Pradesh,Agar Malwa,Intellectual Disability,15,35,112,49,161
Madhya Pradesh,Agar Malwa,Intellectual Disability,35,60,65,16,81
Madhya Pradesh,Agar Malwa,Intellectual Disability,60,80,8,2,10
Telangana,Adilabad,Intellectual Disability,6,15,30,18,48
Telangana,Adilabad,Intellectual Disability,15,35,106,87,193
Telangana,Adilabad,Intellectual Disability,35,60,23,26,49
Telangana,Adilabad,Intellectual Disability,60,80,3,1,4
West Bengal,24 Paraganas South,Intellectual Disability,6,15,1,1,2
West Bengal,24 Paraganas South,Intellectual Disability,15,35,2,2,4
West Bengal,24 Paraganas North,Intellectual Disability,6,15,1,0,1
Maharashtra,Yavatmal,Leprosy Cured,15,35,2,0,2
Maharashtra,Yavatmal,Leprosy Cured,35,60,4,1,5
Maharashtra,Yavatmal,Leprosy Cured,60,80,2,1,3
Haryana,Yamunanagar,Leprosy Cured,15,35,5,4,9
Haryana,Yamunanagar,Leprosy Cured,35,60,28,31,59
Haryana,Yamunanagar,Leprosy Cured,60,80,14,18,32
Haryana,Yamunanagar,Leprosy Cured,80,100,1,2,3
Karnataka,Yadgir,Leprosy Cured,15,35,7,1,8
Karnataka,Yadgir,Leprosy Cured,35,60,15,7,22
Karnataka,Yadgir,Leprosy Cured,60,80,0,2,2
Jharkhand,West Singhbhum,Leprosy Cured,6,15,2,2,4
Jharkhand,West Singhbhum,Leprosy Cured,15,35,5,1,6
Jharkhand,West Singhbhum,Leprosy Cured,35,60,11,4,15
Meghalaya,West Jaintia Hills,Leprosy Cured,60,80,1,0,1
Meghalaya,West Garo Hills,Leprosy Cured,35,60,1,1,2
Meghalaya,West Garo Hills,Leprosy Cured,60,80,10,4,14
Meghalaya,West Garo Hills,Leprosy Cured,80,100,1,0,1
Delhi,West,Leprosy Cured,15,35,0,2,2
Delhi,West,Leprosy Cured,35,60,2,2,4
Kerala,Wayanad,Leprosy Cured,35,60,2,0,2
Maharashtra,Washim,Leprosy Cured,15,35,1,0,1
Maharashtra,Washim,Leprosy Cured,35,60,1,1,2
Maharashtra,Washim,Leprosy Cured,60,80,4,2,6
Maharashtra,Wardha,Leprosy Cured,35,60,5,4,9
Maharashtra,Wardha,Leprosy Cured,60,80,8,3,11
Maharashtra,Wardha,Leprosy Cured,80,100,2,1,3
Andhra Pradesh,Vizianagaram,Leprosy Cured,35,60,1,0,1
Tamil Nadu,Virudhunagar,Leprosy Cured,6,15,3,1,4
Tamil Nadu,Virudhunagar,Leprosy Cured,15,35,4,6,10
Tamil Nadu,Virudhunagar,Leprosy Cured,35,60,61,31,92
Tamil Nadu,Virudhunagar,Leprosy Cured,60,80,88,33,121
Tamil Nadu,Virudhunagar,Leprosy Cured,80,100,7,1,8
Tamil Nadu,Villupuram,Leprosy Cured,15,35,9,4,13
Tamil Nadu,Villupuram,Leprosy Cured,35,60,88,66,154
Tamil Nadu,Villupuram,Leprosy Cured,60,80,179,104,283
Tamil Nadu,Villupuram,Leprosy Cured,80,100,39,10,49
Karnataka,Vijayapura,Leprosy Cured,6,15,1,0,1
Karnataka,Vijayapura,Leprosy Cured,15,35,9,3,12
Karnataka,Vijayapura,Leprosy Cured,35,60,16,12,28
Karnataka,Vijayapura,Leprosy Cured,60,80,14,7,21
Karnataka,Vijayapura,Leprosy Cured,80,100,1,0,1
Madhya Pradesh,Vidisha,Leprosy Cured,6,15,2,0,2
Madhya Pradesh,Vidisha,Leprosy Cured,15,35,29,10,39
Madhya Pradesh,Vidisha,Leprosy Cured,35,60,30,15,45
Madhya Pradesh,Vidisha,Leprosy Cured,60,80,13,5,18
Madhya Pradesh,Vidisha,Leprosy Cured,80,100,1,0,1
Tamil Nadu,Vellore,Leprosy Cured,15,35,2,3,5
Tamil Nadu,Vellore,Leprosy Cured,35,60,37,25,62
Tamil Nadu,Vellore,Leprosy Cured,60,80,78,36,114
Tamil Nadu,Vellore,Leprosy Cured,80,100,11,0,11
Uttar Pradesh,Varanasi,Leprosy Cured,15,35,17,5,22
Uttar Pradesh,Varanasi,Leprosy Cured,35,60,46,26,72
Uttar Pradesh,Varanasi,Leprosy Cured,60,80,29,13,42
Gujarat,Valsad,Leprosy Cured,35,60,0,1,1
Bihar,Vaishali,Leprosy Cured,6,15,2,0,2
Bihar,Vaishali,Leprosy Cured,15,35,3,2,5
Bihar,Vaishali,Leprosy Cured,35,60,18,7,25
Bihar,Vaishali,Leprosy Cured,60,80,4,2,6
Gujarat,Vadodara,Leprosy Cured,35,60,26,26,52
Gujarat,Vadodara,Leprosy Cured,60,80,37,32,69
Gujarat,Vadodara,Leprosy Cured,80,100,1,3,4
Karnataka,Uttara Kannada,Leprosy Cured,15,35,2,1,3
Karnataka,Uttara Kannada,Leprosy Cured,35,60,2,3,5
Karnataka,Uttara Kannada,Leprosy Cured,60,80,2,1,3
Uttarakhand,Uttar Kashi,Leprosy Cured,15,35,2,0,2
Uttarakhand,Uttar Kashi,Leprosy Cured,35,60,1,0,1
Uttar Pradesh,Unnao,Leprosy Cured,15,35,44,22,66
Uttar Pradesh,Unnao,Leprosy Cured,35,60,108,36,144
Uttar Pradesh,Unnao,Leprosy Cured,60,80,75,11,86
Uttar Pradesh,Unnao,Leprosy Cured,80,100,3,0,3
Tripura,Unakoti,Leprosy Cured,35,60,1,1,2
Tripura,Unakoti,Leprosy Cured,60,80,1,0,1
Himachal Pradesh,Una,Leprosy Cured,6,15,0,1,1
Himachal Pradesh,Una,Leprosy Cured,15,35,1,2,3
Himachal Pradesh,Una,Leprosy Cured,60,80,2,0,2
Madhya Pradesh,Umaria,Leprosy Cured,6,15,2,0,2
Madhya Pradesh,Umaria,Leprosy Cured,15,35,5,4,9
Madhya Pradesh,Umaria,Leprosy Cured,35,60,6,5,11
Madhya Pradesh,Umaria,Leprosy Cured,80,100,0,1,1
Madhya Pradesh,Ujjain,Leprosy Cured,6,15,1,0,1
Madhya Pradesh,Ujjain,Leprosy Cured,15,35,5,1,6
Madhya Pradesh,Ujjain,Leprosy Cured,35,60,17,12,29
Madhya Pradesh,Ujjain,Leprosy Cured,60,80,10,18,28
Madhya Pradesh,Ujjain,Leprosy Cured,80,100,4,5,9
Karnataka,Udupi,Leprosy Cured,6,15,1,0,1
Karnataka,Udupi,Leprosy Cured,15,35,0,1,1
Karnataka,Udupi,Leprosy Cured,35,60,2,0,2
Karnataka,Udupi,Leprosy Cured,60,80,4,3,7
Jammu And Kashmir,Udhampur,Leprosy Cured,35,60,2,0,2
Jammu And Kashmir,Udhampur,Leprosy Cured,60,80,3,1,4
Uttarakhand,Udam Singh Nagar,Leprosy Cured,6,15,0,1,1
Uttarakhand,Udam Singh Nagar,Leprosy Cured,15,35,2,1,3
Uttarakhand,Udam Singh Nagar,Leprosy Cured,35,60,4,1,5
Uttarakhand,Udam Singh Nagar,Leprosy Cured,60,80,4,0,4
Assam,Udalguri,Leprosy Cured,35,60,0,1,1
Rajasthan,Udaipur,Leprosy Cured,15,35,4,2,6
Rajasthan,Udaipur,Leprosy Cured,35,60,14,9,23
Rajasthan,Udaipur,Leprosy Cured,60,80,13,6,19
Rajasthan,Udaipur,Leprosy Cured,80,100,0,1,1
Tamil Nadu,Tuticorin,Leprosy Cured,6,15,0,1,1
Tamil Nadu,Tuticorin,Leprosy Cured,15,35,3,2,5
Tamil Nadu,Tuticorin,Leprosy Cured,35,60,35,26,61
Tamil Nadu,Tuticorin,Leprosy Cured,60,80,68,26,94
Tamil Nadu,Tuticorin,Leprosy Cured,80,100,12,3,15
Karnataka,Tumakuru,Leprosy Cured,6,15,2,0,2
Karnataka,Tumakuru,Leprosy Cured,15,35,2,1,3
Karnataka,Tumakuru,Leprosy Cured,35,60,12,5,17
Karnataka,Tumakuru,Leprosy Cured,60,80,6,3,9
Karnataka,Tumakuru,Leprosy Cured,80,100,2,0,2
Tamil Nadu,Tiruvannamalai,Leprosy Cured,6,15,3,0,3
Tamil Nadu,Tiruvannamalai,Leprosy Cured,15,35,5,1,6
Tamil Nadu,Tiruvannamalai,Leprosy Cured,35,60,62,40,102
Tamil Nadu,Tiruvannamalai,Leprosy Cured,60,80,115,60,175
Tamil Nadu,Tiruvannamalai,Leprosy Cured,80,100,24,8,32
Tamil Nadu,Tiruppur,Leprosy Cured,15,35,3,1,4
Tamil Nadu,Tiruppur,Leprosy Cured,35,60,26,14,40
Tamil Nadu,Tiruppur,Leprosy Cured,60,80,31,9,40
Tamil Nadu,Tiruppur,Leprosy Cured,80,100,3,1,4
Tamil Nadu,Tirupathur,Leprosy Cured,15,35,1,0,1
Tamil Nadu,Tirupathur,Leprosy Cured,35,60,6,6,12
Tamil Nadu,Tirupathur,Leprosy Cured,60,80,14,4,18
Tamil Nadu,Tirupathur,Leprosy Cured,80,100,0,2,2
Tamil Nadu,Tirunelveli,Leprosy Cured,15,35,2,0,2
Tamil Nadu,Tirunelveli,Leprosy Cured,35,60,46,24,70
Tamil Nadu,Tirunelveli,Leprosy Cured,60,80,102,44,146
Tamil Nadu,Tirunelveli,Leprosy Cured,80,100,10,4,14
Tamil Nadu,Tiruchirappalli,Leprosy Cured,15,35,6,2,8
Tamil Nadu,Tiruchirappalli,Leprosy Cured,35,60,103,52,155
Tamil Nadu,Tiruchirappalli,Leprosy Cured,60,80,154,76,230
Tamil Nadu,Tiruchirappalli,Leprosy Cured,80,100,14,3,17
Assam,Tinsukia,Leprosy Cured,15,35,2,0,2
Madhya Pradesh,Tikamgarh,Leprosy Cured,15,35,3,0,3
Madhya Pradesh,Tikamgarh,Leprosy Cured,35,60,11,4,15
Madhya Pradesh,Tikamgarh,Leprosy Cured,60,80,2,3,5
Madhya Pradesh,Tikamgarh,Leprosy Cured,80,100,0,1,1
Kerala,Thrissur,Leprosy Cured,15,35,1,1,2
Kerala,Thrissur,Leprosy Cured,35,60,2,1,3
Kerala,Thrissur,Leprosy Cured,60,80,9,1,10
Tamil Nadu,Thiruvarur,Leprosy Cured,15,35,2,0,2
Tamil Nadu,Thiruvarur,Leprosy Cured,35,60,23,12,35
Tamil Nadu,Thiruvarur,Leprosy Cured,60,80,71,23,94
Tamil Nadu,Thiruvarur,Leprosy Cured,80,100,8,1,9
Kerala,Thiruvananthapuram,Leprosy Cured,35,60,3,2,5
Kerala,Thiruvananthapuram,Leprosy Cured,60,80,6,1,7
Kerala,Thiruvananthapuram,Leprosy Cured,80,100,1,0,1
Tamil Nadu,Thiruvallur,Leprosy Cured,6,15,1,0,1
Tamil Nadu,Thiruvallur,Leprosy Cured,15,35,1,3,4
Tamil Nadu,Thiruvallur,Leprosy Cured,35,60,91,44,135
Tamil Nadu,Thiruvallur,Leprosy Cured,60,80,98,48,146
Tamil Nadu,Thiruvallur,Leprosy Cured,80,100,6,1,7
Tamil Nadu,Theni,Leprosy Cured,15,35,3,3,6
Tamil Nadu,Theni,Leprosy Cured,35,60,61,21,82
Tamil Nadu,Theni,Leprosy Cured,60,80,90,33,123
Tamil Nadu,Theni,Leprosy Cured,80,100,9,1,10
Tamil Nadu,The Nilgiris,Leprosy Cured,60,80,1,0,1
Tamil Nadu,Thanjavur,Leprosy Cured,15,35,6,3,9
Tamil Nadu,Thanjavur,Leprosy Cured,35,60,74,37,111
Tamil Nadu,Thanjavur,Leprosy Cured,60,80,158,89,247
Tamil Nadu,Thanjavur,Leprosy Cured,80,100,28,19,47
Maharashtra,Thane,Leprosy Cured,6,15,1,0,1
Maharashtra,Thane,Leprosy Cured,15,35,5,12,17
Maharashtra,Thane,Leprosy Cured,35,60,70,45,115
Maharashtra,Thane,Leprosy Cured,60,80,59,37,96
Maharashtra,Thane,Leprosy Cured,80,100,1,0,1
Tamil Nadu,Tenkasi,Leprosy Cured,15,35,3,0,3
Tamil Nadu,Tenkasi,Leprosy Cured,35,60,18,8,26
Tamil Nadu,Tenkasi,Leprosy Cured,60,80,32,9,41
Tamil Nadu,Tenkasi,Leprosy Cured,80,100,1,1,2
Uttarakhand,Tehri Garhwal,Leprosy Cured,6,15,1,0,1
Arunachal Pradesh,Tawang,Leprosy Cured,60,80,1,0,1
Arunachal Pradesh,Tawang,Leprosy Cured,80,100,1,1,2
Punjab,Tarn Taran,Leprosy Cured,15,35,2,5,7
Punjab,Tarn Taran,Leprosy Cured,35,60,16,13,29
Punjab,Tarn Taran,Leprosy Cured,80,100,1,0,1
Chhattisgarh,Surguja,Leprosy Cured,35,60,1,0,1
Gujarat,Surendranagar,Leprosy Cured,15,35,1,0,1
Gujarat,Surat,Leprosy Cured,35,60,1,0,1
Gujarat,Surat,Leprosy Cured,60,80,0,1,1
Chhattisgarh,Surajpur,Leprosy Cured,6,15,1,0,1
Chhattisgarh,Surajpur,Leprosy Cured,15,35,3,0,3
Chhattisgarh,Surajpur,Leprosy Cured,35,60,6,4,10
Chhattisgarh,Surajpur,Leprosy Cured,60,80,2,1,3
Chhattisgarh,Surajpur,Leprosy Cured,80,100,2,0,2
Bihar,Supaul,Leprosy Cured,6,15,1,0,1
Bihar,Supaul,Leprosy Cured,15,35,3,1,4
Bihar,Supaul,Leprosy Cured,35,60,18,6,24
Bihar,Supaul,Leprosy Cured,60,80,5,1,6
Bihar,Supaul,Leprosy Cured,80,100,1,0,1
Odisha,Sundargarh,Leprosy Cured,0,6,1,0,1
Odisha,Sundargarh,Leprosy Cured,6,15,1,2,3
Odisha,Sundargarh,Leprosy Cured,15,35,7,14,21
Odisha,Sundargarh,Leprosy Cured,35,60,47,42,89
Odisha,Sundargarh,Leprosy Cured,60,80,20,20,40
Odisha,Sundargarh,Leprosy Cured,80,100,0,1,1
Uttar Pradesh,Sultanpur,Leprosy Cured,6,15,2,1,3
Uttar Pradesh,Sultanpur,Leprosy Cured,15,35,20,5,25
Uttar Pradesh,Sultanpur,Leprosy Cured,35,60,45,5,50
Uttar Pradesh,Sultanpur,Leprosy Cured,60,80,11,1,12
Uttar Pradesh,Sultanpur,Leprosy Cured,80,100,1,0,1
Jammu And Kashmir,Srinagar,Leprosy Cured,15,35,1,0,1
Jammu And Kashmir,Srinagar,Leprosy Cured,35,60,1,1,2
Jammu And Kashmir,Srinagar,Leprosy Cured,60,80,1,1,2
Andhra Pradesh,Srikakulam,Leprosy Cured,35,60,1,0,1
Punjab,Sri Muktsar Sahib,Leprosy Cured,15,35,7,2,9
Punjab,Sri Muktsar Sahib,Leprosy Cured,35,60,18,4,22
Punjab,Sri Muktsar Sahib,Leprosy Cured,60,80,7,3,10
Punjab,Sri Muktsar Sahib,Leprosy Cured,80,100,1,1,2
Meghalaya,South West Khasi Hills,Leprosy Cured,35,60,1,0,1
Delhi,South West,Leprosy Cured,35,60,0,1,1
Goa,South Goa,Leprosy Cured,35,60,1,1,2
Andaman And Nicobar Islands,South Andamans,Leprosy Cured,35,60,2,0,2
Andaman And Nicobar Islands,South Andamans,Leprosy Cured,60,80,1,0,1
Delhi,South,Leprosy Cured,35,60,0,1,1
Assam,Sonitpur,Leprosy Cured,15,35,1,0,1
Assam,Sonitpur,Leprosy Cured,35,60,2,0,2
Assam,Sonitpur,Leprosy Cured,60,80,2,0,2
Haryana,Sonipat,Leprosy Cured,15,35,1,0,1
Haryana,Sonipat,Leprosy Cured,35,60,7,3,10
Haryana,Sonipat,Leprosy Cured,60,80,7,4,11
Odisha,Sonepur,Leprosy Cured,15,35,1,0,1
Odisha,Sonepur,Leprosy Cured,35,60,11,4,15
Odisha,Sonepur,Leprosy Cured,60,80,5,0,5
Uttar Pradesh,Sonbhadra,Leprosy Cured,6,15,1,0,1
Uttar Pradesh,Sonbhadra,Leprosy Cured,15,35,13,9,22
Uttar Pradesh,Sonbhadra,Leprosy Cured,35,60,26,7,33
Uttar Pradesh,Sonbhadra,Leprosy Cured,60,80,17,2,19
Maharashtra,Solapur,Leprosy Cured,35,60,3,2,5
Maharashtra,Solapur,Leprosy Cured,60,80,9,3,12
Maharashtra,Solapur,Leprosy Cured,80,100,2,0,2
Himachal Pradesh,Solan,Leprosy Cured,0,6,1,0,1
Himachal Pradesh,Solan,Leprosy Cured,35,60,0,2,2
Himachal Pradesh,Solan,Leprosy Cured,60,80,0,1,1
Bihar,Siwan,Leprosy Cured,0,6,1,0,1
Bihar,Siwan,Leprosy Cured,6,15,0,1,1
Bihar,Siwan,Leprosy Cured,15,35,4,4,8
Bihar,Siwan,Leprosy Cured,35,60,5,1,6
Bihar,Siwan,Leprosy Cured,60,80,1,2,3
Assam,Sivasagar,Leprosy Cured,15,35,0,1,1
Tamil Nadu,Sivaganga,Leprosy Cured,15,35,3,1,4
Tamil Nadu,Sivaganga,Leprosy Cured,35,60,46,33,79
Tamil Nadu,Sivaganga,Leprosy Cured,60,80,115,40,155
Tamil Nadu,Sivaganga,Leprosy Cured,80,100,8,1,9
Uttar Pradesh,Sitapur,Leprosy Cured,15,35,25,8,33
Uttar Pradesh,Sitapur,Leprosy Cured,35,60,48,18,66
Uttar Pradesh,Sitapur,Leprosy Cured,60,80,14,0,14
Bihar,Sitamarhi,Leprosy Cured,0,6,0,1,1
Bihar,Sitamarhi,Leprosy Cured,6,15,0,1,1
Bihar,Sitamarhi,Leprosy Cured,15,35,10,5,15
Bihar,Sitamarhi,Leprosy Cured,35,60,28,10,38
Bihar,Sitamarhi,Leprosy Cured,60,80,20,4,24
Haryana,Sirsa,Leprosy Cured,15,35,1,0,1
Rajasthan,Sirohi,Leprosy Cured,6,15,0,2,2
Rajasthan,Sirohi,Leprosy Cured,15,35,1,3,4
Rajasthan,Sirohi,Leprosy Cured,35,60,2,0,2
Himachal Pradesh,Sirmaur,Leprosy Cured,15,35,1,0,1
Himachal Pradesh,Sirmaur,Leprosy Cured,35,60,5,4,9
Himachal Pradesh,Sirmaur,Leprosy Cured,60,80,7,0,7
Himachal Pradesh,Sirmaur,Leprosy Cured,80,100,1,1,2
Madhya Pradesh,Singrauli,Leprosy Cured,6,15,0,3,3
Madhya Pradesh,Singrauli,Leprosy Cured,15,35,5,3,8
Madhya Pradesh,Singrauli,Leprosy Cured,35,60,5,5,10
Madhya Pradesh,Singrauli,Leprosy Cured,60,80,0,1,1
Maharashtra,Sindhudurg,Leprosy Cured,15,35,1,0,1
Maharashtra,Sindhudurg,Leprosy Cured,35,60,0,1,1
Jharkhand,Simdega,Leprosy Cured,35,60,3,0,3
Rajasthan,Sikar,Leprosy Cured,15,35,1,0,1
Rajasthan,Sikar,Leprosy Cured,35,60,0,1,1
Madhya Pradesh,Sidhi,Leprosy Cured,6,15,2,1,3
Madhya Pradesh,Sidhi,Leprosy Cured,15,35,9,5,14
Madhya Pradesh,Sidhi,Leprosy Cured,35,60,35,8,43
Madhya Pradesh,Sidhi,Leprosy Cured,60,80,12,2,14
Madhya Pradesh,Sidhi,Leprosy Cured,80,100,3,0,3
Uttar Pradesh,Siddharth Nagar,Leprosy Cured,6,15,1,1,2
Uttar Pradesh,Siddharth Nagar,Leprosy Cured,15,35,29,31,60
Uttar Pradesh,Siddharth Nagar,Leprosy Cured,35,60,69,44,113
Uttar Pradesh,Siddharth Nagar,Leprosy Cured,60,80,53,13,66
Uttar Pradesh,Siddharth Nagar,Leprosy Cured,80,100,1,1,2
Uttar Pradesh,Shravasti,Leprosy Cured,6,15,0,1,1
Uttar Pradesh,Shravasti,Leprosy Cured,15,35,16,2,18
Uttar Pradesh,Shravasti,Leprosy Cured,35,60,19,5,24
Uttar Pradesh,Shravasti,Leprosy Cured,60,80,11,4,15
Uttar Pradesh,Shravasti,Leprosy Cured,80,100,2,0,2
Jammu And Kashmir,Shopian,Leprosy Cured,60,80,1,0,1
Madhya Pradesh,Shivpuri,Leprosy Cured,6,15,1,0,1
Madhya Pradesh,Shivpuri,Leprosy Cured,15,35,8,1,9
Madhya Pradesh,Shivpuri,Leprosy Cured,35,60,6,3,9
Madhya Pradesh,Shivpuri,Leprosy Cured,60,80,1,0,1
Karnataka,Shivamogga,Leprosy Cured,35,60,4,1,5
Karnataka,Shivamogga,Leprosy Cured,60,80,1,0,1
Himachal Pradesh,Shimla,Leprosy Cured,15,35,1,0,1
Himachal Pradesh,Shimla,Leprosy Cured,35,60,6,2,8
Himachal Pradesh,Shimla,Leprosy Cured,60,80,2,1,3
Madhya Pradesh,Sheopur,Leprosy Cured,6,15,0,1,1
Madhya Pradesh,Sheopur,Leprosy Cured,15,35,2,2,4
Madhya Pradesh,Sheopur,Leprosy Cured,35,60,5,3,8
Madhya Pradesh,Sheopur,Leprosy Cured,60,80,1,0,1
Bihar,Sheohar,Leprosy Cured,0,6,1,0,1
Bihar,Sheohar,Leprosy Cured,6,15,2,3,5
Bihar,Sheohar,Leprosy Cured,15,35,10,5,15
Bihar,Sheohar,Leprosy Cured,35,60,13,2,15
Bihar,Sheohar,Leprosy Cured,60,80,8,3,11
Bihar,Sheikhpura,Leprosy Cured,15,35,3,2,5
Bihar,Sheikhpura,Leprosy Cured,35,60,7,3,10
Bihar,Sheikhpura,Leprosy Cured,60,80,4,2,6
Uttar Pradesh,Shamli,Leprosy Cured,15,35,3,5,8
Uttar Pradesh,Shamli,Leprosy Cured,35,60,12,9,21
Uttar Pradesh,Shamli,Leprosy Cured,60,80,7,2,9
Uttar Pradesh,Shamli,Leprosy Cured,80,100,1,0,1
Madhya Pradesh,Shajapur,Leprosy Cured,6,15,0,1,1
Madhya Pradesh,Shajapur,Leprosy Cured,15,35,0,1,1
Madhya Pradesh,Shajapur,Leprosy Cured,35,60,3,4,7
Madhya Pradesh,Shajapur,Leprosy Cured,60,80,0,1,1
Uttar Pradesh,Shahjahanpur,Leprosy Cured,6,15,6,1,7
Uttar Pradesh,Shahjahanpur,Leprosy Cured,15,35,72,33,105
Uttar Pradesh,Shahjahanpur,Leprosy Cured,35,60,147,74,221
Uttar Pradesh,Shahjahanpur,Leprosy Cured,60,80,58,13,71
Uttar Pradesh,Shahjahanpur,Leprosy Cured,80,100,3,0,3
Punjab,Shahid Bhagat Singh Nagar,Leprosy Cured,15,35,8,6,14
Punjab,Shahid Bhagat Singh Nagar,Leprosy Cured,35,60,27,26,53
Punjab,Shahid Bhagat Singh Nagar,Leprosy Cured,60,80,9,10,19
Punjab,Shahid Bhagat Singh Nagar,Leprosy Cured,80,100,0,1,1
Madhya Pradesh,Shahdol,Leprosy Cured,6,15,7,5,12
Madhya Pradesh,Shahdol,Leprosy Cured,15,35,27,11,38
Madhya Pradesh,Shahdol,Leprosy Cured,35,60,54,22,76
Madhya Pradesh,Shahdol,Leprosy Cured,60,80,12,15,27
Madhya Pradesh,Shahdol,Leprosy Cured,80,100,1,1,2
Delhi,Shahdara,Leprosy Cured,15,35,21,12,33
Delhi,Shahdara,Leprosy Cured,35,60,251,93,344
Delhi,Shahdara,Leprosy Cured,60,80,83,16,99
Delhi,Shahdara,Leprosy Cured,80,100,2,0,2
Madhya Pradesh,Seoni,Leprosy Cured,6,15,1,1,2
Madhya Pradesh,Seoni,Leprosy Cured,15,35,10,4,14
Madhya Pradesh,Seoni,Leprosy Cured,35,60,7,9,16
Madhya Pradesh,Seoni,Leprosy Cured,60,80,5,1,6
Madhya Pradesh,Sehore,Leprosy Cured,15,35,0,3,3
Madhya Pradesh,Sehore,Leprosy Cured,35,60,5,4,9
Rajasthan,Sawai Madhopur,Leprosy Cured,6,15,1,2,3
Rajasthan,Sawai Madhopur,Leprosy Cured,35,60,0,1,1
Madhya Pradesh,Satna,Leprosy Cured,15,35,3,0,3
Madhya Pradesh,Satna,Leprosy Cured,35,60,5,0,5
Madhya Pradesh,Satna,Leprosy Cured,60,80,2,0,2
Maharashtra,Satara,Leprosy Cured,15,35,2,1,3
Maharashtra,Satara,Leprosy Cured,35,60,9,1,10
Maharashtra,Satara,Leprosy Cured,60,80,5,2,7
Maharashtra,Satara,Leprosy Cured,80,100,1,0,1
Bihar,Saran,Leprosy Cured,0,6,1,0,1
Bihar,Saran,Leprosy Cured,6,15,0,1,1
Bihar,Saran,Leprosy Cured,15,35,13,3,16
Bihar,Saran,Leprosy Cured,35,60,15,3,18
Bihar,Saran,Leprosy Cured,60,80,7,0,7
Bihar,Saran,Leprosy Cured,80,100,2,1,3
Jharkhand,Saraikela Kharsawan,Leprosy Cured,15,35,1,0,1
Jharkhand,Saraikela Kharsawan,Leprosy Cured,35,60,3,0,3
Uttar Pradesh,Sant Kabeer Nagar,Leprosy Cured,6,15,0,1,1
Uttar Pradesh,Sant Kabeer Nagar,Leprosy Cured,15,35,5,1,6
Uttar Pradesh,Sant Kabeer Nagar,Leprosy Cured,35,60,12,4,16
Uttar Pradesh,Sant Kabeer Nagar,Leprosy Cured,60,80,9,3,12
Uttar Pradesh,Sant Kabeer Nagar,Leprosy Cured,80,100,1,0,1
Punjab,Sangrur,Leprosy Cured,15,35,6,0,6
Punjab,Sangrur,Leprosy Cured,35,60,17,13,30
Punjab,Sangrur,Leprosy Cured,60,80,5,3,8
Maharashtra,Sangli,Leprosy Cured,15,35,0,1,1
Maharashtra,Sangli,Leprosy Cured,35,60,13,14,27
Maharashtra,Sangli,Leprosy Cured,60,80,21,43,64
Maharashtra,Sangli,Leprosy Cured,80,100,6,7,13
Uttar Pradesh,Sambhal,Leprosy Cured,15,35,4,7,11
Uttar Pradesh,Sambhal,Leprosy Cured,35,60,13,3,16
Uttar Pradesh,Sambhal,Leprosy Cured,60,80,2,1,3
Uttar Pradesh,Sambhal,Leprosy Cured,80,100,0,1,1
Odisha,Sambalpur,Leprosy Cured,15,35,16,6,22
Odisha,Sambalpur,Leprosy Cured,35,60,58,56,114
Odisha,Sambalpur,Leprosy Cured,60,80,53,43,96
Odisha,Sambalpur,Leprosy Cured,80,100,4,4,8
Bihar,Samastipur,Leprosy Cured,6,15,7,1,8
Bihar,Samastipur,Leprosy Cured,15,35,30,10,40
Bihar,Samastipur,Leprosy Cured,35,60,49,21,70
Bihar,Samastipur,Leprosy Cured,60,80,35,7,42
Bihar,Samastipur,Leprosy Cured,80,100,5,1,6
Tamil Nadu,Salem,Leprosy Cured,6,15,0,1,1
Tamil Nadu,Salem,Leprosy Cured,15,35,11,8,19
Tamil Nadu,Salem,Leprosy Cured,35,60,102,89,191
Tamil Nadu,Salem,Leprosy Cured,60,80,216,92,308
Tamil Nadu,Salem,Leprosy Cured,80,100,33,15,48
Jharkhand,Sahebganj,Leprosy Cured,0,6,1,3,4
Jharkhand,Sahebganj,Leprosy Cured,6,15,21,9,30
Jharkhand,Sahebganj,Leprosy Cured,15,35,38,15,53
Jharkhand,Sahebganj,Leprosy Cured,35,60,70,15,85
Jharkhand,Sahebganj,Leprosy Cured,60,80,4,3,7
Bihar,Saharsa,Leprosy Cured,0,6,1,0,1
Bihar,Saharsa,Leprosy Cured,6,15,7,2,9
Bihar,Saharsa,Leprosy Cured,15,35,19,8,27
Bihar,Saharsa,Leprosy Cured,35,60,40,9,49
Bihar,Saharsa,Leprosy Cured,60,80,26,6,32
Bihar,Saharsa,Leprosy Cured,80,100,2,0,2
Uttar Pradesh,Saharanpur,Leprosy Cured,6,15,3,1,4
Uttar Pradesh,Saharanpur,Leprosy Cured,15,35,38,19,57
Uttar Pradesh,Saharanpur,Leprosy Cured,35,60,47,33,80
Uttar Pradesh,Saharanpur,Leprosy Cured,60,80,18,15,33
Uttar Pradesh,Saharanpur,Leprosy Cured,80,100,0,4,4
Madhya Pradesh,Sagar,Leprosy Cured,0,6,1,0,1
Madhya Pradesh,Sagar,Leprosy Cured,6,15,7,3,10
Madhya Pradesh,Sagar,Leprosy Cured,15,35,40,12,52
Madhya Pradesh,Sagar,Leprosy Cured,35,60,47,17,64
Madhya Pradesh,Sagar,Leprosy Cured,60,80,9,2,11
Gujarat,Sabar Kantha,Leprosy Cured,15,35,6,1,7
Gujarat,Sabar Kantha,Leprosy Cured,35,60,55,28,83
Gujarat,Sabar Kantha,Leprosy Cured,60,80,42,22,64
Gujarat,Sabar Kantha,Leprosy Cured,80,100,7,2,9
Punjab,S.A.S Nagar,Leprosy Cured,6,15,1,1,2
Punjab,S.A.S Nagar,Leprosy Cured,15,35,2,0,2
Punjab,S.A.S Nagar,Leprosy Cured,35,60,5,4,9
Punjab,S.A.S Nagar,Leprosy Cured,60,80,1,2,3
Punjab,Rupnagar,Leprosy Cured,6,15,0,1,1
Punjab,Rupnagar,Leprosy Cured,15,35,1,0,1
Punjab,Rupnagar,Leprosy Cured,35,60,1,3,4
Punjab,Rupnagar,Leprosy Cured,60,80,2,0,2
Uttarakhand,Rudra Prayag,Leprosy Cured,0,6,1,0,1
Uttarakhand,Rudra Prayag,Leprosy Cured,6,15,2,4,6
Uttarakhand,Rudra Prayag,Leprosy Cured,15,35,0,2,2
Uttarakhand,Rudra Prayag,Leprosy Cured,35,60,2,3,5
Bihar,Rohtas,Leprosy Cured,6,15,1,1,2
Bihar,Rohtas,Leprosy Cured,15,35,11,6,17
Bihar,Rohtas,Leprosy Cured,35,60,23,8,31
Bihar,Rohtas,Leprosy Cured,60,80,8,4,12
Bihar,Rohtas,Leprosy Cured,80,100,0,1,1
Haryana,Rohtak,Leprosy Cured,15,35,1,1,2
Haryana,Rohtak,Leprosy Cured,35,60,1,1,2
Haryana,Rohtak,Leprosy Cured,60,80,1,0,1
Meghalaya,Ri Bhoi,Leprosy Cured,15,35,0,1,1
Meghalaya,Ri Bhoi,Leprosy Cured,35,60,22,8,30
Meghalaya,Ri Bhoi,Leprosy Cured,60,80,14,6,20
Meghalaya,Ri Bhoi,Leprosy Cured,80,100,1,1,2
Madhya Pradesh,Rewa,Leprosy Cured,15,35,1,1,2
Madhya Pradesh,Rewa,Leprosy Cured,35,60,3,1,4
Madhya Pradesh,Rewa,Leprosy Cured,60,80,3,2,5
Odisha,Rayagada,Leprosy Cured,15,35,1,4,5
Odisha,Rayagada,Leprosy Cured,35,60,14,11,25
Odisha,Rayagada,Leprosy Cured,60,80,9,4,13
Odisha,Rayagada,Leprosy Cured,80,100,2,1,3
Maharashtra,Ratnagiri,Leprosy Cured,35,60,2,5,7
Maharashtra,Ratnagiri,Leprosy Cured,60,80,7,6,13
Madhya Pradesh,Ratlam,Leprosy Cured,15,35,4,0,4
Madhya Pradesh,Ratlam,Leprosy Cured,35,60,19,5,24
Madhya Pradesh,Ratlam,Leprosy Cured,60,80,9,4,13
Madhya Pradesh,Ratlam,Leprosy Cured,80,100,1,1,2
Tamil Nadu,Ranipet,Leprosy Cured,15,35,1,0,1
Tamil Nadu,Ranipet,Leprosy Cured,35,60,8,3,11
Tamil Nadu,Ranipet,Leprosy Cured,60,80,24,9,33
Tamil Nadu,Ranipet,Leprosy Cured,80,100,2,0,2
Jharkhand,Ranchi,Leprosy Cured,15,35,3,3,6
Jharkhand,Ranchi,Leprosy Cured,35,60,26,29,55
Jharkhand,Ranchi,Leprosy Cured,60,80,17,31,48
Jharkhand,Ranchi,Leprosy Cured,80,100,1,4,5
Uttar Pradesh,Rampur,Leprosy Cured,6,15,1,0,1
Uttar Pradesh,Rampur,Leprosy Cured,15,35,21,9,30
Uttar Pradesh,Rampur,Leprosy Cured,35,60,29,5,34
Uttar Pradesh,Rampur,Leprosy Cured,60,80,9,3,12
Uttar Pradesh,Rampur,Leprosy Cured,80,100,1,0,1
Jharkhand,Ramgarh,Leprosy Cured,0,6,3,0,3
Jharkhand,Ramgarh,Leprosy Cured,6,15,2,4,6
Jharkhand,Ramgarh,Leprosy Cured,15,35,18,18,36
Jharkhand,Ramgarh,Leprosy Cured,35,60,50,19,69
Jharkhand,Ramgarh,Leprosy Cured,60,80,9,6,15
Jharkhand,Ramgarh,Leprosy Cured,80,100,2,0,2
Jammu And Kashmir,Ramban,Leprosy Cured,6,15,1,0,1
Jammu And Kashmir,Ramban,Leprosy Cured,15,35,4,1,5
Jammu And Kashmir,Ramban,Leprosy Cured,35,60,4,0,4
Tamil Nadu,Ramanathapuram,Leprosy Cured,15,35,1,1,2
Tamil Nadu,Ramanathapuram,Leprosy Cured,35,60,31,11,42
Tamil Nadu,Ramanathapuram,Leprosy Cured,60,80,55,12,67
Tamil Nadu,Ramanathapuram,Leprosy Cured,80,100,3,0,3
Karnataka,Ramanagara,Leprosy Cured,6,15,1,0,1
Karnataka,Ramanagara,Leprosy Cured,15,35,1,1,2
Karnataka,Ramanagara,Leprosy Cured,35,60,6,6,12
Karnataka,Ramanagara,Leprosy Cured,60,80,2,1,3
Rajasthan,Rajsamand,Leprosy Cured,15,35,0,3,3
Rajasthan,Rajsamand,Leprosy Cured,35,60,3,3,6
Rajasthan,Rajsamand,Leprosy Cured,60,80,2,0,2
Jammu And Kashmir,Rajouri,Leprosy Cured,15,35,3,3,6
Jammu And Kashmir,Rajouri,Leprosy Cured,35,60,8,0,8
Jammu And Kashmir,Rajouri,Leprosy Cured,60,80,1,0,1
Chhattisgarh,Rajnandgaon,Leprosy Cured,6,15,2,1,3
Chhattisgarh,Rajnandgaon,Leprosy Cured,15,35,3,4,7
Chhattisgarh,Rajnandgaon,Leprosy Cured,35,60,20,7,27
Chhattisgarh,Rajnandgaon,Leprosy Cured,60,80,10,3,13
Chhattisgarh,Rajnandgaon,Leprosy Cured,80,100,2,1,3
Madhya Pradesh,Rajgarh,Leprosy Cured,6,15,4,3,7
Madhya Pradesh,Rajgarh,Leprosy Cured,15,35,26,7,33
Madhya Pradesh,Rajgarh,Leprosy Cured,35,60,42,23,65
Madhya Pradesh,Rajgarh,Leprosy Cured,60,80,14,6,20
Madhya Pradesh,Raisen,Leprosy Cured,0,6,1,0,1
Madhya Pradesh,Raisen,Leprosy Cured,6,15,1,1,2
Madhya Pradesh,Raisen,Leprosy Cured,15,35,6,1,7
Madhya Pradesh,Raisen,Leprosy Cured,35,60,9,5,14
Madhya Pradesh,Raisen,Leprosy Cured,60,80,5,1,6
Madhya Pradesh,Raisen,Leprosy Cured,80,100,1,0,1
Chhattisgarh,Raipur,Leprosy Cured,15,35,0,1,1
Chhattisgarh,Raipur,Leprosy Cured,35,60,3,7,10
Chhattisgarh,Raipur,Leprosy Cured,60,80,11,20,31
Chhattisgarh,Raipur,Leprosy Cured,80,100,3,2,5
Chhattisgarh,Raigarh,Leprosy Cured,15,35,3,3,6
Chhattisgarh,Raigarh,Leprosy Cured,35,60,10,2,12
Chhattisgarh,Raigarh,Leprosy Cured,60,80,3,0,3
Maharashtra,Raigad,Leprosy Cured,15,35,4,2,6
Maharashtra,Raigad,Leprosy Cured,35,60,42,25,67
Maharashtra,Raigad,Leprosy Cured,60,80,47,20,67
Maharashtra,Raigad,Leprosy Cured,80,100,5,1,6
Karnataka,Raichur,Leprosy Cured,15,35,20,7,27
Karnataka,Raichur,Leprosy Cured,35,60,58,25,83
Karnataka,Raichur,Leprosy Cured,60,80,19,8,27
Karnataka,Raichur,Leprosy Cured,80,100,1,0,1
Uttar Pradesh,Rae Bareli,Leprosy Cured,15,35,17,5,22
Uttar Pradesh,Rae Bareli,Leprosy Cured,35,60,78,22,100
Uttar Pradesh,Rae Bareli,Leprosy Cured,60,80,32,15,47
Uttar Pradesh,Rae Bareli,Leprosy Cured,80,100,3,1,4
Bihar,Purnia,Leprosy Cured,0,6,0,1,1
Bihar,Purnia,Leprosy Cured,6,15,0,1,1
Bihar,Purnia,Leprosy Cured,15,35,8,5,13
Bihar,Purnia,Leprosy Cured,35,60,11,5,16
Bihar,Purnia,Leprosy Cured,60,80,9,0,9
Odisha,Puri,Leprosy Cured,0,6,1,0,1
Odisha,Puri,Leprosy Cured,6,15,1,2,3
Odisha,Puri,Leprosy Cured,15,35,2,3,5
Odisha,Puri,Leprosy Cured,35,60,32,23,55
Odisha,Puri,Leprosy Cured,60,80,22,17,39
Odisha,Puri,Leprosy Cured,80,100,11,5,16
Bihar,Purbi Champaran,Leprosy Cured,6,15,1,2,3
Bihar,Purbi Champaran,Leprosy Cured,15,35,37,33,70
Bihar,Purbi Champaran,Leprosy Cured,35,60,134,94,228
Bihar,Purbi Champaran,Leprosy Cured,60,80,124,34,158
Bihar,Purbi Champaran,Leprosy Cured,80,100,14,3,17
Maharashtra,Pune,Leprosy Cured,6,15,0,1,1
Maharashtra,Pune,Leprosy Cured,15,35,7,7,14
Maharashtra,Pune,Leprosy Cured,35,60,102,150,252
Maharashtra,Pune,Leprosy Cured,60,80,103,60,163
Maharashtra,Pune,Leprosy Cured,80,100,8,2,10
Jammu And Kashmir,Pulwama,Leprosy Cured,35,60,1,0,1
Jammu And Kashmir,Pulwama,Leprosy Cured,60,80,1,0,1
Tamil Nadu,Pudukkottai,Leprosy Cured,6,15,1,0,1
Tamil Nadu,Pudukkottai,Leprosy Cured,15,35,2,1,3
Tamil Nadu,Pudukkottai,Leprosy Cured,35,60,36,30,66
Tamil Nadu,Pudukkottai,Leprosy Cured,60,80,86,54,140
Tamil Nadu,Pudukkottai,Leprosy Cured,80,100,18,2,20
Uttar Pradesh,Prayagraj,Leprosy Cured,15,35,30,15,45
Uttar Pradesh,Prayagraj,Leprosy Cured,35,60,71,23,94
Uttar Pradesh,Prayagraj,Leprosy Cured,60,80,35,7,42
Rajasthan,Pratapgarh,Leprosy Cured,15,35,3,0,3
Rajasthan,Pratapgarh,Leprosy Cured,35,60,6,12,18
Rajasthan,Pratapgarh,Leprosy Cured,60,80,6,4,10
Rajasthan,Pratapgarh,Leprosy Cured,80,100,1,0,1
Uttar Pradesh,Pratapgarh,Leprosy Cured,6,15,1,1,2
Uttar Pradesh,Pratapgarh,Leprosy Cured,15,35,29,19,48
Uttar Pradesh,Pratapgarh,Leprosy Cured,35,60,50,17,67
Uttar Pradesh,Pratapgarh,Leprosy Cured,60,80,32,6,38
Jammu And Kashmir,Poonch,Leprosy Cured,0,6,3,1,4
Jammu And Kashmir,Poonch,Leprosy Cured,6,15,4,1,5
Jammu And Kashmir,Poonch,Leprosy Cured,15,35,13,13,26
Jammu And Kashmir,Poonch,Leprosy Cured,35,60,14,8,22
Jammu And Kashmir,Poonch,Leprosy Cured,60,80,3,2,5
Puducherry,Pondicherry,Leprosy Cured,35,60,1,3,4
Puducherry,Pondicherry,Leprosy Cured,60,80,6,4,10
Puducherry,Pondicherry,Leprosy Cured,80,100,0,4,4
Uttar Pradesh,Pilibhit,Leprosy Cured,6,15,2,0,2
Uttar Pradesh,Pilibhit,Leprosy Cured,15,35,24,11,35
Uttar Pradesh,Pilibhit,Leprosy Cured,35,60,20,12,32
Uttar Pradesh,Pilibhit,Leprosy Cured,60,80,11,1,12
Uttar Pradesh,Pilibhit,Leprosy Cured,80,100,1,0,1
Tamil Nadu,Perambalur,Leprosy Cured,6,15,1,0,1
Tamil Nadu,Perambalur,Leprosy Cured,15,35,1,1,2
Tamil Nadu,Perambalur,Leprosy Cured,35,60,24,22,46
Tamil Nadu,Perambalur,Leprosy Cured,60,80,69,27,96
Tamil Nadu,Perambalur,Leprosy Cured,80,100,10,5,15
Uttarakhand,Pauri Garhwal,Leprosy Cured,35,60,3,3,6
Bihar,Patna,Leprosy Cured,6,15,9,9,18
Bihar,Patna,Leprosy Cured,15,35,26,10,36
Bihar,Patna,Leprosy Cured,35,60,29,11,40
Bihar,Patna,Leprosy Cured,60,80,18,2,20
Punjab,Patiala,Leprosy Cured,15,35,10,4,14
Punjab,Patiala,Leprosy Cured,35,60,21,8,29
Punjab,Patiala,Leprosy Cured,60,80,9,7,16
Punjab,Patiala,Leprosy Cured,80,100,0,1,1
Punjab,Pathankot,Leprosy Cured,15,35,2,1,3
Punjab,Pathankot,Leprosy Cured,35,60,7,2,9
Bihar,Pashchim Champaran,Leprosy Cured,0,6,1,0,1
Bihar,Pashchim Champaran,Leprosy Cured,6,15,3,3,6
Bihar,Pashchim Champaran,Leprosy Cured,15,35,28,17,45
Bihar,Pashchim Champaran,Leprosy Cured,35,60,43,18,61
Bihar,Pashchim Champaran,Leprosy Cured,60,80,17,9,26
Maharashtra,Parbhani,Leprosy Cured,6,15,1,0,1
Maharashtra,Parbhani,Leprosy Cured,15,35,3,1,4
Maharashtra,Parbhani,Leprosy Cured,35,60,14,8,22
Maharashtra,Parbhani,Leprosy Cured,60,80,8,6,14
Maharashtra,Parbhani,Leprosy Cured,80,100,1,0,1
Arunachal Pradesh,Papum Pare,Leprosy Cured,15,35,0,1,1
Madhya Pradesh,Panna,Leprosy Cured,6,15,4,0,4
Madhya Pradesh,Panna,Leprosy Cured,15,35,8,9,17
Madhya Pradesh,Panna,Leprosy Cured,35,60,9,4,13
Madhya Pradesh,Panna,Leprosy Cured,60,80,5,1,6
Haryana,Panipat,Leprosy Cured,15,35,1,0,1
Haryana,Panipat,Leprosy Cured,35,60,1,1,2
Haryana,Panchkula,Leprosy Cured,15,35,4,1,5
Haryana,Panchkula,Leprosy Cured,35,60,16,11,27
Haryana,Panchkula,Leprosy Cured,60,80,5,1,6
Gujarat,Panch Mahals,Leprosy Cured,15,35,0,1,1
Haryana,Palwal,Leprosy Cured,15,35,1,0,1
Haryana,Palwal,Leprosy Cured,35,60,0,1,1
Rajasthan,Pali,Leprosy Cured,15,35,0,2,2
Rajasthan,Pali,Leprosy Cured,35,60,6,1,7
Rajasthan,Pali,Leprosy Cured,60,80,2,4,6
Rajasthan,Pali,Leprosy Cured,80,100,1,0,1
Maharashtra,Palghar,Leprosy Cured,6,15,2,1,3
Maharashtra,Palghar,Leprosy Cured,15,35,3,0,3
Maharashtra,Palghar,Leprosy Cured,35,60,4,2,6
Maharashtra,Palghar,Leprosy Cured,60,80,3,1,4
Jharkhand,Palamu,Leprosy Cured,6,15,1,0,1
Jharkhand,Palamu,Leprosy Cured,15,35,3,2,5
Jharkhand,Palamu,Leprosy Cured,60,80,2,0,2
Kerala,Palakkad,Leprosy Cured,15,35,0,1,1
Kerala,Palakkad,Leprosy Cured,35,60,10,3,13
Kerala,Palakkad,Leprosy Cured,60,80,16,5,21
Kerala,Palakkad,Leprosy Cured,80,100,5,2,7
Jharkhand,Pakur,Leprosy Cured,35,60,0,1,1
Maharashtra,Osmanabad,Leprosy Cured,15,35,0,1,1
Maharashtra,Osmanabad,Leprosy Cured,35,60,7,4,11
Maharashtra,Osmanabad,Leprosy Cured,60,80,10,3,13
Maharashtra,Osmanabad,Leprosy Cured,80,100,4,4,8
Haryana,Nuh,Leprosy Cured,6,15,1,0,1
Haryana,Nuh,Leprosy Cured,15,35,5,1,6
Haryana,Nuh,Leprosy Cured,35,60,1,0,1
Odisha,Nuapada,Leprosy Cured,0,6,1,0,1
Odisha,Nuapada,Leprosy Cured,6,15,1,0,1
Odisha,Nuapada,Leprosy Cured,15,35,7,2,9
Odisha,Nuapada,Leprosy Cured,35,60,14,3,17
Odisha,Nuapada,Leprosy Cured,60,80,3,5,8
Delhi,North West,Leprosy Cured,15,35,1,1,2
Delhi,North West,Leprosy Cured,35,60,7,1,8
Goa,North Goa,Leprosy Cured,35,60,1,0,1
Goa,North Goa,Leprosy Cured,60,80,1,0,1
Delhi,North East,Leprosy Cured,15,35,2,2,4
Delhi,North East,Leprosy Cured,35,60,55,22,77
Delhi,North East,Leprosy Cured,60,80,19,10,29
Delhi,North East,Leprosy Cured,80,100,1,0,1
Andaman And Nicobar Islands,North And Middle Andaman,Leprosy Cured,35,60,7,0,7
Andaman And Nicobar Islands,North And Middle Andaman,Leprosy Cured,60,80,1,0,1
Delhi,North,Leprosy Cured,35,60,1,0,1
Madhya Pradesh,Niwari,Leprosy Cured,15,35,3,0,3
Madhya Pradesh,Niwari,Leprosy Cured,35,60,6,0,6
Madhya Pradesh,Niwari,Leprosy Cured,60,80,0,2,2
Madhya Pradesh,Neemuch,Leprosy Cured,6,15,0,1,1
Madhya Pradesh,Neemuch,Leprosy Cured,15,35,5,1,6
Madhya Pradesh,Neemuch,Leprosy Cured,35,60,4,3,7
Odisha,Nayagarh,Leprosy Cured,0,6,1,0,1
Odisha,Nayagarh,Leprosy Cured,6,15,0,1,1
Odisha,Nayagarh,Leprosy Cured,15,35,4,3,7
Odisha,Nayagarh,Leprosy Cured,35,60,36,18,54
Odisha,Nayagarh,Leprosy Cured,60,80,28,9,37
Odisha,Nayagarh,Leprosy Cured,80,100,2,0,2
Bihar,Nawada,Leprosy Cured,6,15,2,2,4
Bihar,Nawada,Leprosy Cured,15,35,13,7,20
Bihar,Nawada,Leprosy Cured,35,60,27,5,32
Bihar,Nawada,Leprosy Cured,60,80,18,6,24
Bihar,Nawada,Leprosy Cured,80,100,1,0,1
Maharashtra,Nashik,Leprosy Cured,15,35,14,6,20
Maharashtra,Nashik,Leprosy Cured,35,60,65,47,112
Maharashtra,Nashik,Leprosy Cured,60,80,42,32,74
Maharashtra,Nashik,Leprosy Cured,80,100,4,1,5
Madhya Pradesh,Narsinghpur,Leprosy Cured,15,35,20,5,25
Madhya Pradesh,Narsinghpur,Leprosy Cured,35,60,28,15,43
Madhya Pradesh,Narsinghpur,Leprosy Cured,60,80,13,4,17
Madhya Pradesh,Narmadapuram,Leprosy Cured,15,35,5,0,5
Madhya Pradesh,Narmadapuram,Leprosy Cured,35,60,11,5,16
Madhya Pradesh,Narmadapuram,Leprosy Cured,60,80,0,1,1
Gujarat,Narmada,Leprosy Cured,35,60,1,0,1
Maharashtra,Nandurbar,Leprosy Cured,15,35,15,4,19
Maharashtra,Nandurbar,Leprosy Cured,35,60,26,14,40
Maharashtra,Nandurbar,Leprosy Cured,60,80,13,5,18
Maharashtra,Nandurbar,Leprosy Cured,80,100,1,0,1
Maharashtra,Nanded,Leprosy Cured,6,15,1,1,2
Maharashtra,Nanded,Leprosy Cured,15,35,3,2,5
Maharashtra,Nanded,Leprosy Cured,35,60,9,4,13
Maharashtra,Nanded,Leprosy Cured,60,80,5,1,6
Tamil Nadu,Namakkal,Leprosy Cured,0,6,1,0,1
Tamil Nadu,Namakkal,Leprosy Cured,15,35,5,3,8
Tamil Nadu,Namakkal,Leprosy Cured,35,60,66,43,109
Tamil Nadu,Namakkal,Leprosy Cured,60,80,148,65,213
Tamil Nadu,Namakkal,Leprosy Cured,80,100,21,8,29
Assam,Nalbari,Leprosy Cured,15,35,1,0,1
Bihar,Nalanda,Leprosy Cured,6,15,3,2,5
Bihar,Nalanda,Leprosy Cured,15,35,7,8,15
Bihar,Nalanda,Leprosy Cured,35,60,22,4,26
Bihar,Nalanda,Leprosy Cured,60,80,16,1,17
Bihar,Nalanda,Leprosy Cured,80,100,1,0,1
Uttarakhand,Nainital,Leprosy Cured,15,35,0,1,1
Uttarakhand,Nainital,Leprosy Cured,35,60,11,15,26
Uttarakhand,Nainital,Leprosy Cured,60,80,8,7,15
Maharashtra,Nagpur,Leprosy Cured,15,35,3,1,4
Maharashtra,Nagpur,Leprosy Cured,35,60,3,0,3
Maharashtra,Nagpur,Leprosy Cured,60,80,2,2,4
Maharashtra,Nagpur,Leprosy Cured,80,100,1,0,1
Rajasthan,Nagaur,Leprosy Cured,15,35,1,0,1
Rajasthan,Nagaur,Leprosy Cured,35,60,0,1,1
Tamil Nadu,Nagapattinam,Leprosy Cured,15,35,3,0,3
Tamil Nadu,Nagapattinam,Leprosy Cured,35,60,33,14,47
Tamil Nadu,Nagapattinam,Leprosy Cured,60,80,63,26,89
Tamil Nadu,Nagapattinam,Leprosy Cured,80,100,7,2,9
Assam,Nagaon,Leprosy Cured,6,15,2,0,2
Assam,Nagaon,Leprosy Cured,15,35,1,2,3
Assam,Nagaon,Leprosy Cured,35,60,1,0,1
Odisha,Nabarangpur,Leprosy Cured,6,15,1,7,8
Odisha,Nabarangpur,Leprosy Cured,15,35,13,10,23
Odisha,Nabarangpur,Leprosy Cured,35,60,42,24,66
Odisha,Nabarangpur,Leprosy Cured,60,80,23,15,38
Odisha,Nabarangpur,Leprosy Cured,80,100,1,0,1
Karnataka,Mysuru,Leprosy Cured,15,35,2,0,2
Karnataka,Mysuru,Leprosy Cured,35,60,13,3,16
Karnataka,Mysuru,Leprosy Cured,60,80,8,6,14
Karnataka,Mysuru,Leprosy Cured,80,100,2,3,5
Bihar,Muzaffarpur,Leprosy Cured,15,35,10,2,12
Bihar,Muzaffarpur,Leprosy Cured,35,60,24,21,45
Bihar,Muzaffarpur,Leprosy Cured,60,80,21,12,33
Uttar Pradesh,Muzaffarnagar,Leprosy Cured,6,15,1,0,1
Uttar Pradesh,Muzaffarnagar,Leprosy Cured,15,35,7,1,8
Uttar Pradesh,Muzaffarnagar,Leprosy Cured,35,60,9,5,14
Uttar Pradesh,Muzaffarnagar,Leprosy Cured,60,80,4,0,4
Bihar,Munger,Leprosy Cured,6,15,2,0,2
Bihar,Munger,Leprosy Cured,15,35,8,7,15
Bihar,Munger,Leprosy Cured,35,60,22,2,24
Bihar,Munger,Leprosy Cured,60,80,15,2,17
Bihar,Munger,Leprosy Cured,80,100,0,1,1
Chhattisgarh,Mungeli,Leprosy Cured,35,60,1,0,1
Maharashtra,Mumbai Suburban,Leprosy Cured,15,35,4,0,4
Maharashtra,Mumbai Suburban,Leprosy Cured,35,60,26,22,48
Maharashtra,Mumbai Suburban,Leprosy Cured,60,80,32,34,66
Maharashtra,Mumbai Suburban,Leprosy Cured,80,100,1,2,3
Maharashtra,Mumbai,Leprosy Cured,15,35,2,0,2
Maharashtra,Mumbai,Leprosy Cured,35,60,5,0,5
Maharashtra,Mumbai,Leprosy Cured,60,80,4,1,5
Madhya Pradesh,Morena,Leprosy Cured,15,35,7,1,8
Madhya Pradesh,Morena,Leprosy Cured,35,60,3,0,3
Madhya Pradesh,Morena,Leprosy Cured,60,80,3,0,3
Uttar Pradesh,Moradabad,Leprosy Cured,15,35,27,16,43
Uttar Pradesh,Moradabad,Leprosy Cured,35,60,43,28,71
Uttar Pradesh,Moradabad,Leprosy Cured,60,80,17,2,19
Punjab,Moga,Leprosy Cured,6,15,0,1,1
Punjab,Moga,Leprosy Cured,15,35,1,0,1
Punjab,Moga,Leprosy Cured,35,60,6,1,7
Punjab,Moga,Leprosy Cured,60,80,1,0,1
Uttar Pradesh,Mirzapur,Leprosy Cured,6,15,1,0,1
Uttar Pradesh,Mirzapur,Leprosy Cured,15,35,23,5,28
Uttar Pradesh,Mirzapur,Leprosy Cured,35,60,47,13,60
Uttar Pradesh,Mirzapur,Leprosy Cured,60,80,35,6,41
Uttar Pradesh,Mirzapur,Leprosy Cured,80,100,1,0,1
Uttar Pradesh,Meerut,Leprosy Cured,6,15,1,0,1
Uttar Pradesh,Meerut,Leprosy Cured,15,35,10,8,18
Uttar Pradesh,Meerut,Leprosy Cured,35,60,34,22,56
Uttar Pradesh,Meerut,Leprosy Cured,60,80,17,16,33
Uttar Pradesh,Meerut,Leprosy Cured,80,100,1,0,1
Odisha,Mayurbhanj,Leprosy Cured,6,15,0,2,2
Odisha,Mayurbhanj,Leprosy Cured,15,35,11,4,15
Odisha,Mayurbhanj,Leprosy Cured,35,60,57,28,85
Odisha,Mayurbhanj,Leprosy Cured,60,80,41,36,77
Odisha,Mayurbhanj,Leprosy Cured,80,100,8,8,16
Tamil Nadu,Mayiladuthurai,Leprosy Cured,0,6,1,0,1
Tamil Nadu,Mayiladuthurai,Leprosy Cured,6,15,1,0,1
Tamil Nadu,Mayiladuthurai,Leprosy Cured,15,35,1,0,1
Tamil Nadu,Mayiladuthurai,Leprosy Cured,35,60,7,2,9
Tamil Nadu,Mayiladuthurai,Leprosy Cured,60,80,8,5,13
Tamil Nadu,Mayiladuthurai,Leprosy Cured,80,100,4,0,4
Uttar Pradesh,Mau,Leprosy Cured,15,35,14,3,17
Uttar Pradesh,Mau,Leprosy Cured,35,60,71,19,90
Uttar Pradesh,Mau,Leprosy Cured,60,80,38,7,45
Uttar Pradesh,Mau,Leprosy Cured,80,100,2,0,2
Uttar Pradesh,Mathura,Leprosy Cured,15,35,4,1,5
Uttar Pradesh,Mathura,Leprosy Cured,35,60,15,0,15
Uttar Pradesh,Mathura,Leprosy Cured,60,80,11,8,19
Uttar Pradesh,Mathura,Leprosy Cured,80,100,0,1,1
Assam,Marigaon,Leprosy Cured,15,35,1,0,1
Assam,Marigaon,Leprosy Cured,35,60,3,1,4
Assam,Marigaon,Leprosy Cured,60,80,0,1,1
Punjab,Mansa,Leprosy Cured,6,15,3,0,3
Punjab,Mansa,Leprosy Cured,15,35,7,8,15
Punjab,Mansa,Leprosy Cured,35,60,16,10,26
Punjab,Mansa,Leprosy Cured,60,80,5,2,7
Punjab,Mansa,Leprosy Cured,80,100,0,1,1
Karnataka,Mandya,Leprosy Cured,15,35,1,0,1
Karnataka,Mandya,Leprosy Cured,35,60,9,2,11
Karnataka,Mandya,Leprosy Cured,60,80,10,1,11
Karnataka,Mandya,Leprosy Cured,80,100,1,0,1
Madhya Pradesh,Mandsaur,Leprosy Cured,15,35,2,0,2
Madhya Pradesh,Mandsaur,Leprosy Cured,35,60,1,2,3
Madhya Pradesh,Mandsaur,Leprosy Cured,60,80,0,4,4
Madhya Pradesh,Mandsaur,Leprosy Cured,80,100,0,1,1
Madhya Pradesh,Mandla,Leprosy Cured,6,15,1,0,1
Madhya Pradesh,Mandla,Leprosy Cured,15,35,7,4,11
Madhya Pradesh,Mandla,Leprosy Cured,35,60,13,4,17
Madhya Pradesh,Mandla,Leprosy Cured,60,80,2,1,3
Himachal Pradesh,Mandi,Leprosy Cured,15,35,4,2,6
Himachal Pradesh,Mandi,Leprosy Cured,35,60,8,4,12
Himachal Pradesh,Mandi,Leprosy Cured,60,80,7,1,8
Himachal Pradesh,Mandi,Leprosy Cured,80,100,1,0,1
Odisha,Malkangiri,Leprosy Cured,6,15,0,2,2
Odisha,Malkangiri,Leprosy Cured,15,35,4,3,7
Odisha,Malkangiri,Leprosy Cured,35,60,11,8,19
Odisha,Malkangiri,Leprosy Cured,60,80,1,5,6
Odisha,Malkangiri,Leprosy Cured,80,100,0,1,1
Kerala,Malappuram,Leprosy Cured,15,35,0,1,1
Kerala,Malappuram,Leprosy Cured,35,60,5,3,8
Kerala,Malappuram,Leprosy Cured,60,80,7,2,9
Kerala,Malappuram,Leprosy Cured,80,100,1,0,1
Assam,Majuli,Leprosy Cured,15,35,0,1,1
Assam,Majuli,Leprosy Cured,35,60,3,0,3
Uttar Pradesh,Mainpuri,Leprosy Cured,6,15,0,1,1
Uttar Pradesh,Mainpuri,Leprosy Cured,15,35,16,20,36
Uttar Pradesh,Mainpuri,Leprosy Cured,35,60,33,32,65
Uttar Pradesh,Mainpuri,Leprosy Cured,60,80,22,8,30
Uttar Pradesh,Mahoba,Leprosy Cured,0,6,0,1,1
Uttar Pradesh,Mahoba,Leprosy Cured,6,15,1,1,2
Uttar Pradesh,Mahoba,Leprosy Cured,15,35,12,3,15
Uttar Pradesh,Mahoba,Leprosy Cured,35,60,41,25,66
Uttar Pradesh,Mahoba,Leprosy Cured,60,80,35,2,37
Uttar Pradesh,Mahoba,Leprosy Cured,80,100,3,0,3
Gujarat,Mahesana,Leprosy Cured,35,60,0,1,1
Haryana,Mahendragarh,Leprosy Cured,35,60,4,1,5
Haryana,Mahendragarh,Leprosy Cured,60,80,1,0,1
Chhattisgarh,Mahasamund,Leprosy Cured,15,35,2,1,3
Chhattisgarh,Mahasamund,Leprosy Cured,35,60,11,5,16
Chhattisgarh,Mahasamund,Leprosy Cured,60,80,1,2,3
Chhattisgarh,Mahasamund,Leprosy Cured,80,100,1,0,1
Uttar Pradesh,Maharajganj,Leprosy Cured,6,15,1,1,2
Uttar Pradesh,Maharajganj,Leprosy Cured,15,35,59,14,73
Uttar Pradesh,Maharajganj,Leprosy Cured,35,60,137,42,179
Uttar Pradesh,Maharajganj,Leprosy Cured,60,80,93,14,107
Uttar Pradesh,Maharajganj,Leprosy Cured,80,100,7,1,8
Tamil Nadu,Madurai,Leprosy Cured,6,15,1,0,1
Tamil Nadu,Madurai,Leprosy Cured,15,35,6,4,10
Tamil Nadu,Madurai,Leprosy Cured,35,60,129,76,205
Tamil Nadu,Madurai,Leprosy Cured,60,80,247,132,379
Tamil Nadu,Madurai,Leprosy Cured,80,100,28,14,42
Bihar,Madhubani,Leprosy Cured,0,6,1,0,1
Bihar,Madhubani,Leprosy Cured,6,15,1,0,1
Bihar,Madhubani,Leprosy Cured,15,35,16,6,22
Bihar,Madhubani,Leprosy Cured,35,60,16,2,18
Bihar,Madhubani,Leprosy Cured,60,80,4,5,9
Bihar,Madhepura,Leprosy Cured,6,15,2,2,4
Bihar,Madhepura,Leprosy Cured,15,35,19,5,24
Bihar,Madhepura,Leprosy Cured,35,60,22,5,27
Bihar,Madhepura,Leprosy Cured,60,80,11,4,15
Bihar,Madhepura,Leprosy Cured,80,100,1,0,1
Punjab,Ludhiana,Leprosy Cured,6,15,1,3,4
Punjab,Ludhiana,Leprosy Cured,15,35,15,8,23
Punjab,Ludhiana,Leprosy Cured,35,60,46,30,76
Punjab,Ludhiana,Leprosy Cured,60,80,27,19,46
Punjab,Ludhiana,Leprosy Cured,80,100,1,1,2
Uttar Pradesh,Lucknow,Leprosy Cured,6,15,2,1,3
Uttar Pradesh,Lucknow,Leprosy Cured,15,35,20,14,34
Uttar Pradesh,Lucknow,Leprosy Cured,35,60,51,17,68
Uttar Pradesh,Lucknow,Leprosy Cured,60,80,26,3,29
Uttar Pradesh,Lucknow,Leprosy Cured,80,100,1,0,1
Arunachal Pradesh,Longding,Leprosy Cured,35,60,0,1,1
Jharkhand,Lohardaga,Leprosy Cured,6,15,0,1,1
Jharkhand,Lohardaga,Leprosy Cured,15,35,5,1,6
Jharkhand,Lohardaga,Leprosy Cured,35,60,8,3,11
Jharkhand,Lohardaga,Leprosy Cured,60,80,2,0,2
Ladakh,Leh Ladakh,Leprosy Cured,35,60,0,1,1
Maharashtra,Latur,Leprosy Cured,15,35,4,3,7
Maharashtra,Latur,Leprosy Cured,35,60,18,21,39
Maharashtra,Latur,Leprosy Cured,60,80,36,20,56
Maharashtra,Latur,Leprosy Cured,80,100,4,1,5
Jharkhand,Latehar,Leprosy Cured,15,35,3,1,4
Jharkhand,Latehar,Leprosy Cured,60,80,0,1,1
Uttar Pradesh,Lalitpur,Leprosy Cured,15,35,7,3,10
Uttar Pradesh,Lalitpur,Leprosy Cured,35,60,35,8,43
Uttar Pradesh,Lalitpur,Leprosy Cured,60,80,5,5,10
Uttar Pradesh,Lalitpur,Leprosy Cured,80,100,1,1,2
Lakshadweep,Lakshadweep District,Leprosy Cured,35,60,1,0,1
Lakshadweep,Lakshadweep District,Leprosy Cured,60,80,1,0,1
Bihar,Lakhisarai,Leprosy Cured,6,15,1,0,1
Bihar,Lakhisarai,Leprosy Cured,15,35,9,1,10
Bihar,Lakhisarai,Leprosy Cured,35,60,4,4,8
Bihar,Lakhisarai,Leprosy Cured,60,80,3,1,4
Assam,Lakhimpur,Leprosy Cured,15,35,1,0,1
Assam,Lakhimpur,Leprosy Cured,35,60,1,1,2
Assam,Lakhimpur,Leprosy Cured,60,80,1,0,1
Uttar Pradesh,Kushi Nagar,Leprosy Cured,6,15,2,1,3
Uttar Pradesh,Kushi Nagar,Leprosy Cured,15,35,46,19,65
Uttar Pradesh,Kushi Nagar,Leprosy Cured,35,60,163,43,206
Uttar Pradesh,Kushi Nagar,Leprosy Cured,60,80,78,12,90
Uttar Pradesh,Kushi Nagar,Leprosy Cured,80,100,2,0,2
Haryana,Kurukshetra,Leprosy Cured,15,35,1,0,1
Haryana,Kurukshetra,Leprosy Cured,35,60,3,1,4
Jammu And Kashmir,Kupwara,Leprosy Cured,6,15,0,1,1
Jammu And Kashmir,Kupwara,Leprosy Cured,15,35,1,0,1
Jammu And Kashmir,Kupwara,Leprosy Cured,35,60,1,2,3
Jammu And Kashmir,Kupwara,Leprosy Cured,60,80,2,0,2
Himachal Pradesh,Kullu,Leprosy Cured,35,60,1,2,3
Jammu And Kashmir,Kulgam,Leprosy Cured,15,35,0,1,1
Tamil Nadu,Krishnagiri,Leprosy Cured,15,35,8,6,14
Tamil Nadu,Krishnagiri,Leprosy Cured,35,60,36,36,72
Tamil Nadu,Krishnagiri,Leprosy Cured,60,80,73,53,126
Tamil Nadu,Krishnagiri,Leprosy Cured,80,100,12,4,16
Kerala,Kozhikode,Leprosy Cured,15,35,0,1,1
Kerala,Kozhikode,Leprosy Cured,35,60,1,0,1
Kerala,Kozhikode,Leprosy Cured,60,80,3,2,5
Kerala,Kottayam,Leprosy Cured,60,80,0,1,1
Rajasthan,Kota,Leprosy Cured,35,60,1,2,3
Rajasthan,Kota,Leprosy Cured,60,80,1,1,2
Chhattisgarh,Korea,Leprosy Cured,6,15,1,0,1
Chhattisgarh,Korea,Leprosy Cured,15,35,1,1,2
Chhattisgarh,Korea,Leprosy Cured,35,60,2,3,5
Chhattisgarh,Korea,Leprosy Cured,60,80,1,0,1
Chhattisgarh,Korea,Leprosy Cured,80,100,1,1,2
Odisha,Koraput,Leprosy Cured,15,35,0,1,1
Odisha,Koraput,Leprosy Cured,35,60,8,8,16
Odisha,Koraput,Leprosy Cured,60,80,4,0,4
Odisha,Koraput,Leprosy Cured,80,100,1,0,1
Karnataka,Koppal,Leprosy Cured,6,15,0,1,1
Karnataka,Koppal,Leprosy Cured,15,35,3,0,3
Karnataka,Koppal,Leprosy Cured,35,60,35,15,50
Karnataka,Koppal,Leprosy Cured,60,80,27,7,34
Karnataka,Koppal,Leprosy Cured,80,100,2,0,2
Chhattisgarh,Kondagaon,Leprosy Cured,6,15,1,2,3
Chhattisgarh,Kondagaon,Leprosy Cured,15,35,5,4,9
Chhattisgarh,Kondagaon,Leprosy Cured,35,60,14,4,18
Chhattisgarh,Kondagaon,Leprosy Cured,60,80,4,0,4
Kerala,Kollam,Leprosy Cured,35,60,0,1,1
Kerala,Kollam,Leprosy Cured,80,100,1,0,1
Maharashtra,Kolhapur,Leprosy Cured,6,15,2,1,3
Maharashtra,Kolhapur,Leprosy Cured,15,35,4,1,5
Maharashtra,Kolhapur,Leprosy Cured,35,60,23,20,43
Maharashtra,Kolhapur,Leprosy Cured,60,80,17,22,39
Maharashtra,Kolhapur,Leprosy Cured,80,100,2,1,3
Mizoram,Kolasib,Leprosy Cured,35,60,0,1,1
Karnataka,Kolar,Leprosy Cured,6,15,1,0,1
Karnataka,Kolar,Leprosy Cured,15,35,1,4,5
Karnataka,Kolar,Leprosy Cured,35,60,22,8,30
Karnataka,Kolar,Leprosy Cured,60,80,14,8,22
Karnataka,Kolar,Leprosy Cured,80,100,1,1,2
Nagaland,Kohima,Leprosy Cured,35,60,2,0,2
Nagaland,Kohima,Leprosy Cured,60,80,4,0,4
Jharkhand,Koderma,Leprosy Cured,6,15,2,1,3
Jharkhand,Koderma,Leprosy Cured,15,35,11,8,19
Jharkhand,Koderma,Leprosy Cured,35,60,12,1,13
Jharkhand,Koderma,Leprosy Cured,60,80,1,0,1
Jammu And Kashmir,Kishtwar,Leprosy Cured,15,35,1,0,1
Bihar,Kishanganj,Leprosy Cured,6,15,3,1,4
Bihar,Kishanganj,Leprosy Cured,15,35,20,6,26
Bihar,Kishanganj,Leprosy Cured,35,60,51,38,89
Bihar,Kishanganj,Leprosy Cured,60,80,20,8,28
Bihar,Kishanganj,Leprosy Cured,80,100,6,0,6
Himachal Pradesh,Kinnaur,Leprosy Cured,60,80,0,1,1
Jharkhand,Khunti,Leprosy Cured,6,15,2,3,5
Jharkhand,Khunti,Leprosy Cured,15,35,15,7,22
Jharkhand,Khunti,Leprosy Cured,35,60,6,3,9
Jharkhand,Khunti,Leprosy Cured,60,80,4,1,5
Tripura,Khowai,Leprosy Cured,60,80,1,0,1
Odisha,Khordha,Leprosy Cured,0,6,1,0,1
Odisha,Khordha,Leprosy Cured,6,15,1,0,1
Odisha,Khordha,Leprosy Cured,15,35,11,2,13
Odisha,Khordha,Leprosy Cured,35,60,62,49,111
Odisha,Khordha,Leprosy Cured,60,80,70,36,106
Odisha,Khordha,Leprosy Cured,80,100,5,5,10
Uttar Pradesh,Kheri,Leprosy Cured,6,15,2,0,2
Uttar Pradesh,Kheri,Leprosy Cured,15,35,22,8,30
Uttar Pradesh,Kheri,Leprosy Cured,35,60,48,13,61
Uttar Pradesh,Kheri,Leprosy Cured,60,80,39,10,49
Uttar Pradesh,Kheri,Leprosy Cured,80,100,2,1,3
Gujarat,Kheda,Leprosy Cured,6,15,0,1,1
Madhya Pradesh,Khargone,Leprosy Cured,6,15,2,0,2
Madhya Pradesh,Khargone,Leprosy Cured,15,35,5,1,6
Madhya Pradesh,Khargone,Leprosy Cured,35,60,15,8,23
Madhya Pradesh,Khargone,Leprosy Cured,60,80,4,2,6
Bihar,Khagaria,Leprosy Cured,6,15,0,1,1
Bihar,Khagaria,Leprosy Cured,15,35,1,2,3
Bihar,Khagaria,Leprosy Cured,35,60,2,1,3
Bihar,Khagaria,Leprosy Cured,60,80,1,0,1
Odisha,Kendujhar,Leprosy Cured,15,35,2,4,6
Odisha,Kendujhar,Leprosy Cured,35,60,23,10,33
Odisha,Kendujhar,Leprosy Cured,60,80,9,3,12
Odisha,Kendujhar,Leprosy Cured,80,100,1,0,1
Odisha,Kendrapara,Leprosy Cured,6,15,1,0,1
Odisha,Kendrapara,Leprosy Cured,15,35,2,1,3
Odisha,Kendrapara,Leprosy Cured,35,60,4,2,6
Odisha,Kendrapara,Leprosy Cured,60,80,4,1,5
Uttar Pradesh,Kaushambi,Leprosy Cured,6,15,0,1,1
Uttar Pradesh,Kaushambi,Leprosy Cured,15,35,28,11,39
Uttar Pradesh,Kaushambi,Leprosy Cured,35,60,46,14,60
Uttar Pradesh,Kaushambi,Leprosy Cured,60,80,26,7,33
Uttar Pradesh,Kaushambi,Leprosy Cured,80,100,3,1,4
Madhya Pradesh,Katni,Leprosy Cured,6,15,2,0,2
Madhya Pradesh,Katni,Leprosy Cured,15,35,11,7,18
Madhya Pradesh,Katni,Leprosy Cured,35,60,7,9,16
Madhya Pradesh,Katni,Leprosy Cured,60,80,8,4,12
Bihar,Katihar,Leprosy Cured,15,35,5,2,7
Bihar,Katihar,Leprosy Cured,35,60,6,2,8
Bihar,Katihar,Leprosy Cured,60,80,6,1,7
Jammu And Kashmir,Kathua,Leprosy Cured,6,15,1,1,2
Jammu And Kashmir,Kathua,Leprosy Cured,15,35,3,4,7
Jammu And Kashmir,Kathua,Leprosy Cured,35,60,6,4,10
Jammu And Kashmir,Kathua,Leprosy Cured,60,80,4,0,4
Uttar Pradesh,Kasganj,Leprosy Cured,15,35,29,9,38
Uttar Pradesh,Kasganj,Leprosy Cured,35,60,30,9,39
Uttar Pradesh,Kasganj,Leprosy Cured,60,80,8,4,12
Kerala,Kasaragod,Leprosy Cured,35,60,1,0,1
Kerala,Kasaragod,Leprosy Cured,60,80,2,1,3
Tamil Nadu,Karur,Leprosy Cured,15,35,1,3,4
Tamil Nadu,Karur,Leprosy Cured,35,60,32,21,53
Tamil Nadu,Karur,Leprosy Cured,60,80,54,30,84
Tamil Nadu,Karur,Leprosy Cured,80,100,12,7,19
Haryana,Karnal,Leprosy Cured,15,35,2,0,2
Haryana,Karnal,Leprosy Cured,35,60,5,2,7
Haryana,Karnal,Leprosy Cured,60,80,2,1,3
Assam,Karimganj,Leprosy Cured,60,80,1,0,1
Ladakh,Kargil,Leprosy Cured,35,60,2,0,2
Rajasthan,Karauli,Leprosy Cured,35,60,1,0,1
Puducherry,Karaikal,Leprosy Cured,35,60,0,1,1
Punjab,Kapurthala,Leprosy Cured,15,35,2,0,2
Punjab,Kapurthala,Leprosy Cured,35,60,2,2,4
Punjab,Kapurthala,Leprosy Cured,60,80,1,0,1
Uttar Pradesh,Kanpur Nagar,Leprosy Cured,0,6,1,0,1
Uttar Pradesh,Kanpur Nagar,Leprosy Cured,15,35,38,18,56
Uttar Pradesh,Kanpur Nagar,Leprosy Cured,35,60,143,30,173
Uttar Pradesh,Kanpur Nagar,Leprosy Cured,60,80,58,17,75
Uttar Pradesh,Kanpur Nagar,Leprosy Cured,80,100,5,0,5
Uttar Pradesh,Kanpur Dehat,Leprosy Cured,0,6,1,0,1
Uttar Pradesh,Kanpur Dehat,Leprosy Cured,6,15,1,0,1
Uttar Pradesh,Kanpur Dehat,Leprosy Cured,15,35,26,21,47
Uttar Pradesh,Kanpur Dehat,Leprosy Cured,35,60,113,37,150
Uttar Pradesh,Kanpur Dehat,Leprosy Cured,60,80,67,21,88
Uttar Pradesh,Kanpur Dehat,Leprosy Cured,80,100,3,1,4
Kerala,Kannur,Leprosy Cured,15,35,0,1,1
Kerala,Kannur,Leprosy Cured,35,60,3,1,4
Kerala,Kannur,Leprosy Cured,60,80,1,1,2
Kerala,Kannur,Leprosy Cured,80,100,1,0,1
Tamil Nadu,Kanniyakumari,Leprosy Cured,15,35,3,2,5
Tamil Nadu,Kanniyakumari,Leprosy Cured,35,60,28,13,41
Tamil Nadu,Kanniyakumari,Leprosy Cured,60,80,32,7,39
Tamil Nadu,Kanniyakumari,Leprosy Cured,80,100,8,2,10
Uttar Pradesh,Kannauj,Leprosy Cured,15,35,18,12,30
Uttar Pradesh,Kannauj,Leprosy Cured,35,60,63,18,81
Uttar Pradesh,Kannauj,Leprosy Cured,60,80,47,4,51
Uttar Pradesh,Kannauj,Leprosy Cured,80,100,3,0,3
Chhattisgarh,Kanker,Leprosy Cured,15,35,2,3,5
Chhattisgarh,Kanker,Leprosy Cured,35,60,6,1,7
Chhattisgarh,Kanker,Leprosy Cured,60,80,1,0,1
Himachal Pradesh,Kangra,Leprosy Cured,15,35,1,1,2
Himachal Pradesh,Kangra,Leprosy Cured,35,60,7,8,15
Himachal Pradesh,Kangra,Leprosy Cured,60,80,1,1,2
Odisha,Kandhamal,Leprosy Cured,15,35,5,4,9
Odisha,Kandhamal,Leprosy Cured,35,60,8,5,13
Odisha,Kandhamal,Leprosy Cured,60,80,0,1,1
Tamil Nadu,Kanchipuram,Leprosy Cured,15,35,4,1,5
Tamil Nadu,Kanchipuram,Leprosy Cured,35,60,38,21,59
Tamil Nadu,Kanchipuram,Leprosy Cured,60,80,81,56,137
Tamil Nadu,Kanchipuram,Leprosy Cured,80,100,13,4,17
Assam,Kamrup,Leprosy Cured,15,35,1,0,1
Assam,Kamrup,Leprosy Cured,35,60,2,0,2
Manipur,Kamjong,Leprosy Cured,15,35,0,1,1
Tamil Nadu,Kallakurichi,Leprosy Cured,0,6,1,0,1
Tamil Nadu,Kallakurichi,Leprosy Cured,15,35,3,1,4
Tamil Nadu,Kallakurichi,Leprosy Cured,35,60,20,6,26
Tamil Nadu,Kallakurichi,Leprosy Cured,60,80,22,6,28
Tamil Nadu,Kallakurichi,Leprosy Cured,80,100,4,0,4
Odisha,Kalahandi,Leprosy Cured,6,15,0,1,1
Odisha,Kalahandi,Leprosy Cured,15,35,1,1,2
Odisha,Kalahandi,Leprosy Cured,35,60,6,5,11
Odisha,Kalahandi,Leprosy Cured,60,80,4,1,5
Odisha,Kalahandi,Leprosy Cured,80,100,0,1,1
Karnataka,Kalaburagi,Leprosy Cured,15,35,12,1,13
Karnataka,Kalaburagi,Leprosy Cured,35,60,43,16,59
Karnataka,Kalaburagi,Leprosy Cured,60,80,11,7,18
Karnataka,Kalaburagi,Leprosy Cured,80,100,0,1,1
Manipur,Kakching,Leprosy Cured,15,35,1,0,1
Haryana,Kaithal,Leprosy Cured,6,15,1,0,1
Haryana,Kaithal,Leprosy Cured,15,35,3,2,5
Haryana,Kaithal,Leprosy Cured,35,60,16,5,21
Haryana,Kaithal,Leprosy Cured,60,80,3,0,3
Haryana,Kaithal,Leprosy Cured,80,100,2,0,2
Bihar,Kaimur (Bhabua),Leprosy Cured,0,6,1,0,1
Bihar,Kaimur (Bhabua),Leprosy Cured,6,15,0,1,1
Bihar,Kaimur (Bhabua),Leprosy Cured,15,35,8,1,9
Bihar,Kaimur (Bhabua),Leprosy Cured,35,60,13,3,16
Bihar,Kaimur (Bhabua),Leprosy Cured,60,80,11,4,15
Gujarat,Kachchh,Leprosy Cured,15,35,1,0,1
Gujarat,Junagadh,Leprosy Cured,15,35,3,1,4
Gujarat,Junagadh,Leprosy Cured,35,60,4,0,4
Gujarat,Junagadh,Leprosy Cured,60,80,1,0,1
Assam,Jorhat,Leprosy Cured,35,60,1,1,2
Rajasthan,Jodhpur,Leprosy Cured,35,60,1,0,1
Rajasthan,Jodhpur,Leprosy Cured,60,80,4,0,4
Haryana,Jind,Leprosy Cured,15,35,1,1,2
Haryana,Jind,Leprosy Cured,35,60,1,1,2
Haryana,Jind,Leprosy Cured,60,80,1,0,1
Rajasthan,Jhunjhunu,Leprosy Cured,35,60,0,1,1
Rajasthan,Jhunjhunu,Leprosy Cured,60,80,0,1,1
Odisha,Jharsuguda,Leprosy Cured,0,6,1,0,1
Odisha,Jharsuguda,Leprosy Cured,6,15,1,0,1
Odisha,Jharsuguda,Leprosy Cured,15,35,6,2,8
Odisha,Jharsuguda,Leprosy Cured,35,60,19,21,40
Odisha,Jharsuguda,Leprosy Cured,60,80,19,12,31
Odisha,Jharsuguda,Leprosy Cured,80,100,1,5,6
Uttar Pradesh,Jhansi,Leprosy Cured,6,15,1,1,2
Uttar Pradesh,Jhansi,Leprosy Cured,15,35,5,7,12
Uttar Pradesh,Jhansi,Leprosy Cured,35,60,31,11,42
Uttar Pradesh,Jhansi,Leprosy Cured,60,80,13,6,19
Uttar Pradesh,Jhansi,Leprosy Cured,80,100,2,1,3
Rajasthan,Jhalawar,Leprosy Cured,0,6,0,1,1
Rajasthan,Jhalawar,Leprosy Cured,6,15,2,1,3
Rajasthan,Jhalawar,Leprosy Cured,15,35,10,8,18
Rajasthan,Jhalawar,Leprosy Cured,35,60,11,12,23
Rajasthan,Jhalawar,Leprosy Cured,60,80,2,0,2
Haryana,Jhajjar,Leprosy Cured,15,35,0,1,1
Haryana,Jhajjar,Leprosy Cured,60,80,2,0,2
Haryana,Jhajjar,Leprosy Cured,80,100,1,0,1
Madhya Pradesh,Jhabua,Leprosy Cured,6,15,1,2,3
Madhya Pradesh,Jhabua,Leprosy Cured,15,35,6,7,13
Madhya Pradesh,Jhabua,Leprosy Cured,35,60,10,5,15
Madhya Pradesh,Jhabua,Leprosy Cured,60,80,3,2,5
Madhya Pradesh,Jhabua,Leprosy Cured,80,100,2,0,2
Bihar,Jehanabad,Leprosy Cured,15,35,5,2,7
Uttar Pradesh,Jaunpur,Leprosy Cured,6,15,1,2,3
Uttar Pradesh,Jaunpur,Leprosy Cured,15,35,35,13,48
Uttar Pradesh,Jaunpur,Leprosy Cured,35,60,56,10,66
Uttar Pradesh,Jaunpur,Leprosy Cured,60,80,24,6,30
Uttar Pradesh,Jaunpur,Leprosy Cured,80,100,1,0,1
Chhattisgarh,Jashpur,Leprosy Cured,15,35,0,1,1
Chhattisgarh,Jashpur,Leprosy Cured,35,60,4,0,4
Chhattisgarh,Jashpur,Leprosy Cured,60,80,2,1,3
Chhattisgarh,Janjgir-Champa,Leprosy Cured,6,15,1,2,3
Chhattisgarh,Janjgir-Champa,Leprosy Cured,15,35,11,5,16
Chhattisgarh,Janjgir-Champa,Leprosy Cured,35,60,47,39,86
Chhattisgarh,Janjgir-Champa,Leprosy Cured,60,80,47,70,117
Chhattisgarh,Janjgir-Champa,Leprosy Cured,80,100,10,18,28
Bihar,Jamui,Leprosy Cured,6,15,0,1,1
Bihar,Jamui,Leprosy Cured,15,35,13,3,16
Bihar,Jamui,Leprosy Cured,35,60,12,5,17
Bihar,Jamui,Leprosy Cured,60,80,2,1,3
Jharkhand,Jamtara,Leprosy Cured,6,15,1,0,1
Jharkhand,Jamtara,Leprosy Cured,15,35,2,1,3
Jharkhand,Jamtara,Leprosy Cured,35,60,2,2,4
Jharkhand,Jamtara,Leprosy Cured,60,80,2,0,2
Gujarat,Jamnagar,Leprosy Cured,35,60,3,0,3
Gujarat,Jamnagar,Leprosy Cured,60,80,1,0,1
Jammu And Kashmir,Jammu,Leprosy Cured,15,35,0,1,1
Jammu And Kashmir,Jammu,Leprosy Cured,35,60,6,4,10
Jammu And Kashmir,Jammu,Leprosy Cured,60,80,4,0,4
Rajasthan,Jalore,Leprosy Cured,6,15,1,0,1
Rajasthan,Jalore,Leprosy Cured,15,35,1,3,4
Rajasthan,Jalore,Leprosy Cured,35,60,6,0,6
Rajasthan,Jalore,Leprosy Cured,60,80,1,1,2
Maharashtra,Jalna,Leprosy Cured,35,60,4,0,4
Maharashtra,Jalgaon,Leprosy Cured,15,35,7,0,7
Maharashtra,Jalgaon,Leprosy Cured,35,60,8,3,11
Maharashtra,Jalgaon,Leprosy Cured,60,80,5,4,9
Uttar Pradesh,Jalaun,Leprosy Cured,15,35,12,3,15
Uttar Pradesh,Jalaun,Leprosy Cured,35,60,36,18,54
Uttar Pradesh,Jalaun,Leprosy Cured,60,80,14,1,15
Uttar Pradesh,Jalaun,Leprosy Cured,80,100,2,0,2
Punjab,Jalandhar,Leprosy Cured,15,35,0,1,1
Punjab,Jalandhar,Leprosy Cured,35,60,1,3,4
Punjab,Jalandhar,Leprosy Cured,60,80,1,1,2
Odisha,Jajapur,Leprosy Cured,15,35,1,0,1
Odisha,Jajapur,Leprosy Cured,35,60,6,2,8
Odisha,Jajapur,Leprosy Cured,60,80,10,2,12
Odisha,Jajapur,Leprosy Cured,80,100,1,0,1
Rajasthan,Jaisalmer,Leprosy Cured,6,15,0,1,1
Rajasthan,Jaisalmer,Leprosy Cured,15,35,1,0,1
Rajasthan,Jaisalmer,Leprosy Cured,35,60,1,0,1
Rajasthan,Jaipur,Leprosy Cured,0,6,1,0,1
Rajasthan,Jaipur,Leprosy Cured,6,15,1,1,2
Rajasthan,Jaipur,Leprosy Cured,15,35,10,7,17
Rajasthan,Jaipur,Leprosy Cured,35,60,47,48,95
Rajasthan,Jaipur,Leprosy Cured,60,80,32,14,46
Rajasthan,Jaipur,Leprosy Cured,80,100,3,5,8
Odisha,Jagatsinghapur,Leprosy Cured,35,60,4,5,9
Odisha,Jagatsinghapur,Leprosy Cured,80,100,0,1,1
Madhya Pradesh,Jabalpur,Leprosy Cured,6,15,2,0,2
Madhya Pradesh,Jabalpur,Leprosy Cured,15,35,5,8,13
Madhya Pradesh,Jabalpur,Leprosy Cured,35,60,27,13,40
Madhya Pradesh,Jabalpur,Leprosy Cured,60,80,6,2,8
Madhya Pradesh,Indore,Leprosy Cured,15,35,4,4,8
Madhya Pradesh,Indore,Leprosy Cured,35,60,30,32,62
Madhya Pradesh,Indore,Leprosy Cured,60,80,50,54,104
Madhya Pradesh,Indore,Leprosy Cured,80,100,5,5,10
Kerala,Idukki,Leprosy Cured,60,80,0,1,1
Punjab,Hoshiarpur,Leprosy Cured,6,15,1,0,1
Punjab,Hoshiarpur,Leprosy Cured,15,35,9,3,12
Punjab,Hoshiarpur,Leprosy Cured,35,60,25,23,48
Punjab,Hoshiarpur,Leprosy Cured,60,80,11,1,12
Assam,Hojai,Leprosy Cured,0,6,1,0,1
Haryana,Hisar,Leprosy Cured,15,35,1,0,1
Haryana,Hisar,Leprosy Cured,60,80,2,0,2
Maharashtra,Hingoli,Leprosy Cured,35,60,2,1,3
Maharashtra,Hingoli,Leprosy Cured,60,80,0,3,3
Jharkhand,Hazaribagh,Leprosy Cured,6,15,2,2,4
Jharkhand,Hazaribagh,Leprosy Cured,15,35,11,2,13
Jharkhand,Hazaribagh,Leprosy Cured,35,60,11,4,15
Jharkhand,Hazaribagh,Leprosy Cured,60,80,1,0,1
Karnataka,Haveri,Leprosy Cured,6,15,1,0,1
Karnataka,Haveri,Leprosy Cured,35,60,14,7,21
Karnataka,Haveri,Leprosy Cured,60,80,7,1,8
Uttar Pradesh,Hathras,Leprosy Cured,15,35,6,2,8
Uttar Pradesh,Hathras,Leprosy Cured,35,60,5,0,5
Uttar Pradesh,Hathras,Leprosy Cured,60,80,3,1,4
Uttar Pradesh,Hathras,Leprosy Cured,80,100,0,1,1
Karnataka,Hassan,Leprosy Cured,15,35,1,0,1
Karnataka,Hassan,Leprosy Cured,35,60,4,1,5
Karnataka,Hassan,Leprosy Cured,60,80,3,0,3
Karnataka,Hassan,Leprosy Cured,80,100,1,0,1
Uttarakhand,Haridwar,Leprosy Cured,6,15,1,0,1
Uttarakhand,Haridwar,Leprosy Cured,15,35,19,17,36
Uttarakhand,Haridwar,Leprosy Cured,35,60,78,60,138
Uttarakhand,Haridwar,Leprosy Cured,60,80,30,15,45
Uttarakhand,Haridwar,Leprosy Cured,80,100,1,1,2
Uttar Pradesh,Hardoi,Leprosy Cured,15,35,40,12,52
Uttar Pradesh,Hardoi,Leprosy Cured,35,60,101,34,135
Uttar Pradesh,Hardoi,Leprosy Cured,60,80,57,9,66
Uttar Pradesh,Hardoi,Leprosy Cured,80,100,1,1,2
Madhya Pradesh,Harda,Leprosy Cured,15,35,0,5,5
Madhya Pradesh,Harda,Leprosy Cured,35,60,6,3,9
Madhya Pradesh,Harda,Leprosy Cured,60,80,1,0,1
Uttar Pradesh,Hapur,Leprosy Cured,15,35,4,2,6
Uttar Pradesh,Hapur,Leprosy Cured,35,60,9,4,13
Uttar Pradesh,Hapur,Leprosy Cured,60,80,5,1,6
Uttar Pradesh,Hapur,Leprosy Cured,80,100,1,0,1
Rajasthan,Hanumangarh,Leprosy Cured,6,15,0,1,1
Rajasthan,Hanumangarh,Leprosy Cured,15,35,0,1,1
Rajasthan,Hanumangarh,Leprosy Cured,35,60,2,0,2
Rajasthan,Hanumangarh,Leprosy Cured,60,80,1,2,3
Himachal Pradesh,Hamirpur,Leprosy Cured,35,60,3,2,5
Himachal Pradesh,Hamirpur,Leprosy Cured,60,80,1,0,1
Uttar Pradesh,Hamirpur,Leprosy Cured,15,35,9,3,12
Uttar Pradesh,Hamirpur,Leprosy Cured,35,60,41,20,61
Uttar Pradesh,Hamirpur,Leprosy Cured,60,80,46,10,56
Uttar Pradesh,Hamirpur,Leprosy Cured,80,100,3,0,3
Sikkim,Gyalshing,Leprosy Cured,80,100,1,0,1
Madhya Pradesh,Gwalior,Leprosy Cured,15,35,6,1,7
Madhya Pradesh,Gwalior,Leprosy Cured,35,60,4,4,8
Madhya Pradesh,Gwalior,Leprosy Cured,60,80,2,0,2
Punjab,Gurdaspur,Leprosy Cured,15,35,1,0,1
Punjab,Gurdaspur,Leprosy Cured,35,60,20,15,35
Punjab,Gurdaspur,Leprosy Cured,60,80,12,8,20
Punjab,Gurdaspur,Leprosy Cured,80,100,1,3,4
Andhra Pradesh,Guntur,Leprosy Cured,15,35,3,0,3
Andhra Pradesh,Guntur,Leprosy Cured,35,60,1,1,2
Madhya Pradesh,Guna,Leprosy Cured,15,35,0,1,1
Madhya Pradesh,Guna,Leprosy Cured,35,60,3,3,6
Madhya Pradesh,Guna,Leprosy Cured,60,80,1,0,1
Jharkhand,Gumla,Leprosy Cured,6,15,3,1,4
Jharkhand,Gumla,Leprosy Cured,15,35,9,10,19
Jharkhand,Gumla,Leprosy Cured,35,60,19,9,28
Jharkhand,Gumla,Leprosy Cured,60,80,7,2,9
Jharkhand,Gumla,Leprosy Cured,80,100,1,0,1
Uttar Pradesh,Gorakhpur,Leprosy Cured,6,15,9,1,10
Uttar Pradesh,Gorakhpur,Leprosy Cured,15,35,71,22,93
Uttar Pradesh,Gorakhpur,Leprosy Cured,35,60,157,46,203
Uttar Pradesh,Gorakhpur,Leprosy Cured,60,80,80,22,102
Uttar Pradesh,Gorakhpur,Leprosy Cured,80,100,1,0,1
Bihar,Gopalganj,Leprosy Cured,6,15,1,1,2
Bihar,Gopalganj,Leprosy Cured,15,35,23,13,36
Bihar,Gopalganj,Leprosy Cured,35,60,52,14,66
Bihar,Gopalganj,Leprosy Cured,60,80,25,2,27
Maharashtra,Gondia,Leprosy Cured,0,6,0,1,1
Maharashtra,Gondia,Leprosy Cured,15,35,3,1,4
Maharashtra,Gondia,Leprosy Cured,35,60,8,6,14
Maharashtra,Gondia,Leprosy Cured,60,80,3,1,4
Uttar Pradesh,Gonda,Leprosy Cured,6,15,4,4,8
Uttar Pradesh,Gonda,Leprosy Cured,15,35,33,8,41
Uttar Pradesh,Gonda,Leprosy Cured,35,60,54,18,72
Uttar Pradesh,Gonda,Leprosy Cured,60,80,28,4,32
Uttar Pradesh,Gonda,Leprosy Cured,80,100,0,1,1
Assam,Golaghat,Leprosy Cured,6,15,0,1,1
Assam,Golaghat,Leprosy Cured,15,35,1,0,1
Assam,Golaghat,Leprosy Cured,35,60,2,1,3
Assam,Golaghat,Leprosy Cured,60,80,1,0,1
Jharkhand,Godda,Leprosy Cured,6,15,1,2,3
Jharkhand,Godda,Leprosy Cured,15,35,28,15,43
Jharkhand,Godda,Leprosy Cured,35,60,17,7,24
Jharkhand,Godda,Leprosy Cured,60,80,15,2,17
Jharkhand,Godda,Leprosy Cured,80,100,1,2,3
Assam,Goalpara,Leprosy Cured,15,35,1,2,3
Assam,Goalpara,Leprosy Cured,35,60,1,1,2
Jharkhand,Giridih,Leprosy Cured,6,15,3,2,5
Jharkhand,Giridih,Leprosy Cured,15,35,21,3,24
Jharkhand,Giridih,Leprosy Cured,35,60,19,12,31
Jharkhand,Giridih,Leprosy Cured,60,80,10,1,11
Jharkhand,Giridih,Leprosy Cured,80,100,1,0,1
Gujarat,Gir Somnath,Leprosy Cured,15,35,2,0,2
Gujarat,Gir Somnath,Leprosy Cured,35,60,0,1,1
Uttar Pradesh,Ghazipur,Leprosy Cured,15,35,33,9,42
Uttar Pradesh,Ghazipur,Leprosy Cured,35,60,132,21,153
Uttar Pradesh,Ghazipur,Leprosy Cured,60,80,73,11,84
Uttar Pradesh,Ghazipur,Leprosy Cured,80,100,4,1,5
Uttar Pradesh,Ghaziabad,Leprosy Cured,15,35,17,7,24
Uttar Pradesh,Ghaziabad,Leprosy Cured,35,60,46,36,82
Uttar Pradesh,Ghaziabad,Leprosy Cured,60,80,18,5,23
Uttar Pradesh,Ghaziabad,Leprosy Cured,80,100,1,0,1
Bihar,Gaya,Leprosy Cured,6,15,0,1,1
Bihar,Gaya,Leprosy Cured,15,35,3,4,7
Bihar,Gaya,Leprosy Cured,35,60,42,19,61
Bihar,Gaya,Leprosy Cured,60,80,15,6,21
Bihar,Gaya,Leprosy Cured,80,100,0,1,1
Uttar Pradesh,Gautam Buddha Nagar,Leprosy Cured,15,35,3,3,6
Uttar Pradesh,Gautam Buddha Nagar,Leprosy Cured,35,60,6,1,7
Uttar Pradesh,Gautam Buddha Nagar,Leprosy Cured,60,80,1,0,1
Chhattisgarh,Gaurella Pendra Marwahi,Leprosy Cured,35,60,0,1,1
Chhattisgarh,Gariyaband,Leprosy Cured,6,15,0,1,1
Chhattisgarh,Gariyaband,Leprosy Cured,15,35,2,0,2
Chhattisgarh,Gariyaband,Leprosy Cured,35,60,5,2,7
Chhattisgarh,Gariyaband,Leprosy Cured,60,80,1,0,1
Jharkhand,Garhwa,Leprosy Cured,0,6,1,0,1
Jharkhand,Garhwa,Leprosy Cured,6,15,2,2,4
Jharkhand,Garhwa,Leprosy Cured,15,35,3,5,8
Jharkhand,Garhwa,Leprosy Cured,35,60,6,3,9
Jharkhand,Garhwa,Leprosy Cured,60,80,1,0,1
Odisha,Ganjam,Leprosy Cured,15,35,0,1,1
Odisha,Ganjam,Leprosy Cured,35,60,11,6,17
Odisha,Ganjam,Leprosy Cured,60,80,4,0,4
Odisha,Ganjam,Leprosy Cured,80,100,1,0,1
Rajasthan,Ganganagar,Leprosy Cured,35,60,1,0,1
Gujarat,Gandhinagar,Leprosy Cured,35,60,1,1,2
Jammu And Kashmir,Ganderbal,Leprosy Cured,35,60,1,0,1
Jammu And Kashmir,Ganderbal,Leprosy Cured,60,80,1,0,1
Odisha,Gajapati,Leprosy Cured,0,6,0,1,1
Odisha,Gajapati,Leprosy Cured,35,60,4,3,7
Odisha,Gajapati,Leprosy Cured,60,80,2,4,6
Odisha,Gajapati,Leprosy Cured,80,100,0,1,1
Maharashtra,Gadchiroli,Leprosy Cured,6,15,1,0,1
Maharashtra,Gadchiroli,Leprosy Cured,15,35,10,2,12
Maharashtra,Gadchiroli,Leprosy Cured,35,60,15,8,23
Maharashtra,Gadchiroli,Leprosy Cured,60,80,12,5,17
Maharashtra,Gadchiroli,Leprosy Cured,80,100,2,0,2
Karnataka,Gadag,Leprosy Cured,15,35,1,2,3
Karnataka,Gadag,Leprosy Cured,35,60,11,4,15
Karnataka,Gadag,Leprosy Cured,60,80,7,4,11
Karnataka,Gadag,Leprosy Cured,80,100,1,0,1
Uttar Pradesh,Firozabad,Leprosy Cured,6,15,1,0,1
Uttar Pradesh,Firozabad,Leprosy Cured,15,35,15,13,28
Uttar Pradesh,Firozabad,Leprosy Cured,35,60,38,22,60
Uttar Pradesh,Firozabad,Leprosy Cured,60,80,4,2,6
Uttar Pradesh,Firozabad,Leprosy Cured,80,100,0,1,1
Punjab,Ferozepur,Leprosy Cured,15,35,2,0,2
Punjab,Ferozepur,Leprosy Cured,35,60,19,2,21
Punjab,Ferozepur,Leprosy Cured,60,80,4,1,5
Punjab,Fazilka,Leprosy Cured,15,35,3,1,4
Punjab,Fazilka,Leprosy Cured,35,60,1,0,1
Uttar Pradesh,Fatehpur,Leprosy Cured,0,6,1,0,1
Uttar Pradesh,Fatehpur,Leprosy Cured,6,15,3,1,4
Uttar Pradesh,Fatehpur,Leprosy Cured,15,35,30,15,45
Uttar Pradesh,Fatehpur,Leprosy Cured,35,60,75,25,100
Uttar Pradesh,Fatehpur,Leprosy Cured,60,80,58,15,73
Uttar Pradesh,Fatehpur,Leprosy Cured,80,100,1,1,2
Punjab,Fatehgarh Sahib,Leprosy Cured,15,35,2,0,2
Punjab,Fatehgarh Sahib,Leprosy Cured,35,60,3,2,5
Punjab,Fatehgarh Sahib,Leprosy Cured,60,80,0,2,2
Haryana,Fatehabad,Leprosy Cured,15,35,5,2,7
Haryana,Fatehabad,Leprosy Cured,35,60,6,2,8
Uttar Pradesh,Farrukhabad,Leprosy Cured,6,15,1,0,1
Uttar Pradesh,Farrukhabad,Leprosy Cured,15,35,17,8,25
Uttar Pradesh,Farrukhabad,Leprosy Cured,35,60,34,5,39
Uttar Pradesh,Farrukhabad,Leprosy Cured,60,80,10,6,16
Uttar Pradesh,Farrukhabad,Leprosy Cured,80,100,1,0,1
Punjab,Faridkot,Leprosy Cured,15,35,1,0,1
Punjab,Faridkot,Leprosy Cured,35,60,11,2,13
Punjab,Faridkot,Leprosy Cured,60,80,5,2,7
Haryana,Faridabad,Leprosy Cured,15,35,1,0,1
Haryana,Faridabad,Leprosy Cured,35,60,2,0,2
Uttar Pradesh,Etawah,Leprosy Cured,15,35,11,5,16
Uttar Pradesh,Etawah,Leprosy Cured,35,60,25,2,27
Uttar Pradesh,Etawah,Leprosy Cured,60,80,11,3,14
Uttar Pradesh,Etah,Leprosy Cured,15,35,9,3,12
Uttar Pradesh,Etah,Leprosy Cured,35,60,11,5,16
Uttar Pradesh,Etah,Leprosy Cured,60,80,8,3,11
Tamil Nadu,Erode,Leprosy Cured,15,35,5,1,6
Tamil Nadu,Erode,Leprosy Cured,35,60,82,59,141
Tamil Nadu,Erode,Leprosy Cured,60,80,141,67,208
Tamil Nadu,Erode,Leprosy Cured,80,100,23,5,28
Jharkhand,East Singhbum,Leprosy Cured,6,15,3,0,3
Jharkhand,East Singhbum,Leprosy Cured,15,35,26,21,47
Jharkhand,East Singhbum,Leprosy Cured,35,60,81,90,171
Jharkhand,East Singhbum,Leprosy Cured,60,80,76,101,177
Jharkhand,East Singhbum,Leprosy Cured,80,100,4,12,16
Madhya Pradesh,East Nimar,Leprosy Cured,15,35,3,2,5
Madhya Pradesh,East Nimar,Leprosy Cured,35,60,9,4,13
Madhya Pradesh,East Nimar,Leprosy Cured,60,80,0,1,1
Delhi,East,Leprosy Cured,15,35,0,1,1
Delhi,East,Leprosy Cured,35,60,2,2,4
Delhi,East,Leprosy Cured,60,80,1,0,1
Chhattisgarh,Durg,Leprosy Cured,6,15,1,0,1
Chhattisgarh,Durg,Leprosy Cured,15,35,4,5,9
Chhattisgarh,Durg,Leprosy Cured,35,60,12,7,19
Chhattisgarh,Durg,Leprosy Cured,60,80,6,10,16
Chhattisgarh,Durg,Leprosy Cured,80,100,0,1,1
Rajasthan,Dungarpur,Leprosy Cured,35,60,1,1,2
Rajasthan,Dungarpur,Leprosy Cured,60,80,1,0,1
Rajasthan,Dungarpur,Leprosy Cured,80,100,1,0,1
Jharkhand,Dumka,Leprosy Cured,0,6,0,1,1
Jharkhand,Dumka,Leprosy Cured,6,15,0,4,4
Jharkhand,Dumka,Leprosy Cured,15,35,4,1,5
Jharkhand,Dumka,Leprosy Cured,35,60,5,1,6
Jharkhand,Dumka,Leprosy Cured,60,80,0,1,1
Gujarat,Dohad,Leprosy Cured,15,35,1,0,1
Jammu And Kashmir,Doda,Leprosy Cured,6,15,2,0,2
Jammu And Kashmir,Doda,Leprosy Cured,15,35,3,1,4
Jammu And Kashmir,Doda,Leprosy Cured,35,60,5,3,8
Jammu And Kashmir,Doda,Leprosy Cured,60,80,3,0,3
Madhya Pradesh,Dindori,Leprosy Cured,15,35,3,5,8
Madhya Pradesh,Dindori,Leprosy Cured,35,60,10,4,14
Madhya Pradesh,Dindori,Leprosy Cured,60,80,2,0,2
Tamil Nadu,Dindigul,Leprosy Cured,15,35,5,2,7
Tamil Nadu,Dindigul,Leprosy Cured,35,60,89,44,133
Tamil Nadu,Dindigul,Leprosy Cured,60,80,199,86,285
Tamil Nadu,Dindigul,Leprosy Cured,80,100,19,6,25
Assam,Dibrugarh,Leprosy Cured,35,60,1,0,1
Maharashtra,Dhule,Leprosy Cured,15,35,1,0,1
Maharashtra,Dhule,Leprosy Cured,35,60,0,2,2
Maharashtra,Dhule,Leprosy Cured,60,80,3,1,4
Rajasthan,Dholpur,Leprosy Cured,35,60,1,0,1
Odisha,Dhenkanal,Leprosy Cured,6,15,2,1,3
Odisha,Dhenkanal,Leprosy Cured,15,35,11,1,12
Odisha,Dhenkanal,Leprosy Cured,35,60,34,21,55
Odisha,Dhenkanal,Leprosy Cured,60,80,20,5,25
Odisha,Dhenkanal,Leprosy Cured,80,100,1,0,1
Assam,Dhemaji,Leprosy Cured,35,60,1,0,1
Karnataka,Dharwad,Leprosy Cured,15,35,3,0,3
Karnataka,Dharwad,Leprosy Cured,35,60,5,2,7
Karnataka,Dharwad,Leprosy Cured,60,80,3,2,5
Tamil Nadu,Dharmapuri,Leprosy Cured,6,15,0,1,1
Tamil Nadu,Dharmapuri,Leprosy Cured,15,35,9,0,9
Tamil Nadu,Dharmapuri,Leprosy Cured,35,60,51,30,81
Tamil Nadu,Dharmapuri,Leprosy Cured,60,80,76,28,104
Tamil Nadu,Dharmapuri,Leprosy Cured,80,100,6,3,9
Madhya Pradesh,Dhar,Leprosy Cured,6,15,0,1,1
Madhya Pradesh,Dhar,Leprosy Cured,15,35,10,9,19
Madhya Pradesh,Dhar,Leprosy Cured,35,60,29,48,77
Madhya Pradesh,Dhar,Leprosy Cured,60,80,8,8,16
Madhya Pradesh,Dhar,Leprosy Cured,80,100,0,1,1
Jharkhand,Dhanbad,Leprosy Cured,6,15,1,2,3
Jharkhand,Dhanbad,Leprosy Cured,15,35,20,9,29
Jharkhand,Dhanbad,Leprosy Cured,35,60,36,28,64
Jharkhand,Dhanbad,Leprosy Cured,60,80,13,21,34
Jharkhand,Dhanbad,Leprosy Cured,80,100,1,0,1
Chhattisgarh,Dhamtari,Leprosy Cured,15,35,0,1,1
Chhattisgarh,Dhamtari,Leprosy Cured,35,60,1,0,1
Tripura,Dhalai,Leprosy Cured,35,60,1,0,1
Madhya Pradesh,Dewas,Leprosy Cured,6,15,1,0,1
Madhya Pradesh,Dewas,Leprosy Cured,15,35,5,4,9
Madhya Pradesh,Dewas,Leprosy Cured,35,60,10,1,11
Madhya Pradesh,Dewas,Leprosy Cured,80,100,0,1,1
Gujarat,Devbhumi Dwarka,Leprosy Cured,35,60,1,0,1
Uttar Pradesh,Deoria,Leprosy Cured,6,15,2,1,3
Uttar Pradesh,Deoria,Leprosy Cured,15,35,64,27,91
Uttar Pradesh,Deoria,Leprosy Cured,35,60,187,40,227
Uttar Pradesh,Deoria,Leprosy Cured,60,80,90,16,106
Uttar Pradesh,Deoria,Leprosy Cured,80,100,4,3,7
Jharkhand,Deoghar,Leprosy Cured,6,15,4,1,5
Jharkhand,Deoghar,Leprosy Cured,15,35,9,6,15
Jharkhand,Deoghar,Leprosy Cured,35,60,12,5,17
Jharkhand,Deoghar,Leprosy Cured,60,80,6,3,9
Jharkhand,Deoghar,Leprosy Cured,80,100,1,0,1
Odisha,Deogarh,Leprosy Cured,15,35,0,1,1
Odisha,Deogarh,Leprosy Cured,35,60,8,5,13
Odisha,Deogarh,Leprosy Cured,60,80,5,0,5
Uttarakhand,Dehradun,Leprosy Cured,6,15,1,0,1
Uttarakhand,Dehradun,Leprosy Cured,35,60,5,5,10
Uttarakhand,Dehradun,Leprosy Cured,60,80,0,9,9
Karnataka,Davangere,Leprosy Cured,6,15,1,0,1
Karnataka,Davangere,Leprosy Cured,15,35,2,0,2
Karnataka,Davangere,Leprosy Cured,35,60,7,0,7
Karnataka,Davangere,Leprosy Cured,60,80,3,1,4
Rajasthan,Dausa,Leprosy Cured,6,15,0,2,2
Rajasthan,Dausa,Leprosy Cured,15,35,8,20,28
Rajasthan,Dausa,Leprosy Cured,35,60,4,3,7
Madhya Pradesh,Datia,Leprosy Cured,6,15,1,0,1
Madhya Pradesh,Datia,Leprosy Cured,15,35,0,3,3
Madhya Pradesh,Datia,Leprosy Cured,35,60,1,1,2
Madhya Pradesh,Datia,Leprosy Cured,60,80,1,0,1
Assam,Darrang,Leprosy Cured,15,35,4,1,5
Assam,Darrang,Leprosy Cured,60,80,1,0,1
Bihar,Darbhanga,Leprosy Cured,6,15,4,5,9
Bihar,Darbhanga,Leprosy Cured,15,35,56,54,110
Bihar,Darbhanga,Leprosy Cured,35,60,87,55,142
Bihar,Darbhanga,Leprosy Cured,60,80,48,12,60
Bihar,Darbhanga,Leprosy Cured,80,100,4,1,5
Chhattisgarh,Dantewada,Leprosy Cured,15,35,1,0,1
Chhattisgarh,Dantewada,Leprosy Cured,35,60,1,0,1
Gujarat,Dang,Leprosy Cured,35,60,1,0,1
Madhya Pradesh,Damoh,Leprosy Cured,15,35,24,5,29
Madhya Pradesh,Damoh,Leprosy Cured,35,60,28,8,36
Madhya Pradesh,Damoh,Leprosy Cured,60,80,1,9,10
Karnataka,Dakshina Kannada,Leprosy Cured,35,60,7,4,11
Karnataka,Dakshina Kannada,Leprosy Cured,60,80,3,5,8
Karnataka,Dakshina Kannada,Leprosy Cured,80,100,0,4,4
Dadra Nagar Haveli And Daman And Diu,Dadra And Nagar Haveli,Leprosy Cured,60,80,1,0,1
Odisha,Cuttack,Leprosy Cured,0,6,0,1,1
Odisha,Cuttack,Leprosy Cured,6,15,6,2,8
Odisha,Cuttack,Leprosy Cured,15,35,16,12,28
Odisha,Cuttack,Leprosy Cured,35,60,115,118,233
Odisha,Cuttack,Leprosy Cured,60,80,145,115,260
Odisha,Cuttack,Leprosy Cured,80,100,23,12,35
Tamil Nadu,Cuddalore,Leprosy Cured,15,35,3,1,4
Tamil Nadu,Cuddalore,Leprosy Cured,35,60,14,9,23
Tamil Nadu,Cuddalore,Leprosy Cured,60,80,29,8,37
Tamil Nadu,Cuddalore,Leprosy Cured,80,100,2,0,2
Tamil Nadu,Coimbatore,Leprosy Cured,15,35,3,0,3
Tamil Nadu,Coimbatore,Leprosy Cured,35,60,10,13,23
Tamil Nadu,Coimbatore,Leprosy Cured,60,80,12,13,25
Tamil Nadu,Coimbatore,Leprosy Cured,80,100,5,0,5
Rajasthan,Chittorgarh,Leprosy Cured,15,35,1,1,2
Rajasthan,Chittorgarh,Leprosy Cured,35,60,3,2,5
Rajasthan,Chittorgarh,Leprosy Cured,60,80,1,1,2
Rajasthan,Chittorgarh,Leprosy Cured,80,100,1,0,1
Uttar Pradesh,Chitrakoot,Leprosy Cured,6,15,4,2,6
Uttar Pradesh,Chitrakoot,Leprosy Cured,15,35,24,11,35
Uttar Pradesh,Chitrakoot,Leprosy Cured,35,60,50,13,63
Uttar Pradesh,Chitrakoot,Leprosy Cured,60,80,17,5,22
Uttar Pradesh,Chitrakoot,Leprosy Cured,80,100,4,0,4
Karnataka,Chitradurga,Leprosy Cured,0,6,0,1,1
Karnataka,Chitradurga,Leprosy Cured,6,15,2,0,2
Karnataka,Chitradurga,Leprosy Cured,15,35,5,0,5
Karnataka,Chitradurga,Leprosy Cured,35,60,7,3,10
Karnataka,Chitradurga,Leprosy Cured,60,80,6,2,8
Assam,Chirang,Leprosy Cured,35,60,1,0,1
Karnataka,Chikkamagaluru,Leprosy Cured,15,35,1,1,2
Karnataka,Chikkamagaluru,Leprosy Cured,35,60,3,3,6
Karnataka,Chikkamagaluru,Leprosy Cured,60,80,1,1,2
Karnataka,Chikkaballapura,Leprosy Cured,6,15,0,2,2
Karnataka,Chikkaballapura,Leprosy Cured,15,35,0,1,1
Karnataka,Chikkaballapura,Leprosy Cured,35,60,11,5,16
Karnataka,Chikkaballapura,Leprosy Cured,60,80,8,5,13
Karnataka,Chikkaballapura,Leprosy Cured,80,100,0,1,1
Gujarat,Chhotaudepur,Leprosy Cured,6,15,0,1,1
Madhya Pradesh,Chhindwara,Leprosy Cured,6,15,0,1,1
Madhya Pradesh,Chhindwara,Leprosy Cured,15,35,9,8,17
Madhya Pradesh,Chhindwara,Leprosy Cured,35,60,30,18,48
Madhya Pradesh,Chhindwara,Leprosy Cured,60,80,14,1,15
Madhya Pradesh,Chhindwara,Leprosy Cured,80,100,1,0,1
Madhya Pradesh,Chhatarpur,Leprosy Cured,15,35,5,3,8
Madhya Pradesh,Chhatarpur,Leprosy Cured,35,60,8,1,9
Madhya Pradesh,Chhatarpur,Leprosy Cured,60,80,3,1,4
Tamil Nadu,Chennai,Leprosy Cured,15,35,4,1,5
Tamil Nadu,Chennai,Leprosy Cured,35,60,45,28,73
Tamil Nadu,Chennai,Leprosy Cured,60,80,78,32,110
Tamil Nadu,Chennai,Leprosy Cured,80,100,14,3,17
Tamil Nadu,Chengalpattu,Leprosy Cured,15,35,0,1,1
Tamil Nadu,Chengalpattu,Leprosy Cured,35,60,36,24,60
Tamil Nadu,Chengalpattu,Leprosy Cured,60,80,51,27,78
Tamil Nadu,Chengalpattu,Leprosy Cured,80,100,10,5,15
Jharkhand,Chatra,Leprosy Cured,0,6,1,0,1
Jharkhand,Chatra,Leprosy Cured,6,15,0,1,1
Jharkhand,Chatra,Leprosy Cured,15,35,2,0,2
Jharkhand,Chatra,Leprosy Cured,35,60,0,1,1
Haryana,Charki Dadri,Leprosy Cured,15,35,0,1,1
Haryana,Charki Dadri,Leprosy Cured,60,80,0,1,1
Assam,Charaideo,Leprosy Cured,0,6,1,0,1
Assam,Charaideo,Leprosy Cured,35,60,1,0,1
Maharashtra,Chandrapur,Leprosy Cured,15,35,18,11,29
Maharashtra,Chandrapur,Leprosy Cured,35,60,77,36,113
Maharashtra,Chandrapur,Leprosy Cured,60,80,54,26,80
Maharashtra,Chandrapur,Leprosy Cured,80,100,1,1,2
Chandigarh,Chandigarh,Leprosy Cured,6,15,0,1,1
Chandigarh,Chandigarh,Leprosy Cured,15,35,2,2,4
Chandigarh,Chandigarh,Leprosy Cured,35,60,5,2,7
Chandigarh,Chandigarh,Leprosy Cured,60,80,1,0,1
Uttar Pradesh,Chandauli,Leprosy Cured,15,35,48,11,59
Uttar Pradesh,Chandauli,Leprosy Cured,35,60,152,28,180
Uttar Pradesh,Chandauli,Leprosy Cured,60,80,69,6,75
Uttar Pradesh,Chandauli,Leprosy Cured,80,100,3,1,4
Mizoram,Champhai,Leprosy Cured,35,60,0,1,1
Uttarakhand,Champawat,Leprosy Cured,35,60,1,1,2
Uttarakhand,Chamoli,Leprosy Cured,15,35,4,0,4
Uttarakhand,Chamoli,Leprosy Cured,35,60,0,1,1
Uttarakhand,Chamoli,Leprosy Cured,60,80,1,0,1
Karnataka,Chamarajanagara,Leprosy Cured,15,35,3,2,5
Karnataka,Chamarajanagara,Leprosy Cured,35,60,9,2,11
Karnataka,Chamarajanagara,Leprosy Cured,60,80,10,0,10
Karnataka,Chamarajanagara,Leprosy Cured,80,100,0,1,1
Delhi,Central,Leprosy Cured,35,60,1,0,1
Assam,Cachar,Leprosy Cured,35,60,4,0,4
Assam,Cachar,Leprosy Cured,60,80,1,0,1
Bihar,Buxar,Leprosy Cured,6,15,2,2,4
Bihar,Buxar,Leprosy Cured,15,35,32,11,43
Bihar,Buxar,Leprosy Cured,35,60,84,19,103
Bihar,Buxar,Leprosy Cured,60,80,45,10,55
Bihar,Buxar,Leprosy Cured,80,100,3,1,4
Madhya Pradesh,Burhanpur,Leprosy Cured,0,6,0,1,1
Madhya Pradesh,Burhanpur,Leprosy Cured,6,15,1,1,2
Madhya Pradesh,Burhanpur,Leprosy Cured,15,35,4,1,5
Madhya Pradesh,Burhanpur,Leprosy Cured,35,60,2,2,4
Rajasthan,Bundi,Leprosy Cured,15,35,4,1,5
Rajasthan,Bundi,Leprosy Cured,35,60,19,4,23
Rajasthan,Bundi,Leprosy Cured,60,80,4,4,8
Rajasthan,Bundi,Leprosy Cured,80,100,1,0,1
Maharashtra,Buldhana,Leprosy Cured,15,35,1,0,1
Maharashtra,Buldhana,Leprosy Cured,35,60,2,4,6
Maharashtra,Buldhana,Leprosy Cured,60,80,2,0,2
Uttar Pradesh,Bulandshahr,Leprosy Cured,0,6,1,0,1
Uttar Pradesh,Bulandshahr,Leprosy Cured,6,15,1,0,1
Uttar Pradesh,Bulandshahr,Leprosy Cured,15,35,17,12,29
Uttar Pradesh,Bulandshahr,Leprosy Cured,35,60,32,21,53
Uttar Pradesh,Bulandshahr,Leprosy Cured,60,80,14,9,23
Jammu And Kashmir,Budgam,Leprosy Cured,35,60,0,4,4
Jammu And Kashmir,Budgam,Leprosy Cured,60,80,0,1,1
Uttar Pradesh,Budaun,Leprosy Cured,15,35,1,0,1
Uttar Pradesh,Budaun,Leprosy Cured,35,60,12,2,14
Uttar Pradesh,Budaun,Leprosy Cured,60,80,5,0,5
Odisha,Boudh,Leprosy Cured,0,6,0,1,1
Odisha,Boudh,Leprosy Cured,6,15,1,1,2
Odisha,Boudh,Leprosy Cured,15,35,7,5,12
Odisha,Boudh,Leprosy Cured,35,60,13,7,20
Odisha,Boudh,Leprosy Cured,60,80,16,1,17
Gujarat,Botad,Leprosy Cured,35,60,0,1,1
Assam,Bongaigaon,Leprosy Cured,15,35,0,2,2
Jharkhand,Bokaro,Leprosy Cured,6,15,2,0,2
Jharkhand,Bokaro,Leprosy Cured,15,35,13,12,25
Jharkhand,Bokaro,Leprosy Cured,35,60,23,24,47
Jharkhand,Bokaro,Leprosy Cured,60,80,29,13,42
Jharkhand,Bokaro,Leprosy Cured,80,100,1,1,2
Assam,Biswanath,Leprosy Cured,15,35,1,0,1
West Bengal,Birbhum,Leprosy Cured,0,6,1,0,1
West Bengal,Birbhum,Leprosy Cured,15,35,1,0,1
Chhattisgarh,Bilaspur,Leprosy Cured,15,35,1,1,2
Chhattisgarh,Bilaspur,Leprosy Cured,35,60,7,3,10
Chhattisgarh,Bilaspur,Leprosy Cured,60,80,3,5,8
Himachal Pradesh,Bilaspur,Leprosy Cured,15,35,0,1,1
Himachal Pradesh,Bilaspur,Leprosy Cured,35,60,3,1,4
Himachal Pradesh,Bilaspur,Leprosy Cured,60,80,2,0,2
Uttar Pradesh,Bijnor,Leprosy Cured,6,15,0,2,2
Uttar Pradesh,Bijnor,Leprosy Cured,15,35,30,15,45
Uttar Pradesh,Bijnor,Leprosy Cured,35,60,49,36,85
Uttar Pradesh,Bijnor,Leprosy Cured,60,80,18,14,32
Uttar Pradesh,Bijnor,Leprosy Cured,80,100,3,0,3
Chhattisgarh,Bijapur,Leprosy Cured,6,15,0,1,1
Chhattisgarh,Bijapur,Leprosy Cured,35,60,0,1,1
Chhattisgarh,Bijapur,Leprosy Cured,60,80,0,1,1
Karnataka,Bidar,Leprosy Cured,6,15,1,0,1
Karnataka,Bidar,Leprosy Cured,15,35,8,7,15
Karnataka,Bidar,Leprosy Cured,35,60,36,14,50
Karnataka,Bidar,Leprosy Cured,60,80,36,17,53
Karnataka,Bidar,Leprosy Cured,80,100,1,2,3
Madhya Pradesh,Bhopal,Leprosy Cured,6,15,1,3,4
Madhya Pradesh,Bhopal,Leprosy Cured,15,35,18,13,31
Madhya Pradesh,Bhopal,Leprosy Cured,35,60,40,19,59
Madhya Pradesh,Bhopal,Leprosy Cured,60,80,11,7,18
Bihar,Bhojpur,Leprosy Cured,6,15,2,2,4
Bihar,Bhojpur,Leprosy Cured,15,35,25,9,34
Bihar,Bhojpur,Leprosy Cured,35,60,38,4,42
Bihar,Bhojpur,Leprosy Cured,60,80,9,0,9
Haryana,Bhiwani,Leprosy Cured,15,35,3,0,3
Haryana,Bhiwani,Leprosy Cured,35,60,14,5,19
Haryana,Bhiwani,Leprosy Cured,60,80,4,1,5
Madhya Pradesh,Bhind,Leprosy Cured,6,15,0,2,2
Madhya Pradesh,Bhind,Leprosy Cured,15,35,17,6,23
Madhya Pradesh,Bhind,Leprosy Cured,35,60,50,20,70
Madhya Pradesh,Bhind,Leprosy Cured,60,80,16,8,24
Rajasthan,Bhilwara,Leprosy Cured,15,35,4,1,5
Rajasthan,Bhilwara,Leprosy Cured,35,60,6,4,10
Rajasthan,Bhilwara,Leprosy Cured,60,80,5,1,6
Gujarat,Bhavnagar,Leprosy Cured,15,35,1,0,1
Gujarat,Bhavnagar,Leprosy Cured,35,60,1,2,3
Gujarat,Bhavnagar,Leprosy Cured,60,80,1,1,2
Gujarat,Bharuch,Leprosy Cured,35,60,0,1,1
Rajasthan,Bharatpur,Leprosy Cured,6,15,1,0,1
Rajasthan,Bharatpur,Leprosy Cured,15,35,0,1,1
Rajasthan,Bharatpur,Leprosy Cured,35,60,3,0,3
Rajasthan,Bharatpur,Leprosy Cured,60,80,1,0,1
Maharashtra,Bhandara,Leprosy Cured,15,35,3,0,3
Maharashtra,Bhandara,Leprosy Cured,35,60,9,2,11
Maharashtra,Bhandara,Leprosy Cured,60,80,5,1,6
Bihar,Bhagalpur,Leprosy Cured,6,15,3,0,3
Bihar,Bhagalpur,Leprosy Cured,15,35,9,4,13
Bihar,Bhagalpur,Leprosy Cured,35,60,26,7,33
Bihar,Bhagalpur,Leprosy Cured,60,80,10,4,14
Odisha,Bhadrak,Leprosy Cured,6,15,1,0,1
Odisha,Bhadrak,Leprosy Cured,15,35,1,0,1
Odisha,Bhadrak,Leprosy Cured,35,60,8,6,14
Odisha,Bhadrak,Leprosy Cured,60,80,10,2,12
Uttar Pradesh,Bhadohi,Leprosy Cured,6,15,0,1,1
Uttar Pradesh,Bhadohi,Leprosy Cured,15,35,11,2,13
Uttar Pradesh,Bhadohi,Leprosy Cured,35,60,32,6,38
Uttar Pradesh,Bhadohi,Leprosy Cured,60,80,15,3,18
Uttar Pradesh,Bhadohi,Leprosy Cured,80,100,3,0,3
Madhya Pradesh,Betul,Leprosy Cured,6,15,2,0,2
Madhya Pradesh,Betul,Leprosy Cured,15,35,8,4,12
Madhya Pradesh,Betul,Leprosy Cured,35,60,18,10,28
Madhya Pradesh,Betul,Leprosy Cured,60,80,3,2,5
Karnataka,Bengaluru Urban,Leprosy Cured,15,35,3,1,4
Karnataka,Bengaluru Urban,Leprosy Cured,35,60,15,1,16
Karnataka,Bengaluru Urban,Leprosy Cured,60,80,8,0,8
Karnataka,Bengaluru Urban,Leprosy Cured,80,100,0,1,1
Karnataka,Bengaluru Rural,Leprosy Cured,6,15,0,1,1
Karnataka,Bengaluru Rural,Leprosy Cured,15,35,0,1,1
Karnataka,Bengaluru Rural,Leprosy Cured,35,60,3,2,5
Karnataka,Bengaluru Rural,Leprosy Cured,60,80,4,2,6
Karnataka,Bengaluru Rural,Leprosy Cured,80,100,1,0,1
Chhattisgarh,Bemetara,Leprosy Cured,35,60,2,0,2
Karnataka,Belagavi,Leprosy Cured,6,15,2,0,2
Karnataka,Belagavi,Leprosy Cured,15,35,10,7,17
Karnataka,Belagavi,Leprosy Cured,35,60,31,12,43
Karnataka,Belagavi,Leprosy Cured,60,80,10,6,16
Bihar,Begusarai,Leprosy Cured,6,15,6,3,9
Bihar,Begusarai,Leprosy Cured,15,35,8,1,9
Bihar,Begusarai,Leprosy Cured,35,60,6,3,9
Bihar,Begusarai,Leprosy Cured,60,80,4,0,4
Maharashtra,Beed,Leprosy Cured,6,15,1,0,1
Maharashtra,Beed,Leprosy Cured,35,60,5,4,9
Maharashtra,Beed,Leprosy Cured,60,80,16,6,22
Maharashtra,Beed,Leprosy Cured,80,100,0,1,1
Punjab,Bathinda,Leprosy Cured,15,35,1,1,2
Punjab,Bathinda,Leprosy Cured,35,60,5,7,12
Punjab,Bathinda,Leprosy Cured,60,80,1,2,3
Uttar Pradesh,Basti,Leprosy Cured,15,35,12,3,15
Uttar Pradesh,Basti,Leprosy Cured,35,60,18,8,26
Uttar Pradesh,Basti,Leprosy Cured,60,80,27,3,30
Chhattisgarh,Bastar,Leprosy Cured,15,35,1,1,2
Chhattisgarh,Bastar,Leprosy Cured,35,60,2,0,2
Madhya Pradesh,Barwani,Leprosy Cured,15,35,8,8,16
Madhya Pradesh,Barwani,Leprosy Cured,35,60,17,18,35
Madhya Pradesh,Barwani,Leprosy Cured,60,80,6,6,12
Assam,Barpeta,Leprosy Cured,6,15,0,1,1
Assam,Barpeta,Leprosy Cured,15,35,1,3,4
Assam,Barpeta,Leprosy Cured,35,60,2,2,4
Punjab,Barnala,Leprosy Cured,15,35,2,0,2
Punjab,Barnala,Leprosy Cured,35,60,2,2,4
Rajasthan,Barmer,Leprosy Cured,0,6,1,0,1
Rajasthan,Barmer,Leprosy Cured,35,60,2,3,5
Rajasthan,Barmer,Leprosy Cured,60,80,1,0,1
Odisha,Bargarh,Leprosy Cured,6,15,1,1,2
Odisha,Bargarh,Leprosy Cured,15,35,1,5,6
Odisha,Bargarh,Leprosy Cured,35,60,20,13,33
Odisha,Bargarh,Leprosy Cured,60,80,7,2,9
Uttar Pradesh,Bareilly,Leprosy Cured,6,15,2,0,2
Uttar Pradesh,Bareilly,Leprosy Cured,15,35,44,9,53
Uttar Pradesh,Bareilly,Leprosy Cured,35,60,46,20,66
Uttar Pradesh,Bareilly,Leprosy Cured,60,80,23,4,27
Uttar Pradesh,Bareilly,Leprosy Cured,80,100,3,1,4
Rajasthan,Baran,Leprosy Cured,35,60,3,2,5
Rajasthan,Baran,Leprosy Cured,60,80,1,0,1
Jammu And Kashmir,Baramulla,Leprosy Cured,6,15,0,1,1
Jammu And Kashmir,Baramulla,Leprosy Cured,15,35,2,4,6
Jammu And Kashmir,Baramulla,Leprosy Cured,35,60,3,0,3
Jammu And Kashmir,Baramulla,Leprosy Cured,60,80,2,0,2
Uttar Pradesh,Barabanki,Leprosy Cured,6,15,2,1,3
Uttar Pradesh,Barabanki,Leprosy Cured,15,35,66,37,103
Uttar Pradesh,Barabanki,Leprosy Cured,35,60,104,36,140
Uttar Pradesh,Barabanki,Leprosy Cured,60,80,33,5,38
Uttar Pradesh,Barabanki,Leprosy Cured,80,100,2,0,2
Rajasthan,Banswara,Leprosy Cured,0,6,1,0,1
Rajasthan,Banswara,Leprosy Cured,6,15,2,0,2
Rajasthan,Banswara,Leprosy Cured,15,35,2,1,3
Rajasthan,Banswara,Leprosy Cured,35,60,8,5,13
Rajasthan,Banswara,Leprosy Cured,60,80,0,1,1
Bihar,Banka,Leprosy Cured,0,6,1,0,1
Bihar,Banka,Leprosy Cured,6,15,1,2,3
Bihar,Banka,Leprosy Cured,15,35,12,3,15
Bihar,Banka,Leprosy Cured,35,60,23,8,31
Bihar,Banka,Leprosy Cured,60,80,15,0,15
Jammu And Kashmir,Bandipora,Leprosy Cured,6,15,0,1,1
Jammu And Kashmir,Bandipora,Leprosy Cured,15,35,1,3,4
Jammu And Kashmir,Bandipora,Leprosy Cured,35,60,3,2,5
Uttar Pradesh,Banda,Leprosy Cured,6,15,0,2,2
Uttar Pradesh,Banda,Leprosy Cured,15,35,25,9,34
Uttar Pradesh,Banda,Leprosy Cured,35,60,61,9,70
Uttar Pradesh,Banda,Leprosy Cured,60,80,28,8,36
Uttar Pradesh,Banda,Leprosy Cured,80,100,4,0,4
Chhattisgarh,Balrampur,Leprosy Cured,15,35,2,2,4
Chhattisgarh,Balrampur,Leprosy Cured,35,60,5,2,7
Chhattisgarh,Balrampur,Leprosy Cured,60,80,2,0,2
Uttar Pradesh,Balrampur,Leprosy Cured,6,15,2,0,2
Uttar Pradesh,Balrampur,Leprosy Cured,15,35,15,12,27
Uttar Pradesh,Balrampur,Leprosy Cured,35,60,33,7,40
Uttar Pradesh,Balrampur,Leprosy Cured,60,80,13,4,17
Uttar Pradesh,Balrampur,Leprosy Cured,80,100,2,0,2
Chhattisgarh,Baloda Bazar,Leprosy Cured,6,15,1,0,1
Chhattisgarh,Baloda Bazar,Leprosy Cured,15,35,9,9,18
Chhattisgarh,Baloda Bazar,Leprosy Cured,35,60,13,6,19
Chhattisgarh,Baloda Bazar,Leprosy Cured,60,80,3,2,5
Uttar Pradesh,Ballia,Leprosy Cured,15,35,26,6,32
Uttar Pradesh,Ballia,Leprosy Cured,35,60,94,17,111
Uttar Pradesh,Ballia,Leprosy Cured,60,80,41,5,46
Uttar Pradesh,Ballia,Leprosy Cured,80,100,1,0,1
Karnataka,Ballari,Leprosy Cured,0,6,1,0,1
Karnataka,Ballari,Leprosy Cured,6,15,1,3,4
Karnataka,Ballari,Leprosy Cured,15,35,13,11,24
Karnataka,Ballari,Leprosy Cured,35,60,56,21,77
Karnataka,Ballari,Leprosy Cured,60,80,17,13,30
Karnataka,Ballari,Leprosy Cured,80,100,1,1,2
Odisha,Baleshwar,Leprosy Cured,0,6,1,1,2
Odisha,Baleshwar,Leprosy Cured,6,15,5,7,12
Odisha,Baleshwar,Leprosy Cured,15,35,26,13,39
Odisha,Baleshwar,Leprosy Cured,35,60,36,33,69
Odisha,Baleshwar,Leprosy Cured,60,80,32,16,48
Odisha,Baleshwar,Leprosy Cured,80,100,2,3,5
Odisha,Balangir,Leprosy Cured,6,15,4,3,7
Odisha,Balangir,Leprosy Cured,15,35,10,7,17
Odisha,Balangir,Leprosy Cured,35,60,38,29,67
Odisha,Balangir,Leprosy Cured,60,80,36,38,74
Odisha,Balangir,Leprosy Cured,80,100,4,3,7
Madhya Pradesh,Balaghat,Leprosy Cured,6,15,4,1,5
Madhya Pradesh,Balaghat,Leprosy Cured,15,35,12,13,25
Madhya Pradesh,Balaghat,Leprosy Cured,35,60,23,10,33
Madhya Pradesh,Balaghat,Leprosy Cured,60,80,7,5,12
Madhya Pradesh,Balaghat,Leprosy Cured,80,100,0,1,1
Assam,Baksa,Leprosy Cured,15,35,1,0,1
Uttar Pradesh,Bahraich,Leprosy Cured,15,35,61,17,78
Uttar Pradesh,Bahraich,Leprosy Cured,35,60,218,39,257
Uttar Pradesh,Bahraich,Leprosy Cured,60,80,122,14,136
Uttar Pradesh,Bahraich,Leprosy Cured,80,100,3,3,6
Uttar Pradesh,Baghpat,Leprosy Cured,6,15,1,0,1
Uttar Pradesh,Baghpat,Leprosy Cured,15,35,13,8,21
Uttar Pradesh,Baghpat,Leprosy Cured,35,60,12,7,19
Uttar Pradesh,Baghpat,Leprosy Cured,60,80,3,0,3
Uttarakhand,Bageshwar,Leprosy Cured,35,60,1,0,1
Uttarakhand,Bageshwar,Leprosy Cured,60,80,1,0,1
Karnataka,Bagalkote,Leprosy Cured,15,35,2,1,3
Karnataka,Bagalkote,Leprosy Cured,35,60,20,10,30
Karnataka,Bagalkote,Leprosy Cured,60,80,7,2,9
Karnataka,Bagalkote,Leprosy Cured,80,100,2,1,3
Uttar Pradesh,Azamgarh,Leprosy Cured,15,35,17,4,21
Uttar Pradesh,Azamgarh,Leprosy Cured,35,60,19,11,30
Uttar Pradesh,Azamgarh,Leprosy Cured,60,80,20,3,23
Uttar Pradesh,Azamgarh,Leprosy Cured,80,100,4,1,5
Uttar Pradesh,Ayodhya,Leprosy Cured,15,35,6,1,7
Uttar Pradesh,Ayodhya,Leprosy Cured,35,60,18,7,25
Uttar Pradesh,Ayodhya,Leprosy Cured,60,80,18,2,20
Bihar,Aurangabad,Leprosy Cured,6,15,1,1,2
Bihar,Aurangabad,Leprosy Cured,15,35,24,7,31
Bihar,Aurangabad,Leprosy Cured,35,60,28,10,38
Bihar,Aurangabad,Leprosy Cured,60,80,9,1,10
Maharashtra,Aurangabad,Leprosy Cured,35,60,7,1,8
Maharashtra,Aurangabad,Leprosy Cured,80,100,1,0,1
Uttar Pradesh,Auraiya,Leprosy Cured,15,35,9,3,12
Uttar Pradesh,Auraiya,Leprosy Cured,35,60,26,10,36
Uttar Pradesh,Auraiya,Leprosy Cured,60,80,15,2,17
Uttar Pradesh,Auraiya,Leprosy Cured,80,100,1,0,1
Madhya Pradesh,Ashoknagar,Leprosy Cured,15,35,4,1,5
Madhya Pradesh,Ashoknagar,Leprosy Cured,35,60,4,2,6
Madhya Pradesh,Ashoknagar,Leprosy Cured,60,80,1,1,2
Bihar,Arwal,Leprosy Cured,15,35,4,0,4
Bihar,Arwal,Leprosy Cured,35,60,11,2,13
Bihar,Arwal,Leprosy Cured,60,80,3,1,4
Gujarat,Arvalli,Leprosy Cured,35,60,1,0,1
Tamil Nadu,Ariyalur,Leprosy Cured,15,35,2,3,5
Tamil Nadu,Ariyalur,Leprosy Cured,35,60,32,10,42
Tamil Nadu,Ariyalur,Leprosy Cured,60,80,72,35,107
Tamil Nadu,Ariyalur,Leprosy Cured,80,100,10,1,11
Bihar,Araria,Leprosy Cured,6,15,1,1,2
Bihar,Araria,Leprosy Cured,15,35,10,1,11
Bihar,Araria,Leprosy Cured,35,60,8,0,8
Bihar,Araria,Leprosy Cured,60,80,3,0,3
Madhya Pradesh,Anuppur,Leprosy Cured,15,35,5,2,7
Madhya Pradesh,Anuppur,Leprosy Cured,35,60,7,4,11
Odisha,Anugul,Leprosy Cured,6,15,1,1,2
Odisha,Anugul,Leprosy Cured,15,35,7,1,8
Odisha,Anugul,Leprosy Cured,35,60,29,13,42
Odisha,Anugul,Leprosy Cured,60,80,14,10,24
Odisha,Anugul,Leprosy Cured,80,100,1,0,1
Jammu And Kashmir,Anantnag,Leprosy Cured,6,15,1,0,1
Jammu And Kashmir,Anantnag,Leprosy Cured,35,60,1,0,1
Gujarat,Anand,Leprosy Cured,35,60,3,2,5
Gujarat,Anand,Leprosy Cured,60,80,4,0,4
Uttar Pradesh,Amroha,Leprosy Cured,6,15,1,1,2
Uttar Pradesh,Amroha,Leprosy Cured,15,35,37,16,53
Uttar Pradesh,Amroha,Leprosy Cured,35,60,52,17,69
Uttar Pradesh,Amroha,Leprosy Cured,60,80,11,5,16
Uttar Pradesh,Amroha,Leprosy Cured,80,100,1,0,1
Punjab,Amritsar,Leprosy Cured,15,35,2,2,4
Punjab,Amritsar,Leprosy Cured,35,60,4,0,4
Punjab,Amritsar,Leprosy Cured,60,80,1,1,2
Gujarat,Amreli,Leprosy Cured,15,35,2,1,3
Gujarat,Amreli,Leprosy Cured,35,60,1,1,2
Maharashtra,Amravati,Leprosy Cured,6,15,1,1,2
Maharashtra,Amravati,Leprosy Cured,15,35,2,1,3
Maharashtra,Amravati,Leprosy Cured,35,60,20,13,33
Maharashtra,Amravati,Leprosy Cured,60,80,18,26,44
Maharashtra,Amravati,Leprosy Cured,80,100,9,3,12
Uttar Pradesh,Amethi,Leprosy Cured,6,15,1,1,2
Uttar Pradesh,Amethi,Leprosy Cured,15,35,8,4,12
Uttar Pradesh,Amethi,Leprosy Cured,35,60,17,4,21
Uttar Pradesh,Amethi,Leprosy Cured,60,80,13,4,17
Uttar Pradesh,Amethi,Leprosy Cured,80,100,2,0,2
Uttar Pradesh,Ambedkar Nagar,Leprosy Cured,15,35,10,5,15
Uttar Pradesh,Ambedkar Nagar,Leprosy Cured,35,60,29,7,36
Uttar Pradesh,Ambedkar Nagar,Leprosy Cured,60,80,10,1,11
Uttar Pradesh,Ambedkar Nagar,Leprosy Cured,80,100,1,0,1
Haryana,Ambala,Leprosy Cured,35,60,5,8,13
Rajasthan,Alwar,Leprosy Cured,15,35,1,4,5
Rajasthan,Alwar,Leprosy Cured,35,60,5,5,10
Rajasthan,Alwar,Leprosy Cured,80,100,1,0,1
Uttarakhand,Almora,Leprosy Cured,15,35,1,0,1
Uttarakhand,Almora,Leprosy Cured,35,60,1,0,1
Uttarakhand,Almora,Leprosy Cured,60,80,5,1,6
Madhya Pradesh,Alirajpur,Leprosy Cured,15,35,0,1,1
Madhya Pradesh,Alirajpur,Leprosy Cured,35,60,3,1,4
Madhya Pradesh,Alirajpur,Leprosy Cured,60,80,1,0,1
Uttar Pradesh,Aligarh,Leprosy Cured,15,35,21,3,24
Uttar Pradesh,Aligarh,Leprosy Cured,35,60,21,11,32
Uttar Pradesh,Aligarh,Leprosy Cured,60,80,8,3,11
Kerala,Alappuzha,Leprosy Cured,35,60,2,1,3
Kerala,Alappuzha,Leprosy Cured,60,80,1,0,1
Kerala,Alappuzha,Leprosy Cured,80,100,1,0,1
Maharashtra,Akola,Leprosy Cured,15,35,2,1,3
Maharashtra,Akola,Leprosy Cured,35,60,11,4,15
Maharashtra,Akola,Leprosy Cured,60,80,14,2,16
Maharashtra,Akola,Leprosy Cured,80,100,1,0,1
Rajasthan,Ajmer,Leprosy Cured,15,35,1,0,1
Rajasthan,Ajmer,Leprosy Cured,35,60,1,0,1
Rajasthan,Ajmer,Leprosy Cured,60,80,1,0,1
Mizoram,Aizawl,Leprosy Cured,35,60,2,0,2
Maharashtra,Ahmednagar,Leprosy Cured,6,15,1,0,1
Maharashtra,Ahmednagar,Leprosy Cured,15,35,0,1,1
Maharashtra,Ahmednagar,Leprosy Cured,35,60,7,1,8
Maharashtra,Ahmednagar,Leprosy Cured,60,80,2,0,2
Gujarat,Ahmadabad,Leprosy Cured,35,60,2,2,4
Gujarat,Ahmadabad,Leprosy Cured,60,80,2,1,3
Uttar Pradesh,Agra,Leprosy Cured,15,35,8,5,13
Uttar Pradesh,Agra,Leprosy Cured,35,60,29,42,71
Uttar Pradesh,Agra,Leprosy Cured,60,80,12,13,25
Uttar Pradesh,Agra,Leprosy Cured,80,100,1,2,3
Madhya Pradesh,Agar Malwa,Leprosy Cured,6,15,1,0,1
Madhya Pradesh,Agar Malwa,Leprosy Cured,15,35,2,0,2
Madhya Pradesh,Agar Malwa,Leprosy Cured,35,60,1,0,1
Madhya Pradesh,Agar Malwa,Leprosy Cured,60,80,1,0,1
Nagaland,Zunheboto,Locomotor Disability,15,35,3,4,7
Nagaland,Zunheboto,Locomotor Disability,35,60,11,5,16
Nagaland,Zunheboto,Locomotor Disability,60,80,5,1,6
Maharashtra,Yavatmal,Locomotor Disability,0,6,65,42,107
Maharashtra,Yavatmal,Locomotor Disability,6,15,336,218,554
Maharashtra,Yavatmal,Locomotor Disability,15,35,1796,845,2641
Maharashtra,Yavatmal,Locomotor Disability,35,60,3835,1259,5094
Maharashtra,Yavatmal,Locomotor Disability,60,80,1078,243,1321
Maharashtra,Yavatmal,Locomotor Disability,80,100,31,13,44
Puducherry,Yanam,Locomotor Disability,6,15,2,2,4
Puducherry,Yanam,Locomotor Disability,15,35,57,54,111
Puducherry,Yanam,Locomotor Disability,35,60,125,90,215
Puducherry,Yanam,Locomotor Disability,60,80,43,40,83
Puducherry,Yanam,Locomotor Disability,80,100,2,3,5
Haryana,Yamunanagar,Locomotor Disability,0,6,16,15,31
Haryana,Yamunanagar,Locomotor Disability,6,15,126,69,195
Haryana,Yamunanagar,Locomotor Disability,15,35,690,341,1031
Haryana,Yamunanagar,Locomotor Disability,35,60,1452,634,2086
Haryana,Yamunanagar,Locomotor Disability,60,80,249,71,320
Haryana,Yamunanagar,Locomotor Disability,80,100,1,2,3
Karnataka,Yadgir,Locomotor Disability,0,6,80,46,126
Karnataka,Yadgir,Locomotor Disability,6,15,554,297,851
Karnataka,Yadgir,Locomotor Disability,15,35,2744,1481,4225
Karnataka,Yadgir,Locomotor Disability,35,60,4253,1776,6029
Karnataka,Yadgir,Locomotor Disability,60,80,634,204,838
Karnataka,Yadgir,Locomotor Disability,80,100,21,8,29
Telangana,Yadadri Bhuvanagiri,Locomotor Disability,0,6,1,0,1
Telangana,Yadadri Bhuvanagiri,Locomotor Disability,6,15,79,53,132
Telangana,Yadadri Bhuvanagiri,Locomotor Disability,15,35,979,587,1566
Telangana,Yadadri Bhuvanagiri,Locomotor Disability,35,60,2690,1340,4030
Telangana,Yadadri Bhuvanagiri,Locomotor Disability,60,80,1975,1072,3047
Telangana,Yadadri Bhuvanagiri,Locomotor Disability,80,100,456,224,680
Andhra Pradesh,Y.S.R.,Locomotor Disability,0,6,50,24,74
Andhra Pradesh,Y.S.R.,Locomotor Disability,6,15,592,320,912
Andhra Pradesh,Y.S.R.,Locomotor Disability,15,35,4063,2861,6924
Andhra Pradesh,Y.S.R.,Locomotor Disability,35,60,13571,6707,20278
Andhra Pradesh,Y.S.R.,Locomotor Disability,60,80,5397,1050,6447
Andhra Pradesh,Y.S.R.,Locomotor Disability,80,100,298,135,433
Nagaland,Wokha,Locomotor Disability,6,15,4,3,7
Nagaland,Wokha,Locomotor Disability,15,35,6,6,12
Nagaland,Wokha,Locomotor Disability,35,60,11,6,17
Nagaland,Wokha,Locomotor Disability,60,80,4,1,5
Tripura,West Tripura,Locomotor Disability,0,6,22,20,42
Tripura,West Tripura,Locomotor Disability,6,15,168,90,258
Tripura,West Tripura,Locomotor Disability,15,35,489,232,721
Tripura,West Tripura,Locomotor Disability,35,60,887,340,1227
Tripura,West Tripura,Locomotor Disability,60,80,227,88,315
Tripura,West Tripura,Locomotor Disability,80,100,12,15,27
Jharkhand,West Singhbhum,Locomotor Disability,0,6,31,23,54
Jharkhand,West Singhbhum,Locomotor Disability,6,15,343,262,605
Jharkhand,West Singhbhum,Locomotor Disability,15,35,945,588,1533
Jharkhand,West Singhbhum,Locomotor Disability,35,60,1265,635,1900
Jharkhand,West Singhbhum,Locomotor Disability,60,80,202,99,301
Jharkhand,West Singhbhum,Locomotor Disability,80,100,7,2,9
Arunachal Pradesh,West Siang,Locomotor Disability,6,15,4,2,6
Arunachal Pradesh,West Siang,Locomotor Disability,15,35,37,35,72
Arunachal Pradesh,West Siang,Locomotor Disability,35,60,28,11,39
Arunachal Pradesh,West Siang,Locomotor Disability,60,80,3,1,4
Arunachal Pradesh,West Siang,Locomotor Disability,80,100,2,0,2
Meghalaya,West Khasi Hills,Locomotor Disability,0,6,13,14,27
Meghalaya,West Khasi Hills,Locomotor Disability,6,15,43,48,91
Meghalaya,West Khasi Hills,Locomotor Disability,15,35,187,116,303
Meghalaya,West Khasi Hills,Locomotor Disability,35,60,95,72,167
Meghalaya,West Khasi Hills,Locomotor Disability,60,80,36,9,45
Meghalaya,West Khasi Hills,Locomotor Disability,80,100,2,6,8
Assam,West Karbi Anglong,Locomotor Disability,0,6,1,0,1
Assam,West Karbi Anglong,Locomotor Disability,6,15,11,8,19
Assam,West Karbi Anglong,Locomotor Disability,15,35,84,29,113
Assam,West Karbi Anglong,Locomotor Disability,35,60,73,22,95
Assam,West Karbi Anglong,Locomotor Disability,60,80,8,11,19
Assam,West Karbi Anglong,Locomotor Disability,80,100,4,0,4
Arunachal Pradesh,West Kameng,Locomotor Disability,15,35,7,1,8
Arunachal Pradesh,West Kameng,Locomotor Disability,35,60,5,2,7
Meghalaya,West Jaintia Hills,Locomotor Disability,0,6,11,7,18
Meghalaya,West Jaintia Hills,Locomotor Disability,6,15,79,52,131
Meghalaya,West Jaintia Hills,Locomotor Disability,15,35,238,209,447
Meghalaya,West Jaintia Hills,Locomotor Disability,35,60,201,135,336
Meghalaya,West Jaintia Hills,Locomotor Disability,60,80,45,37,82
Meghalaya,West Jaintia Hills,Locomotor Disability,80,100,7,2,9
Andhra Pradesh,West Godavari,Locomotor Disability,0,6,72,59,131
Andhra Pradesh,West Godavari,Locomotor Disability,6,15,508,318,826
Andhra Pradesh,West Godavari,Locomotor Disability,15,35,1949,906,2855
Andhra Pradesh,West Godavari,Locomotor Disability,35,60,7967,1581,9548
Andhra Pradesh,West Godavari,Locomotor Disability,60,80,3031,567,3598
Andhra Pradesh,West Godavari,Locomotor Disability,80,100,225,68,293
Meghalaya,West Garo Hills,Locomotor Disability,0,6,7,6,13
Meghalaya,West Garo Hills,Locomotor Disability,6,15,87,63,150
Meghalaya,West Garo Hills,Locomotor Disability,15,35,480,342,822
Meghalaya,West Garo Hills,Locomotor Disability,35,60,518,298,816
Meghalaya,West Garo Hills,Locomotor Disability,60,80,123,59,182
Meghalaya,West Garo Hills,Locomotor Disability,80,100,9,1,10
Delhi,West,Locomotor Disability,0,6,20,9,29
Delhi,West,Locomotor Disability,6,15,82,75,157
Delhi,West,Locomotor Disability,15,35,585,313,898
Delhi,West,Locomotor Disability,35,60,977,344,1321
Delhi,West,Locomotor Disability,60,80,191,37,228
Delhi,West,Locomotor Disability,80,100,2,4,6
Kerala,Wayanad,Locomotor Disability,0,6,8,7,15
Kerala,Wayanad,Locomotor Disability,6,15,54,30,84
Kerala,Wayanad,Locomotor Disability,15,35,186,89,275
Kerala,Wayanad,Locomotor Disability,35,60,707,422,1129
Kerala,Wayanad,Locomotor Disability,60,80,379,174,553
Kerala,Wayanad,Locomotor Disability,80,100,25,6,31
Maharashtra,Washim,Locomotor Disability,0,6,27,24,51
Maharashtra,Washim,Locomotor Disability,6,15,308,142,450
Maharashtra,Washim,Locomotor Disability,15,35,1295,550,1845
Maharashtra,Washim,Locomotor Disability,35,60,2467,718,3185
Maharashtra,Washim,Locomotor Disability,60,80,844,227,1071
Maharashtra,Washim,Locomotor Disability,80,100,43,11,54
Maharashtra,Wardha,Locomotor Disability,0,6,37,21,58
Maharashtra,Wardha,Locomotor Disability,6,15,230,144,374
Maharashtra,Wardha,Locomotor Disability,15,35,1297,557,1854
Maharashtra,Wardha,Locomotor Disability,35,60,3713,1227,4940
Maharashtra,Wardha,Locomotor Disability,60,80,1282,322,1604
Maharashtra,Wardha,Locomotor Disability,80,100,71,20,91
Telangana,Warangal,Locomotor Disability,0,6,1,0,1
Telangana,Warangal,Locomotor Disability,6,15,93,78,171
Telangana,Warangal,Locomotor Disability,15,35,1152,785,1937
Telangana,Warangal,Locomotor Disability,35,60,2871,1663,4534
Telangana,Warangal,Locomotor Disability,60,80,1652,825,2477
Telangana,Warangal,Locomotor Disability,80,100,260,95,355
Telangana,Wanaparthy,Locomotor Disability,0,6,0,1,1
Telangana,Wanaparthy,Locomotor Disability,6,15,113,78,191
Telangana,Wanaparthy,Locomotor Disability,15,35,1270,886,2156
Telangana,Wanaparthy,Locomotor Disability,35,60,2884,1546,4430
Telangana,Wanaparthy,Locomotor Disability,60,80,1376,728,2104
Telangana,Wanaparthy,Locomotor Disability,80,100,152,82,234
Andhra Pradesh,Vizianagaram,Locomotor Disability,0,6,35,37,72
Andhra Pradesh,Vizianagaram,Locomotor Disability,6,15,386,263,649
Andhra Pradesh,Vizianagaram,Locomotor Disability,15,35,2801,1424,4225
Andhra Pradesh,Vizianagaram,Locomotor Disability,35,60,7868,1516,9384
Andhra Pradesh,Vizianagaram,Locomotor Disability,60,80,3370,565,3935
Andhra Pradesh,Vizianagaram,Locomotor Disability,80,100,285,67,352
Andhra Pradesh,Visakhapatanam,Locomotor Disability,0,6,92,56,148
Andhra Pradesh,Visakhapatanam,Locomotor Disability,6,15,654,411,1065
Andhra Pradesh,Visakhapatanam,Locomotor Disability,15,35,3443,1632,5075
Andhra Pradesh,Visakhapatanam,Locomotor Disability,35,60,9640,1832,11472
Andhra Pradesh,Visakhapatanam,Locomotor Disability,60,80,3410,551,3961
Andhra Pradesh,Visakhapatanam,Locomotor Disability,80,100,225,58,283
Tamil Nadu,Virudhunagar,Locomotor Disability,0,6,45,25,70
Tamil Nadu,Virudhunagar,Locomotor Disability,6,15,232,154,386
Tamil Nadu,Virudhunagar,Locomotor Disability,15,35,1227,708,1935
Tamil Nadu,Virudhunagar,Locomotor Disability,35,60,3835,2188,6023
Tamil Nadu,Virudhunagar,Locomotor Disability,60,80,987,361,1348
Tamil Nadu,Virudhunagar,Locomotor Disability,80,100,41,14,55
Tamil Nadu,Villupuram,Locomotor Disability,0,6,13,8,21
Tamil Nadu,Villupuram,Locomotor Disability,6,15,183,148,331
Tamil Nadu,Villupuram,Locomotor Disability,15,35,1310,777,2087
Tamil Nadu,Villupuram,Locomotor Disability,35,60,4290,2246,6536
Tamil Nadu,Villupuram,Locomotor Disability,60,80,1724,792,2516
Tamil Nadu,Villupuram,Locomotor Disability,80,100,155,51,206
Telangana,Vikarabad,Locomotor Disability,0,6,0,2,2
Telangana,Vikarabad,Locomotor Disability,6,15,194,133,327
Telangana,Vikarabad,Locomotor Disability,15,35,1272,728,2000
Telangana,Vikarabad,Locomotor Disability,35,60,2624,1117,3741
Telangana,Vikarabad,Locomotor Disability,60,80,991,486,1477
Telangana,Vikarabad,Locomotor Disability,80,100,70,34,104
Karnataka,Vijayapura,Locomotor Disability,0,6,130,85,215
Karnataka,Vijayapura,Locomotor Disability,6,15,803,460,1263
Karnataka,Vijayapura,Locomotor Disability,15,35,3624,2003,5627
Karnataka,Vijayapura,Locomotor Disability,35,60,6306,2577,8883
Karnataka,Vijayapura,Locomotor Disability,60,80,1059,249,1308
Karnataka,Vijayapura,Locomotor Disability,80,100,27,5,32
Karnataka,Vijayanagar,Locomotor Disability,6,15,1,0,1
Karnataka,Vijayanagar,Locomotor Disability,15,35,4,1,5
Karnataka,Vijayanagar,Locomotor Disability,35,60,1,0,1
Karnataka,Vijayanagar,Locomotor Disability,60,80,2,0,2
Madhya Pradesh,Vidisha,Locomotor Disability,0,6,46,20,66
Madhya Pradesh,Vidisha,Locomotor Disability,6,15,500,330,830
Madhya Pradesh,Vidisha,Locomotor Disability,15,35,3467,1332,4799
Madhya Pradesh,Vidisha,Locomotor Disability,35,60,5115,1697,6812
Madhya Pradesh,Vidisha,Locomotor Disability,60,80,1374,419,1793
Madhya Pradesh,Vidisha,Locomotor Disability,80,100,108,30,138
Tamil Nadu,Vellore,Locomotor Disability,0,6,9,11,20
Tamil Nadu,Vellore,Locomotor Disability,6,15,186,107,293
Tamil Nadu,Vellore,Locomotor Disability,15,35,1217,646,1863
Tamil Nadu,Vellore,Locomotor Disability,35,60,3996,1788,5784
Tamil Nadu,Vellore,Locomotor Disability,60,80,1760,498,2258
Tamil Nadu,Vellore,Locomotor Disability,80,100,91,25,116
Uttar Pradesh,Varanasi,Locomotor Disability,0,6,27,13,40
Uttar Pradesh,Varanasi,Locomotor Disability,6,15,240,184,424
Uttar Pradesh,Varanasi,Locomotor Disability,15,35,3262,1463,4725
Uttar Pradesh,Varanasi,Locomotor Disability,35,60,3635,1359,4994
Uttar Pradesh,Varanasi,Locomotor Disability,60,80,827,184,1011
Uttar Pradesh,Varanasi,Locomotor Disability,80,100,24,6,30
Gujarat,Valsad,Locomotor Disability,0,6,28,17,45
Gujarat,Valsad,Locomotor Disability,6,15,281,209,490
Gujarat,Valsad,Locomotor Disability,15,35,839,444,1283
Gujarat,Valsad,Locomotor Disability,35,60,1386,477,1863
Gujarat,Valsad,Locomotor Disability,60,80,497,92,589
Gujarat,Valsad,Locomotor Disability,80,100,17,4,21
Bihar,Vaishali,Locomotor Disability,0,6,71,37,108
Bihar,Vaishali,Locomotor Disability,6,15,449,217,666
Bihar,Vaishali,Locomotor Disability,15,35,1623,582,2205
Bihar,Vaishali,Locomotor Disability,35,60,1429,361,1790
Bihar,Vaishali,Locomotor Disability,60,80,261,62,323
Bihar,Vaishali,Locomotor Disability,80,100,14,3,17
Gujarat,Vadodara,Locomotor Disability,0,6,39,43,82
Gujarat,Vadodara,Locomotor Disability,6,15,420,269,689
Gujarat,Vadodara,Locomotor Disability,15,35,1360,640,2000
Gujarat,Vadodara,Locomotor Disability,35,60,2899,1199,4098
Gujarat,Vadodara,Locomotor Disability,60,80,1026,233,1259
Gujarat,Vadodara,Locomotor Disability,80,100,39,6,45
Karnataka,Uttara Kannada,Locomotor Disability,0,6,29,20,49
Karnataka,Uttara Kannada,Locomotor Disability,6,15,216,135,351
Karnataka,Uttara Kannada,Locomotor Disability,15,35,948,598,1546
Karnataka,Uttara Kannada,Locomotor Disability,35,60,2974,1502,4476
Karnataka,Uttara Kannada,Locomotor Disability,60,80,910,330,1240
Karnataka,Uttara Kannada,Locomotor Disability,80,100,49,26,75
Uttarakhand,Uttar Kashi,Locomotor Disability,0,6,7,2,9
Uttarakhand,Uttar Kashi,Locomotor Disability,6,15,67,33,100
Uttarakhand,Uttar Kashi,Locomotor Disability,15,35,481,229,710
Uttarakhand,Uttar Kashi,Locomotor Disability,35,60,745,395,1140
Uttarakhand,Uttar Kashi,Locomotor Disability,60,80,120,73,193
Uttarakhand,Uttar Kashi,Locomotor Disability,80,100,7,3,10
Arunachal Pradesh,Upper Subansiri,Locomotor Disability,6,15,0,1,1
Arunachal Pradesh,Upper Subansiri,Locomotor Disability,15,35,18,15,33
Arunachal Pradesh,Upper Subansiri,Locomotor Disability,35,60,4,3,7
Arunachal Pradesh,Upper Subansiri,Locomotor Disability,60,80,1,0,1
Arunachal Pradesh,Upper Siang,Locomotor Disability,15,35,5,5,10
Arunachal Pradesh,Upper Siang,Locomotor Disability,35,60,4,2,6
Uttar Pradesh,Unnao,Locomotor Disability,0,6,20,12,32
Uttar Pradesh,Unnao,Locomotor Disability,6,15,192,118,310
Uttar Pradesh,Unnao,Locomotor Disability,15,35,2953,1175,4128
Uttar Pradesh,Unnao,Locomotor Disability,35,60,4085,1333,5418
Uttar Pradesh,Unnao,Locomotor Disability,60,80,910,218,1128
Uttar Pradesh,Unnao,Locomotor Disability,80,100,41,17,58
Tripura,Unakoti,Locomotor Disability,0,6,7,8,15
Tripura,Unakoti,Locomotor Disability,6,15,102,42,144
Tripura,Unakoti,Locomotor Disability,15,35,293,199,492
Tripura,Unakoti,Locomotor Disability,35,60,577,256,833
Tripura,Unakoti,Locomotor Disability,60,80,182,96,278
Tripura,Unakoti,Locomotor Disability,80,100,16,17,33
Himachal Pradesh,Una,Locomotor Disability,0,6,7,6,13
Himachal Pradesh,Una,Locomotor Disability,6,15,71,50,121
Himachal Pradesh,Una,Locomotor Disability,15,35,443,186,629
Himachal Pradesh,Una,Locomotor Disability,35,60,1098,543,1641
Himachal Pradesh,Una,Locomotor Disability,60,80,452,125,577
Himachal Pradesh,Una,Locomotor Disability,80,100,32,18,50
Madhya Pradesh,Umaria,Locomotor Disability,0,6,6,7,13
Madhya Pradesh,Umaria,Locomotor Disability,6,15,143,101,244
Madhya Pradesh,Umaria,Locomotor Disability,15,35,899,440,1339
Madhya Pradesh,Umaria,Locomotor Disability,35,60,1244,499,1743
Madhya Pradesh,Umaria,Locomotor Disability,60,80,360,95,455
Madhya Pradesh,Umaria,Locomotor Disability,80,100,12,6,18
Manipur,Ukhrul,Locomotor Disability,0,6,1,0,1
Manipur,Ukhrul,Locomotor Disability,6,15,4,7,11
Manipur,Ukhrul,Locomotor Disability,15,35,21,18,39
Manipur,Ukhrul,Locomotor Disability,35,60,52,28,80
Manipur,Ukhrul,Locomotor Disability,60,80,22,10,32
Manipur,Ukhrul,Locomotor Disability,80,100,3,2,5
Madhya Pradesh,Ujjain,Locomotor Disability,0,6,33,22,55
Madhya Pradesh,Ujjain,Locomotor Disability,6,15,285,192,477
Madhya Pradesh,Ujjain,Locomotor Disability,15,35,2234,1163,3397
Madhya Pradesh,Ujjain,Locomotor Disability,35,60,4482,1921,6403
Madhya Pradesh,Ujjain,Locomotor Disability,60,80,1135,308,1443
Madhya Pradesh,Ujjain,Locomotor Disability,80,100,60,26,86
Karnataka,Udupi,Locomotor Disability,0,6,20,25,45
Karnataka,Udupi,Locomotor Disability,6,15,142,103,245
Karnataka,Udupi,Locomotor Disability,15,35,512,356,868
Karnataka,Udupi,Locomotor Disability,35,60,2059,1146,3205
Karnataka,Udupi,Locomotor Disability,60,80,910,358,1268
Karnataka,Udupi,Locomotor Disability,80,100,39,23,62
Jammu And Kashmir,Udhampur,Locomotor Disability,0,6,17,8,25
Jammu And Kashmir,Udhampur,Locomotor Disability,6,15,129,81,210
Jammu And Kashmir,Udhampur,Locomotor Disability,15,35,762,336,1098
Jammu And Kashmir,Udhampur,Locomotor Disability,35,60,1331,610,1941
Jammu And Kashmir,Udhampur,Locomotor Disability,60,80,285,126,411
Jammu And Kashmir,Udhampur,Locomotor Disability,80,100,17,5,22
Uttarakhand,Udam Singh Nagar,Locomotor Disability,0,6,7,9,16
Uttarakhand,Udam Singh Nagar,Locomotor Disability,6,15,137,84,221
Uttarakhand,Udam Singh Nagar,Locomotor Disability,15,35,1395,732,2127
Uttarakhand,Udam Singh Nagar,Locomotor Disability,35,60,1699,677,2376
Uttarakhand,Udam Singh Nagar,Locomotor Disability,60,80,241,91,332
Uttarakhand,Udam Singh Nagar,Locomotor Disability,80,100,8,2,10
Assam,Udalguri,Locomotor Disability,0,6,18,11,29
Assam,Udalguri,Locomotor Disability,6,15,68,74,142
Assam,Udalguri,Locomotor Disability,15,35,464,240,704
Assam,Udalguri,Locomotor Disability,35,60,666,384,1050
Assam,Udalguri,Locomotor Disability,60,80,138,87,225
Assam,Udalguri,Locomotor Disability,80,100,14,10,24
Rajasthan,Udaipur,Locomotor Disability,0,6,41,17,58
Rajasthan,Udaipur,Locomotor Disability,6,15,429,288,717
Rajasthan,Udaipur,Locomotor Disability,15,35,2473,1490,3963
Rajasthan,Udaipur,Locomotor Disability,35,60,4218,2153,6371
Rajasthan,Udaipur,Locomotor Disability,60,80,1428,657,2085
Rajasthan,Udaipur,Locomotor Disability,80,100,120,85,205
Tamil Nadu,Tuticorin,Locomotor Disability,0,6,18,16,34
Tamil Nadu,Tuticorin,Locomotor Disability,6,15,151,110,261
Tamil Nadu,Tuticorin,Locomotor Disability,15,35,941,628,1569
Tamil Nadu,Tuticorin,Locomotor Disability,35,60,3542,2196,5738
Tamil Nadu,Tuticorin,Locomotor Disability,60,80,1219,575,1794
Tamil Nadu,Tuticorin,Locomotor Disability,80,100,79,31,110
Karnataka,Tumakuru,Locomotor Disability,0,6,107,60,167
Karnataka,Tumakuru,Locomotor Disability,6,15,561,357,918
Karnataka,Tumakuru,Locomotor Disability,15,35,2636,1513,4149
Karnataka,Tumakuru,Locomotor Disability,35,60,8070,3555,11625
Karnataka,Tumakuru,Locomotor Disability,60,80,2141,648,2789
Karnataka,Tumakuru,Locomotor Disability,80,100,86,34,120
Nagaland,Tuensang,Locomotor Disability,15,35,8,6,14
Nagaland,Tuensang,Locomotor Disability,35,60,5,4,9
Nagaland,Tuensang,Locomotor Disability,60,80,1,2,3
Nagaland,Tseminyu,Locomotor Disability,15,35,1,0,1
Nagaland,Tseminyu,Locomotor Disability,35,60,1,0,1
Rajasthan,Tonk,Locomotor Disability,0,6,23,23,46
Rajasthan,Tonk,Locomotor Disability,6,15,321,164,485
Rajasthan,Tonk,Locomotor Disability,15,35,1856,851,2707
Rajasthan,Tonk,Locomotor Disability,35,60,2816,1357,4173
Rajasthan,Tonk,Locomotor Disability,60,80,583,231,814
Rajasthan,Tonk,Locomotor Disability,80,100,31,23,54
Tamil Nadu,Tiruvannamalai,Locomotor Disability,0,6,41,32,73
Tamil Nadu,Tiruvannamalai,Locomotor Disability,6,15,260,190,450
Tamil Nadu,Tiruvannamalai,Locomotor Disability,15,35,1635,970,2605
Tamil Nadu,Tiruvannamalai,Locomotor Disability,35,60,5695,3021,8716
Tamil Nadu,Tiruvannamalai,Locomotor Disability,60,80,2694,1190,3884
Tamil Nadu,Tiruvannamalai,Locomotor Disability,80,100,221,74,295
Tamil Nadu,Tiruppur,Locomotor Disability,0,6,11,13,24
Tamil Nadu,Tiruppur,Locomotor Disability,6,15,141,122,263
Tamil Nadu,Tiruppur,Locomotor Disability,15,35,492,330,822
Tamil Nadu,Tiruppur,Locomotor Disability,35,60,2240,928,3168
Tamil Nadu,Tiruppur,Locomotor Disability,60,80,727,175,902
Tamil Nadu,Tiruppur,Locomotor Disability,80,100,21,5,26
Tamil Nadu,Tirupathur,Locomotor Disability,0,6,21,24,45
Tamil Nadu,Tirupathur,Locomotor Disability,6,15,123,83,206
Tamil Nadu,Tirupathur,Locomotor Disability,15,35,632,335,967
Tamil Nadu,Tirupathur,Locomotor Disability,35,60,1905,899,2804
Tamil Nadu,Tirupathur,Locomotor Disability,60,80,786,304,1090
Tamil Nadu,Tirupathur,Locomotor Disability,80,100,27,15,42
Tamil Nadu,Tirunelveli,Locomotor Disability,0,6,14,16,30
Tamil Nadu,Tirunelveli,Locomotor Disability,6,15,167,149,316
Tamil Nadu,Tirunelveli,Locomotor Disability,15,35,1047,728,1775
Tamil Nadu,Tirunelveli,Locomotor Disability,35,60,4430,2436,6866
Tamil Nadu,Tirunelveli,Locomotor Disability,60,80,1010,360,1370
Tamil Nadu,Tirunelveli,Locomotor Disability,80,100,33,13,46
Tamil Nadu,Tiruchirappalli,Locomotor Disability,0,6,61,38,99
Tamil Nadu,Tiruchirappalli,Locomotor Disability,6,15,473,355,828
Tamil Nadu,Tiruchirappalli,Locomotor Disability,15,35,2154,1374,3528
Tamil Nadu,Tiruchirappalli,Locomotor Disability,35,60,7276,4016,11292
Tamil Nadu,Tiruchirappalli,Locomotor Disability,60,80,2916,1085,4001
Tamil Nadu,Tiruchirappalli,Locomotor Disability,80,100,181,45,226
Arunachal Pradesh,Tirap,Locomotor Disability,6,15,0,1,1
Arunachal Pradesh,Tirap,Locomotor Disability,15,35,9,3,12
Arunachal Pradesh,Tirap,Locomotor Disability,35,60,5,2,7
Assam,Tinsukia,Locomotor Disability,0,6,5,3,8
Assam,Tinsukia,Locomotor Disability,6,15,41,32,73
Assam,Tinsukia,Locomotor Disability,15,35,181,79,260
Assam,Tinsukia,Locomotor Disability,35,60,236,108,344
Assam,Tinsukia,Locomotor Disability,60,80,53,18,71
Assam,Tinsukia,Locomotor Disability,80,100,1,0,1
Madhya Pradesh,Tikamgarh,Locomotor Disability,0,6,27,19,46
Madhya Pradesh,Tikamgarh,Locomotor Disability,6,15,238,145,383
Madhya Pradesh,Tikamgarh,Locomotor Disability,15,35,2431,1033,3464
Madhya Pradesh,Tikamgarh,Locomotor Disability,35,60,3540,1479,5019
Madhya Pradesh,Tikamgarh,Locomotor Disability,60,80,896,355,1251
Madhya Pradesh,Tikamgarh,Locomotor Disability,80,100,57,9,66
Kerala,Thrissur,Locomotor Disability,0,6,21,8,29
Kerala,Thrissur,Locomotor Disability,6,15,154,97,251
Kerala,Thrissur,Locomotor Disability,15,35,619,443,1062
Kerala,Thrissur,Locomotor Disability,35,60,2831,1552,4383
Kerala,Thrissur,Locomotor Disability,60,80,1573,674,2247
Kerala,Thrissur,Locomotor Disability,80,100,81,35,116
Manipur,Thoubal,Locomotor Disability,0,6,0,1,1
Manipur,Thoubal,Locomotor Disability,6,15,9,6,15
Manipur,Thoubal,Locomotor Disability,15,35,39,16,55
Manipur,Thoubal,Locomotor Disability,35,60,61,37,98
Manipur,Thoubal,Locomotor Disability,60,80,34,8,42
Tamil Nadu,Thiruvarur,Locomotor Disability,0,6,16,11,27
Tamil Nadu,Thiruvarur,Locomotor Disability,6,15,147,94,241
Tamil Nadu,Thiruvarur,Locomotor Disability,15,35,750,408,1158
Tamil Nadu,Thiruvarur,Locomotor Disability,35,60,2536,1236,3772
Tamil Nadu,Thiruvarur,Locomotor Disability,60,80,912,241,1153
Tamil Nadu,Thiruvarur,Locomotor Disability,80,100,31,15,46
Kerala,Thiruvananthapuram,Locomotor Disability,0,6,46,30,76
Kerala,Thiruvananthapuram,Locomotor Disability,6,15,260,188,448
Kerala,Thiruvananthapuram,Locomotor Disability,15,35,1050,652,1702
Kerala,Thiruvananthapuram,Locomotor Disability,35,60,3356,1910,5266
Kerala,Thiruvananthapuram,Locomotor Disability,60,80,1673,712,2385
Kerala,Thiruvananthapuram,Locomotor Disability,80,100,68,24,92
Tamil Nadu,Thiruvallur,Locomotor Disability,0,6,23,17,40
Tamil Nadu,Thiruvallur,Locomotor Disability,6,15,200,142,342
Tamil Nadu,Thiruvallur,Locomotor Disability,15,35,1187,703,1890
Tamil Nadu,Thiruvallur,Locomotor Disability,35,60,4580,2502,7082
Tamil Nadu,Thiruvallur,Locomotor Disability,60,80,1253,519,1772
Tamil Nadu,Thiruvallur,Locomotor Disability,80,100,51,30,81
Tamil Nadu,Theni,Locomotor Disability,0,6,19,18,37
Tamil Nadu,Theni,Locomotor Disability,6,15,144,94,238
Tamil Nadu,Theni,Locomotor Disability,15,35,896,501,1397
Tamil Nadu,Theni,Locomotor Disability,35,60,3214,1689,4903
Tamil Nadu,Theni,Locomotor Disability,60,80,1293,528,1821
Tamil Nadu,Theni,Locomotor Disability,80,100,63,21,84
Tamil Nadu,The Nilgiris,Locomotor Disability,0,6,4,2,6
Tamil Nadu,The Nilgiris,Locomotor Disability,6,15,24,17,41
Tamil Nadu,The Nilgiris,Locomotor Disability,15,35,235,161,396
Tamil Nadu,The Nilgiris,Locomotor Disability,35,60,932,467,1399
Tamil Nadu,The Nilgiris,Locomotor Disability,60,80,456,161,617
Tamil Nadu,The Nilgiris,Locomotor Disability,80,100,15,4,19
Tamil Nadu,Thanjavur,Locomotor Disability,0,6,45,27,72
Tamil Nadu,Thanjavur,Locomotor Disability,6,15,288,170,458
Tamil Nadu,Thanjavur,Locomotor Disability,15,35,1357,785,2142
Tamil Nadu,Thanjavur,Locomotor Disability,35,60,4900,2706,7606
Tamil Nadu,Thanjavur,Locomotor Disability,60,80,1657,527,2184
Tamil Nadu,Thanjavur,Locomotor Disability,80,100,76,27,103
Maharashtra,Thane,Locomotor Disability,0,6,120,78,198
Maharashtra,Thane,Locomotor Disability,6,15,1077,657,1734
Maharashtra,Thane,Locomotor Disability,15,35,6010,3064,9074
Maharashtra,Thane,Locomotor Disability,35,60,14913,4586,19499
Maharashtra,Thane,Locomotor Disability,60,80,4604,872,5476
Maharashtra,Thane,Locomotor Disability,80,100,195,38,233
Tamil Nadu,Tenkasi,Locomotor Disability,0,6,16,20,36
Tamil Nadu,Tenkasi,Locomotor Disability,6,15,88,59,147
Tamil Nadu,Tenkasi,Locomotor Disability,15,35,355,191,546
Tamil Nadu,Tenkasi,Locomotor Disability,35,60,1100,595,1695
Tamil Nadu,Tenkasi,Locomotor Disability,60,80,320,123,443
Tamil Nadu,Tenkasi,Locomotor Disability,80,100,9,2,11
Manipur,Tengnoupal,Locomotor Disability,0,6,0,2,2
Manipur,Tengnoupal,Locomotor Disability,6,15,5,1,6
Manipur,Tengnoupal,Locomotor Disability,15,35,17,9,26
Manipur,Tengnoupal,Locomotor Disability,35,60,7,14,21
Manipur,Tengnoupal,Locomotor Disability,60,80,6,8,14
Manipur,Tengnoupal,Locomotor Disability,80,100,1,0,1
Uttarakhand,Tehri Garhwal,Locomotor Disability,0,6,7,9,16
Uttarakhand,Tehri Garhwal,Locomotor Disability,6,15,113,64,177
Uttarakhand,Tehri Garhwal,Locomotor Disability,15,35,728,381,1109
Uttarakhand,Tehri Garhwal,Locomotor Disability,35,60,1367,622,1989
Uttarakhand,Tehri Garhwal,Locomotor Disability,60,80,343,163,506
Uttarakhand,Tehri Garhwal,Locomotor Disability,80,100,19,12,31
Arunachal Pradesh,Tawang,Locomotor Disability,6,15,0,3,3
Arunachal Pradesh,Tawang,Locomotor Disability,15,35,3,3,6
Arunachal Pradesh,Tawang,Locomotor Disability,35,60,4,2,6
Punjab,Tarn Taran,Locomotor Disability,0,6,37,19,56
Punjab,Tarn Taran,Locomotor Disability,6,15,257,121,378
Punjab,Tarn Taran,Locomotor Disability,15,35,1692,831,2523
Punjab,Tarn Taran,Locomotor Disability,35,60,3459,1361,4820
Punjab,Tarn Taran,Locomotor Disability,60,80,705,132,837
Punjab,Tarn Taran,Locomotor Disability,80,100,38,10,48
Gujarat,Tapi,Locomotor Disability,0,6,6,2,8
Gujarat,Tapi,Locomotor Disability,6,15,97,52,149
Gujarat,Tapi,Locomotor Disability,15,35,352,206,558
Gujarat,Tapi,Locomotor Disability,35,60,737,295,1032
Gujarat,Tapi,Locomotor Disability,60,80,247,58,305
Gujarat,Tapi,Locomotor Disability,80,100,13,4,17
Manipur,Tamenglong,Locomotor Disability,0,6,0,6,6
Manipur,Tamenglong,Locomotor Disability,6,15,6,1,7
Manipur,Tamenglong,Locomotor Disability,15,35,29,15,44
Manipur,Tamenglong,Locomotor Disability,35,60,39,25,64
Manipur,Tamenglong,Locomotor Disability,60,80,13,8,21
Manipur,Tamenglong,Locomotor Disability,80,100,3,1,4
Telangana,Suryapet,Locomotor Disability,0,6,0,1,1
Telangana,Suryapet,Locomotor Disability,6,15,155,99,254
Telangana,Suryapet,Locomotor Disability,15,35,1847,1267,3114
Telangana,Suryapet,Locomotor Disability,35,60,4308,2491,6799
Telangana,Suryapet,Locomotor Disability,60,80,2547,1590,4137
Telangana,Suryapet,Locomotor Disability,80,100,537,275,812
Chhattisgarh,Surguja,Locomotor Disability,0,6,18,12,30
Chhattisgarh,Surguja,Locomotor Disability,6,15,201,130,331
Chhattisgarh,Surguja,Locomotor Disability,15,35,783,480,1263
Chhattisgarh,Surguja,Locomotor Disability,35,60,990,429,1419
Chhattisgarh,Surguja,Locomotor Disability,60,80,265,92,357
Chhattisgarh,Surguja,Locomotor Disability,80,100,23,9,32
Gujarat,Surendranagar,Locomotor Disability,0,6,5,8,13
Gujarat,Surendranagar,Locomotor Disability,6,15,162,89,251
Gujarat,Surendranagar,Locomotor Disability,15,35,783,366,1149
Gujarat,Surendranagar,Locomotor Disability,35,60,1588,688,2276
Gujarat,Surendranagar,Locomotor Disability,60,80,447,105,552
Gujarat,Surendranagar,Locomotor Disability,80,100,16,9,25
Gujarat,Surat,Locomotor Disability,0,6,73,52,125
Gujarat,Surat,Locomotor Disability,6,15,641,406,1047
Gujarat,Surat,Locomotor Disability,15,35,2508,1118,3626
Gujarat,Surat,Locomotor Disability,35,60,3838,1569,5407
Gujarat,Surat,Locomotor Disability,60,80,818,189,1007
Gujarat,Surat,Locomotor Disability,80,100,21,7,28
Chhattisgarh,Surajpur,Locomotor Disability,0,6,19,11,30
Chhattisgarh,Surajpur,Locomotor Disability,6,15,183,116,299
Chhattisgarh,Surajpur,Locomotor Disability,15,35,625,305,930
Chhattisgarh,Surajpur,Locomotor Disability,35,60,587,236,823
Chhattisgarh,Surajpur,Locomotor Disability,60,80,136,60,196
Chhattisgarh,Surajpur,Locomotor Disability,80,100,6,7,13
Bihar,Supaul,Locomotor Disability,0,6,68,32,100
Bihar,Supaul,Locomotor Disability,6,15,518,297,815
Bihar,Supaul,Locomotor Disability,15,35,1224,512,1736
Bihar,Supaul,Locomotor Disability,35,60,1481,536,2017
Bihar,Supaul,Locomotor Disability,60,80,582,154,736
Bihar,Supaul,Locomotor Disability,80,100,31,7,38
Odisha,Sundargarh,Locomotor Disability,0,6,113,60,173
Odisha,Sundargarh,Locomotor Disability,6,15,668,421,1089
Odisha,Sundargarh,Locomotor Disability,15,35,2390,1505,3895
Odisha,Sundargarh,Locomotor Disability,35,60,5640,2906,8546
Odisha,Sundargarh,Locomotor Disability,60,80,1916,842,2758
Odisha,Sundargarh,Locomotor Disability,80,100,128,68,196
Uttar Pradesh,Sultanpur,Locomotor Disability,0,6,29,17,46
Uttar Pradesh,Sultanpur,Locomotor Disability,6,15,259,124,383
Uttar Pradesh,Sultanpur,Locomotor Disability,15,35,2658,984,3642
Uttar Pradesh,Sultanpur,Locomotor Disability,35,60,3479,888,4367
Uttar Pradesh,Sultanpur,Locomotor Disability,60,80,801,133,934
Uttar Pradesh,Sultanpur,Locomotor Disability,80,100,28,1,29
Chhattisgarh,Sukma,Locomotor Disability,0,6,3,6,9
Chhattisgarh,Sukma,Locomotor Disability,6,15,155,128,283
Chhattisgarh,Sukma,Locomotor Disability,15,35,522,364,886
Chhattisgarh,Sukma,Locomotor Disability,35,60,541,287,828
Chhattisgarh,Sukma,Locomotor Disability,60,80,121,84,205
Chhattisgarh,Sukma,Locomotor Disability,80,100,5,2,7
Jammu And Kashmir,Srinagar,Locomotor Disability,0,6,18,11,29
Jammu And Kashmir,Srinagar,Locomotor Disability,6,15,90,44,134
Jammu And Kashmir,Srinagar,Locomotor Disability,15,35,362,293,655
Jammu And Kashmir,Srinagar,Locomotor Disability,35,60,719,491,1210
Jammu And Kashmir,Srinagar,Locomotor Disability,60,80,134,74,208
Jammu And Kashmir,Srinagar,Locomotor Disability,80,100,9,3,12
Andhra Pradesh,Srikakulam,Locomotor Disability,0,6,46,31,77
Andhra Pradesh,Srikakulam,Locomotor Disability,6,15,406,274,680
Andhra Pradesh,Srikakulam,Locomotor Disability,15,35,1416,508,1924
Andhra Pradesh,Srikakulam,Locomotor Disability,35,60,5503,674,6177
Andhra Pradesh,Srikakulam,Locomotor Disability,60,80,1748,233,1981
Andhra Pradesh,Srikakulam,Locomotor Disability,80,100,67,2,69
Andhra Pradesh,Sri Sathya Sai,Locomotor Disability,35,60,1,0,1
Punjab,Sri Muktsar Sahib,Locomotor Disability,0,6,21,10,31
Punjab,Sri Muktsar Sahib,Locomotor Disability,6,15,120,83,203
Punjab,Sri Muktsar Sahib,Locomotor Disability,15,35,939,472,1411
Punjab,Sri Muktsar Sahib,Locomotor Disability,35,60,1728,841,2569
Punjab,Sri Muktsar Sahib,Locomotor Disability,60,80,352,111,463
Punjab,Sri Muktsar Sahib,Locomotor Disability,80,100,19,6,25
Andhra Pradesh,Spsr Nellore,Locomotor Disability,0,6,40,22,62
Andhra Pradesh,Spsr Nellore,Locomotor Disability,6,15,289,192,481
Andhra Pradesh,Spsr Nellore,Locomotor Disability,15,35,1184,469,1653
Andhra Pradesh,Spsr Nellore,Locomotor Disability,35,60,4977,824,5801
Andhra Pradesh,Spsr Nellore,Locomotor Disability,60,80,1690,235,1925
Andhra Pradesh,Spsr Nellore,Locomotor Disability,80,100,96,2,98
Meghalaya,South West Khasi Hills,Locomotor Disability,0,6,6,7,13
Meghalaya,South West Khasi Hills,Locomotor Disability,6,15,21,25,46
Meghalaya,South West Khasi Hills,Locomotor Disability,15,35,92,65,157
Meghalaya,South West Khasi Hills,Locomotor Disability,35,60,68,36,104
Meghalaya,South West Khasi Hills,Locomotor Disability,60,80,29,22,51
Meghalaya,South West Khasi Hills,Locomotor Disability,80,100,4,3,7
Meghalaya,South West Garo Hills,Locomotor Disability,0,6,9,2,11
Meghalaya,South West Garo Hills,Locomotor Disability,6,15,45,41,86
Meghalaya,South West Garo Hills,Locomotor Disability,15,35,171,108,279
Meghalaya,South West Garo Hills,Locomotor Disability,35,60,157,114,271
Meghalaya,South West Garo Hills,Locomotor Disability,60,80,41,14,55
Meghalaya,South West Garo Hills,Locomotor Disability,80,100,3,1,4
Delhi,South West,Locomotor Disability,0,6,12,14,26
Delhi,South West,Locomotor Disability,6,15,111,60,171
Delhi,South West,Locomotor Disability,15,35,668,300,968
Delhi,South West,Locomotor Disability,35,60,845,283,1128
Delhi,South West,Locomotor Disability,60,80,127,24,151
Delhi,South West,Locomotor Disability,80,100,2,0,2
Tripura,South Tripura,Locomotor Disability,0,6,3,12,15
Tripura,South Tripura,Locomotor Disability,6,15,105,57,162
Tripura,South Tripura,Locomotor Disability,15,35,372,195,567
Tripura,South Tripura,Locomotor Disability,35,60,626,263,889
Tripura,South Tripura,Locomotor Disability,60,80,103,45,148
Tripura,South Tripura,Locomotor Disability,80,100,3,4,7
Assam,South Salmara Mancachar,Locomotor Disability,0,6,1,0,1
Assam,South Salmara Mancachar,Locomotor Disability,6,15,11,5,16
Assam,South Salmara Mancachar,Locomotor Disability,15,35,34,17,51
Assam,South Salmara Mancachar,Locomotor Disability,35,60,33,6,39
Assam,South Salmara Mancachar,Locomotor Disability,60,80,2,0,2
Goa,South Goa,Locomotor Disability,0,6,4,2,6
Goa,South Goa,Locomotor Disability,6,15,23,19,42
Goa,South Goa,Locomotor Disability,15,35,190,89,279
Goa,South Goa,Locomotor Disability,35,60,574,242,816
Goa,South Goa,Locomotor Disability,60,80,195,72,267
Goa,South Goa,Locomotor Disability,80,100,4,6,10
Meghalaya,South Garo Hills,Locomotor Disability,0,6,0,1,1
Meghalaya,South Garo Hills,Locomotor Disability,6,15,31,21,52
Meghalaya,South Garo Hills,Locomotor Disability,15,35,94,55,149
Meghalaya,South Garo Hills,Locomotor Disability,35,60,45,38,83
Meghalaya,South Garo Hills,Locomotor Disability,60,80,15,4,19
Meghalaya,South Garo Hills,Locomotor Disability,80,100,2,0,2
Delhi,South East,Locomotor Disability,0,6,5,1,6
Delhi,South East,Locomotor Disability,6,15,37,26,63
Delhi,South East,Locomotor Disability,15,35,157,71,228
Delhi,South East,Locomotor Disability,35,60,245,55,300
Delhi,South East,Locomotor Disability,60,80,31,2,33
Andaman And Nicobar Islands,South Andamans,Locomotor Disability,0,6,6,6,12
Andaman And Nicobar Islands,South Andamans,Locomotor Disability,6,15,30,16,46
Andaman And Nicobar Islands,South Andamans,Locomotor Disability,15,35,191,100,291
Andaman And Nicobar Islands,South Andamans,Locomotor Disability,35,60,536,230,766
Andaman And Nicobar Islands,South Andamans,Locomotor Disability,60,80,152,41,193
Andaman And Nicobar Islands,South Andamans,Locomotor Disability,80,100,6,2,8
Delhi,South,Locomotor Disability,0,6,14,12,26
Delhi,South,Locomotor Disability,6,15,89,59,148
Delhi,South,Locomotor Disability,15,35,408,201,609
Delhi,South,Locomotor Disability,35,60,548,114,662
Delhi,South,Locomotor Disability,60,80,87,15,102
Delhi,South,Locomotor Disability,80,100,0,1,1
Assam,Sonitpur,Locomotor Disability,0,6,25,25,50
Assam,Sonitpur,Locomotor Disability,6,15,164,100,264
Assam,Sonitpur,Locomotor Disability,15,35,576,381,957
Assam,Sonitpur,Locomotor Disability,35,60,959,455,1414
Assam,Sonitpur,Locomotor Disability,60,80,196,66,262
Assam,Sonitpur,Locomotor Disability,80,100,6,0,6
Haryana,Sonipat,Locomotor Disability,0,6,16,16,32
Haryana,Sonipat,Locomotor Disability,6,15,93,42,135
Haryana,Sonipat,Locomotor Disability,15,35,721,309,1030
Haryana,Sonipat,Locomotor Disability,35,60,1244,502,1746
Haryana,Sonipat,Locomotor Disability,60,80,151,69,220
Haryana,Sonipat,Locomotor Disability,80,100,5,1,6
Odisha,Sonepur,Locomotor Disability,0,6,37,30,67
Odisha,Sonepur,Locomotor Disability,6,15,224,131,355
Odisha,Sonepur,Locomotor Disability,15,35,948,575,1523
Odisha,Sonepur,Locomotor Disability,35,60,1946,838,2784
Odisha,Sonepur,Locomotor Disability,60,80,571,216,787
Odisha,Sonepur,Locomotor Disability,80,100,28,11,39
Uttar Pradesh,Sonbhadra,Locomotor Disability,0,6,27,13,40
Uttar Pradesh,Sonbhadra,Locomotor Disability,6,15,178,112,290
Uttar Pradesh,Sonbhadra,Locomotor Disability,15,35,1634,541,2175
Uttar Pradesh,Sonbhadra,Locomotor Disability,35,60,1853,563,2416
Uttar Pradesh,Sonbhadra,Locomotor Disability,60,80,532,110,642
Uttar Pradesh,Sonbhadra,Locomotor Disability,80,100,23,5,28
Maharashtra,Solapur,Locomotor Disability,0,6,29,15,44
Maharashtra,Solapur,Locomotor Disability,6,15,407,216,623
Maharashtra,Solapur,Locomotor Disability,15,35,2496,1098,3594
Maharashtra,Solapur,Locomotor Disability,35,60,4966,1641,6607
Maharashtra,Solapur,Locomotor Disability,60,80,1287,194,1481
Maharashtra,Solapur,Locomotor Disability,80,100,78,5,83
Himachal Pradesh,Solan,Locomotor Disability,0,6,13,12,25
Himachal Pradesh,Solan,Locomotor Disability,6,15,134,89,223
Himachal Pradesh,Solan,Locomotor Disability,15,35,763,392,1155
Himachal Pradesh,Solan,Locomotor Disability,35,60,1633,690,2323
Himachal Pradesh,Solan,Locomotor Disability,60,80,505,147,652
Himachal Pradesh,Solan,Locomotor Disability,80,100,30,9,39
Bihar,Siwan,Locomotor Disability,0,6,85,51,136
Bihar,Siwan,Locomotor Disability,6,15,589,312,901
Bihar,Siwan,Locomotor Disability,15,35,2241,879,3120
Bihar,Siwan,Locomotor Disability,35,60,2110,713,2823
Bihar,Siwan,Locomotor Disability,60,80,449,148,597
Bihar,Siwan,Locomotor Disability,80,100,21,9,30
Assam,Sivasagar,Locomotor Disability,0,6,15,9,24
Assam,Sivasagar,Locomotor Disability,6,15,96,77,173
Assam,Sivasagar,Locomotor Disability,15,35,378,166,544
Assam,Sivasagar,Locomotor Disability,35,60,565,277,842
Assam,Sivasagar,Locomotor Disability,60,80,123,55,178
Assam,Sivasagar,Locomotor Disability,80,100,2,1,3
Tamil Nadu,Sivaganga,Locomotor Disability,0,6,14,11,25
Tamil Nadu,Sivaganga,Locomotor Disability,6,15,155,99,254
Tamil Nadu,Sivaganga,Locomotor Disability,15,35,748,459,1207
Tamil Nadu,Sivaganga,Locomotor Disability,35,60,3056,1634,4690
Tamil Nadu,Sivaganga,Locomotor Disability,60,80,1111,441,1552
Tamil Nadu,Sivaganga,Locomotor Disability,80,100,50,17,67
Uttar Pradesh,Sitapur,Locomotor Disability,0,6,38,5,43
Uttar Pradesh,Sitapur,Locomotor Disability,6,15,567,326,893
Uttar Pradesh,Sitapur,Locomotor Disability,15,35,4015,1480,5495
Uttar Pradesh,Sitapur,Locomotor Disability,35,60,3866,1095,4961
Uttar Pradesh,Sitapur,Locomotor Disability,60,80,536,95,631
Uttar Pradesh,Sitapur,Locomotor Disability,80,100,11,4,15
Bihar,Sitamarhi,Locomotor Disability,0,6,73,46,119
Bihar,Sitamarhi,Locomotor Disability,6,15,582,320,902
Bihar,Sitamarhi,Locomotor Disability,15,35,1919,815,2734
Bihar,Sitamarhi,Locomotor Disability,35,60,1802,663,2465
Bihar,Sitamarhi,Locomotor Disability,60,80,607,131,738
Bihar,Sitamarhi,Locomotor Disability,80,100,31,7,38
Haryana,Sirsa,Locomotor Disability,0,6,14,8,22
Haryana,Sirsa,Locomotor Disability,6,15,141,111,252
Haryana,Sirsa,Locomotor Disability,15,35,772,366,1138
Haryana,Sirsa,Locomotor Disability,35,60,1451,704,2155
Haryana,Sirsa,Locomotor Disability,60,80,272,84,356
Haryana,Sirsa,Locomotor Disability,80,100,17,3,20
Rajasthan,Sirohi,Locomotor Disability,0,6,17,14,31
Rajasthan,Sirohi,Locomotor Disability,6,15,288,179,467
Rajasthan,Sirohi,Locomotor Disability,15,35,1332,704,2036
Rajasthan,Sirohi,Locomotor Disability,35,60,2174,959,3133
Rajasthan,Sirohi,Locomotor Disability,60,80,450,200,650
Rajasthan,Sirohi,Locomotor Disability,80,100,25,21,46
Himachal Pradesh,Sirmaur,Locomotor Disability,0,6,29,14,43
Himachal Pradesh,Sirmaur,Locomotor Disability,6,15,120,82,202
Himachal Pradesh,Sirmaur,Locomotor Disability,15,35,622,336,958
Himachal Pradesh,Sirmaur,Locomotor Disability,35,60,1141,407,1548
Himachal Pradesh,Sirmaur,Locomotor Disability,60,80,284,73,357
Himachal Pradesh,Sirmaur,Locomotor Disability,80,100,18,2,20
Madhya Pradesh,Singrauli,Locomotor Disability,0,6,29,21,50
Madhya Pradesh,Singrauli,Locomotor Disability,6,15,323,167,490
Madhya Pradesh,Singrauli,Locomotor Disability,15,35,1656,727,2383
Madhya Pradesh,Singrauli,Locomotor Disability,35,60,1660,652,2312
Madhya Pradesh,Singrauli,Locomotor Disability,60,80,328,133,461
Madhya Pradesh,Singrauli,Locomotor Disability,80,100,11,3,14
Maharashtra,Sindhudurg,Locomotor Disability,0,6,6,6,12
Maharashtra,Sindhudurg,Locomotor Disability,6,15,195,159,354
Maharashtra,Sindhudurg,Locomotor Disability,15,35,797,426,1223
Maharashtra,Sindhudurg,Locomotor Disability,35,60,2411,751,3162
Maharashtra,Sindhudurg,Locomotor Disability,60,80,1124,159,1283
Maharashtra,Sindhudurg,Locomotor Disability,80,100,59,6,65
Jharkhand,Simdega,Locomotor Disability,0,6,8,6,14
Jharkhand,Simdega,Locomotor Disability,6,15,187,106,293
Jharkhand,Simdega,Locomotor Disability,15,35,489,327,816
Jharkhand,Simdega,Locomotor Disability,35,60,860,426,1286
Jharkhand,Simdega,Locomotor Disability,60,80,228,113,341
Jharkhand,Simdega,Locomotor Disability,80,100,16,6,22
Rajasthan,Sikar,Locomotor Disability,0,6,17,15,32
Rajasthan,Sikar,Locomotor Disability,6,15,324,158,482
Rajasthan,Sikar,Locomotor Disability,15,35,2271,972,3243
Rajasthan,Sikar,Locomotor Disability,35,60,3092,1080,4172
Rajasthan,Sikar,Locomotor Disability,60,80,591,184,775
Rajasthan,Sikar,Locomotor Disability,80,100,25,12,37
Madhya Pradesh,Sidhi,Locomotor Disability,0,6,14,7,21
Madhya Pradesh,Sidhi,Locomotor Disability,6,15,281,164,445
Madhya Pradesh,Sidhi,Locomotor Disability,15,35,1825,809,2634
Madhya Pradesh,Sidhi,Locomotor Disability,35,60,2502,854,3356
Madhya Pradesh,Sidhi,Locomotor Disability,60,80,632,253,885
Madhya Pradesh,Sidhi,Locomotor Disability,80,100,37,9,46
Telangana,Siddipet,Locomotor Disability,6,15,149,91,240
Telangana,Siddipet,Locomotor Disability,15,35,1280,886,2166
Telangana,Siddipet,Locomotor Disability,35,60,2924,1518,4442
Telangana,Siddipet,Locomotor Disability,60,80,1469,869,2338
Telangana,Siddipet,Locomotor Disability,80,100,212,109,321
Uttar Pradesh,Siddharth Nagar,Locomotor Disability,0,6,39,21,60
Uttar Pradesh,Siddharth Nagar,Locomotor Disability,6,15,373,226,599
Uttar Pradesh,Siddharth Nagar,Locomotor Disability,15,35,2817,1258,4075
Uttar Pradesh,Siddharth Nagar,Locomotor Disability,35,60,3022,1114,4136
Uttar Pradesh,Siddharth Nagar,Locomotor Disability,60,80,970,311,1281
Uttar Pradesh,Siddharth Nagar,Locomotor Disability,80,100,49,16,65
Arunachal Pradesh,Siang,Locomotor Disability,6,15,0,1,1
Arunachal Pradesh,Siang,Locomotor Disability,15,35,10,4,14
Arunachal Pradesh,Siang,Locomotor Disability,35,60,3,1,4
Arunachal Pradesh,Siang,Locomotor Disability,60,80,1,0,1
Uttar Pradesh,Shravasti,Locomotor Disability,0,6,29,22,51
Uttar Pradesh,Shravasti,Locomotor Disability,6,15,238,134,372
Uttar Pradesh,Shravasti,Locomotor Disability,15,35,965,358,1323
Uttar Pradesh,Shravasti,Locomotor Disability,35,60,1038,333,1371
Uttar Pradesh,Shravasti,Locomotor Disability,60,80,219,49,268
Uttar Pradesh,Shravasti,Locomotor Disability,80,100,13,2,15
Jammu And Kashmir,Shopian,Locomotor Disability,0,6,13,9,22
Jammu And Kashmir,Shopian,Locomotor Disability,6,15,40,29,69
Jammu And Kashmir,Shopian,Locomotor Disability,15,35,285,161,446
Jammu And Kashmir,Shopian,Locomotor Disability,35,60,424,191,615
Jammu And Kashmir,Shopian,Locomotor Disability,60,80,83,57,140
Jammu And Kashmir,Shopian,Locomotor Disability,80,100,4,6,10
Madhya Pradesh,Shivpuri,Locomotor Disability,0,6,54,23,77
Madhya Pradesh,Shivpuri,Locomotor Disability,6,15,249,136,385
Madhya Pradesh,Shivpuri,Locomotor Disability,15,35,2152,867,3019
Madhya Pradesh,Shivpuri,Locomotor Disability,35,60,3033,939,3972
Madhya Pradesh,Shivpuri,Locomotor Disability,60,80,658,174,832
Madhya Pradesh,Shivpuri,Locomotor Disability,80,100,28,5,33
Karnataka,Shivamogga,Locomotor Disability,0,6,20,18,38
Karnataka,Shivamogga,Locomotor Disability,6,15,220,134,354
Karnataka,Shivamogga,Locomotor Disability,15,35,1127,670,1797
Karnataka,Shivamogga,Locomotor Disability,35,60,3068,1687,4755
Karnataka,Shivamogga,Locomotor Disability,60,80,857,322,1179
Karnataka,Shivamogga,Locomotor Disability,80,100,24,10,34
Himachal Pradesh,Shimla,Locomotor Disability,0,6,11,15,26
Himachal Pradesh,Shimla,Locomotor Disability,6,15,78,76,154
Himachal Pradesh,Shimla,Locomotor Disability,15,35,824,438,1262
Himachal Pradesh,Shimla,Locomotor Disability,35,60,2051,981,3032
Himachal Pradesh,Shimla,Locomotor Disability,60,80,851,327,1178
Himachal Pradesh,Shimla,Locomotor Disability,80,100,60,19,79
Arunachal Pradesh,Shi Yomi,Locomotor Disability,6,15,1,2,3
Madhya Pradesh,Sheopur,Locomotor Disability,0,6,9,10,19
Madhya Pradesh,Sheopur,Locomotor Disability,6,15,169,93,262
Madhya Pradesh,Sheopur,Locomotor Disability,15,35,1291,580,1871
Madhya Pradesh,Sheopur,Locomotor Disability,35,60,1547,593,2140
Madhya Pradesh,Sheopur,Locomotor Disability,60,80,305,107,412
Madhya Pradesh,Sheopur,Locomotor Disability,80,100,16,4,20
Bihar,Sheohar,Locomotor Disability,0,6,76,41,117
Bihar,Sheohar,Locomotor Disability,6,15,361,195,556
Bihar,Sheohar,Locomotor Disability,15,35,560,227,787
Bihar,Sheohar,Locomotor Disability,35,60,528,182,710
Bihar,Sheohar,Locomotor Disability,60,80,179,62,241
Bihar,Sheohar,Locomotor Disability,80,100,22,3,25
Bihar,Sheikhpura,Locomotor Disability,0,6,12,8,20
Bihar,Sheikhpura,Locomotor Disability,6,15,97,75,172
Bihar,Sheikhpura,Locomotor Disability,15,35,687,281,968
Bihar,Sheikhpura,Locomotor Disability,35,60,466,135,601
Bihar,Sheikhpura,Locomotor Disability,60,80,118,26,144
Bihar,Sheikhpura,Locomotor Disability,80,100,7,1,8
Uttar Pradesh,Shamli,Locomotor Disability,0,6,11,7,18
Uttar Pradesh,Shamli,Locomotor Disability,6,15,139,86,225
Uttar Pradesh,Shamli,Locomotor Disability,15,35,2124,835,2959
Uttar Pradesh,Shamli,Locomotor Disability,35,60,2306,757,3063
Uttar Pradesh,Shamli,Locomotor Disability,60,80,532,112,644
Uttar Pradesh,Shamli,Locomotor Disability,80,100,24,8,32
Madhya Pradesh,Shajapur,Locomotor Disability,0,6,42,28,70
Madhya Pradesh,Shajapur,Locomotor Disability,6,15,293,188,481
Madhya Pradesh,Shajapur,Locomotor Disability,15,35,1172,564,1736
Madhya Pradesh,Shajapur,Locomotor Disability,35,60,2219,922,3141
Madhya Pradesh,Shajapur,Locomotor Disability,60,80,479,139,618
Madhya Pradesh,Shajapur,Locomotor Disability,80,100,35,9,44
Uttar Pradesh,Shahjahanpur,Locomotor Disability,0,6,43,30,73
Uttar Pradesh,Shahjahanpur,Locomotor Disability,6,15,571,357,928
Uttar Pradesh,Shahjahanpur,Locomotor Disability,15,35,5970,2202,8172
Uttar Pradesh,Shahjahanpur,Locomotor Disability,35,60,6452,2151,8603
Uttar Pradesh,Shahjahanpur,Locomotor Disability,60,80,1554,422,1976
Uttar Pradesh,Shahjahanpur,Locomotor Disability,80,100,65,16,81
Punjab,Shahid Bhagat Singh Nagar,Locomotor Disability,0,6,6,6,12
Punjab,Shahid Bhagat Singh Nagar,Locomotor Disability,6,15,73,53,126
Punjab,Shahid Bhagat Singh Nagar,Locomotor Disability,15,35,564,320,884
Punjab,Shahid Bhagat Singh Nagar,Locomotor Disability,35,60,2003,1001,3004
Punjab,Shahid Bhagat Singh Nagar,Locomotor Disability,60,80,623,189,812
Punjab,Shahid Bhagat Singh Nagar,Locomotor Disability,80,100,42,17,59
Madhya Pradesh,Shahdol,Locomotor Disability,0,6,9,8,17
Madhya Pradesh,Shahdol,Locomotor Disability,6,15,193,148,341
Madhya Pradesh,Shahdol,Locomotor Disability,15,35,1897,948,2845
Madhya Pradesh,Shahdol,Locomotor Disability,35,60,3050,1556,4606
Madhya Pradesh,Shahdol,Locomotor Disability,60,80,896,347,1243
Madhya Pradesh,Shahdol,Locomotor Disability,80,100,34,10,44
Delhi,Shahdara,Locomotor Disability,0,6,2,3,5
Delhi,Shahdara,Locomotor Disability,6,15,26,32,58
Delhi,Shahdara,Locomotor Disability,15,35,220,121,341
Delhi,Shahdara,Locomotor Disability,35,60,347,109,456
Delhi,Shahdara,Locomotor Disability,60,80,71,14,85
Delhi,Shahdara,Locomotor Disability,80,100,2,0,2
Mizoram,Serchhip,Locomotor Disability,0,6,1,0,1
Mizoram,Serchhip,Locomotor Disability,6,15,4,5,9
Mizoram,Serchhip,Locomotor Disability,15,35,12,5,17
Mizoram,Serchhip,Locomotor Disability,35,60,12,6,18
Mizoram,Serchhip,Locomotor Disability,60,80,6,2,8
Mizoram,Serchhip,Locomotor Disability,80,100,3,1,4
Tripura,Sepahijala,Locomotor Disability,0,6,20,10,30
Tripura,Sepahijala,Locomotor Disability,6,15,109,37,146
Tripura,Sepahijala,Locomotor Disability,15,35,245,141,386
Tripura,Sepahijala,Locomotor Disability,35,60,435,165,600
Tripura,Sepahijala,Locomotor Disability,60,80,103,55,158
Tripura,Sepahijala,Locomotor Disability,80,100,7,3,10
Madhya Pradesh,Seoni,Locomotor Disability,0,6,12,12,24
Madhya Pradesh,Seoni,Locomotor Disability,6,15,217,134,351
Madhya Pradesh,Seoni,Locomotor Disability,15,35,2343,1237,3580
Madhya Pradesh,Seoni,Locomotor Disability,35,60,3323,1252,4575
Madhya Pradesh,Seoni,Locomotor Disability,60,80,877,286,1163
Madhya Pradesh,Seoni,Locomotor Disability,80,100,43,12,55
Manipur,Senapati,Locomotor Disability,0,6,3,0,3
Manipur,Senapati,Locomotor Disability,6,15,9,5,14
Manipur,Senapati,Locomotor Disability,15,35,35,22,57
Manipur,Senapati,Locomotor Disability,35,60,46,13,59
Manipur,Senapati,Locomotor Disability,60,80,7,5,12
Manipur,Senapati,Locomotor Disability,80,100,1,0,1
Madhya Pradesh,Sehore,Locomotor Disability,0,6,31,20,51
Madhya Pradesh,Sehore,Locomotor Disability,6,15,306,176,482
Madhya Pradesh,Sehore,Locomotor Disability,15,35,2797,1329,4126
Madhya Pradesh,Sehore,Locomotor Disability,35,60,5092,1883,6975
Madhya Pradesh,Sehore,Locomotor Disability,60,80,1074,359,1433
Madhya Pradesh,Sehore,Locomotor Disability,80,100,76,17,93
Rajasthan,Sawai Madhopur,Locomotor Disability,0,6,15,12,27
Rajasthan,Sawai Madhopur,Locomotor Disability,6,15,262,125,387
Rajasthan,Sawai Madhopur,Locomotor Disability,15,35,1409,677,2086
Rajasthan,Sawai Madhopur,Locomotor Disability,35,60,1943,853,2796
Rajasthan,Sawai Madhopur,Locomotor Disability,60,80,398,152,550
Rajasthan,Sawai Madhopur,Locomotor Disability,80,100,16,13,29
Madhya Pradesh,Satna,Locomotor Disability,0,6,44,24,68
Madhya Pradesh,Satna,Locomotor Disability,6,15,367,191,558
Madhya Pradesh,Satna,Locomotor Disability,15,35,3128,1459,4587
Madhya Pradesh,Satna,Locomotor Disability,35,60,4806,1812,6618
Madhya Pradesh,Satna,Locomotor Disability,60,80,1257,429,1686
Madhya Pradesh,Satna,Locomotor Disability,80,100,73,20,93
Maharashtra,Satara,Locomotor Disability,0,6,39,24,63
Maharashtra,Satara,Locomotor Disability,6,15,462,258,720
Maharashtra,Satara,Locomotor Disability,15,35,2439,1070,3509
Maharashtra,Satara,Locomotor Disability,35,60,5600,1788,7388
Maharashtra,Satara,Locomotor Disability,60,80,1985,349,2334
Maharashtra,Satara,Locomotor Disability,80,100,107,20,127
Bihar,Saran,Locomotor Disability,0,6,83,50,133
Bihar,Saran,Locomotor Disability,6,15,604,371,975
Bihar,Saran,Locomotor Disability,15,35,2008,776,2784
Bihar,Saran,Locomotor Disability,35,60,2016,630,2646
Bihar,Saran,Locomotor Disability,60,80,535,134,669
Bihar,Saran,Locomotor Disability,80,100,17,10,27
Jharkhand,Saraikela Kharsawan,Locomotor Disability,0,6,3,1,4
Jharkhand,Saraikela Kharsawan,Locomotor Disability,6,15,90,64,154
Jharkhand,Saraikela Kharsawan,Locomotor Disability,15,35,268,147,415
Jharkhand,Saraikela Kharsawan,Locomotor Disability,35,60,327,172,499
Jharkhand,Saraikela Kharsawan,Locomotor Disability,60,80,53,28,81
Jharkhand,Saraikela Kharsawan,Locomotor Disability,80,100,1,0,1
Uttar Pradesh,Sant Kabeer Nagar,Locomotor Disability,0,6,4,1,5
Uttar Pradesh,Sant Kabeer Nagar,Locomotor Disability,6,15,78,41,119
Uttar Pradesh,Sant Kabeer Nagar,Locomotor Disability,15,35,1364,535,1899
Uttar Pradesh,Sant Kabeer Nagar,Locomotor Disability,35,60,1238,416,1654
Uttar Pradesh,Sant Kabeer Nagar,Locomotor Disability,60,80,283,58,341
Uttar Pradesh,Sant Kabeer Nagar,Locomotor Disability,80,100,8,1,9
Punjab,Sangrur,Locomotor Disability,0,6,59,41,100
Punjab,Sangrur,Locomotor Disability,6,15,350,201,551
Punjab,Sangrur,Locomotor Disability,15,35,2211,1075,3286
Punjab,Sangrur,Locomotor Disability,35,60,5328,2387,7715
Punjab,Sangrur,Locomotor Disability,60,80,1537,404,1941
Punjab,Sangrur,Locomotor Disability,80,100,85,24,109
Maharashtra,Sangli,Locomotor Disability,0,6,25,12,37
Maharashtra,Sangli,Locomotor Disability,6,15,417,220,637
Maharashtra,Sangli,Locomotor Disability,15,35,2509,1177,3686
Maharashtra,Sangli,Locomotor Disability,35,60,5278,1887,7165
Maharashtra,Sangli,Locomotor Disability,60,80,2007,401,2408
Maharashtra,Sangli,Locomotor Disability,80,100,139,22,161
Telangana,Sangareddy,Locomotor Disability,0,6,2,0,2
Telangana,Sangareddy,Locomotor Disability,6,15,193,135,328
Telangana,Sangareddy,Locomotor Disability,15,35,679,371,1050
Telangana,Sangareddy,Locomotor Disability,35,60,1112,488,1600
Telangana,Sangareddy,Locomotor Disability,60,80,418,174,592
Telangana,Sangareddy,Locomotor Disability,80,100,52,29,81
Uttar Pradesh,Sambhal,Locomotor Disability,0,6,5,6,11
Uttar Pradesh,Sambhal,Locomotor Disability,6,15,125,70,195
Uttar Pradesh,Sambhal,Locomotor Disability,15,35,2149,605,2754
Uttar Pradesh,Sambhal,Locomotor Disability,35,60,1802,430,2232
Uttar Pradesh,Sambhal,Locomotor Disability,60,80,314,47,361
Uttar Pradesh,Sambhal,Locomotor Disability,80,100,9,0,9
Odisha,Sambalpur,Locomotor Disability,0,6,48,37,85
Odisha,Sambalpur,Locomotor Disability,6,15,283,188,471
Odisha,Sambalpur,Locomotor Disability,15,35,1106,657,1763
Odisha,Sambalpur,Locomotor Disability,35,60,2334,1255,3589
Odisha,Sambalpur,Locomotor Disability,60,80,963,537,1500
Odisha,Sambalpur,Locomotor Disability,80,100,84,61,145
Jammu And Kashmir,Samba,Locomotor Disability,0,6,7,3,10
Jammu And Kashmir,Samba,Locomotor Disability,6,15,43,19,62
Jammu And Kashmir,Samba,Locomotor Disability,15,35,315,145,460
Jammu And Kashmir,Samba,Locomotor Disability,35,60,800,380,1180
Jammu And Kashmir,Samba,Locomotor Disability,60,80,204,60,264
Jammu And Kashmir,Samba,Locomotor Disability,80,100,13,7,20
Bihar,Samastipur,Locomotor Disability,0,6,134,87,221
Bihar,Samastipur,Locomotor Disability,6,15,1338,744,2082
Bihar,Samastipur,Locomotor Disability,15,35,6051,2738,8789
Bihar,Samastipur,Locomotor Disability,35,60,6102,3206,9308
Bihar,Samastipur,Locomotor Disability,60,80,1928,880,2808
Bihar,Samastipur,Locomotor Disability,80,100,58,19,77
Tamil Nadu,Salem,Locomotor Disability,0,6,30,21,51
Tamil Nadu,Salem,Locomotor Disability,6,15,212,183,395
Tamil Nadu,Salem,Locomotor Disability,15,35,1163,620,1783
Tamil Nadu,Salem,Locomotor Disability,35,60,3952,1941,5893
Tamil Nadu,Salem,Locomotor Disability,60,80,1393,484,1877
Tamil Nadu,Salem,Locomotor Disability,80,100,76,28,104
Mizoram,Saitual,Locomotor Disability,15,35,2,1,3
Mizoram,Saiha,Locomotor Disability,15,35,6,2,8
Mizoram,Saiha,Locomotor Disability,35,60,7,2,9
Mizoram,Saiha,Locomotor Disability,60,80,5,0,5
Mizoram,Saiha,Locomotor Disability,80,100,1,0,1
Jharkhand,Sahebganj,Locomotor Disability,0,6,18,7,25
Jharkhand,Sahebganj,Locomotor Disability,6,15,149,112,261
Jharkhand,Sahebganj,Locomotor Disability,15,35,846,400,1246
Jharkhand,Sahebganj,Locomotor Disability,35,60,733,275,1008
Jharkhand,Sahebganj,Locomotor Disability,60,80,140,37,177
Jharkhand,Sahebganj,Locomotor Disability,80,100,5,1,6
Bihar,Saharsa,Locomotor Disability,0,6,75,29,104
Bihar,Saharsa,Locomotor Disability,6,15,300,155,455
Bihar,Saharsa,Locomotor Disability,15,35,1031,445,1476
Bihar,Saharsa,Locomotor Disability,35,60,834,322,1156
Bihar,Saharsa,Locomotor Disability,60,80,275,72,347
Bihar,Saharsa,Locomotor Disability,80,100,17,2,19
Uttar Pradesh,Saharanpur,Locomotor Disability,0,6,23,17,40
Uttar Pradesh,Saharanpur,Locomotor Disability,6,15,226,116,342
Uttar Pradesh,Saharanpur,Locomotor Disability,15,35,3494,1380,4874
Uttar Pradesh,Saharanpur,Locomotor Disability,35,60,4022,1249,5271
Uttar Pradesh,Saharanpur,Locomotor Disability,60,80,739,145,884
Uttar Pradesh,Saharanpur,Locomotor Disability,80,100,25,7,32
Madhya Pradesh,Sagar,Locomotor Disability,0,6,19,13,32
Madhya Pradesh,Sagar,Locomotor Disability,6,15,350,217,567
Madhya Pradesh,Sagar,Locomotor Disability,15,35,3100,1455,4555
Madhya Pradesh,Sagar,Locomotor Disability,35,60,4446,1492,5938
Madhya Pradesh,Sagar,Locomotor Disability,60,80,1058,331,1389
Madhya Pradesh,Sagar,Locomotor Disability,80,100,44,26,70
Gujarat,Sabar Kantha,Locomotor Disability,0,6,29,12,41
Gujarat,Sabar Kantha,Locomotor Disability,6,15,411,287,698
Gujarat,Sabar Kantha,Locomotor Disability,15,35,1300,624,1924
Gujarat,Sabar Kantha,Locomotor Disability,35,60,2796,1135,3931
Gujarat,Sabar Kantha,Locomotor Disability,60,80,765,150,915
Gujarat,Sabar Kantha,Locomotor Disability,80,100,34,6,40
Punjab,S.A.S Nagar,Locomotor Disability,0,6,10,11,21
Punjab,S.A.S Nagar,Locomotor Disability,6,15,118,96,214
Punjab,S.A.S Nagar,Locomotor Disability,15,35,690,324,1014
Punjab,S.A.S Nagar,Locomotor Disability,35,60,1789,733,2522
Punjab,S.A.S Nagar,Locomotor Disability,60,80,429,96,525
Punjab,S.A.S Nagar,Locomotor Disability,80,100,14,3,17
Punjab,Rupnagar,Locomotor Disability,0,6,7,16,23
Punjab,Rupnagar,Locomotor Disability,6,15,84,65,149
Punjab,Rupnagar,Locomotor Disability,15,35,675,314,989
Punjab,Rupnagar,Locomotor Disability,35,60,1760,770,2530
Punjab,Rupnagar,Locomotor Disability,60,80,469,119,588
Punjab,Rupnagar,Locomotor Disability,80,100,39,6,45
Uttarakhand,Rudra Prayag,Locomotor Disability,0,6,0,7,7
Uttarakhand,Rudra Prayag,Locomotor Disability,6,15,36,19,55
Uttarakhand,Rudra Prayag,Locomotor Disability,15,35,211,117,328
Uttarakhand,Rudra Prayag,Locomotor Disability,35,60,393,164,557
Uttarakhand,Rudra Prayag,Locomotor Disability,60,80,91,51,142
Uttarakhand,Rudra Prayag,Locomotor Disability,80,100,4,1,5
Bihar,Rohtas,Locomotor Disability,0,6,23,12,35
Bihar,Rohtas,Locomotor Disability,6,15,340,214,554
Bihar,Rohtas,Locomotor Disability,15,35,2195,733,2928
Bihar,Rohtas,Locomotor Disability,35,60,2068,713,2781
Bihar,Rohtas,Locomotor Disability,60,80,515,153,668
Bihar,Rohtas,Locomotor Disability,80,100,16,8,24
Haryana,Rohtak,Locomotor Disability,0,6,8,4,12
Haryana,Rohtak,Locomotor Disability,6,15,114,70,184
Haryana,Rohtak,Locomotor Disability,15,35,925,441,1366
Haryana,Rohtak,Locomotor Disability,35,60,1834,803,2637
Haryana,Rohtak,Locomotor Disability,60,80,343,121,464
Haryana,Rohtak,Locomotor Disability,80,100,9,8,17
Meghalaya,Ri Bhoi,Locomotor Disability,0,6,11,6,17
Meghalaya,Ri Bhoi,Locomotor Disability,6,15,60,45,105
Meghalaya,Ri Bhoi,Locomotor Disability,15,35,232,149,381
Meghalaya,Ri Bhoi,Locomotor Disability,35,60,194,132,326
Meghalaya,Ri Bhoi,Locomotor Disability,60,80,68,47,115
Meghalaya,Ri Bhoi,Locomotor Disability,80,100,11,7,18
Haryana,Rewari,Locomotor Disability,0,6,7,8,15
Haryana,Rewari,Locomotor Disability,6,15,78,42,120
Haryana,Rewari,Locomotor Disability,15,35,459,210,669
Haryana,Rewari,Locomotor Disability,35,60,972,327,1299
Haryana,Rewari,Locomotor Disability,60,80,139,39,178
Haryana,Rewari,Locomotor Disability,80,100,4,5,9
Madhya Pradesh,Rewa,Locomotor Disability,0,6,14,6,20
Madhya Pradesh,Rewa,Locomotor Disability,6,15,261,148,409
Madhya Pradesh,Rewa,Locomotor Disability,15,35,2244,948,3192
Madhya Pradesh,Rewa,Locomotor Disability,35,60,3239,990,4229
Madhya Pradesh,Rewa,Locomotor Disability,60,80,827,270,1097
Madhya Pradesh,Rewa,Locomotor Disability,80,100,80,15,95
Jammu And Kashmir,Reasi,Locomotor Disability,0,6,9,7,16
Jammu And Kashmir,Reasi,Locomotor Disability,6,15,77,48,125
Jammu And Kashmir,Reasi,Locomotor Disability,15,35,382,181,563
Jammu And Kashmir,Reasi,Locomotor Disability,35,60,513,263,776
Jammu And Kashmir,Reasi,Locomotor Disability,60,80,84,27,111
Jammu And Kashmir,Reasi,Locomotor Disability,80,100,3,1,4
Odisha,Rayagada,Locomotor Disability,0,6,51,39,90
Odisha,Rayagada,Locomotor Disability,6,15,305,216,521
Odisha,Rayagada,Locomotor Disability,15,35,1263,745,2008
Odisha,Rayagada,Locomotor Disability,35,60,1703,801,2504
Odisha,Rayagada,Locomotor Disability,60,80,450,173,623
Odisha,Rayagada,Locomotor Disability,80,100,24,11,35
Maharashtra,Ratnagiri,Locomotor Disability,0,6,22,18,40
Maharashtra,Ratnagiri,Locomotor Disability,6,15,388,282,670
Maharashtra,Ratnagiri,Locomotor Disability,15,35,1837,984,2821
Maharashtra,Ratnagiri,Locomotor Disability,35,60,4795,1623,6418
Maharashtra,Ratnagiri,Locomotor Disability,60,80,1747,353,2100
Maharashtra,Ratnagiri,Locomotor Disability,80,100,110,24,134
Madhya Pradesh,Ratlam,Locomotor Disability,0,6,18,11,29
Madhya Pradesh,Ratlam,Locomotor Disability,6,15,172,138,310
Madhya Pradesh,Ratlam,Locomotor Disability,15,35,1366,676,2042
Madhya Pradesh,Ratlam,Locomotor Disability,35,60,2619,1166,3785
Madhya Pradesh,Ratlam,Locomotor Disability,60,80,655,179,834
Madhya Pradesh,Ratlam,Locomotor Disability,80,100,29,10,39
Tamil Nadu,Ranipet,Locomotor Disability,0,6,22,10,32
Tamil Nadu,Ranipet,Locomotor Disability,6,15,104,60,164
Tamil Nadu,Ranipet,Locomotor Disability,15,35,478,274,752
Tamil Nadu,Ranipet,Locomotor Disability,35,60,1607,858,2465
Tamil Nadu,Ranipet,Locomotor Disability,60,80,633,229,862
Tamil Nadu,Ranipet,Locomotor Disability,80,100,26,7,33
Telangana,Ranga Reddy,Locomotor Disability,0,6,2,0,2
Telangana,Ranga Reddy,Locomotor Disability,6,15,303,179,482
Telangana,Ranga Reddy,Locomotor Disability,15,35,2602,1626,4228
Telangana,Ranga Reddy,Locomotor Disability,35,60,6431,2807,9238
Telangana,Ranga Reddy,Locomotor Disability,60,80,3163,1156,4319
Telangana,Ranga Reddy,Locomotor Disability,80,100,300,101,401
Jharkhand,Ranchi,Locomotor Disability,0,6,53,34,87
Jharkhand,Ranchi,Locomotor Disability,6,15,380,268,648
Jharkhand,Ranchi,Locomotor Disability,15,35,1304,817,2121
Jharkhand,Ranchi,Locomotor Disability,35,60,1981,905,2886
Jharkhand,Ranchi,Locomotor Disability,60,80,305,138,443
Jharkhand,Ranchi,Locomotor Disability,80,100,12,5,17
Uttar Pradesh,Rampur,Locomotor Disability,0,6,5,6,11
Uttar Pradesh,Rampur,Locomotor Disability,6,15,83,46,129
Uttar Pradesh,Rampur,Locomotor Disability,15,35,1957,734,2691
Uttar Pradesh,Rampur,Locomotor Disability,35,60,1562,459,2021
Uttar Pradesh,Rampur,Locomotor Disability,60,80,253,51,304
Uttar Pradesh,Rampur,Locomotor Disability,80,100,10,3,13
Jharkhand,Ramgarh,Locomotor Disability,0,6,15,10,25
Jharkhand,Ramgarh,Locomotor Disability,6,15,147,90,237
Jharkhand,Ramgarh,Locomotor Disability,15,35,711,351,1062
Jharkhand,Ramgarh,Locomotor Disability,35,60,825,306,1131
Jharkhand,Ramgarh,Locomotor Disability,60,80,160,55,215
Jharkhand,Ramgarh,Locomotor Disability,80,100,9,0,9
Jammu And Kashmir,Ramban,Locomotor Disability,0,6,18,8,26
Jammu And Kashmir,Ramban,Locomotor Disability,6,15,149,108,257
Jammu And Kashmir,Ramban,Locomotor Disability,15,35,653,390,1043
Jammu And Kashmir,Ramban,Locomotor Disability,35,60,923,519,1442
Jammu And Kashmir,Ramban,Locomotor Disability,60,80,168,76,244
Jammu And Kashmir,Ramban,Locomotor Disability,80,100,8,2,10
Tamil Nadu,Ramanathapuram,Locomotor Disability,0,6,11,11,22
Tamil Nadu,Ramanathapuram,Locomotor Disability,6,15,112,108,220
Tamil Nadu,Ramanathapuram,Locomotor Disability,15,35,813,465,1278
Tamil Nadu,Ramanathapuram,Locomotor Disability,35,60,2633,1544,4177
Tamil Nadu,Ramanathapuram,Locomotor Disability,60,80,995,339,1334
Tamil Nadu,Ramanathapuram,Locomotor Disability,80,100,35,11,46
Karnataka,Ramanagara,Locomotor Disability,0,6,21,18,39
Karnataka,Ramanagara,Locomotor Disability,6,15,182,119,301
Karnataka,Ramanagara,Locomotor Disability,15,35,1002,552,1554
Karnataka,Ramanagara,Locomotor Disability,35,60,3078,1216,4294
Karnataka,Ramanagara,Locomotor Disability,60,80,960,256,1216
Karnataka,Ramanagara,Locomotor Disability,80,100,51,7,58
Rajasthan,Rajsamand,Locomotor Disability,0,6,20,13,33
Rajasthan,Rajsamand,Locomotor Disability,6,15,387,209,596
Rajasthan,Rajsamand,Locomotor Disability,15,35,1543,906,2449
Rajasthan,Rajsamand,Locomotor Disability,35,60,2831,1314,4145
Rajasthan,Rajsamand,Locomotor Disability,60,80,805,427,1232
Rajasthan,Rajsamand,Locomotor Disability,80,100,56,32,88
Jammu And Kashmir,Rajouri,Locomotor Disability,0,6,54,53,107
Jammu And Kashmir,Rajouri,Locomotor Disability,6,15,332,234,566
Jammu And Kashmir,Rajouri,Locomotor Disability,15,35,1480,854,2334
Jammu And Kashmir,Rajouri,Locomotor Disability,35,60,2596,1424,4020
Jammu And Kashmir,Rajouri,Locomotor Disability,60,80,483,224,707
Jammu And Kashmir,Rajouri,Locomotor Disability,80,100,57,11,68
Chhattisgarh,Rajnandgaon,Locomotor Disability,0,6,22,24,46
Chhattisgarh,Rajnandgaon,Locomotor Disability,6,15,304,231,535
Chhattisgarh,Rajnandgaon,Locomotor Disability,15,35,1838,1207,3045
Chhattisgarh,Rajnandgaon,Locomotor Disability,35,60,3212,1438,4650
Chhattisgarh,Rajnandgaon,Locomotor Disability,60,80,750,220,970
Chhattisgarh,Rajnandgaon,Locomotor Disability,80,100,33,18,51
Gujarat,Rajkot,Locomotor Disability,0,6,61,35,96
Gujarat,Rajkot,Locomotor Disability,6,15,368,213,581
Gujarat,Rajkot,Locomotor Disability,15,35,1739,881,2620
Gujarat,Rajkot,Locomotor Disability,35,60,4651,2343,6994
Gujarat,Rajkot,Locomotor Disability,60,80,1613,476,2089
Gujarat,Rajkot,Locomotor Disability,80,100,93,27,120
Madhya Pradesh,Rajgarh,Locomotor Disability,0,6,32,28,60
Madhya Pradesh,Rajgarh,Locomotor Disability,6,15,346,201,547
Madhya Pradesh,Rajgarh,Locomotor Disability,15,35,2681,1180,3861
Madhya Pradesh,Rajgarh,Locomotor Disability,35,60,4459,1808,6267
Madhya Pradesh,Rajgarh,Locomotor Disability,60,80,1215,470,1685
Madhya Pradesh,Rajgarh,Locomotor Disability,80,100,104,41,145
Telangana,Rajanna Sircilla,Locomotor Disability,6,15,39,33,72
Telangana,Rajanna Sircilla,Locomotor Disability,15,35,519,381,900
Telangana,Rajanna Sircilla,Locomotor Disability,35,60,1206,718,1924
Telangana,Rajanna Sircilla,Locomotor Disability,60,80,898,493,1391
Telangana,Rajanna Sircilla,Locomotor Disability,80,100,202,99,301
Madhya Pradesh,Raisen,Locomotor Disability,0,6,41,34,75
Madhya Pradesh,Raisen,Locomotor Disability,6,15,526,325,851
Madhya Pradesh,Raisen,Locomotor Disability,15,35,2875,1196,4071
Madhya Pradesh,Raisen,Locomotor Disability,35,60,4199,1359,5558
Madhya Pradesh,Raisen,Locomotor Disability,60,80,1261,341,1602
Madhya Pradesh,Raisen,Locomotor Disability,80,100,98,26,124
Chhattisgarh,Raipur,Locomotor Disability,0,6,23,18,41
Chhattisgarh,Raipur,Locomotor Disability,6,15,283,149,432
Chhattisgarh,Raipur,Locomotor Disability,15,35,1615,977,2592
Chhattisgarh,Raipur,Locomotor Disability,35,60,2687,1096,3783
Chhattisgarh,Raipur,Locomotor Disability,60,80,577,182,759
Chhattisgarh,Raipur,Locomotor Disability,80,100,30,8,38
Chhattisgarh,Raigarh,Locomotor Disability,0,6,28,15,43
Chhattisgarh,Raigarh,Locomotor Disability,6,15,329,232,561
Chhattisgarh,Raigarh,Locomotor Disability,15,35,1444,804,2248
Chhattisgarh,Raigarh,Locomotor Disability,35,60,2491,1018,3509
Chhattisgarh,Raigarh,Locomotor Disability,60,80,706,254,960
Chhattisgarh,Raigarh,Locomotor Disability,80,100,41,27,68
Maharashtra,Raigad,Locomotor Disability,0,6,34,26,60
Maharashtra,Raigad,Locomotor Disability,6,15,269,174,443
Maharashtra,Raigad,Locomotor Disability,15,35,1369,652,2021
Maharashtra,Raigad,Locomotor Disability,35,60,4518,1745,6263
Maharashtra,Raigad,Locomotor Disability,60,80,1398,368,1766
Maharashtra,Raigad,Locomotor Disability,80,100,58,19,77
Karnataka,Raichur,Locomotor Disability,0,6,79,55,134
Karnataka,Raichur,Locomotor Disability,6,15,454,307,761
Karnataka,Raichur,Locomotor Disability,15,35,2748,1597,4345
Karnataka,Raichur,Locomotor Disability,35,60,4576,1658,6234
Karnataka,Raichur,Locomotor Disability,60,80,779,216,995
Karnataka,Raichur,Locomotor Disability,80,100,23,4,27
Uttar Pradesh,Rae Bareli,Locomotor Disability,0,6,26,14,40
Uttar Pradesh,Rae Bareli,Locomotor Disability,6,15,338,276,614
Uttar Pradesh,Rae Bareli,Locomotor Disability,15,35,2850,1108,3958
Uttar Pradesh,Rae Bareli,Locomotor Disability,35,60,4074,1112,5186
Uttar Pradesh,Rae Bareli,Locomotor Disability,60,80,1143,193,1336
Uttar Pradesh,Rae Bareli,Locomotor Disability,80,100,47,10,57
Bihar,Purnia,Locomotor Disability,0,6,91,46,137
Bihar,Purnia,Locomotor Disability,6,15,561,385,946
Bihar,Purnia,Locomotor Disability,15,35,1868,982,2850
Bihar,Purnia,Locomotor Disability,35,60,1605,677,2282
Bihar,Purnia,Locomotor Disability,60,80,484,155,639
Bihar,Purnia,Locomotor Disability,80,100,17,7,24
Odisha,Puri,Locomotor Disability,0,6,258,149,407
Odisha,Puri,Locomotor Disability,6,15,958,571,1529
Odisha,Puri,Locomotor Disability,15,35,2870,1376,4246
Odisha,Puri,Locomotor Disability,35,60,7128,3612,10740
Odisha,Puri,Locomotor Disability,60,80,2456,1091,3547
Odisha,Puri,Locomotor Disability,80,100,115,64,179
Bihar,Purbi Champaran,Locomotor Disability,0,6,135,57,192
Bihar,Purbi Champaran,Locomotor Disability,6,15,656,343,999
Bihar,Purbi Champaran,Locomotor Disability,15,35,2104,685,2789
Bihar,Purbi Champaran,Locomotor Disability,35,60,1746,567,2313
Bihar,Purbi Champaran,Locomotor Disability,60,80,424,92,516
Bihar,Purbi Champaran,Locomotor Disability,80,100,19,5,24
Maharashtra,Pune,Locomotor Disability,0,6,134,82,216
Maharashtra,Pune,Locomotor Disability,6,15,1373,738,2111
Maharashtra,Pune,Locomotor Disability,15,35,5481,2584,8065
Maharashtra,Pune,Locomotor Disability,35,60,12964,4692,17656
Maharashtra,Pune,Locomotor Disability,60,80,4519,989,5508
Maharashtra,Pune,Locomotor Disability,80,100,246,38,284
Jammu And Kashmir,Pulwama,Locomotor Disability,0,6,27,16,43
Jammu And Kashmir,Pulwama,Locomotor Disability,6,15,102,76,178
Jammu And Kashmir,Pulwama,Locomotor Disability,15,35,428,367,795
Jammu And Kashmir,Pulwama,Locomotor Disability,35,60,1001,606,1607
Jammu And Kashmir,Pulwama,Locomotor Disability,60,80,221,121,342
Jammu And Kashmir,Pulwama,Locomotor Disability,80,100,18,16,34
Karnataka,Pudukkottai,Locomotor Disability,35,60,1,0,1
Tamil Nadu,Pudukkottai,Locomotor Disability,0,6,14,17,31
Tamil Nadu,Pudukkottai,Locomotor Disability,6,15,151,115,266
Tamil Nadu,Pudukkottai,Locomotor Disability,15,35,671,406,1077
Tamil Nadu,Pudukkottai,Locomotor Disability,35,60,2533,1312,3845
Tamil Nadu,Pudukkottai,Locomotor Disability,60,80,623,202,825
Tamil Nadu,Pudukkottai,Locomotor Disability,80,100,26,10,36
Uttar Pradesh,Prayagraj,Locomotor Disability,0,6,57,39,96
Uttar Pradesh,Prayagraj,Locomotor Disability,6,15,612,259,871
Uttar Pradesh,Prayagraj,Locomotor Disability,15,35,4734,1898,6632
Uttar Pradesh,Prayagraj,Locomotor Disability,35,60,4771,1347,6118
Uttar Pradesh,Prayagraj,Locomotor Disability,60,80,1006,206,1212
Uttar Pradesh,Prayagraj,Locomotor Disability,80,100,36,8,44
Rajasthan,Pratapgarh,Locomotor Disability,0,6,24,11,35
Rajasthan,Pratapgarh,Locomotor Disability,6,15,289,198,487
Rajasthan,Pratapgarh,Locomotor Disability,15,35,1440,914,2354
Rajasthan,Pratapgarh,Locomotor Disability,35,60,2177,1281,3458
Rajasthan,Pratapgarh,Locomotor Disability,60,80,717,434,1151
Rajasthan,Pratapgarh,Locomotor Disability,80,100,77,58,135
Uttar Pradesh,Pratapgarh,Locomotor Disability,0,6,17,9,26
Uttar Pradesh,Pratapgarh,Locomotor Disability,6,15,193,101,294
Uttar Pradesh,Pratapgarh,Locomotor Disability,15,35,3552,1540,5092
Uttar Pradesh,Pratapgarh,Locomotor Disability,35,60,4472,1531,6003
Uttar Pradesh,Pratapgarh,Locomotor Disability,60,80,1019,193,1212
Uttar Pradesh,Pratapgarh,Locomotor Disability,80,100,38,6,44
Andhra Pradesh,Prakasam,Locomotor Disability,0,6,103,64,167
Andhra Pradesh,Prakasam,Locomotor Disability,6,15,567,378,945
Andhra Pradesh,Prakasam,Locomotor Disability,15,35,2307,957,3264
Andhra Pradesh,Prakasam,Locomotor Disability,35,60,7188,1601,8789
Andhra Pradesh,Prakasam,Locomotor Disability,60,80,2650,519,3169
Andhra Pradesh,Prakasam,Locomotor Disability,80,100,153,37,190
Gujarat,Porbandar,Locomotor Disability,0,6,25,17,42
Gujarat,Porbandar,Locomotor Disability,6,15,146,106,252
Gujarat,Porbandar,Locomotor Disability,15,35,527,303,830
Gujarat,Porbandar,Locomotor Disability,35,60,1265,529,1794
Gujarat,Porbandar,Locomotor Disability,60,80,521,186,707
Gujarat,Porbandar,Locomotor Disability,80,100,48,10,58
Jammu And Kashmir,Poonch,Locomotor Disability,0,6,88,65,153
Jammu And Kashmir,Poonch,Locomotor Disability,6,15,488,303,791
Jammu And Kashmir,Poonch,Locomotor Disability,15,35,1557,1213,2770
Jammu And Kashmir,Poonch,Locomotor Disability,35,60,2204,1410,3614
Jammu And Kashmir,Poonch,Locomotor Disability,60,80,269,129,398
Jammu And Kashmir,Poonch,Locomotor Disability,80,100,22,13,35
Puducherry,Pondicherry,Locomotor Disability,0,6,3,4,7
Puducherry,Pondicherry,Locomotor Disability,6,15,70,46,116
Puducherry,Pondicherry,Locomotor Disability,15,35,519,331,850
Puducherry,Pondicherry,Locomotor Disability,35,60,2310,1698,4008
Puducherry,Pondicherry,Locomotor Disability,60,80,797,565,1362
Puducherry,Pondicherry,Locomotor Disability,80,100,104,103,207
Uttarakhand,Pithoragarh,Locomotor Disability,0,6,10,9,19
Uttarakhand,Pithoragarh,Locomotor Disability,6,15,112,51,163
Uttarakhand,Pithoragarh,Locomotor Disability,15,35,392,170,562
Uttarakhand,Pithoragarh,Locomotor Disability,35,60,780,272,1052
Uttarakhand,Pithoragarh,Locomotor Disability,60,80,198,65,263
Uttarakhand,Pithoragarh,Locomotor Disability,80,100,10,5,15
Uttar Pradesh,Pilibhit,Locomotor Disability,0,6,23,11,34
Uttar Pradesh,Pilibhit,Locomotor Disability,6,15,249,127,376
Uttar Pradesh,Pilibhit,Locomotor Disability,15,35,3028,1339,4367
Uttar Pradesh,Pilibhit,Locomotor Disability,35,60,2832,1083,3915
Uttar Pradesh,Pilibhit,Locomotor Disability,60,80,456,154,610
Uttar Pradesh,Pilibhit,Locomotor Disability,80,100,12,2,14
Manipur,Pherzawl,Locomotor Disability,15,35,1,0,1
Manipur,Pherzawl,Locomotor Disability,60,80,1,0,1
Nagaland,Phek,Locomotor Disability,6,15,1,1,2
Nagaland,Phek,Locomotor Disability,15,35,9,6,15
Nagaland,Phek,Locomotor Disability,35,60,7,4,11
Nagaland,Phek,Locomotor Disability,60,80,2,0,2
Nagaland,Phek,Locomotor Disability,80,100,0,1,1
Nagaland,Peren,Locomotor Disability,15,35,2,0,2
Nagaland,Peren,Locomotor Disability,35,60,3,1,4
Tamil Nadu,Perambalur,Locomotor Disability,0,6,11,9,20
Tamil Nadu,Perambalur,Locomotor Disability,6,15,119,64,183
Tamil Nadu,Perambalur,Locomotor Disability,15,35,525,323,848
Tamil Nadu,Perambalur,Locomotor Disability,35,60,1772,904,2676
Tamil Nadu,Perambalur,Locomotor Disability,60,80,797,348,1145
Tamil Nadu,Perambalur,Locomotor Disability,80,100,53,13,66
Telangana,Peddapalli,Locomotor Disability,0,6,6,1,7
Telangana,Peddapalli,Locomotor Disability,6,15,76,42,118
Telangana,Peddapalli,Locomotor Disability,15,35,725,494,1219
Telangana,Peddapalli,Locomotor Disability,35,60,1980,940,2920
Telangana,Peddapalli,Locomotor Disability,60,80,1077,554,1631
Telangana,Peddapalli,Locomotor Disability,80,100,138,84,222
Uttarakhand,Pauri Garhwal,Locomotor Disability,0,6,15,5,20
Uttarakhand,Pauri Garhwal,Locomotor Disability,6,15,93,42,135
Uttarakhand,Pauri Garhwal,Locomotor Disability,15,35,643,266,909
Uttarakhand,Pauri Garhwal,Locomotor Disability,35,60,1516,506,2022
Uttarakhand,Pauri Garhwal,Locomotor Disability,60,80,341,120,461
Uttarakhand,Pauri Garhwal,Locomotor Disability,80,100,29,16,45
Bihar,Patna,Locomotor Disability,0,6,52,39,91
Bihar,Patna,Locomotor Disability,6,15,448,286,734
Bihar,Patna,Locomotor Disability,15,35,2944,1070,4014
Bihar,Patna,Locomotor Disability,35,60,2400,756,3156
Bihar,Patna,Locomotor Disability,60,80,484,99,583
Bihar,Patna,Locomotor Disability,80,100,17,3,20
Punjab,Patiala,Locomotor Disability,0,6,31,29,60
Punjab,Patiala,Locomotor Disability,6,15,268,182,450
Punjab,Patiala,Locomotor Disability,15,35,1932,972,2904
Punjab,Patiala,Locomotor Disability,35,60,4879,2187,7066
Punjab,Patiala,Locomotor Disability,60,80,1247,315,1562
Punjab,Patiala,Locomotor Disability,80,100,84,19,103
Punjab,Pathankot,Locomotor Disability,0,6,24,27,51
Punjab,Pathankot,Locomotor Disability,6,15,189,79,268
Punjab,Pathankot,Locomotor Disability,15,35,846,389,1235
Punjab,Pathankot,Locomotor Disability,35,60,1624,656,2280
Punjab,Pathankot,Locomotor Disability,60,80,474,111,585
Punjab,Pathankot,Locomotor Disability,80,100,17,11,28
Kerala,Pathanamthitta,Locomotor Disability,0,6,5,6,11
Kerala,Pathanamthitta,Locomotor Disability,6,15,44,29,73
Kerala,Pathanamthitta,Locomotor Disability,15,35,236,153,389
Kerala,Pathanamthitta,Locomotor Disability,35,60,1036,561,1597
Kerala,Pathanamthitta,Locomotor Disability,60,80,734,294,1028
Kerala,Pathanamthitta,Locomotor Disability,80,100,48,20,68
Gujarat,Patan,Locomotor Disability,0,6,18,11,29
Gujarat,Patan,Locomotor Disability,6,15,230,159,389
Gujarat,Patan,Locomotor Disability,15,35,772,363,1135
Gujarat,Patan,Locomotor Disability,35,60,1644,643,2287
Gujarat,Patan,Locomotor Disability,60,80,370,62,432
Gujarat,Patan,Locomotor Disability,80,100,9,2,11
Bihar,Pashchim Champaran,Locomotor Disability,0,6,77,45,122
Bihar,Pashchim Champaran,Locomotor Disability,6,15,696,356,1052
Bihar,Pashchim Champaran,Locomotor Disability,15,35,3077,1122,4199
Bihar,Pashchim Champaran,Locomotor Disability,35,60,2850,1158,4008
Bihar,Pashchim Champaran,Locomotor Disability,60,80,693,225,918
Bihar,Pashchim Champaran,Locomotor Disability,80,100,22,2,24
Maharashtra,Parbhani,Locomotor Disability,0,6,97,56,153
Maharashtra,Parbhani,Locomotor Disability,6,15,906,535,1441
Maharashtra,Parbhani,Locomotor Disability,15,35,3554,1639,5193
Maharashtra,Parbhani,Locomotor Disability,35,60,6040,1622,7662
Maharashtra,Parbhani,Locomotor Disability,60,80,2447,723,3170
Maharashtra,Parbhani,Locomotor Disability,80,100,188,57,245
Arunachal Pradesh,Papum Pare,Locomotor Disability,0,6,2,1,3
Arunachal Pradesh,Papum Pare,Locomotor Disability,6,15,11,11,22
Arunachal Pradesh,Papum Pare,Locomotor Disability,15,35,142,79,221
Arunachal Pradesh,Papum Pare,Locomotor Disability,35,60,68,37,105
Arunachal Pradesh,Papum Pare,Locomotor Disability,60,80,9,5,14
Madhya Pradesh,Panna,Locomotor Disability,0,6,16,18,34
Madhya Pradesh,Panna,Locomotor Disability,6,15,204,137,341
Madhya Pradesh,Panna,Locomotor Disability,15,35,1651,790,2441
Madhya Pradesh,Panna,Locomotor Disability,35,60,2025,784,2809
Madhya Pradesh,Panna,Locomotor Disability,60,80,413,155,568
Madhya Pradesh,Panna,Locomotor Disability,80,100,21,11,32
Haryana,Panipat,Locomotor Disability,0,6,17,15,32
Haryana,Panipat,Locomotor Disability,6,15,130,71,201
Haryana,Panipat,Locomotor Disability,15,35,811,346,1157
Haryana,Panipat,Locomotor Disability,35,60,1349,490,1839
Haryana,Panipat,Locomotor Disability,60,80,184,59,243
Haryana,Panipat,Locomotor Disability,80,100,6,1,7
Haryana,Panchkula,Locomotor Disability,0,6,2,5,7
Haryana,Panchkula,Locomotor Disability,6,15,63,49,112
Haryana,Panchkula,Locomotor Disability,15,35,442,205,647
Haryana,Panchkula,Locomotor Disability,35,60,1000,433,1433
Haryana,Panchkula,Locomotor Disability,60,80,193,49,242
Haryana,Panchkula,Locomotor Disability,80,100,8,3,11
Gujarat,Panch Mahals,Locomotor Disability,0,6,73,45,118
Gujarat,Panch Mahals,Locomotor Disability,6,15,399,274,673
Gujarat,Panch Mahals,Locomotor Disability,15,35,961,544,1505
Gujarat,Panch Mahals,Locomotor Disability,35,60,1479,527,2006
Gujarat,Panch Mahals,Locomotor Disability,60,80,387,80,467
Gujarat,Panch Mahals,Locomotor Disability,80,100,16,2,18
Haryana,Palwal,Locomotor Disability,0,6,13,10,23
Haryana,Palwal,Locomotor Disability,6,15,143,70,213
Haryana,Palwal,Locomotor Disability,15,35,906,453,1359
Haryana,Palwal,Locomotor Disability,35,60,1327,499,1826
Haryana,Palwal,Locomotor Disability,60,80,141,55,196
Haryana,Palwal,Locomotor Disability,80,100,6,1,7
Rajasthan,Pali,Locomotor Disability,0,6,58,36,94
Rajasthan,Pali,Locomotor Disability,6,15,561,343,904
Rajasthan,Pali,Locomotor Disability,15,35,2530,1477,4007
Rajasthan,Pali,Locomotor Disability,35,60,4627,2315,6942
Rajasthan,Pali,Locomotor Disability,60,80,1595,683,2278
Rajasthan,Pali,Locomotor Disability,80,100,126,65,191
Maharashtra,Palghar,Locomotor Disability,0,6,31,14,45
Maharashtra,Palghar,Locomotor Disability,6,15,441,346,787
Maharashtra,Palghar,Locomotor Disability,15,35,1551,811,2362
Maharashtra,Palghar,Locomotor Disability,35,60,3274,1056,4330
Maharashtra,Palghar,Locomotor Disability,60,80,909,190,1099
Maharashtra,Palghar,Locomotor Disability,80,100,28,6,34
Jharkhand,Palamu,Locomotor Disability,0,6,34,22,56
Jharkhand,Palamu,Locomotor Disability,6,15,313,167,480
Jharkhand,Palamu,Locomotor Disability,15,35,1253,614,1867
Jharkhand,Palamu,Locomotor Disability,35,60,1271,516,1787
Jharkhand,Palamu,Locomotor Disability,60,80,230,75,305
Jharkhand,Palamu,Locomotor Disability,80,100,9,4,13
Kerala,Palakkad,Locomotor Disability,0,6,33,21,54
Kerala,Palakkad,Locomotor Disability,6,15,161,119,280
Kerala,Palakkad,Locomotor Disability,15,35,730,450,1180
Kerala,Palakkad,Locomotor Disability,35,60,2705,1353,4058
Kerala,Palakkad,Locomotor Disability,60,80,1167,488,1655
Kerala,Palakkad,Locomotor Disability,80,100,72,38,110
Jharkhand,Pakur,Locomotor Disability,0,6,6,5,11
Jharkhand,Pakur,Locomotor Disability,6,15,364,256,620
Jharkhand,Pakur,Locomotor Disability,15,35,798,557,1355
Jharkhand,Pakur,Locomotor Disability,35,60,884,483,1367
Jharkhand,Pakur,Locomotor Disability,60,80,195,79,274
Jharkhand,Pakur,Locomotor Disability,80,100,6,2,8
Arunachal Pradesh,Pakke Kessang,Locomotor Disability,15,35,2,1,3
Arunachal Pradesh,Pakke Kessang,Locomotor Disability,35,60,1,0,1
Maharashtra,Osmanabad,Locomotor Disability,0,6,25,20,45
Maharashtra,Osmanabad,Locomotor Disability,6,15,419,236,655
Maharashtra,Osmanabad,Locomotor Disability,15,35,2000,882,2882
Maharashtra,Osmanabad,Locomotor Disability,35,60,4121,1191,5312
Maharashtra,Osmanabad,Locomotor Disability,60,80,1400,328,1728
Maharashtra,Osmanabad,Locomotor Disability,80,100,129,32,161
Haryana,Nuh,Locomotor Disability,0,6,21,19,40
Haryana,Nuh,Locomotor Disability,6,15,312,198,510
Haryana,Nuh,Locomotor Disability,15,35,1522,699,2221
Haryana,Nuh,Locomotor Disability,35,60,1333,631,1964
Haryana,Nuh,Locomotor Disability,60,80,258,119,377
Haryana,Nuh,Locomotor Disability,80,100,5,6,11
Odisha,Nuapada,Locomotor Disability,0,6,127,80,207
Odisha,Nuapada,Locomotor Disability,6,15,552,323,875
Odisha,Nuapada,Locomotor Disability,15,35,1001,536,1537
Odisha,Nuapada,Locomotor Disability,35,60,2063,828,2891
Odisha,Nuapada,Locomotor Disability,60,80,625,251,876
Odisha,Nuapada,Locomotor Disability,80,100,35,17,52
Delhi,North West,Locomotor Disability,0,6,29,25,54
Delhi,North West,Locomotor Disability,6,15,305,225,530
Delhi,North West,Locomotor Disability,15,35,1450,731,2181
Delhi,North West,Locomotor Disability,35,60,2175,600,2775
Delhi,North West,Locomotor Disability,60,80,423,70,493
Delhi,North West,Locomotor Disability,80,100,15,2,17
Tripura,North Tripura,Locomotor Disability,0,6,24,18,42
Tripura,North Tripura,Locomotor Disability,6,15,123,58,181
Tripura,North Tripura,Locomotor Disability,15,35,286,193,479
Tripura,North Tripura,Locomotor Disability,35,60,472,237,709
Tripura,North Tripura,Locomotor Disability,60,80,94,41,135
Tripura,North Tripura,Locomotor Disability,80,100,6,3,9
Goa,North Goa,Locomotor Disability,0,6,6,3,9
Goa,North Goa,Locomotor Disability,6,15,33,14,47
Goa,North Goa,Locomotor Disability,15,35,165,123,288
Goa,North Goa,Locomotor Disability,35,60,608,211,819
Goa,North Goa,Locomotor Disability,60,80,199,59,258
Goa,North Goa,Locomotor Disability,80,100,1,5,6
Meghalaya,North Garo Hills,Locomotor Disability,0,6,3,1,4
Meghalaya,North Garo Hills,Locomotor Disability,6,15,27,19,46
Meghalaya,North Garo Hills,Locomotor Disability,15,35,158,109,267
Meghalaya,North Garo Hills,Locomotor Disability,35,60,160,105,265
Meghalaya,North Garo Hills,Locomotor Disability,60,80,41,19,60
Meghalaya,North Garo Hills,Locomotor Disability,80,100,3,0,3
Delhi,North East,Locomotor Disability,0,6,33,30,63
Delhi,North East,Locomotor Disability,6,15,282,205,487
Delhi,North East,Locomotor Disability,15,35,1369,772,2141
Delhi,North East,Locomotor Disability,35,60,1688,591,2279
Delhi,North East,Locomotor Disability,60,80,294,59,353
Delhi,North East,Locomotor Disability,80,100,10,0,10
Andaman And Nicobar Islands,North And Middle Andaman,Locomotor Disability,0,6,8,2,10
Andaman And Nicobar Islands,North And Middle Andaman,Locomotor Disability,6,15,24,11,35
Andaman And Nicobar Islands,North And Middle Andaman,Locomotor Disability,15,35,93,67,160
Andaman And Nicobar Islands,North And Middle Andaman,Locomotor Disability,35,60,258,122,380
Andaman And Nicobar Islands,North And Middle Andaman,Locomotor Disability,60,80,56,13,69
Andaman And Nicobar Islands,North And Middle Andaman,Locomotor Disability,80,100,6,0,6
Delhi,North,Locomotor Disability,0,6,3,3,6
Delhi,North,Locomotor Disability,6,15,52,34,86
Delhi,North,Locomotor Disability,15,35,287,139,426
Delhi,North,Locomotor Disability,35,60,436,117,553
Delhi,North,Locomotor Disability,60,80,105,19,124
Delhi,North,Locomotor Disability,80,100,3,0,3
Manipur,Noney,Locomotor Disability,6,15,4,4,8
Manipur,Noney,Locomotor Disability,15,35,12,9,21
Manipur,Noney,Locomotor Disability,35,60,16,6,22
Manipur,Noney,Locomotor Disability,60,80,4,4,8
Manipur,Noney,Locomotor Disability,80,100,4,0,4
Telangana,Nizamabad,Locomotor Disability,0,6,2,0,2
Telangana,Nizamabad,Locomotor Disability,6,15,221,156,377
Telangana,Nizamabad,Locomotor Disability,15,35,1926,1264,3190
Telangana,Nizamabad,Locomotor Disability,35,60,4470,2604,7074
Telangana,Nizamabad,Locomotor Disability,60,80,2360,1242,3602
Telangana,Nizamabad,Locomotor Disability,80,100,251,169,420
Madhya Pradesh,Niwari,Locomotor Disability,0,6,6,2,8
Madhya Pradesh,Niwari,Locomotor Disability,6,15,100,44,144
Madhya Pradesh,Niwari,Locomotor Disability,15,35,720,264,984
Madhya Pradesh,Niwari,Locomotor Disability,35,60,1268,367,1635
Madhya Pradesh,Niwari,Locomotor Disability,60,80,345,97,442
Madhya Pradesh,Niwari,Locomotor Disability,80,100,22,3,25
Telangana,Nirmal,Locomotor Disability,6,15,187,110,297
Telangana,Nirmal,Locomotor Disability,15,35,625,312,937
Telangana,Nirmal,Locomotor Disability,35,60,1410,634,2044
Telangana,Nirmal,Locomotor Disability,60,80,756,393,1149
Telangana,Nirmal,Locomotor Disability,80,100,44,52,96
Andaman And Nicobar Islands,Nicobars,Locomotor Disability,0,6,0,1,1
Andaman And Nicobar Islands,Nicobars,Locomotor Disability,6,15,5,1,6
Andaman And Nicobar Islands,Nicobars,Locomotor Disability,15,35,22,9,31
Andaman And Nicobar Islands,Nicobars,Locomotor Disability,35,60,45,19,64
Andaman And Nicobar Islands,Nicobars,Locomotor Disability,60,80,13,3,16
Andaman And Nicobar Islands,Nicobars,Locomotor Disability,80,100,2,3,5
Delhi,New Delhi,Locomotor Disability,0,6,1,1,2
Delhi,New Delhi,Locomotor Disability,6,15,4,3,7
Delhi,New Delhi,Locomotor Disability,15,35,32,12,44
Delhi,New Delhi,Locomotor Disability,35,60,71,14,85
Delhi,New Delhi,Locomotor Disability,60,80,10,2,12
Madhya Pradesh,Neemuch,Locomotor Disability,0,6,2,1,3
Madhya Pradesh,Neemuch,Locomotor Disability,6,15,78,51,129
Madhya Pradesh,Neemuch,Locomotor Disability,15,35,887,492,1379
Madhya Pradesh,Neemuch,Locomotor Disability,35,60,1827,853,2680
Madhya Pradesh,Neemuch,Locomotor Disability,60,80,466,125,591
Madhya Pradesh,Neemuch,Locomotor Disability,80,100,18,8,26
Odisha,Nayagarh,Locomotor Disability,0,6,75,35,110
Odisha,Nayagarh,Locomotor Disability,6,15,467,246,713
Odisha,Nayagarh,Locomotor Disability,15,35,1889,781,2670
Odisha,Nayagarh,Locomotor Disability,35,60,4724,2128,6852
Odisha,Nayagarh,Locomotor Disability,60,80,2095,802,2897
Odisha,Nayagarh,Locomotor Disability,80,100,153,45,198
Bihar,Nawada,Locomotor Disability,0,6,16,9,25
Bihar,Nawada,Locomotor Disability,6,15,318,177,495
Bihar,Nawada,Locomotor Disability,15,35,1719,691,2410
Bihar,Nawada,Locomotor Disability,35,60,1275,457,1732
Bihar,Nawada,Locomotor Disability,60,80,405,121,526
Bihar,Nawada,Locomotor Disability,80,100,16,8,24
Gujarat,Navsari,Locomotor Disability,0,6,16,14,30
Gujarat,Navsari,Locomotor Disability,6,15,136,84,220
Gujarat,Navsari,Locomotor Disability,15,35,411,193,604
Gujarat,Navsari,Locomotor Disability,35,60,871,306,1177
Gujarat,Navsari,Locomotor Disability,60,80,307,68,375
Gujarat,Navsari,Locomotor Disability,80,100,9,0,9
Maharashtra,Nashik,Locomotor Disability,0,6,187,56,243
Maharashtra,Nashik,Locomotor Disability,6,15,568,363,931
Maharashtra,Nashik,Locomotor Disability,15,35,2993,1443,4436
Maharashtra,Nashik,Locomotor Disability,35,60,7441,2743,10184
Maharashtra,Nashik,Locomotor Disability,60,80,1860,479,2339
Maharashtra,Nashik,Locomotor Disability,80,100,63,16,79
Madhya Pradesh,Narsinghpur,Locomotor Disability,0,6,21,18,39
Madhya Pradesh,Narsinghpur,Locomotor Disability,6,15,268,166,434
Madhya Pradesh,Narsinghpur,Locomotor Disability,15,35,1916,837,2753
Madhya Pradesh,Narsinghpur,Locomotor Disability,35,60,3554,1138,4692
Madhya Pradesh,Narsinghpur,Locomotor Disability,60,80,956,257,1213
Madhya Pradesh,Narsinghpur,Locomotor Disability,80,100,41,8,49
Madhya Pradesh,Narmadapuram,Locomotor Disability,0,6,0,2,2
Madhya Pradesh,Narmadapuram,Locomotor Disability,6,15,142,74,216
Madhya Pradesh,Narmadapuram,Locomotor Disability,15,35,1385,709,2094
Madhya Pradesh,Narmadapuram,Locomotor Disability,35,60,2248,916,3164
Madhya Pradesh,Narmadapuram,Locomotor Disability,60,80,520,138,658
Madhya Pradesh,Narmadapuram,Locomotor Disability,80,100,30,10,40
Gujarat,Narmada,Locomotor Disability,0,6,7,3,10
Gujarat,Narmada,Locomotor Disability,6,15,66,53,119
Gujarat,Narmada,Locomotor Disability,15,35,237,128,365
Gujarat,Narmada,Locomotor Disability,35,60,525,160,685
Gujarat,Narmada,Locomotor Disability,60,80,152,32,184
Gujarat,Narmada,Locomotor Disability,80,100,12,1,13
Chhattisgarh,Narayanpur,Locomotor Disability,0,6,5,1,6
Chhattisgarh,Narayanpur,Locomotor Disability,6,15,55,34,89
Chhattisgarh,Narayanpur,Locomotor Disability,15,35,163,98,261
Chhattisgarh,Narayanpur,Locomotor Disability,35,60,229,69,298
Chhattisgarh,Narayanpur,Locomotor Disability,60,80,59,22,81
Chhattisgarh,Narayanpur,Locomotor Disability,80,100,2,1,3
Telangana,Narayanpet,Locomotor Disability,15,35,2,1,3
Telangana,Narayanpet,Locomotor Disability,35,60,3,4,7
Telangana,Narayanpet,Locomotor Disability,60,80,3,0,3
Andhra Pradesh,Nandyal,Locomotor Disability,15,35,1,0,1
Maharashtra,Nandurbar,Locomotor Disability,0,6,32,19,51
Maharashtra,Nandurbar,Locomotor Disability,6,15,292,181,473
Maharashtra,Nandurbar,Locomotor Disability,15,35,1493,646,2139
Maharashtra,Nandurbar,Locomotor Disability,35,60,2105,765,2870
Maharashtra,Nandurbar,Locomotor Disability,60,80,586,135,721
Maharashtra,Nandurbar,Locomotor Disability,80,100,29,3,32
Maharashtra,Nanded,Locomotor Disability,0,6,151,72,223
Maharashtra,Nanded,Locomotor Disability,6,15,1128,688,1816
Maharashtra,Nanded,Locomotor Disability,15,35,4653,2249,6902
Maharashtra,Nanded,Locomotor Disability,35,60,7651,2396,10047
Maharashtra,Nanded,Locomotor Disability,60,80,2076,541,2617
Maharashtra,Nanded,Locomotor Disability,80,100,143,41,184
Arunachal Pradesh,Namsai,Locomotor Disability,6,15,8,7,15
Arunachal Pradesh,Namsai,Locomotor Disability,15,35,19,5,24
Arunachal Pradesh,Namsai,Locomotor Disability,35,60,21,6,27
Arunachal Pradesh,Namsai,Locomotor Disability,60,80,6,3,9
Sikkim,Namchi,Locomotor Disability,6,15,12,11,23
Sikkim,Namchi,Locomotor Disability,15,35,65,41,106
Sikkim,Namchi,Locomotor Disability,35,60,104,51,155
Sikkim,Namchi,Locomotor Disability,60,80,37,9,46
Sikkim,Namchi,Locomotor Disability,80,100,3,3,6
Tamil Nadu,Namakkal,Locomotor Disability,0,6,26,18,44
Tamil Nadu,Namakkal,Locomotor Disability,6,15,111,109,220
Tamil Nadu,Namakkal,Locomotor Disability,15,35,785,487,1272
Tamil Nadu,Namakkal,Locomotor Disability,35,60,3145,1736,4881
Tamil Nadu,Namakkal,Locomotor Disability,60,80,1440,548,1988
Tamil Nadu,Namakkal,Locomotor Disability,80,100,97,32,129
Telangana,Nalgonda,Locomotor Disability,0,6,1,0,1
Telangana,Nalgonda,Locomotor Disability,6,15,173,100,273
Telangana,Nalgonda,Locomotor Disability,15,35,2518,1728,4246
Telangana,Nalgonda,Locomotor Disability,35,60,5890,3315,9205
Telangana,Nalgonda,Locomotor Disability,60,80,4173,2901,7074
Telangana,Nalgonda,Locomotor Disability,80,100,852,498,1350
Assam,Nalbari,Locomotor Disability,0,6,58,41,99
Assam,Nalbari,Locomotor Disability,6,15,251,128,379
Assam,Nalbari,Locomotor Disability,15,35,841,408,1249
Assam,Nalbari,Locomotor Disability,35,60,1417,592,2009
Assam,Nalbari,Locomotor Disability,60,80,284,114,398
Assam,Nalbari,Locomotor Disability,80,100,11,5,16
Bihar,Nalanda,Locomotor Disability,0,6,60,49,109
Bihar,Nalanda,Locomotor Disability,6,15,347,214,561
Bihar,Nalanda,Locomotor Disability,15,35,1970,723,2693
Bihar,Nalanda,Locomotor Disability,35,60,1471,467,1938
Bihar,Nalanda,Locomotor Disability,60,80,232,61,293
Bihar,Nalanda,Locomotor Disability,80,100,14,5,19
Uttarakhand,Nainital,Locomotor Disability,0,6,15,9,24
Uttarakhand,Nainital,Locomotor Disability,6,15,109,75,184
Uttarakhand,Nainital,Locomotor Disability,15,35,778,419,1197
Uttarakhand,Nainital,Locomotor Disability,35,60,1411,677,2088
Uttarakhand,Nainital,Locomotor Disability,60,80,313,152,465
Uttarakhand,Nainital,Locomotor Disability,80,100,20,7,27
Maharashtra,Nagpur,Locomotor Disability,0,6,113,80,193
Maharashtra,Nagpur,Locomotor Disability,6,15,902,546,1448
Maharashtra,Nagpur,Locomotor Disability,15,35,3482,1814,5296
Maharashtra,Nagpur,Locomotor Disability,35,60,7311,2776,10087
Maharashtra,Nagpur,Locomotor Disability,60,80,1720,306,2026
Maharashtra,Nagpur,Locomotor Disability,80,100,45,9,54
Rajasthan,Nagaur,Locomotor Disability,0,6,35,24,59
Rajasthan,Nagaur,Locomotor Disability,6,15,560,319,879
Rajasthan,Nagaur,Locomotor Disability,15,35,4015,1960,5975
Rajasthan,Nagaur,Locomotor Disability,35,60,6307,2505,8812
Rajasthan,Nagaur,Locomotor Disability,60,80,1686,538,2224
Rajasthan,Nagaur,Locomotor Disability,80,100,72,59,131
Telangana,Nagarkurnool,Locomotor Disability,0,6,1,0,1
Telangana,Nagarkurnool,Locomotor Disability,6,15,201,134,335
Telangana,Nagarkurnool,Locomotor Disability,15,35,1547,996,2543
Telangana,Nagarkurnool,Locomotor Disability,35,60,3187,1624,4811
Telangana,Nagarkurnool,Locomotor Disability,60,80,1508,765,2273
Telangana,Nagarkurnool,Locomotor Disability,80,100,188,93,281
Tamil Nadu,Nagapattinam,Locomotor Disability,0,6,8,10,18
Tamil Nadu,Nagapattinam,Locomotor Disability,6,15,115,61,176
Tamil Nadu,Nagapattinam,Locomotor Disability,15,35,742,436,1178
Tamil Nadu,Nagapattinam,Locomotor Disability,35,60,2566,1403,3969
Tamil Nadu,Nagapattinam,Locomotor Disability,60,80,990,353,1343
Tamil Nadu,Nagapattinam,Locomotor Disability,80,100,54,21,75
Assam,Nagaon,Locomotor Disability,0,6,136,100,236
Assam,Nagaon,Locomotor Disability,6,15,425,284,709
Assam,Nagaon,Locomotor Disability,15,35,911,626,1537
Assam,Nagaon,Locomotor Disability,35,60,1223,610,1833
Assam,Nagaon,Locomotor Disability,60,80,285,172,457
Assam,Nagaon,Locomotor Disability,80,100,21,11,32
Odisha,Nabarangpur,Locomotor Disability,0,6,61,46,107
Odisha,Nabarangpur,Locomotor Disability,6,15,317,222,539
Odisha,Nabarangpur,Locomotor Disability,15,35,750,436,1186
Odisha,Nabarangpur,Locomotor Disability,35,60,1013,482,1495
Odisha,Nabarangpur,Locomotor Disability,60,80,261,106,367
Odisha,Nabarangpur,Locomotor Disability,80,100,16,4,20
Karnataka,Mysuru,Locomotor Disability,0,6,68,48,116
Karnataka,Mysuru,Locomotor Disability,6,15,465,284,749
Karnataka,Mysuru,Locomotor Disability,15,35,1883,1117,3000
Karnataka,Mysuru,Locomotor Disability,35,60,5754,2398,8152
Karnataka,Mysuru,Locomotor Disability,60,80,1596,454,2050
Karnataka,Mysuru,Locomotor Disability,80,100,80,21,101
Bihar,Muzaffarpur,Locomotor Disability,0,6,90,41,131
Bihar,Muzaffarpur,Locomotor Disability,6,15,395,237,632
Bihar,Muzaffarpur,Locomotor Disability,15,35,1129,397,1526
Bihar,Muzaffarpur,Locomotor Disability,35,60,961,227,1188
Bihar,Muzaffarpur,Locomotor Disability,60,80,228,27,255
Bihar,Muzaffarpur,Locomotor Disability,80,100,13,0,13
Uttar Pradesh,Muzaffarnagar,Locomotor Disability,0,6,29,19,48
Uttar Pradesh,Muzaffarnagar,Locomotor Disability,6,15,312,153,465
Uttar Pradesh,Muzaffarnagar,Locomotor Disability,15,35,4161,1556,5717
Uttar Pradesh,Muzaffarnagar,Locomotor Disability,35,60,4376,1355,5731
Uttar Pradesh,Muzaffarnagar,Locomotor Disability,60,80,860,192,1052
Uttar Pradesh,Muzaffarnagar,Locomotor Disability,80,100,31,7,38
West Bengal,Murshidabad,Locomotor Disability,6,15,0,1,1
West Bengal,Murshidabad,Locomotor Disability,15,35,8,0,8
West Bengal,Murshidabad,Locomotor Disability,35,60,12,0,12
West Bengal,Murshidabad,Locomotor Disability,60,80,1,0,1
Bihar,Munger,Locomotor Disability,0,6,54,33,87
Bihar,Munger,Locomotor Disability,6,15,366,221,587
Bihar,Munger,Locomotor Disability,15,35,1815,642,2457
Bihar,Munger,Locomotor Disability,35,60,1569,521,2090
Bihar,Munger,Locomotor Disability,60,80,332,71,403
Bihar,Munger,Locomotor Disability,80,100,16,2,18
Chhattisgarh,Mungeli,Locomotor Disability,0,6,22,11,33
Chhattisgarh,Mungeli,Locomotor Disability,6,15,218,131,349
Chhattisgarh,Mungeli,Locomotor Disability,15,35,1237,745,1982
Chhattisgarh,Mungeli,Locomotor Disability,35,60,1698,738,2436
Chhattisgarh,Mungeli,Locomotor Disability,60,80,377,110,487
Chhattisgarh,Mungeli,Locomotor Disability,80,100,25,6,31
Maharashtra,Mumbai Suburban,Locomotor Disability,0,6,45,24,69
Maharashtra,Mumbai Suburban,Locomotor Disability,6,15,272,146,418
Maharashtra,Mumbai Suburban,Locomotor Disability,15,35,1388,562,1950
Maharashtra,Mumbai Suburban,Locomotor Disability,35,60,3579,1187,4766
Maharashtra,Mumbai Suburban,Locomotor Disability,60,80,836,132,968
Maharashtra,Mumbai Suburban,Locomotor Disability,80,100,15,4,19
Maharashtra,Mumbai,Locomotor Disability,0,6,69,10,79
Maharashtra,Mumbai,Locomotor Disability,6,15,539,342,881
Maharashtra,Mumbai,Locomotor Disability,15,35,2661,1188,3849
Maharashtra,Mumbai,Locomotor Disability,35,60,6313,1321,7634
Maharashtra,Mumbai,Locomotor Disability,60,80,2415,225,2640
Maharashtra,Mumbai,Locomotor Disability,80,100,117,9,126
Telangana,Mulugu,Locomotor Disability,35,60,1,2,3
Telangana,Mulugu,Locomotor Disability,60,80,0,1,1
Madhya Pradesh,Morena,Locomotor Disability,0,6,20,24,44
Madhya Pradesh,Morena,Locomotor Disability,6,15,310,188,498
Madhya Pradesh,Morena,Locomotor Disability,15,35,3017,1146,4163
Madhya Pradesh,Morena,Locomotor Disability,35,60,3493,1164,4657
Madhya Pradesh,Morena,Locomotor Disability,60,80,601,170,771
Madhya Pradesh,Morena,Locomotor Disability,80,100,36,7,43
Gujarat,Morbi,Locomotor Disability,0,6,13,14,27
Gujarat,Morbi,Locomotor Disability,6,15,143,102,245
Gujarat,Morbi,Locomotor Disability,15,35,601,320,921
Gujarat,Morbi,Locomotor Disability,35,60,1105,548,1653
Gujarat,Morbi,Locomotor Disability,60,80,330,72,402
Gujarat,Morbi,Locomotor Disability,80,100,16,5,21
Uttar Pradesh,Moradabad,Locomotor Disability,0,6,24,15,39
Uttar Pradesh,Moradabad,Locomotor Disability,6,15,171,112,283
Uttar Pradesh,Moradabad,Locomotor Disability,15,35,3300,1222,4522
Uttar Pradesh,Moradabad,Locomotor Disability,35,60,2837,762,3599
Uttar Pradesh,Moradabad,Locomotor Disability,60,80,450,70,520
Uttar Pradesh,Moradabad,Locomotor Disability,80,100,17,1,18
Nagaland,Mon,Locomotor Disability,0,6,1,1,2
Nagaland,Mon,Locomotor Disability,6,15,24,14,38
Nagaland,Mon,Locomotor Disability,15,35,60,35,95
Nagaland,Mon,Locomotor Disability,35,60,61,22,83
Nagaland,Mon,Locomotor Disability,60,80,19,1,20
Nagaland,Mon,Locomotor Disability,80,100,2,0,2
Nagaland,Mokokchung,Locomotor Disability,6,15,4,1,5
Nagaland,Mokokchung,Locomotor Disability,15,35,21,8,29
Nagaland,Mokokchung,Locomotor Disability,35,60,25,11,36
Nagaland,Mokokchung,Locomotor Disability,60,80,13,4,17
Nagaland,Mokokchung,Locomotor Disability,80,100,3,3,6
Punjab,Moga,Locomotor Disability,0,6,17,12,29
Punjab,Moga,Locomotor Disability,6,15,180,96,276
Punjab,Moga,Locomotor Disability,15,35,1009,618,1627
Punjab,Moga,Locomotor Disability,35,60,2352,1192,3544
Punjab,Moga,Locomotor Disability,60,80,628,146,774
Punjab,Moga,Locomotor Disability,80,100,31,6,37
Uttar Pradesh,Mirzapur,Locomotor Disability,0,6,18,15,33
Uttar Pradesh,Mirzapur,Locomotor Disability,6,15,211,110,321
Uttar Pradesh,Mirzapur,Locomotor Disability,15,35,2640,927,3567
Uttar Pradesh,Mirzapur,Locomotor Disability,35,60,2935,903,3838
Uttar Pradesh,Mirzapur,Locomotor Disability,60,80,590,126,716
Uttar Pradesh,Mirzapur,Locomotor Disability,80,100,22,8,30
Uttar Pradesh,Meerut,Locomotor Disability,0,6,10,14,24
Uttar Pradesh,Meerut,Locomotor Disability,6,15,221,103,324
Uttar Pradesh,Meerut,Locomotor Disability,15,35,3300,1340,4640
Uttar Pradesh,Meerut,Locomotor Disability,35,60,4045,1338,5383
Uttar Pradesh,Meerut,Locomotor Disability,60,80,847,183,1030
Uttar Pradesh,Meerut,Locomotor Disability,80,100,34,6,40
Telangana,Medchal Malkajgiri,Locomotor Disability,0,6,3,0,3
Telangana,Medchal Malkajgiri,Locomotor Disability,6,15,246,129,375
Telangana,Medchal Malkajgiri,Locomotor Disability,15,35,1927,1244,3171
Telangana,Medchal Malkajgiri,Locomotor Disability,35,60,5941,2804,8745
Telangana,Medchal Malkajgiri,Locomotor Disability,60,80,2700,896,3596
Telangana,Medchal Malkajgiri,Locomotor Disability,80,100,165,61,226
Telangana,Medak,Locomotor Disability,6,15,151,100,251
Telangana,Medak,Locomotor Disability,15,35,831,569,1400
Telangana,Medak,Locomotor Disability,35,60,1559,845,2404
Telangana,Medak,Locomotor Disability,60,80,613,351,964
Telangana,Medak,Locomotor Disability,80,100,76,43,119
Odisha,Mayurbhanj,Locomotor Disability,0,6,114,66,180
Odisha,Mayurbhanj,Locomotor Disability,6,15,696,478,1174
Odisha,Mayurbhanj,Locomotor Disability,15,35,2968,1871,4839
Odisha,Mayurbhanj,Locomotor Disability,35,60,6047,3379,9426
Odisha,Mayurbhanj,Locomotor Disability,60,80,2643,1335,3978
Odisha,Mayurbhanj,Locomotor Disability,80,100,194,94,288
Tamil Nadu,Mayiladuthurai,Locomotor Disability,0,6,11,2,13
Tamil Nadu,Mayiladuthurai,Locomotor Disability,6,15,39,30,69
Tamil Nadu,Mayiladuthurai,Locomotor Disability,15,35,141,66,207
Tamil Nadu,Mayiladuthurai,Locomotor Disability,35,60,456,184,640
Tamil Nadu,Mayiladuthurai,Locomotor Disability,60,80,184,47,231
Tamil Nadu,Mayiladuthurai,Locomotor Disability,80,100,8,4,12
Uttar Pradesh,Mau,Locomotor Disability,0,6,9,5,14
Uttar Pradesh,Mau,Locomotor Disability,6,15,140,111,251
Uttar Pradesh,Mau,Locomotor Disability,15,35,2183,873,3056
Uttar Pradesh,Mau,Locomotor Disability,35,60,2122,597,2719
Uttar Pradesh,Mau,Locomotor Disability,60,80,595,116,711
Uttar Pradesh,Mau,Locomotor Disability,80,100,23,5,28
Uttar Pradesh,Mathura,Locomotor Disability,0,6,15,11,26
Uttar Pradesh,Mathura,Locomotor Disability,6,15,187,83,270
Uttar Pradesh,Mathura,Locomotor Disability,15,35,3858,1225,5083
Uttar Pradesh,Mathura,Locomotor Disability,35,60,4162,1273,5435
Uttar Pradesh,Mathura,Locomotor Disability,60,80,830,173,1003
Uttar Pradesh,Mathura,Locomotor Disability,80,100,35,5,40
Assam,Marigaon,Locomotor Disability,0,6,30,32,62
Assam,Marigaon,Locomotor Disability,6,15,182,117,299
Assam,Marigaon,Locomotor Disability,15,35,720,430,1150
Assam,Marigaon,Locomotor Disability,35,60,855,341,1196
Assam,Marigaon,Locomotor Disability,60,80,127,54,181
Assam,Marigaon,Locomotor Disability,80,100,1,3,4
Punjab,Mansa,Locomotor Disability,0,6,13,11,24
Punjab,Mansa,Locomotor Disability,6,15,98,72,170
Punjab,Mansa,Locomotor Disability,15,35,1035,469,1504
Punjab,Mansa,Locomotor Disability,35,60,2173,1000,3173
Punjab,Mansa,Locomotor Disability,60,80,603,151,754
Punjab,Mansa,Locomotor Disability,80,100,34,7,41
Sikkim,Mangan,Locomotor Disability,0,6,2,1,3
Sikkim,Mangan,Locomotor Disability,6,15,6,3,9
Sikkim,Mangan,Locomotor Disability,15,35,20,15,35
Sikkim,Mangan,Locomotor Disability,35,60,26,10,36
Sikkim,Mangan,Locomotor Disability,60,80,6,4,10
Sikkim,Mangan,Locomotor Disability,80,100,3,0,3
Karnataka,Mandya,Locomotor Disability,0,6,34,12,46
Karnataka,Mandya,Locomotor Disability,6,15,248,163,411
Karnataka,Mandya,Locomotor Disability,15,35,1242,678,1920
Karnataka,Mandya,Locomotor Disability,35,60,4687,1996,6683
Karnataka,Mandya,Locomotor Disability,60,80,1610,389,1999
Karnataka,Mandya,Locomotor Disability,80,100,74,9,83
Madhya Pradesh,Mandsaur,Locomotor Disability,0,6,15,8,23
Madhya Pradesh,Mandsaur,Locomotor Disability,6,15,182,92,274
Madhya Pradesh,Mandsaur,Locomotor Disability,15,35,1814,958,2772
Madhya Pradesh,Mandsaur,Locomotor Disability,35,60,4107,2039,6146
Madhya Pradesh,Mandsaur,Locomotor Disability,60,80,1117,410,1527
Madhya Pradesh,Mandsaur,Locomotor Disability,80,100,105,50,155
Madhya Pradesh,Mandla,Locomotor Disability,0,6,7,4,11
Madhya Pradesh,Mandla,Locomotor Disability,6,15,180,159,339
Madhya Pradesh,Mandla,Locomotor Disability,15,35,1394,904,2298
Madhya Pradesh,Mandla,Locomotor Disability,35,60,2343,1167,3510
Madhya Pradesh,Mandla,Locomotor Disability,60,80,662,305,967
Madhya Pradesh,Mandla,Locomotor Disability,80,100,22,9,31
Himachal Pradesh,Mandi,Locomotor Disability,0,6,20,10,30
Himachal Pradesh,Mandi,Locomotor Disability,6,15,157,97,254
Himachal Pradesh,Mandi,Locomotor Disability,15,35,1140,579,1719
Himachal Pradesh,Mandi,Locomotor Disability,35,60,2723,1285,4008
Himachal Pradesh,Mandi,Locomotor Disability,60,80,1035,381,1416
Himachal Pradesh,Mandi,Locomotor Disability,80,100,72,18,90
Telangana,Mancherial,Locomotor Disability,0,6,1,1,2
Telangana,Mancherial,Locomotor Disability,6,15,21,10,31
Telangana,Mancherial,Locomotor Disability,15,35,514,335,849
Telangana,Mancherial,Locomotor Disability,35,60,1105,550,1655
Telangana,Mancherial,Locomotor Disability,60,80,562,227,789
Telangana,Mancherial,Locomotor Disability,80,100,74,35,109
Mizoram,Mamit,Locomotor Disability,0,6,0,1,1
Mizoram,Mamit,Locomotor Disability,6,15,1,2,3
Mizoram,Mamit,Locomotor Disability,15,35,7,7,14
Mizoram,Mamit,Locomotor Disability,35,60,20,2,22
Mizoram,Mamit,Locomotor Disability,60,80,5,2,7
Mizoram,Mamit,Locomotor Disability,80,100,1,0,1
Odisha,Malkangiri,Locomotor Disability,0,6,106,72,178
Odisha,Malkangiri,Locomotor Disability,6,15,681,446,1127
Odisha,Malkangiri,Locomotor Disability,15,35,1601,926,2527
Odisha,Malkangiri,Locomotor Disability,35,60,2487,1377,3864
Odisha,Malkangiri,Locomotor Disability,60,80,668,367,1035
Odisha,Malkangiri,Locomotor Disability,80,100,35,27,62
Punjab,Malerkotla,Locomotor Disability,0,6,7,2,9
Punjab,Malerkotla,Locomotor Disability,6,15,16,13,29
Punjab,Malerkotla,Locomotor Disability,15,35,143,83,226
Punjab,Malerkotla,Locomotor Disability,35,60,375,175,550
Punjab,Malerkotla,Locomotor Disability,60,80,78,13,91
Punjab,Malerkotla,Locomotor Disability,80,100,2,1,3
Kerala,Malappuram,Locomotor Disability,0,6,46,27,73
Kerala,Malappuram,Locomotor Disability,6,15,299,172,471
Kerala,Malappuram,Locomotor Disability,15,35,1091,659,1750
Kerala,Malappuram,Locomotor Disability,35,60,3638,1840,5478
Kerala,Malappuram,Locomotor Disability,60,80,1535,565,2100
Kerala,Malappuram,Locomotor Disability,80,100,76,46,122
Assam,Majuli,Locomotor Disability,0,6,12,3,15
Assam,Majuli,Locomotor Disability,6,15,23,11,34
Assam,Majuli,Locomotor Disability,15,35,116,36,152
Assam,Majuli,Locomotor Disability,35,60,154,63,217
Assam,Majuli,Locomotor Disability,60,80,35,10,45
Assam,Majuli,Locomotor Disability,80,100,0,1,1
Uttar Pradesh,Mainpuri,Locomotor Disability,0,6,12,15,27
Uttar Pradesh,Mainpuri,Locomotor Disability,6,15,317,228,545
Uttar Pradesh,Mainpuri,Locomotor Disability,15,35,3382,1460,4842
Uttar Pradesh,Mainpuri,Locomotor Disability,35,60,3458,1240,4698
Uttar Pradesh,Mainpuri,Locomotor Disability,60,80,820,178,998
Uttar Pradesh,Mainpuri,Locomotor Disability,80,100,43,7,50
Uttar Pradesh,Mahoba,Locomotor Disability,0,6,4,2,6
Uttar Pradesh,Mahoba,Locomotor Disability,6,15,82,57,139
Uttar Pradesh,Mahoba,Locomotor Disability,15,35,690,276,966
Uttar Pradesh,Mahoba,Locomotor Disability,35,60,996,360,1356
Uttar Pradesh,Mahoba,Locomotor Disability,60,80,193,57,250
Uttar Pradesh,Mahoba,Locomotor Disability,80,100,11,2,13
Gujarat,Mahisagar,Locomotor Disability,0,6,26,16,42
Gujarat,Mahisagar,Locomotor Disability,6,15,213,146,359
Gujarat,Mahisagar,Locomotor Disability,15,35,796,362,1158
Gujarat,Mahisagar,Locomotor Disability,35,60,1203,350,1553
Gujarat,Mahisagar,Locomotor Disability,60,80,207,28,235
Gujarat,Mahisagar,Locomotor Disability,80,100,8,1,9
Gujarat,Mahesana,Locomotor Disability,0,6,19,15,34
Gujarat,Mahesana,Locomotor Disability,6,15,322,207,529
Gujarat,Mahesana,Locomotor Disability,15,35,1160,547,1707
Gujarat,Mahesana,Locomotor Disability,35,60,2636,1190,3826
Gujarat,Mahesana,Locomotor Disability,60,80,644,160,804
Gujarat,Mahesana,Locomotor Disability,80,100,20,2,22
Haryana,Mahendragarh,Locomotor Disability,0,6,13,7,20
Haryana,Mahendragarh,Locomotor Disability,6,15,117,63,180
Haryana,Mahendragarh,Locomotor Disability,15,35,1300,457,1757
Haryana,Mahendragarh,Locomotor Disability,35,60,2682,885,3567
Haryana,Mahendragarh,Locomotor Disability,60,80,487,200,687
Haryana,Mahendragarh,Locomotor Disability,80,100,17,11,28
Puducherry,Mahe,Locomotor Disability,0,6,2,0,2
Puducherry,Mahe,Locomotor Disability,6,15,4,3,7
Puducherry,Mahe,Locomotor Disability,15,35,17,9,26
Puducherry,Mahe,Locomotor Disability,35,60,41,24,65
Puducherry,Mahe,Locomotor Disability,60,80,26,14,40
Puducherry,Mahe,Locomotor Disability,80,100,2,0,2
Chhattisgarh,Mahasamund,Locomotor Disability,0,6,13,12,25
Chhattisgarh,Mahasamund,Locomotor Disability,6,15,252,168,420
Chhattisgarh,Mahasamund,Locomotor Disability,15,35,1355,786,2141
Chhattisgarh,Mahasamund,Locomotor Disability,35,60,2137,893,3030
Chhattisgarh,Mahasamund,Locomotor Disability,60,80,590,232,822
Chhattisgarh,Mahasamund,Locomotor Disability,80,100,28,11,39
Uttar Pradesh,Maharajganj,Locomotor Disability,0,6,16,10,26
Uttar Pradesh,Maharajganj,Locomotor Disability,6,15,190,129,319
Uttar Pradesh,Maharajganj,Locomotor Disability,15,35,2438,965,3403
Uttar Pradesh,Maharajganj,Locomotor Disability,35,60,2726,829,3555
Uttar Pradesh,Maharajganj,Locomotor Disability,60,80,649,171,820
Uttar Pradesh,Maharajganj,Locomotor Disability,80,100,23,6,29
Telangana,Mahabubnagar,Locomotor Disability,0,6,1,2,3
Telangana,Mahabubnagar,Locomotor Disability,6,15,313,196,509
Telangana,Mahabubnagar,Locomotor Disability,15,35,2528,1660,4188
Telangana,Mahabubnagar,Locomotor Disability,35,60,5189,2667,7856
Telangana,Mahabubnagar,Locomotor Disability,60,80,2167,1108,3275
Telangana,Mahabubnagar,Locomotor Disability,80,100,187,102,289
Telangana,Mahabubabad,Locomotor Disability,0,6,4,0,4
Telangana,Mahabubabad,Locomotor Disability,6,15,148,90,238
Telangana,Mahabubabad,Locomotor Disability,15,35,1600,1163,2763
Telangana,Mahabubabad,Locomotor Disability,35,60,3243,1811,5054
Telangana,Mahabubabad,Locomotor Disability,60,80,1645,960,2605
Telangana,Mahabubabad,Locomotor Disability,80,100,248,122,370
Tamil Nadu,Madurai,Locomotor Disability,0,6,29,11,40
Tamil Nadu,Madurai,Locomotor Disability,6,15,209,122,331
Tamil Nadu,Madurai,Locomotor Disability,15,35,1224,669,1893
Tamil Nadu,Madurai,Locomotor Disability,35,60,4272,2432,6704
Tamil Nadu,Madurai,Locomotor Disability,60,80,1288,437,1725
Tamil Nadu,Madurai,Locomotor Disability,80,100,61,18,79
Bihar,Madhubani,Locomotor Disability,0,6,11,4,15
Bihar,Madhubani,Locomotor Disability,6,15,73,39,112
Bihar,Madhubani,Locomotor Disability,15,35,537,151,688
Bihar,Madhubani,Locomotor Disability,35,60,340,69,409
Bihar,Madhubani,Locomotor Disability,60,80,68,13,81
Bihar,Madhepura,Locomotor Disability,0,6,7,5,12
Bihar,Madhepura,Locomotor Disability,6,15,195,111,306
Bihar,Madhepura,Locomotor Disability,15,35,1144,465,1609
Bihar,Madhepura,Locomotor Disability,35,60,937,301,1238
Bihar,Madhepura,Locomotor Disability,60,80,293,94,387
Bihar,Madhepura,Locomotor Disability,80,100,15,2,17
Mizoram,Lunglei,Locomotor Disability,0,6,1,0,1
Mizoram,Lunglei,Locomotor Disability,6,15,6,4,10
Mizoram,Lunglei,Locomotor Disability,15,35,24,17,41
Mizoram,Lunglei,Locomotor Disability,35,60,39,9,48
Mizoram,Lunglei,Locomotor Disability,60,80,9,5,14
Mizoram,Lunglei,Locomotor Disability,80,100,2,1,3
Punjab,Ludhiana,Locomotor Disability,0,6,75,49,124
Punjab,Ludhiana,Locomotor Disability,6,15,457,274,731
Punjab,Ludhiana,Locomotor Disability,15,35,2733,1472,4205
Punjab,Ludhiana,Locomotor Disability,35,60,6803,3420,10223
Punjab,Ludhiana,Locomotor Disability,60,80,2248,628,2876
Punjab,Ludhiana,Locomotor Disability,80,100,96,34,130
Uttar Pradesh,Lucknow,Locomotor Disability,0,6,13,9,22
Uttar Pradesh,Lucknow,Locomotor Disability,6,15,118,76,194
Uttar Pradesh,Lucknow,Locomotor Disability,15,35,1693,858,2551
Uttar Pradesh,Lucknow,Locomotor Disability,35,60,2443,820,3263
Uttar Pradesh,Lucknow,Locomotor Disability,60,80,502,95,597
Uttar Pradesh,Lucknow,Locomotor Disability,80,100,11,5,16
Arunachal Pradesh,Lower Subansiri,Locomotor Disability,15,35,5,3,8
Arunachal Pradesh,Lower Subansiri,Locomotor Disability,35,60,1,1,2
Arunachal Pradesh,Lower Subansiri,Locomotor Disability,60,80,1,0,1
Arunachal Pradesh,Lower Siang,Locomotor Disability,15,35,1,1,2
Arunachal Pradesh,Lower Siang,Locomotor Disability,35,60,2,1,3
Arunachal Pradesh,Lower Siang,Locomotor Disability,60,80,0,1,1
Arunachal Pradesh,Lower Dibang Valley,Locomotor Disability,0,6,1,0,1
Arunachal Pradesh,Lower Dibang Valley,Locomotor Disability,6,15,6,1,7
Arunachal Pradesh,Lower Dibang Valley,Locomotor Disability,15,35,26,23,49
Arunachal Pradesh,Lower Dibang Valley,Locomotor Disability,35,60,24,11,35
Arunachal Pradesh,Lower Dibang Valley,Locomotor Disability,60,80,18,11,29
Arunachal Pradesh,Lower Dibang Valley,Locomotor Disability,80,100,1,0,1
Nagaland,Longleng,Locomotor Disability,15,35,0,1,1
Arunachal Pradesh,Longding,Locomotor Disability,0,6,0,1,1
Arunachal Pradesh,Longding,Locomotor Disability,6,15,2,1,3
Arunachal Pradesh,Longding,Locomotor Disability,15,35,13,5,18
Arunachal Pradesh,Longding,Locomotor Disability,35,60,3,1,4
Arunachal Pradesh,Longding,Locomotor Disability,60,80,2,0,2
Arunachal Pradesh,Lohit,Locomotor Disability,15,35,7,3,10
Arunachal Pradesh,Lohit,Locomotor Disability,35,60,1,2,3
Arunachal Pradesh,Lohit,Locomotor Disability,60,80,0,1,1
Jharkhand,Lohardaga,Locomotor Disability,0,6,6,5,11
Jharkhand,Lohardaga,Locomotor Disability,6,15,164,123,287
Jharkhand,Lohardaga,Locomotor Disability,15,35,749,462,1211
Jharkhand,Lohardaga,Locomotor Disability,35,60,1045,499,1544
Jharkhand,Lohardaga,Locomotor Disability,60,80,310,114,424
Jharkhand,Lohardaga,Locomotor Disability,80,100,18,8,26
Arunachal Pradesh,Leparada,Locomotor Disability,15,35,2,0,2
Ladakh,Leh Ladakh,Locomotor Disability,0,6,4,3,7
Ladakh,Leh Ladakh,Locomotor Disability,6,15,16,15,31
Ladakh,Leh Ladakh,Locomotor Disability,15,35,64,53,117
Ladakh,Leh Ladakh,Locomotor Disability,35,60,146,101,247
Ladakh,Leh Ladakh,Locomotor Disability,60,80,61,25,86
Ladakh,Leh Ladakh,Locomotor Disability,80,100,7,6,13
Mizoram,Lawngtlai,Locomotor Disability,6,15,4,0,4
Mizoram,Lawngtlai,Locomotor Disability,15,35,2,1,3
Mizoram,Lawngtlai,Locomotor Disability,35,60,0,1,1
Mizoram,Lawngtlai,Locomotor Disability,60,80,1,0,1
Maharashtra,Latur,Locomotor Disability,0,6,62,43,105
Maharashtra,Latur,Locomotor Disability,6,15,636,328,964
Maharashtra,Latur,Locomotor Disability,15,35,3097,1464,4561
Maharashtra,Latur,Locomotor Disability,35,60,4520,1754,6274
Maharashtra,Latur,Locomotor Disability,60,80,1514,464,1978
Maharashtra,Latur,Locomotor Disability,80,100,160,42,202
Jharkhand,Latehar,Locomotor Disability,0,6,13,6,19
Jharkhand,Latehar,Locomotor Disability,6,15,103,80,183
Jharkhand,Latehar,Locomotor Disability,15,35,478,285,763
Jharkhand,Latehar,Locomotor Disability,35,60,453,179,632
Jharkhand,Latehar,Locomotor Disability,60,80,65,35,100
Jharkhand,Latehar,Locomotor Disability,80,100,6,4,10
Uttar Pradesh,Lalitpur,Locomotor Disability,0,6,16,4,20
Uttar Pradesh,Lalitpur,Locomotor Disability,6,15,143,125,268
Uttar Pradesh,Lalitpur,Locomotor Disability,15,35,1171,470,1641
Uttar Pradesh,Lalitpur,Locomotor Disability,35,60,1542,491,2033
Uttar Pradesh,Lalitpur,Locomotor Disability,60,80,238,76,314
Uttar Pradesh,Lalitpur,Locomotor Disability,80,100,4,3,7
Lakshadweep,Lakshadweep District,Locomotor Disability,0,6,0,1,1
Lakshadweep,Lakshadweep District,Locomotor Disability,6,15,17,11,28
Lakshadweep,Lakshadweep District,Locomotor Disability,15,35,45,24,69
Lakshadweep,Lakshadweep District,Locomotor Disability,35,60,112,54,166
Lakshadweep,Lakshadweep District,Locomotor Disability,60,80,24,5,29
Lakshadweep,Lakshadweep District,Locomotor Disability,80,100,2,2,4
Bihar,Lakhisarai,Locomotor Disability,0,6,16,5,21
Bihar,Lakhisarai,Locomotor Disability,6,15,135,70,205
Bihar,Lakhisarai,Locomotor Disability,15,35,983,316,1299
Bihar,Lakhisarai,Locomotor Disability,35,60,845,195,1040
Bihar,Lakhisarai,Locomotor Disability,60,80,209,42,251
Bihar,Lakhisarai,Locomotor Disability,80,100,6,2,8
Assam,Lakhimpur,Locomotor Disability,0,6,30,10,40
Assam,Lakhimpur,Locomotor Disability,6,15,149,75,224
Assam,Lakhimpur,Locomotor Disability,15,35,514,279,793
Assam,Lakhimpur,Locomotor Disability,35,60,613,281,894
Assam,Lakhimpur,Locomotor Disability,60,80,148,58,206
Assam,Lakhimpur,Locomotor Disability,80,100,3,2,5
Himachal Pradesh,Lahul And Spiti,Locomotor Disability,6,15,3,3,6
Himachal Pradesh,Lahul And Spiti,Locomotor Disability,15,35,13,12,25
Himachal Pradesh,Lahul And Spiti,Locomotor Disability,35,60,39,32,71
Himachal Pradesh,Lahul And Spiti,Locomotor Disability,60,80,18,7,25
Himachal Pradesh,Lahul And Spiti,Locomotor Disability,80,100,1,0,1
Uttar Pradesh,Kushi Nagar,Locomotor Disability,0,6,31,11,42
Uttar Pradesh,Kushi Nagar,Locomotor Disability,6,15,252,126,378
Uttar Pradesh,Kushi Nagar,Locomotor Disability,15,35,2743,982,3725
Uttar Pradesh,Kushi Nagar,Locomotor Disability,35,60,2863,829,3692
Uttar Pradesh,Kushi Nagar,Locomotor Disability,60,80,581,110,691
Uttar Pradesh,Kushi Nagar,Locomotor Disability,80,100,12,3,15
Arunachal Pradesh,Kurung Kumey,Locomotor Disability,15,35,4,3,7
Arunachal Pradesh,Kurung Kumey,Locomotor Disability,35,60,1,0,1
Haryana,Kurukshetra,Locomotor Disability,0,6,23,15,38
Haryana,Kurukshetra,Locomotor Disability,6,15,94,69,163
Haryana,Kurukshetra,Locomotor Disability,15,35,765,372,1137
Haryana,Kurukshetra,Locomotor Disability,35,60,1982,807,2789
Haryana,Kurukshetra,Locomotor Disability,60,80,333,99,432
Haryana,Kurukshetra,Locomotor Disability,80,100,13,5,18
Andhra Pradesh,Kurnool,Locomotor Disability,0,6,289,141,430
Andhra Pradesh,Kurnool,Locomotor Disability,6,15,1047,540,1587
Andhra Pradesh,Kurnool,Locomotor Disability,15,35,4174,2021,6195
Andhra Pradesh,Kurnool,Locomotor Disability,35,60,11429,2485,13914
Andhra Pradesh,Kurnool,Locomotor Disability,60,80,3213,617,3830
Andhra Pradesh,Kurnool,Locomotor Disability,80,100,169,71,240
Jammu And Kashmir,Kupwara,Locomotor Disability,0,6,65,68,133
Jammu And Kashmir,Kupwara,Locomotor Disability,6,15,305,222,527
Jammu And Kashmir,Kupwara,Locomotor Disability,15,35,1201,811,2012
Jammu And Kashmir,Kupwara,Locomotor Disability,35,60,1638,1033,2671
Jammu And Kashmir,Kupwara,Locomotor Disability,60,80,268,140,408
Jammu And Kashmir,Kupwara,Locomotor Disability,80,100,28,9,37
Telangana,Kumuram Bheem Asifabad,Locomotor Disability,6,15,26,19,45
Telangana,Kumuram Bheem Asifabad,Locomotor Disability,15,35,414,257,671
Telangana,Kumuram Bheem Asifabad,Locomotor Disability,35,60,660,345,1005
Telangana,Kumuram Bheem Asifabad,Locomotor Disability,60,80,246,117,363
Telangana,Kumuram Bheem Asifabad,Locomotor Disability,80,100,34,18,52
Himachal Pradesh,Kullu,Locomotor Disability,0,6,23,22,45
Himachal Pradesh,Kullu,Locomotor Disability,6,15,104,81,185
Himachal Pradesh,Kullu,Locomotor Disability,15,35,605,330,935
Himachal Pradesh,Kullu,Locomotor Disability,35,60,1203,628,1831
Himachal Pradesh,Kullu,Locomotor Disability,60,80,393,159,552
Himachal Pradesh,Kullu,Locomotor Disability,80,100,28,13,41
Jammu And Kashmir,Kulgam,Locomotor Disability,0,6,7,15,22
Jammu And Kashmir,Kulgam,Locomotor Disability,6,15,87,50,137
Jammu And Kashmir,Kulgam,Locomotor Disability,15,35,401,259,660
Jammu And Kashmir,Kulgam,Locomotor Disability,35,60,640,412,1052
Jammu And Kashmir,Kulgam,Locomotor Disability,60,80,154,72,226
Jammu And Kashmir,Kulgam,Locomotor Disability,80,100,8,2,10
Tamil Nadu,Krishnagiri,Locomotor Disability,0,6,18,15,33
Tamil Nadu,Krishnagiri,Locomotor Disability,6,15,325,211,536
Tamil Nadu,Krishnagiri,Locomotor Disability,15,35,1326,813,2139
Tamil Nadu,Krishnagiri,Locomotor Disability,35,60,3438,1827,5265
Tamil Nadu,Krishnagiri,Locomotor Disability,60,80,1552,735,2287
Tamil Nadu,Krishnagiri,Locomotor Disability,80,100,109,57,166
Andhra Pradesh,Krishna,Locomotor Disability,0,6,65,42,107
Andhra Pradesh,Krishna,Locomotor Disability,6,15,384,197,581
Andhra Pradesh,Krishna,Locomotor Disability,15,35,1557,470,2027
Andhra Pradesh,Krishna,Locomotor Disability,35,60,7587,892,8479
Andhra Pradesh,Krishna,Locomotor Disability,60,80,2308,268,2576
Andhra Pradesh,Krishna,Locomotor Disability,80,100,96,5,101
Kerala,Kozhikode,Locomotor Disability,0,6,28,24,52
Kerala,Kozhikode,Locomotor Disability,6,15,227,153,380
Kerala,Kozhikode,Locomotor Disability,15,35,854,480,1334
Kerala,Kozhikode,Locomotor Disability,35,60,3475,1782,5257
Kerala,Kozhikode,Locomotor Disability,60,80,1998,771,2769
Kerala,Kozhikode,Locomotor Disability,80,100,96,65,161
Kerala,Kottayam,Locomotor Disability,0,6,16,14,30
Kerala,Kottayam,Locomotor Disability,6,15,90,55,145
Kerala,Kottayam,Locomotor Disability,15,35,422,252,674
Kerala,Kottayam,Locomotor Disability,35,60,1513,893,2406
Kerala,Kottayam,Locomotor Disability,60,80,1054,484,1538
Kerala,Kottayam,Locomotor Disability,80,100,67,39,106
Rajasthan,Kota,Locomotor Disability,0,6,31,16,47
Rajasthan,Kota,Locomotor Disability,6,15,254,113,367
Rajasthan,Kota,Locomotor Disability,15,35,1613,892,2505
Rajasthan,Kota,Locomotor Disability,35,60,3195,1705,4900
Rajasthan,Kota,Locomotor Disability,60,80,758,356,1114
Rajasthan,Kota,Locomotor Disability,80,100,52,39,91
Chhattisgarh,Korea,Locomotor Disability,0,6,7,8,15
Chhattisgarh,Korea,Locomotor Disability,6,15,204,125,329
Chhattisgarh,Korea,Locomotor Disability,15,35,898,537,1435
Chhattisgarh,Korea,Locomotor Disability,35,60,1367,564,1931
Chhattisgarh,Korea,Locomotor Disability,60,80,406,212,618
Chhattisgarh,Korea,Locomotor Disability,80,100,25,25,50
Chhattisgarh,Korba,Locomotor Disability,0,6,13,6,19
Chhattisgarh,Korba,Locomotor Disability,6,15,181,127,308
Chhattisgarh,Korba,Locomotor Disability,15,35,1084,676,1760
Chhattisgarh,Korba,Locomotor Disability,35,60,1464,600,2064
Chhattisgarh,Korba,Locomotor Disability,60,80,298,108,406
Chhattisgarh,Korba,Locomotor Disability,80,100,12,10,22
Odisha,Koraput,Locomotor Disability,0,6,169,107,276
Odisha,Koraput,Locomotor Disability,6,15,612,442,1054
Odisha,Koraput,Locomotor Disability,15,35,1686,1232,2918
Odisha,Koraput,Locomotor Disability,35,60,2598,1472,4070
Odisha,Koraput,Locomotor Disability,60,80,899,467,1366
Odisha,Koraput,Locomotor Disability,80,100,66,31,97
Karnataka,Koppal,Locomotor Disability,0,6,65,38,103
Karnataka,Koppal,Locomotor Disability,6,15,413,241,654
Karnataka,Koppal,Locomotor Disability,15,35,2388,1412,3800
Karnataka,Koppal,Locomotor Disability,35,60,3632,1539,5171
Karnataka,Koppal,Locomotor Disability,60,80,704,199,903
Karnataka,Koppal,Locomotor Disability,80,100,22,3,25
Chhattisgarh,Kondagaon,Locomotor Disability,0,6,25,7,32
Chhattisgarh,Kondagaon,Locomotor Disability,6,15,238,173,411
Chhattisgarh,Kondagaon,Locomotor Disability,15,35,921,479,1400
Chhattisgarh,Kondagaon,Locomotor Disability,35,60,1116,440,1556
Chhattisgarh,Kondagaon,Locomotor Disability,60,80,298,114,412
Chhattisgarh,Kondagaon,Locomotor Disability,80,100,17,4,21
Kerala,Kollam,Locomotor Disability,0,6,14,11,25
Kerala,Kollam,Locomotor Disability,6,15,111,71,182
Kerala,Kollam,Locomotor Disability,15,35,529,367,896
Kerala,Kollam,Locomotor Disability,35,60,2134,1257,3391
Kerala,Kollam,Locomotor Disability,60,80,1321,547,1868
Kerala,Kollam,Locomotor Disability,80,100,71,44,115
West Bengal,Kolkata,Locomotor Disability,15,35,1,0,1
Maharashtra,Kolhapur,Locomotor Disability,0,6,36,31,67
Maharashtra,Kolhapur,Locomotor Disability,6,15,635,330,965
Maharashtra,Kolhapur,Locomotor Disability,15,35,2490,1104,3594
Maharashtra,Kolhapur,Locomotor Disability,35,60,6681,2342,9023
Maharashtra,Kolhapur,Locomotor Disability,60,80,2020,366,2386
Maharashtra,Kolhapur,Locomotor Disability,80,100,77,28,105
Mizoram,Kolasib,Locomotor Disability,0,6,1,0,1
Mizoram,Kolasib,Locomotor Disability,6,15,1,5,6
Mizoram,Kolasib,Locomotor Disability,15,35,17,8,25
Mizoram,Kolasib,Locomotor Disability,35,60,27,14,41
Mizoram,Kolasib,Locomotor Disability,60,80,6,5,11
Mizoram,Kolasib,Locomotor Disability,80,100,4,0,4
Karnataka,Kolar,Locomotor Disability,0,6,26,25,51
Karnataka,Kolar,Locomotor Disability,6,15,209,139,348
Karnataka,Kolar,Locomotor Disability,15,35,1240,677,1917
Karnataka,Kolar,Locomotor Disability,35,60,3392,1416,4808
Karnataka,Kolar,Locomotor Disability,60,80,1142,342,1484
Karnataka,Kolar,Locomotor Disability,80,100,62,14,76
Assam,Kokrajhar,Locomotor Disability,0,6,58,26,84
Assam,Kokrajhar,Locomotor Disability,6,15,193,143,336
Assam,Kokrajhar,Locomotor Disability,15,35,853,457,1310
Assam,Kokrajhar,Locomotor Disability,35,60,1177,566,1743
Assam,Kokrajhar,Locomotor Disability,60,80,283,124,407
Assam,Kokrajhar,Locomotor Disability,80,100,8,8,16
Nagaland,Kohima,Locomotor Disability,0,6,2,0,2
Nagaland,Kohima,Locomotor Disability,6,15,11,6,17
Nagaland,Kohima,Locomotor Disability,15,35,55,18,73
Nagaland,Kohima,Locomotor Disability,35,60,35,30,65
Nagaland,Kohima,Locomotor Disability,60,80,6,4,10
Nagaland,Kohima,Locomotor Disability,80,100,0,1,1
Jharkhand,Koderma,Locomotor Disability,0,6,11,7,18
Jharkhand,Koderma,Locomotor Disability,6,15,176,100,276
Jharkhand,Koderma,Locomotor Disability,15,35,610,271,881
Jharkhand,Koderma,Locomotor Disability,35,60,675,237,912
Jharkhand,Koderma,Locomotor Disability,60,80,126,58,184
Jharkhand,Koderma,Locomotor Disability,80,100,7,5,12
Karnataka,Kodagu,Locomotor Disability,0,6,7,4,11
Karnataka,Kodagu,Locomotor Disability,6,15,54,38,92
Karnataka,Kodagu,Locomotor Disability,15,35,296,173,469
Karnataka,Kodagu,Locomotor Disability,35,60,929,464,1393
Karnataka,Kodagu,Locomotor Disability,60,80,454,183,637
Karnataka,Kodagu,Locomotor Disability,80,100,19,10,29
Jammu And Kashmir,Kishtwar,Locomotor Disability,0,6,23,13,36
Jammu And Kashmir,Kishtwar,Locomotor Disability,6,15,126,94,220
Jammu And Kashmir,Kishtwar,Locomotor Disability,15,35,491,307,798
Jammu And Kashmir,Kishtwar,Locomotor Disability,35,60,668,411,1079
Jammu And Kashmir,Kishtwar,Locomotor Disability,60,80,134,71,205
Jammu And Kashmir,Kishtwar,Locomotor Disability,80,100,11,7,18
Bihar,Kishanganj,Locomotor Disability,0,6,24,12,36
Bihar,Kishanganj,Locomotor Disability,6,15,299,153,452
Bihar,Kishanganj,Locomotor Disability,15,35,1423,750,2173
Bihar,Kishanganj,Locomotor Disability,35,60,1203,409,1612
Bihar,Kishanganj,Locomotor Disability,60,80,402,91,493
Bihar,Kishanganj,Locomotor Disability,80,100,17,4,21
Nagaland,Kiphire,Locomotor Disability,15,35,4,2,6
Nagaland,Kiphire,Locomotor Disability,35,60,5,0,5
Nagaland,Kiphire,Locomotor Disability,60,80,1,0,1
Himachal Pradesh,Kinnaur,Locomotor Disability,0,6,1,0,1
Himachal Pradesh,Kinnaur,Locomotor Disability,6,15,3,4,7
Himachal Pradesh,Kinnaur,Locomotor Disability,15,35,66,28,94
Himachal Pradesh,Kinnaur,Locomotor Disability,35,60,205,113,318
Himachal Pradesh,Kinnaur,Locomotor Disability,60,80,78,42,120
Himachal Pradesh,Kinnaur,Locomotor Disability,80,100,4,1,5
Jharkhand,Khunti,Locomotor Disability,0,6,1,1,2
Jharkhand,Khunti,Locomotor Disability,6,15,58,37,95
Jharkhand,Khunti,Locomotor Disability,15,35,196,140,336
Jharkhand,Khunti,Locomotor Disability,35,60,253,118,371
Jharkhand,Khunti,Locomotor Disability,60,80,58,14,72
Jharkhand,Khunti,Locomotor Disability,80,100,1,1,2
Tripura,Khowai,Locomotor Disability,0,6,2,3,5
Tripura,Khowai,Locomotor Disability,6,15,63,49,112
Tripura,Khowai,Locomotor Disability,15,35,157,94,251
Tripura,Khowai,Locomotor Disability,35,60,244,132,376
Tripura,Khowai,Locomotor Disability,60,80,60,23,83
Tripura,Khowai,Locomotor Disability,80,100,9,4,13
Odisha,Khordha,Locomotor Disability,0,6,66,41,107
Odisha,Khordha,Locomotor Disability,6,15,522,309,831
Odisha,Khordha,Locomotor Disability,15,35,1776,849,2625
Odisha,Khordha,Locomotor Disability,35,60,4761,1992,6753
Odisha,Khordha,Locomotor Disability,60,80,1533,479,2012
Odisha,Khordha,Locomotor Disability,80,100,72,16,88
Uttar Pradesh,Kheri,Locomotor Disability,0,6,46,12,58
Uttar Pradesh,Kheri,Locomotor Disability,6,15,405,276,681
Uttar Pradesh,Kheri,Locomotor Disability,15,35,5180,1904,7084
Uttar Pradesh,Kheri,Locomotor Disability,35,60,5795,1754,7549
Uttar Pradesh,Kheri,Locomotor Disability,60,80,1119,224,1343
Uttar Pradesh,Kheri,Locomotor Disability,80,100,32,8,40
Gujarat,Kheda,Locomotor Disability,0,6,78,48,126
Gujarat,Kheda,Locomotor Disability,6,15,591,414,1005
Gujarat,Kheda,Locomotor Disability,15,35,1386,536,1922
Gujarat,Kheda,Locomotor Disability,35,60,2838,1068,3906
Gujarat,Kheda,Locomotor Disability,60,80,744,167,911
Gujarat,Kheda,Locomotor Disability,80,100,22,4,26
Mizoram,Khawzawl,Locomotor Disability,6,15,0,2,2
Mizoram,Khawzawl,Locomotor Disability,15,35,5,4,9
Mizoram,Khawzawl,Locomotor Disability,35,60,6,6,12
Mizoram,Khawzawl,Locomotor Disability,60,80,2,4,6
Madhya Pradesh,Khargone,Locomotor Disability,0,6,36,31,67
Madhya Pradesh,Khargone,Locomotor Disability,6,15,354,225,579
Madhya Pradesh,Khargone,Locomotor Disability,15,35,2365,1380,3745
Madhya Pradesh,Khargone,Locomotor Disability,35,60,3846,1789,5635
Madhya Pradesh,Khargone,Locomotor Disability,60,80,769,281,1050
Madhya Pradesh,Khargone,Locomotor Disability,80,100,42,17,59
Telangana,Khammam,Locomotor Disability,0,6,8,2,10
Telangana,Khammam,Locomotor Disability,6,15,208,166,374
Telangana,Khammam,Locomotor Disability,15,35,1323,883,2206
Telangana,Khammam,Locomotor Disability,35,60,3626,1837,5463
Telangana,Khammam,Locomotor Disability,60,80,1978,1101,3079
Telangana,Khammam,Locomotor Disability,80,100,238,120,358
Bihar,Khagaria,Locomotor Disability,0,6,32,15,47
Bihar,Khagaria,Locomotor Disability,6,15,259,150,409
Bihar,Khagaria,Locomotor Disability,15,35,1320,471,1791
Bihar,Khagaria,Locomotor Disability,35,60,923,291,1214
Bihar,Khagaria,Locomotor Disability,60,80,231,44,275
Bihar,Khagaria,Locomotor Disability,80,100,12,4,16
Odisha,Kendujhar,Locomotor Disability,0,6,57,41,98
Odisha,Kendujhar,Locomotor Disability,6,15,406,267,673
Odisha,Kendujhar,Locomotor Disability,15,35,1552,699,2251
Odisha,Kendujhar,Locomotor Disability,35,60,2990,1074,4064
Odisha,Kendujhar,Locomotor Disability,60,80,701,256,957
Odisha,Kendujhar,Locomotor Disability,80,100,32,9,41
Odisha,Kendrapara,Locomotor Disability,0,6,103,70,173
Odisha,Kendrapara,Locomotor Disability,6,15,581,312,893
Odisha,Kendrapara,Locomotor Disability,15,35,1416,726,2142
Odisha,Kendrapara,Locomotor Disability,35,60,3424,1526,4950
Odisha,Kendrapara,Locomotor Disability,60,80,1164,424,1588
Odisha,Kendrapara,Locomotor Disability,80,100,75,21,96
Uttar Pradesh,Kaushambi,Locomotor Disability,0,6,7,4,11
Uttar Pradesh,Kaushambi,Locomotor Disability,6,15,178,115,293
Uttar Pradesh,Kaushambi,Locomotor Disability,15,35,1613,525,2138
Uttar Pradesh,Kaushambi,Locomotor Disability,35,60,1697,416,2113
Uttar Pradesh,Kaushambi,Locomotor Disability,60,80,317,63,380
Uttar Pradesh,Kaushambi,Locomotor Disability,80,100,17,1,18
Madhya Pradesh,Katni,Locomotor Disability,0,6,18,11,29
Madhya Pradesh,Katni,Locomotor Disability,6,15,302,181,483
Madhya Pradesh,Katni,Locomotor Disability,15,35,2522,1312,3834
Madhya Pradesh,Katni,Locomotor Disability,35,60,3312,1366,4678
Madhya Pradesh,Katni,Locomotor Disability,60,80,1152,450,1602
Madhya Pradesh,Katni,Locomotor Disability,80,100,79,20,99
Bihar,Katihar,Locomotor Disability,0,6,105,78,183
Bihar,Katihar,Locomotor Disability,6,15,749,433,1182
Bihar,Katihar,Locomotor Disability,15,35,1896,1001,2897
Bihar,Katihar,Locomotor Disability,35,60,1748,762,2510
Bihar,Katihar,Locomotor Disability,60,80,497,134,631
Bihar,Katihar,Locomotor Disability,80,100,12,3,15
Jammu And Kashmir,Kathua,Locomotor Disability,0,6,34,27,61
Jammu And Kashmir,Kathua,Locomotor Disability,6,15,184,97,281
Jammu And Kashmir,Kathua,Locomotor Disability,15,35,797,422,1219
Jammu And Kashmir,Kathua,Locomotor Disability,35,60,1716,794,2510
Jammu And Kashmir,Kathua,Locomotor Disability,60,80,354,164,518
Jammu And Kashmir,Kathua,Locomotor Disability,80,100,18,16,34
Uttar Pradesh,Kasganj,Locomotor Disability,0,6,3,8,11
Uttar Pradesh,Kasganj,Locomotor Disability,6,15,106,49,155
Uttar Pradesh,Kasganj,Locomotor Disability,15,35,1705,557,2262
Uttar Pradesh,Kasganj,Locomotor Disability,35,60,1523,433,1956
Uttar Pradesh,Kasganj,Locomotor Disability,60,80,321,51,372
Uttar Pradesh,Kasganj,Locomotor Disability,80,100,10,3,13
Kerala,Kasaragod,Locomotor Disability,0,6,34,25,59
Kerala,Kasaragod,Locomotor Disability,6,15,205,143,348
Kerala,Kasaragod,Locomotor Disability,15,35,616,392,1008
Kerala,Kasaragod,Locomotor Disability,35,60,2004,974,2978
Kerala,Kasaragod,Locomotor Disability,60,80,1006,385,1391
Kerala,Kasaragod,Locomotor Disability,80,100,49,22,71
Tamil Nadu,Karur,Locomotor Disability,0,6,21,12,33
Tamil Nadu,Karur,Locomotor Disability,6,15,128,75,203
Tamil Nadu,Karur,Locomotor Disability,15,35,643,396,1039
Tamil Nadu,Karur,Locomotor Disability,35,60,2159,1221,3380
Tamil Nadu,Karur,Locomotor Disability,60,80,874,368,1242
Tamil Nadu,Karur,Locomotor Disability,80,100,39,22,61
Haryana,Karnal,Locomotor Disability,0,6,21,26,47
Haryana,Karnal,Locomotor Disability,6,15,168,137,305
Haryana,Karnal,Locomotor Disability,15,35,1420,664,2084
Haryana,Karnal,Locomotor Disability,35,60,2944,1160,4104
Haryana,Karnal,Locomotor Disability,60,80,423,151,574
Haryana,Karnal,Locomotor Disability,80,100,10,5,15
Telangana,Karimnagar,Locomotor Disability,0,6,1,0,1
Telangana,Karimnagar,Locomotor Disability,6,15,89,70,159
Telangana,Karimnagar,Locomotor Disability,15,35,889,509,1398
Telangana,Karimnagar,Locomotor Disability,35,60,2937,1383,4320
Telangana,Karimnagar,Locomotor Disability,60,80,1816,989,2805
Telangana,Karimnagar,Locomotor Disability,80,100,281,97,378
Assam,Karimganj,Locomotor Disability,0,6,99,70,169
Assam,Karimganj,Locomotor Disability,6,15,331,241,572
Assam,Karimganj,Locomotor Disability,15,35,795,485,1280
Assam,Karimganj,Locomotor Disability,35,60,971,376,1347
Assam,Karimganj,Locomotor Disability,60,80,183,66,249
Assam,Karimganj,Locomotor Disability,80,100,5,5,10
Ladakh,Kargil,Locomotor Disability,0,6,4,4,8
Ladakh,Kargil,Locomotor Disability,6,15,48,28,76
Ladakh,Kargil,Locomotor Disability,15,35,153,108,261
Ladakh,Kargil,Locomotor Disability,35,60,178,168,346
Ladakh,Kargil,Locomotor Disability,60,80,104,97,201
Ladakh,Kargil,Locomotor Disability,80,100,10,8,18
Assam,Karbi Anglong,Locomotor Disability,0,6,19,18,37
Assam,Karbi Anglong,Locomotor Disability,6,15,122,93,215
Assam,Karbi Anglong,Locomotor Disability,15,35,541,357,898
Assam,Karbi Anglong,Locomotor Disability,35,60,706,628,1334
Assam,Karbi Anglong,Locomotor Disability,60,80,262,242,504
Assam,Karbi Anglong,Locomotor Disability,80,100,17,13,30
Rajasthan,Karauli,Locomotor Disability,0,6,28,23,51
Rajasthan,Karauli,Locomotor Disability,6,15,238,108,346
Rajasthan,Karauli,Locomotor Disability,15,35,1599,619,2218
Rajasthan,Karauli,Locomotor Disability,35,60,1708,537,2245
Rajasthan,Karauli,Locomotor Disability,60,80,344,106,450
Rajasthan,Karauli,Locomotor Disability,80,100,20,12,32
Puducherry,Karaikal,Locomotor Disability,6,15,17,13,30
Puducherry,Karaikal,Locomotor Disability,15,35,177,107,284
Puducherry,Karaikal,Locomotor Disability,35,60,519,288,807
Puducherry,Karaikal,Locomotor Disability,60,80,169,105,274
Puducherry,Karaikal,Locomotor Disability,80,100,22,11,33
Punjab,Kapurthala,Locomotor Disability,0,6,9,11,20
Punjab,Kapurthala,Locomotor Disability,6,15,85,46,131
Punjab,Kapurthala,Locomotor Disability,15,35,610,326,936
Punjab,Kapurthala,Locomotor Disability,35,60,1774,859,2633
Punjab,Kapurthala,Locomotor Disability,60,80,529,124,653
Punjab,Kapurthala,Locomotor Disability,80,100,35,1,36
Uttar Pradesh,Kanpur Nagar,Locomotor Disability,0,6,48,26,74
Uttar Pradesh,Kanpur Nagar,Locomotor Disability,6,15,480,309,789
Uttar Pradesh,Kanpur Nagar,Locomotor Disability,15,35,5161,2163,7324
Uttar Pradesh,Kanpur Nagar,Locomotor Disability,35,60,8550,2724,11274
Uttar Pradesh,Kanpur Nagar,Locomotor Disability,60,80,2343,454,2797
Uttar Pradesh,Kanpur Nagar,Locomotor Disability,80,100,81,20,101
Uttar Pradesh,Kanpur Dehat,Locomotor Disability,0,6,21,13,34
Uttar Pradesh,Kanpur Dehat,Locomotor Disability,6,15,233,154,387
Uttar Pradesh,Kanpur Dehat,Locomotor Disability,15,35,2589,1032,3621
Uttar Pradesh,Kanpur Dehat,Locomotor Disability,35,60,3255,1021,4276
Uttar Pradesh,Kanpur Dehat,Locomotor Disability,60,80,757,158,915
Uttar Pradesh,Kanpur Dehat,Locomotor Disability,80,100,37,9,46
Kerala,Kannur,Locomotor Disability,0,6,33,25,58
Kerala,Kannur,Locomotor Disability,6,15,106,63,169
Kerala,Kannur,Locomotor Disability,15,35,392,253,645
Kerala,Kannur,Locomotor Disability,35,60,1604,799,2403
Kerala,Kannur,Locomotor Disability,60,80,930,335,1265
Kerala,Kannur,Locomotor Disability,80,100,53,20,73
Tamil Nadu,Kanniyakumari,Locomotor Disability,0,6,23,12,35
Tamil Nadu,Kanniyakumari,Locomotor Disability,6,15,153,87,240
Tamil Nadu,Kanniyakumari,Locomotor Disability,15,35,853,501,1354
Tamil Nadu,Kanniyakumari,Locomotor Disability,35,60,3835,2118,5953
Tamil Nadu,Kanniyakumari,Locomotor Disability,60,80,1480,541,2021
Tamil Nadu,Kanniyakumari,Locomotor Disability,80,100,69,22,91
Uttar Pradesh,Kannauj,Locomotor Disability,0,6,19,7,26
Uttar Pradesh,Kannauj,Locomotor Disability,6,15,200,109,309
Uttar Pradesh,Kannauj,Locomotor Disability,15,35,2976,1103,4079
Uttar Pradesh,Kannauj,Locomotor Disability,35,60,3529,1024,4553
Uttar Pradesh,Kannauj,Locomotor Disability,60,80,886,183,1069
Uttar Pradesh,Kannauj,Locomotor Disability,80,100,42,5,47
Chhattisgarh,Kanker,Locomotor Disability,0,6,61,45,106
Chhattisgarh,Kanker,Locomotor Disability,6,15,712,430,1142
Chhattisgarh,Kanker,Locomotor Disability,15,35,1727,1074,2801
Chhattisgarh,Kanker,Locomotor Disability,35,60,2158,965,3123
Chhattisgarh,Kanker,Locomotor Disability,60,80,536,212,748
Chhattisgarh,Kanker,Locomotor Disability,80,100,37,17,54
Himachal Pradesh,Kangra,Locomotor Disability,0,6,63,32,95
Himachal Pradesh,Kangra,Locomotor Disability,6,15,213,153,366
Himachal Pradesh,Kangra,Locomotor Disability,15,35,1457,665,2122
Himachal Pradesh,Kangra,Locomotor Disability,35,60,4056,1507,5563
Himachal Pradesh,Kangra,Locomotor Disability,60,80,1479,456,1935
Himachal Pradesh,Kangra,Locomotor Disability,80,100,88,24,112
Manipur,Kangpokpi,Locomotor Disability,0,6,1,3,4
Manipur,Kangpokpi,Locomotor Disability,6,15,2,1,3
Manipur,Kangpokpi,Locomotor Disability,15,35,18,13,31
Manipur,Kangpokpi,Locomotor Disability,35,60,25,4,29
Manipur,Kangpokpi,Locomotor Disability,60,80,4,3,7
Odisha,Kandhamal,Locomotor Disability,0,6,56,44,100
Odisha,Kandhamal,Locomotor Disability,6,15,291,205,496
Odisha,Kandhamal,Locomotor Disability,15,35,1026,624,1650
Odisha,Kandhamal,Locomotor Disability,35,60,1785,959,2744
Odisha,Kandhamal,Locomotor Disability,60,80,725,346,1071
Odisha,Kandhamal,Locomotor Disability,80,100,36,29,65
Tamil Nadu,Kanchipuram,Locomotor Disability,0,6,7,9,16
Tamil Nadu,Kanchipuram,Locomotor Disability,6,15,91,76,167
Tamil Nadu,Kanchipuram,Locomotor Disability,15,35,531,326,857
Tamil Nadu,Kanchipuram,Locomotor Disability,35,60,2050,1180,3230
Tamil Nadu,Kanchipuram,Locomotor Disability,60,80,684,233,917
Tamil Nadu,Kanchipuram,Locomotor Disability,80,100,32,9,41
Assam,Kamrup Metro,Locomotor Disability,0,6,10,6,16
Assam,Kamrup Metro,Locomotor Disability,6,15,77,65,142
Assam,Kamrup Metro,Locomotor Disability,15,35,326,167,493
Assam,Kamrup Metro,Locomotor Disability,35,60,408,175,583
Assam,Kamrup Metro,Locomotor Disability,60,80,63,20,83
Assam,Kamrup Metro,Locomotor Disability,80,100,2,4,6
Assam,Kamrup,Locomotor Disability,0,6,52,41,93
Assam,Kamrup,Locomotor Disability,6,15,226,139,365
Assam,Kamrup,Locomotor Disability,15,35,967,489,1456
Assam,Kamrup,Locomotor Disability,35,60,1199,465,1664
Assam,Kamrup,Locomotor Disability,60,80,260,71,331
Assam,Kamrup,Locomotor Disability,80,100,5,6,11
Manipur,Kamjong,Locomotor Disability,6,15,0,1,1
Manipur,Kamjong,Locomotor Disability,15,35,4,4,8
Manipur,Kamjong,Locomotor Disability,35,60,9,4,13
Manipur,Kamjong,Locomotor Disability,60,80,3,4,7
Telangana,Kamareddy,Locomotor Disability,0,6,1,1,2
Telangana,Kamareddy,Locomotor Disability,6,15,315,220,535
Telangana,Kamareddy,Locomotor Disability,15,35,1599,918,2517
Telangana,Kamareddy,Locomotor Disability,35,60,3654,1707,5361
Telangana,Kamareddy,Locomotor Disability,60,80,1586,863,2449
Telangana,Kamareddy,Locomotor Disability,80,100,145,88,233
Tamil Nadu,Kallakurichi,Locomotor Disability,0,6,34,19,53
Tamil Nadu,Kallakurichi,Locomotor Disability,6,15,144,84,228
Tamil Nadu,Kallakurichi,Locomotor Disability,15,35,507,290,797
Tamil Nadu,Kallakurichi,Locomotor Disability,35,60,1409,756,2165
Tamil Nadu,Kallakurichi,Locomotor Disability,60,80,613,286,899
Tamil Nadu,Kallakurichi,Locomotor Disability,80,100,37,22,59
Odisha,Kalahandi,Locomotor Disability,0,6,119,58,177
Odisha,Kalahandi,Locomotor Disability,6,15,481,317,798
Odisha,Kalahandi,Locomotor Disability,15,35,1391,826,2217
Odisha,Kalahandi,Locomotor Disability,35,60,2456,1094,3550
Odisha,Kalahandi,Locomotor Disability,60,80,773,304,1077
Odisha,Kalahandi,Locomotor Disability,80,100,38,11,49
Karnataka,Kalaburagi,Locomotor Disability,0,6,49,29,78
Karnataka,Kalaburagi,Locomotor Disability,6,15,459,235,694
Karnataka,Kalaburagi,Locomotor Disability,15,35,2733,1491,4224
Karnataka,Kalaburagi,Locomotor Disability,35,60,5479,1936,7415
Karnataka,Kalaburagi,Locomotor Disability,60,80,1139,260,1399
Karnataka,Kalaburagi,Locomotor Disability,80,100,45,5,50
Manipur,Kakching,Locomotor Disability,6,15,16,8,24
Manipur,Kakching,Locomotor Disability,15,35,30,20,50
Manipur,Kakching,Locomotor Disability,35,60,81,62,143
Manipur,Kakching,Locomotor Disability,60,80,33,23,56
Manipur,Kakching,Locomotor Disability,80,100,2,1,3
Haryana,Kaithal,Locomotor Disability,0,6,32,13,45
Haryana,Kaithal,Locomotor Disability,6,15,126,72,198
Haryana,Kaithal,Locomotor Disability,15,35,723,324,1047
Haryana,Kaithal,Locomotor Disability,35,60,1256,478,1734
Haryana,Kaithal,Locomotor Disability,60,80,181,45,226
Haryana,Kaithal,Locomotor Disability,80,100,5,1,6
Bihar,Kaimur (Bhabua),Locomotor Disability,0,6,52,36,88
Bihar,Kaimur (Bhabua),Locomotor Disability,6,15,413,252,665
Bihar,Kaimur (Bhabua),Locomotor Disability,15,35,1873,770,2643
Bihar,Kaimur (Bhabua),Locomotor Disability,35,60,1764,737,2501
Bihar,Kaimur (Bhabua),Locomotor Disability,60,80,578,215,793
Bihar,Kaimur (Bhabua),Locomotor Disability,80,100,33,11,44
Gujarat,Kachchh,Locomotor Disability,0,6,31,22,53
Gujarat,Kachchh,Locomotor Disability,6,15,339,233,572
Gujarat,Kachchh,Locomotor Disability,15,35,1018,501,1519
Gujarat,Kachchh,Locomotor Disability,35,60,1902,786,2688
Gujarat,Kachchh,Locomotor Disability,60,80,496,122,618
Gujarat,Kachchh,Locomotor Disability,80,100,24,6,30
Chhattisgarh,Kabirdham,Locomotor Disability,0,6,22,23,45
Chhattisgarh,Kabirdham,Locomotor Disability,6,15,264,159,423
Chhattisgarh,Kabirdham,Locomotor Disability,15,35,1706,1110,2816
Chhattisgarh,Kabirdham,Locomotor Disability,35,60,2122,1104,3226
Chhattisgarh,Kabirdham,Locomotor Disability,60,80,483,214,697
Chhattisgarh,Kabirdham,Locomotor Disability,80,100,20,12,32
Gujarat,Junagadh,Locomotor Disability,0,6,19,10,29
Gujarat,Junagadh,Locomotor Disability,6,15,249,192,441
Gujarat,Junagadh,Locomotor Disability,15,35,888,439,1327
Gujarat,Junagadh,Locomotor Disability,35,60,2015,838,2853
Gujarat,Junagadh,Locomotor Disability,60,80,610,132,742
Gujarat,Junagadh,Locomotor Disability,80,100,27,6,33
Assam,Jorhat,Locomotor Disability,0,6,13,13,26
Assam,Jorhat,Locomotor Disability,6,15,74,52,126
Assam,Jorhat,Locomotor Disability,15,35,372,208,580
Assam,Jorhat,Locomotor Disability,35,60,658,333,991
Assam,Jorhat,Locomotor Disability,60,80,130,42,172
Assam,Jorhat,Locomotor Disability,80,100,4,3,7
Telangana,Jogulamba Gadwal,Locomotor Disability,6,15,132,93,225
Telangana,Jogulamba Gadwal,Locomotor Disability,15,35,1286,948,2234
Telangana,Jogulamba Gadwal,Locomotor Disability,35,60,2409,1223,3632
Telangana,Jogulamba Gadwal,Locomotor Disability,60,80,841,440,1281
Telangana,Jogulamba Gadwal,Locomotor Disability,80,100,72,42,114
Rajasthan,Jodhpur,Locomotor Disability,0,6,67,39,106
Rajasthan,Jodhpur,Locomotor Disability,6,15,580,324,904
Rajasthan,Jodhpur,Locomotor Disability,15,35,3242,1486,4728
Rajasthan,Jodhpur,Locomotor Disability,35,60,4398,1645,6043
Rajasthan,Jodhpur,Locomotor Disability,60,80,1137,401,1538
Rajasthan,Jodhpur,Locomotor Disability,80,100,62,49,111
Manipur,Jiribam,Locomotor Disability,0,6,1,1,2
Manipur,Jiribam,Locomotor Disability,6,15,7,8,15
Manipur,Jiribam,Locomotor Disability,15,35,16,3,19
Manipur,Jiribam,Locomotor Disability,35,60,18,12,30
Manipur,Jiribam,Locomotor Disability,60,80,7,1,8
Haryana,Jind,Locomotor Disability,0,6,14,6,20
Haryana,Jind,Locomotor Disability,6,15,94,60,154
Haryana,Jind,Locomotor Disability,15,35,654,266,920
Haryana,Jind,Locomotor Disability,35,60,1232,380,1612
Haryana,Jind,Locomotor Disability,60,80,143,53,196
Haryana,Jind,Locomotor Disability,80,100,3,4,7
Rajasthan,Jhunjhunu,Locomotor Disability,0,6,24,12,36
Rajasthan,Jhunjhunu,Locomotor Disability,6,15,372,201,573
Rajasthan,Jhunjhunu,Locomotor Disability,15,35,2819,1174,3993
Rajasthan,Jhunjhunu,Locomotor Disability,35,60,3487,1283,4770
Rajasthan,Jhunjhunu,Locomotor Disability,60,80,783,284,1067
Rajasthan,Jhunjhunu,Locomotor Disability,80,100,58,34,92
Odisha,Jharsuguda,Locomotor Disability,0,6,45,20,65
Odisha,Jharsuguda,Locomotor Disability,6,15,130,99,229
Odisha,Jharsuguda,Locomotor Disability,15,35,436,276,712
Odisha,Jharsuguda,Locomotor Disability,35,60,1175,567,1742
Odisha,Jharsuguda,Locomotor Disability,60,80,404,195,599
Odisha,Jharsuguda,Locomotor Disability,80,100,36,17,53
Uttar Pradesh,Jhansi,Locomotor Disability,0,6,14,7,21
Uttar Pradesh,Jhansi,Locomotor Disability,6,15,219,107,326
Uttar Pradesh,Jhansi,Locomotor Disability,15,35,1386,521,1907
Uttar Pradesh,Jhansi,Locomotor Disability,35,60,2055,628,2683
Uttar Pradesh,Jhansi,Locomotor Disability,60,80,420,66,486
Uttar Pradesh,Jhansi,Locomotor Disability,80,100,12,1,13
Rajasthan,Jhalawar,Locomotor Disability,0,6,27,10,37
Rajasthan,Jhalawar,Locomotor Disability,6,15,312,188,500
Rajasthan,Jhalawar,Locomotor Disability,15,35,2663,1946,4609
Rajasthan,Jhalawar,Locomotor Disability,35,60,4107,2295,6402
Rajasthan,Jhalawar,Locomotor Disability,60,80,729,306,1035
Rajasthan,Jhalawar,Locomotor Disability,80,100,52,31,83
Haryana,Jhajjar,Locomotor Disability,0,6,18,3,21
Haryana,Jhajjar,Locomotor Disability,6,15,39,33,72
Haryana,Jhajjar,Locomotor Disability,15,35,483,216,699
Haryana,Jhajjar,Locomotor Disability,35,60,1175,323,1498
Haryana,Jhajjar,Locomotor Disability,60,80,179,51,230
Haryana,Jhajjar,Locomotor Disability,80,100,3,4,7
Madhya Pradesh,Jhabua,Locomotor Disability,0,6,3,5,8
Madhya Pradesh,Jhabua,Locomotor Disability,6,15,241,143,384
Madhya Pradesh,Jhabua,Locomotor Disability,15,35,2087,1291,3378
Madhya Pradesh,Jhabua,Locomotor Disability,35,60,2232,1193,3425
Madhya Pradesh,Jhabua,Locomotor Disability,60,80,427,230,657
Madhya Pradesh,Jhabua,Locomotor Disability,80,100,31,17,48
Bihar,Jehanabad,Locomotor Disability,0,6,77,33,110
Bihar,Jehanabad,Locomotor Disability,6,15,340,196,536
Bihar,Jehanabad,Locomotor Disability,15,35,1258,468,1726
Bihar,Jehanabad,Locomotor Disability,35,60,963,355,1318
Bihar,Jehanabad,Locomotor Disability,60,80,226,64,290
Bihar,Jehanabad,Locomotor Disability,80,100,12,3,15
Telangana,Jayashankar Bhupalapally,Locomotor Disability,0,6,0,1,1
Telangana,Jayashankar Bhupalapally,Locomotor Disability,6,15,70,65,135
Telangana,Jayashankar Bhupalapally,Locomotor Disability,15,35,913,680,1593
Telangana,Jayashankar Bhupalapally,Locomotor Disability,35,60,2069,1203,3272
Telangana,Jayashankar Bhupalapally,Locomotor Disability,60,80,996,546,1542
Telangana,Jayashankar Bhupalapally,Locomotor Disability,80,100,142,70,212
Uttar Pradesh,Jaunpur,Locomotor Disability,0,6,53,38,91
Uttar Pradesh,Jaunpur,Locomotor Disability,6,15,557,330,887
Uttar Pradesh,Jaunpur,Locomotor Disability,15,35,4501,1663,6164
Uttar Pradesh,Jaunpur,Locomotor Disability,35,60,4934,1383,6317
Uttar Pradesh,Jaunpur,Locomotor Disability,60,80,906,177,1083
Uttar Pradesh,Jaunpur,Locomotor Disability,80,100,33,11,44
Chhattisgarh,Jashpur,Locomotor Disability,0,6,12,14,26
Chhattisgarh,Jashpur,Locomotor Disability,6,15,149,103,252
Chhattisgarh,Jashpur,Locomotor Disability,15,35,909,460,1369
Chhattisgarh,Jashpur,Locomotor Disability,35,60,1343,569,1912
Chhattisgarh,Jashpur,Locomotor Disability,60,80,430,171,601
Chhattisgarh,Jashpur,Locomotor Disability,80,100,15,4,19
Chhattisgarh,Janjgir-Champa,Locomotor Disability,0,6,39,12,51
Chhattisgarh,Janjgir-Champa,Locomotor Disability,6,15,365,228,593
Chhattisgarh,Janjgir-Champa,Locomotor Disability,15,35,2094,1307,3401
Chhattisgarh,Janjgir-Champa,Locomotor Disability,35,60,2937,1259,4196
Chhattisgarh,Janjgir-Champa,Locomotor Disability,60,80,636,246,882
Chhattisgarh,Janjgir-Champa,Locomotor Disability,80,100,33,24,57
Telangana,Jangoan,Locomotor Disability,0,6,1,0,1
Telangana,Jangoan,Locomotor Disability,6,15,85,58,143
Telangana,Jangoan,Locomotor Disability,15,35,917,623,1540
Telangana,Jangoan,Locomotor Disability,35,60,2436,1387,3823
Telangana,Jangoan,Locomotor Disability,60,80,1703,935,2638
Telangana,Jangoan,Locomotor Disability,80,100,261,132,393
Bihar,Jamui,Locomotor Disability,0,6,22,9,31
Bihar,Jamui,Locomotor Disability,6,15,294,150,444
Bihar,Jamui,Locomotor Disability,15,35,1297,527,1824
Bihar,Jamui,Locomotor Disability,35,60,1522,523,2045
Bihar,Jamui,Locomotor Disability,60,80,418,144,562
Bihar,Jamui,Locomotor Disability,80,100,12,6,18
Jharkhand,Jamtara,Locomotor Disability,0,6,9,5,14
Jharkhand,Jamtara,Locomotor Disability,6,15,98,49,147
Jharkhand,Jamtara,Locomotor Disability,15,35,374,186,560
Jharkhand,Jamtara,Locomotor Disability,35,60,489,182,671
Jharkhand,Jamtara,Locomotor Disability,60,80,109,27,136
Jharkhand,Jamtara,Locomotor Disability,80,100,4,0,4
Gujarat,Jamnagar,Locomotor Disability,0,6,58,39,97
Gujarat,Jamnagar,Locomotor Disability,6,15,242,179,421
Gujarat,Jamnagar,Locomotor Disability,15,35,1091,536,1627
Gujarat,Jamnagar,Locomotor Disability,35,60,3128,1227,4355
Gujarat,Jamnagar,Locomotor Disability,60,80,1165,284,1449
Gujarat,Jamnagar,Locomotor Disability,80,100,59,20,79
Jammu And Kashmir,Jammu,Locomotor Disability,0,6,24,9,33
Jammu And Kashmir,Jammu,Locomotor Disability,6,15,197,87,284
Jammu And Kashmir,Jammu,Locomotor Disability,15,35,1096,520,1616
Jammu And Kashmir,Jammu,Locomotor Disability,35,60,2664,1209,3873
Jammu And Kashmir,Jammu,Locomotor Disability,60,80,581,176,757
Jammu And Kashmir,Jammu,Locomotor Disability,80,100,21,21,42
Rajasthan,Jalore,Locomotor Disability,0,6,41,22,63
Rajasthan,Jalore,Locomotor Disability,6,15,535,284,819
Rajasthan,Jalore,Locomotor Disability,15,35,2433,1136,3569
Rajasthan,Jalore,Locomotor Disability,35,60,3867,1676,5543
Rajasthan,Jalore,Locomotor Disability,60,80,1049,411,1460
Rajasthan,Jalore,Locomotor Disability,80,100,58,43,101
Maharashtra,Jalna,Locomotor Disability,0,6,76,41,117
Maharashtra,Jalna,Locomotor Disability,6,15,678,377,1055
Maharashtra,Jalna,Locomotor Disability,15,35,3241,1372,4613
Maharashtra,Jalna,Locomotor Disability,35,60,5717,1911,7628
Maharashtra,Jalna,Locomotor Disability,60,80,1890,632,2522
Maharashtra,Jalna,Locomotor Disability,80,100,130,40,170
Maharashtra,Jalgaon,Locomotor Disability,0,6,100,54,154
Maharashtra,Jalgaon,Locomotor Disability,6,15,663,326,989
Maharashtra,Jalgaon,Locomotor Disability,15,35,3183,1367,4550
Maharashtra,Jalgaon,Locomotor Disability,35,60,7779,2813,10592
Maharashtra,Jalgaon,Locomotor Disability,60,80,1799,479,2278
Maharashtra,Jalgaon,Locomotor Disability,80,100,48,20,68
Uttar Pradesh,Jalaun,Locomotor Disability,0,6,18,11,29
Uttar Pradesh,Jalaun,Locomotor Disability,6,15,195,132,327
Uttar Pradesh,Jalaun,Locomotor Disability,15,35,2912,1072,3984
Uttar Pradesh,Jalaun,Locomotor Disability,35,60,4842,1405,6247
Uttar Pradesh,Jalaun,Locomotor Disability,60,80,1233,259,1492
Uttar Pradesh,Jalaun,Locomotor Disability,80,100,52,10,62
Punjab,Jalandhar,Locomotor Disability,0,6,34,34,68
Punjab,Jalandhar,Locomotor Disability,6,15,377,208,585
Punjab,Jalandhar,Locomotor Disability,15,35,1901,1112,3013
Punjab,Jalandhar,Locomotor Disability,35,60,5162,2477,7639
Punjab,Jalandhar,Locomotor Disability,60,80,1673,342,2015
Punjab,Jalandhar,Locomotor Disability,80,100,80,29,109
Odisha,Jajapur,Locomotor Disability,0,6,108,55,163
Odisha,Jajapur,Locomotor Disability,6,15,582,390,972
Odisha,Jajapur,Locomotor Disability,15,35,2312,1046,3358
Odisha,Jajapur,Locomotor Disability,35,60,5624,2300,7924
Odisha,Jajapur,Locomotor Disability,60,80,1863,718,2581
Odisha,Jajapur,Locomotor Disability,80,100,79,41,120
Rajasthan,Jaisalmer,Locomotor Disability,0,6,12,5,17
Rajasthan,Jaisalmer,Locomotor Disability,6,15,153,73,226
Rajasthan,Jaisalmer,Locomotor Disability,15,35,744,212,956
Rajasthan,Jaisalmer,Locomotor Disability,35,60,821,243,1064
Rajasthan,Jaisalmer,Locomotor Disability,60,80,172,69,241
Rajasthan,Jaisalmer,Locomotor Disability,80,100,11,6,17
Rajasthan,Jaipur,Locomotor Disability,0,6,69,33,102
Rajasthan,Jaipur,Locomotor Disability,6,15,760,402,1162
Rajasthan,Jaipur,Locomotor Disability,15,35,4898,2435,7333
Rajasthan,Jaipur,Locomotor Disability,35,60,7092,3245,10337
Rajasthan,Jaipur,Locomotor Disability,60,80,1482,525,2007
Rajasthan,Jaipur,Locomotor Disability,80,100,91,33,124
Telangana,Jagitial,Locomotor Disability,0,6,1,2,3
Telangana,Jagitial,Locomotor Disability,6,15,75,61,136
Telangana,Jagitial,Locomotor Disability,15,35,731,483,1214
Telangana,Jagitial,Locomotor Disability,35,60,1837,982,2819
Telangana,Jagitial,Locomotor Disability,60,80,1492,877,2369
Telangana,Jagitial,Locomotor Disability,80,100,228,164,392
Odisha,Jagatsinghapur,Locomotor Disability,0,6,72,40,112
Odisha,Jagatsinghapur,Locomotor Disability,6,15,384,177,561
Odisha,Jagatsinghapur,Locomotor Disability,15,35,1055,560,1615
Odisha,Jagatsinghapur,Locomotor Disability,35,60,2679,1039,3718
Odisha,Jagatsinghapur,Locomotor Disability,60,80,868,339,1207
Odisha,Jagatsinghapur,Locomotor Disability,80,100,46,19,65
Madhya Pradesh,Jabalpur,Locomotor Disability,0,6,39,49,88
Madhya Pradesh,Jabalpur,Locomotor Disability,6,15,411,222,633
Madhya Pradesh,Jabalpur,Locomotor Disability,15,35,5376,1833,7209
Madhya Pradesh,Jabalpur,Locomotor Disability,35,60,7557,2484,10041
Madhya Pradesh,Jabalpur,Locomotor Disability,60,80,1558,466,2024
Madhya Pradesh,Jabalpur,Locomotor Disability,80,100,64,17,81
Madhya Pradesh,Indore,Locomotor Disability,0,6,31,27,58
Madhya Pradesh,Indore,Locomotor Disability,6,15,272,182,454
Madhya Pradesh,Indore,Locomotor Disability,15,35,1769,1049,2818
Madhya Pradesh,Indore,Locomotor Disability,35,60,3841,1825,5666
Madhya Pradesh,Indore,Locomotor Disability,60,80,965,289,1254
Madhya Pradesh,Indore,Locomotor Disability,80,100,57,12,69
Manipur,Imphal West,Locomotor Disability,0,6,4,2,6
Manipur,Imphal West,Locomotor Disability,6,15,19,11,30
Manipur,Imphal West,Locomotor Disability,15,35,76,46,122
Manipur,Imphal West,Locomotor Disability,35,60,163,77,240
Manipur,Imphal West,Locomotor Disability,60,80,78,28,106
Manipur,Imphal West,Locomotor Disability,80,100,6,6,12
Manipur,Imphal East,Locomotor Disability,0,6,5,4,9
Manipur,Imphal East,Locomotor Disability,6,15,16,14,30
Manipur,Imphal East,Locomotor Disability,15,35,62,44,106
Manipur,Imphal East,Locomotor Disability,35,60,138,73,211
Manipur,Imphal East,Locomotor Disability,60,80,62,26,88
Manipur,Imphal East,Locomotor Disability,80,100,7,2,9
Kerala,Idukki,Locomotor Disability,0,6,3,3,6
Kerala,Idukki,Locomotor Disability,6,15,50,41,91
Kerala,Idukki,Locomotor Disability,15,35,264,175,439
Kerala,Idukki,Locomotor Disability,35,60,991,545,1536
Kerala,Idukki,Locomotor Disability,60,80,613,231,844
Kerala,Idukki,Locomotor Disability,80,100,37,12,49
Telangana,Hyderabad,Locomotor Disability,0,6,4,0,4
Telangana,Hyderabad,Locomotor Disability,6,15,375,254,629
Telangana,Hyderabad,Locomotor Disability,15,35,2963,1946,4909
Telangana,Hyderabad,Locomotor Disability,35,60,6434,3274,9708
Telangana,Hyderabad,Locomotor Disability,60,80,2738,900,3638
Telangana,Hyderabad,Locomotor Disability,80,100,243,94,337
West Bengal,Howrah,Locomotor Disability,0,6,1,0,1
West Bengal,Howrah,Locomotor Disability,6,15,0,1,1
West Bengal,Howrah,Locomotor Disability,15,35,1,0,1
West Bengal,Howrah,Locomotor Disability,35,60,6,0,6
Punjab,Hoshiarpur,Locomotor Disability,0,6,15,26,41
Punjab,Hoshiarpur,Locomotor Disability,6,15,151,76,227
Punjab,Hoshiarpur,Locomotor Disability,15,35,1265,650,1915
Punjab,Hoshiarpur,Locomotor Disability,35,60,4053,1871,5924
Punjab,Hoshiarpur,Locomotor Disability,60,80,1300,276,1576
Punjab,Hoshiarpur,Locomotor Disability,80,100,53,11,64
Assam,Hojai,Locomotor Disability,0,6,69,44,113
Assam,Hojai,Locomotor Disability,6,15,196,127,323
Assam,Hojai,Locomotor Disability,15,35,401,245,646
Assam,Hojai,Locomotor Disability,35,60,519,199,718
Assam,Hojai,Locomotor Disability,60,80,134,58,192
Assam,Hojai,Locomotor Disability,80,100,14,4,18
Mizoram,Hnahthial,Locomotor Disability,0,6,0,1,1
Mizoram,Hnahthial,Locomotor Disability,6,15,1,1,2
Mizoram,Hnahthial,Locomotor Disability,15,35,0,1,1
Mizoram,Hnahthial,Locomotor Disability,35,60,4,1,5
Mizoram,Hnahthial,Locomotor Disability,60,80,1,0,1
Haryana,Hisar,Locomotor Disability,0,6,28,18,46
Haryana,Hisar,Locomotor Disability,6,15,194,117,311
Haryana,Hisar,Locomotor Disability,15,35,1315,544,1859
Haryana,Hisar,Locomotor Disability,35,60,2322,718,3040
Haryana,Hisar,Locomotor Disability,60,80,424,115,539
Haryana,Hisar,Locomotor Disability,80,100,14,7,21
Maharashtra,Hingoli,Locomotor Disability,0,6,33,16,49
Maharashtra,Hingoli,Locomotor Disability,6,15,561,332,893
Maharashtra,Hingoli,Locomotor Disability,15,35,2212,923,3135
Maharashtra,Hingoli,Locomotor Disability,35,60,3428,887,4315
Maharashtra,Hingoli,Locomotor Disability,60,80,1164,282,1446
Maharashtra,Hingoli,Locomotor Disability,80,100,96,15,111
Jharkhand,Hazaribagh,Locomotor Disability,0,6,34,15,49
Jharkhand,Hazaribagh,Locomotor Disability,6,15,306,155,461
Jharkhand,Hazaribagh,Locomotor Disability,15,35,855,417,1272
Jharkhand,Hazaribagh,Locomotor Disability,35,60,1011,430,1441
Jharkhand,Hazaribagh,Locomotor Disability,60,80,117,61,178
Jharkhand,Hazaribagh,Locomotor Disability,80,100,5,1,6
Karnataka,Haveri,Locomotor Disability,0,6,99,49,148
Karnataka,Haveri,Locomotor Disability,6,15,744,451,1195
Karnataka,Haveri,Locomotor Disability,15,35,2936,1613,4549
Karnataka,Haveri,Locomotor Disability,35,60,7066,3276,10342
Karnataka,Haveri,Locomotor Disability,60,80,1909,561,2470
Karnataka,Haveri,Locomotor Disability,80,100,82,23,105
Uttar Pradesh,Hathras,Locomotor Disability,0,6,31,14,45
Uttar Pradesh,Hathras,Locomotor Disability,6,15,235,147,382
Uttar Pradesh,Hathras,Locomotor Disability,15,35,2482,896,3378
Uttar Pradesh,Hathras,Locomotor Disability,35,60,2551,877,3428
Uttar Pradesh,Hathras,Locomotor Disability,60,80,509,111,620
Uttar Pradesh,Hathras,Locomotor Disability,80,100,19,5,24
Karnataka,Hassan,Locomotor Disability,0,6,47,39,86
Karnataka,Hassan,Locomotor Disability,6,15,347,205,552
Karnataka,Hassan,Locomotor Disability,15,35,1518,864,2382
Karnataka,Hassan,Locomotor Disability,35,60,4690,2018,6708
Karnataka,Hassan,Locomotor Disability,60,80,1492,467,1959
Karnataka,Hassan,Locomotor Disability,80,100,56,19,75
Uttarakhand,Haridwar,Locomotor Disability,0,6,14,11,25
Uttarakhand,Haridwar,Locomotor Disability,6,15,168,83,251
Uttarakhand,Haridwar,Locomotor Disability,15,35,2237,907,3144
Uttarakhand,Haridwar,Locomotor Disability,35,60,2364,807,3171
Uttarakhand,Haridwar,Locomotor Disability,60,80,329,109,438
Uttarakhand,Haridwar,Locomotor Disability,80,100,12,1,13
Uttar Pradesh,Hardoi,Locomotor Disability,0,6,29,18,47
Uttar Pradesh,Hardoi,Locomotor Disability,6,15,606,321,927
Uttar Pradesh,Hardoi,Locomotor Disability,15,35,6112,1998,8110
Uttar Pradesh,Hardoi,Locomotor Disability,35,60,7259,1975,9234
Uttar Pradesh,Hardoi,Locomotor Disability,60,80,1825,427,2252
Uttar Pradesh,Hardoi,Locomotor Disability,80,100,98,17,115
Madhya Pradesh,Harda,Locomotor Disability,0,6,2,0,2
Madhya Pradesh,Harda,Locomotor Disability,6,15,171,86,257
Madhya Pradesh,Harda,Locomotor Disability,15,35,895,537,1432
Madhya Pradesh,Harda,Locomotor Disability,35,60,1243,627,1870
Madhya Pradesh,Harda,Locomotor Disability,60,80,573,201,774
Madhya Pradesh,Harda,Locomotor Disability,80,100,39,25,64
Uttar Pradesh,Hapur,Locomotor Disability,0,6,6,2,8
Uttar Pradesh,Hapur,Locomotor Disability,6,15,64,46,110
Uttar Pradesh,Hapur,Locomotor Disability,15,35,1555,565,2120
Uttar Pradesh,Hapur,Locomotor Disability,35,60,1492,493,1985
Uttar Pradesh,Hapur,Locomotor Disability,60,80,290,63,353
Uttar Pradesh,Hapur,Locomotor Disability,80,100,14,5,19
Rajasthan,Hanumangarh,Locomotor Disability,0,6,17,9,26
Rajasthan,Hanumangarh,Locomotor Disability,6,15,272,174,446
Rajasthan,Hanumangarh,Locomotor Disability,15,35,2215,1088,3303
Rajasthan,Hanumangarh,Locomotor Disability,35,60,3661,1800,5461
Rajasthan,Hanumangarh,Locomotor Disability,60,80,879,393,1272
Rajasthan,Hanumangarh,Locomotor Disability,80,100,59,33,92
Telangana,Hanumakonda,Locomotor Disability,0,6,0,2,2
Telangana,Hanumakonda,Locomotor Disability,6,15,80,45,125
Telangana,Hanumakonda,Locomotor Disability,15,35,1026,698,1724
Telangana,Hanumakonda,Locomotor Disability,35,60,2952,1703,4655
Telangana,Hanumakonda,Locomotor Disability,60,80,1740,779,2519
Telangana,Hanumakonda,Locomotor Disability,80,100,230,101,331
Himachal Pradesh,Hamirpur,Locomotor Disability,0,6,15,9,24
Himachal Pradesh,Hamirpur,Locomotor Disability,6,15,64,31,95
Himachal Pradesh,Hamirpur,Locomotor Disability,15,35,339,156,495
Himachal Pradesh,Hamirpur,Locomotor Disability,35,60,1118,490,1608
Himachal Pradesh,Hamirpur,Locomotor Disability,60,80,499,180,679
Himachal Pradesh,Hamirpur,Locomotor Disability,80,100,42,22,64
Uttar Pradesh,Hamirpur,Locomotor Disability,0,6,4,0,4
Uttar Pradesh,Hamirpur,Locomotor Disability,6,15,69,37,106
Uttar Pradesh,Hamirpur,Locomotor Disability,15,35,972,329,1301
Uttar Pradesh,Hamirpur,Locomotor Disability,35,60,1508,516,2024
Uttar Pradesh,Hamirpur,Locomotor Disability,60,80,469,100,569
Uttar Pradesh,Hamirpur,Locomotor Disability,80,100,25,3,28
Assam,Hailakandi,Locomotor Disability,0,6,74,50,124
Assam,Hailakandi,Locomotor Disability,6,15,175,90,265
Assam,Hailakandi,Locomotor Disability,15,35,361,238,599
Assam,Hailakandi,Locomotor Disability,35,60,507,162,669
Assam,Hailakandi,Locomotor Disability,60,80,70,17,87
Assam,Hailakandi,Locomotor Disability,80,100,1,0,1
Sikkim,Gyalshing,Locomotor Disability,0,6,4,1,5
Sikkim,Gyalshing,Locomotor Disability,6,15,15,8,23
Sikkim,Gyalshing,Locomotor Disability,15,35,74,39,113
Sikkim,Gyalshing,Locomotor Disability,35,60,91,33,124
Sikkim,Gyalshing,Locomotor Disability,60,80,23,12,35
Madhya Pradesh,Gwalior,Locomotor Disability,0,6,9,14,23
Madhya Pradesh,Gwalior,Locomotor Disability,6,15,267,133,400
Madhya Pradesh,Gwalior,Locomotor Disability,15,35,2653,1133,3786
Madhya Pradesh,Gwalior,Locomotor Disability,35,60,3763,1425,5188
Madhya Pradesh,Gwalior,Locomotor Disability,60,80,816,210,1026
Madhya Pradesh,Gwalior,Locomotor Disability,80,100,47,15,62
Haryana,Gurugram,Locomotor Disability,0,6,19,15,34
Haryana,Gurugram,Locomotor Disability,6,15,106,68,174
Haryana,Gurugram,Locomotor Disability,15,35,500,266,766
Haryana,Gurugram,Locomotor Disability,35,60,944,391,1335
Haryana,Gurugram,Locomotor Disability,60,80,158,44,202
Haryana,Gurugram,Locomotor Disability,80,100,2,1,3
Punjab,Gurdaspur,Locomotor Disability,0,6,45,39,84
Punjab,Gurdaspur,Locomotor Disability,6,15,527,263,790
Punjab,Gurdaspur,Locomotor Disability,15,35,2843,1442,4285
Punjab,Gurdaspur,Locomotor Disability,35,60,6010,2573,8583
Punjab,Gurdaspur,Locomotor Disability,60,80,1683,504,2187
Punjab,Gurdaspur,Locomotor Disability,80,100,121,29,150
Andhra Pradesh,Guntur,Locomotor Disability,0,6,72,41,113
Andhra Pradesh,Guntur,Locomotor Disability,6,15,661,443,1104
Andhra Pradesh,Guntur,Locomotor Disability,15,35,3776,1829,5605
Andhra Pradesh,Guntur,Locomotor Disability,35,60,14199,2319,16518
Andhra Pradesh,Guntur,Locomotor Disability,60,80,4157,468,4625
Andhra Pradesh,Guntur,Locomotor Disability,80,100,286,18,304
Madhya Pradesh,Guna,Locomotor Disability,0,6,35,14,49
Madhya Pradesh,Guna,Locomotor Disability,6,15,258,189,447
Madhya Pradesh,Guna,Locomotor Disability,15,35,1666,764,2430
Madhya Pradesh,Guna,Locomotor Disability,35,60,2703,1001,3704
Madhya Pradesh,Guna,Locomotor Disability,60,80,533,187,720
Madhya Pradesh,Guna,Locomotor Disability,80,100,34,12,46
Jharkhand,Gumla,Locomotor Disability,0,6,11,8,19
Jharkhand,Gumla,Locomotor Disability,6,15,207,167,374
Jharkhand,Gumla,Locomotor Disability,15,35,845,443,1288
Jharkhand,Gumla,Locomotor Disability,35,60,1179,663,1842
Jharkhand,Gumla,Locomotor Disability,60,80,361,184,545
Jharkhand,Gumla,Locomotor Disability,80,100,18,7,25
Uttar Pradesh,Gorakhpur,Locomotor Disability,0,6,32,42,74
Uttar Pradesh,Gorakhpur,Locomotor Disability,6,15,376,241,617
Uttar Pradesh,Gorakhpur,Locomotor Disability,15,35,3515,1403,4918
Uttar Pradesh,Gorakhpur,Locomotor Disability,35,60,3992,1157,5149
Uttar Pradesh,Gorakhpur,Locomotor Disability,60,80,915,168,1083
Uttar Pradesh,Gorakhpur,Locomotor Disability,80,100,26,6,32
Bihar,Gopalganj,Locomotor Disability,0,6,73,36,109
Bihar,Gopalganj,Locomotor Disability,6,15,444,267,711
Bihar,Gopalganj,Locomotor Disability,15,35,1640,554,2194
Bihar,Gopalganj,Locomotor Disability,35,60,1465,362,1827
Bihar,Gopalganj,Locomotor Disability,60,80,300,60,360
Bihar,Gopalganj,Locomotor Disability,80,100,13,2,15
Maharashtra,Gondia,Locomotor Disability,0,6,38,36,74
Maharashtra,Gondia,Locomotor Disability,6,15,230,142,372
Maharashtra,Gondia,Locomotor Disability,15,35,912,415,1327
Maharashtra,Gondia,Locomotor Disability,35,60,1627,521,2148
Maharashtra,Gondia,Locomotor Disability,60,80,349,75,424
Maharashtra,Gondia,Locomotor Disability,80,100,8,0,8
Uttar Pradesh,Gonda,Locomotor Disability,0,6,34,23,57
Uttar Pradesh,Gonda,Locomotor Disability,6,15,449,265,714
Uttar Pradesh,Gonda,Locomotor Disability,15,35,3025,1170,4195
Uttar Pradesh,Gonda,Locomotor Disability,35,60,3331,953,4284
Uttar Pradesh,Gonda,Locomotor Disability,60,80,578,115,693
Uttar Pradesh,Gonda,Locomotor Disability,80,100,27,2,29
Tripura,Gomati,Locomotor Disability,0,6,17,14,31
Tripura,Gomati,Locomotor Disability,6,15,138,83,221
Tripura,Gomati,Locomotor Disability,15,35,408,232,640
Tripura,Gomati,Locomotor Disability,35,60,648,308,956
Tripura,Gomati,Locomotor Disability,60,80,178,80,258
Tripura,Gomati,Locomotor Disability,80,100,10,3,13
Assam,Golaghat,Locomotor Disability,0,6,23,15,38
Assam,Golaghat,Locomotor Disability,6,15,135,95,230
Assam,Golaghat,Locomotor Disability,15,35,583,374,957
Assam,Golaghat,Locomotor Disability,35,60,763,413,1176
Assam,Golaghat,Locomotor Disability,60,80,167,62,229
Assam,Golaghat,Locomotor Disability,80,100,9,2,11
Jharkhand,Godda,Locomotor Disability,0,6,54,29,83
Jharkhand,Godda,Locomotor Disability,6,15,494,346,840
Jharkhand,Godda,Locomotor Disability,15,35,2233,1169,3402
Jharkhand,Godda,Locomotor Disability,35,60,2319,1036,3355
Jharkhand,Godda,Locomotor Disability,60,80,1012,481,1493
Jharkhand,Godda,Locomotor Disability,80,100,197,85,282
Assam,Goalpara,Locomotor Disability,0,6,97,81,178
Assam,Goalpara,Locomotor Disability,6,15,350,274,624
Assam,Goalpara,Locomotor Disability,15,35,1036,593,1629
Assam,Goalpara,Locomotor Disability,35,60,1422,722,2144
Assam,Goalpara,Locomotor Disability,60,80,417,227,644
Assam,Goalpara,Locomotor Disability,80,100,27,23,50
Jharkhand,Giridih,Locomotor Disability,0,6,34,11,45
Jharkhand,Giridih,Locomotor Disability,6,15,352,203,555
Jharkhand,Giridih,Locomotor Disability,15,35,1160,449,1609
Jharkhand,Giridih,Locomotor Disability,35,60,1089,360,1449
Jharkhand,Giridih,Locomotor Disability,60,80,188,53,241
Jharkhand,Giridih,Locomotor Disability,80,100,8,2,10
Gujarat,Gir Somnath,Locomotor Disability,0,6,10,7,17
Gujarat,Gir Somnath,Locomotor Disability,6,15,123,97,220
Gujarat,Gir Somnath,Locomotor Disability,15,35,568,346,914
Gujarat,Gir Somnath,Locomotor Disability,35,60,1038,399,1437
Gujarat,Gir Somnath,Locomotor Disability,60,80,221,40,261
Gujarat,Gir Somnath,Locomotor Disability,80,100,1,3,4
Uttar Pradesh,Ghazipur,Locomotor Disability,0,6,36,20,56
Uttar Pradesh,Ghazipur,Locomotor Disability,6,15,407,280,687
Uttar Pradesh,Ghazipur,Locomotor Disability,15,35,4150,1404,5554
Uttar Pradesh,Ghazipur,Locomotor Disability,35,60,3698,1174,4872
Uttar Pradesh,Ghazipur,Locomotor Disability,60,80,918,207,1125
Uttar Pradesh,Ghazipur,Locomotor Disability,80,100,50,12,62
Uttar Pradesh,Ghaziabad,Locomotor Disability,0,6,24,11,35
Uttar Pradesh,Ghaziabad,Locomotor Disability,6,15,169,89,258
Uttar Pradesh,Ghaziabad,Locomotor Disability,15,35,1966,908,2874
Uttar Pradesh,Ghaziabad,Locomotor Disability,35,60,2799,968,3767
Uttar Pradesh,Ghaziabad,Locomotor Disability,60,80,526,129,655
Uttar Pradesh,Ghaziabad,Locomotor Disability,80,100,11,7,18
Bihar,Gaya,Locomotor Disability,0,6,53,39,92
Bihar,Gaya,Locomotor Disability,6,15,401,202,603
Bihar,Gaya,Locomotor Disability,15,35,2356,989,3345
Bihar,Gaya,Locomotor Disability,35,60,1809,594,2403
Bihar,Gaya,Locomotor Disability,60,80,282,80,362
Bihar,Gaya,Locomotor Disability,80,100,13,1,14
Uttar Pradesh,Gautam Buddha Nagar,Locomotor Disability,0,6,11,4,15
Uttar Pradesh,Gautam Buddha Nagar,Locomotor Disability,6,15,84,56,140
Uttar Pradesh,Gautam Buddha Nagar,Locomotor Disability,15,35,968,314,1282
Uttar Pradesh,Gautam Buddha Nagar,Locomotor Disability,35,60,1151,277,1428
Uttar Pradesh,Gautam Buddha Nagar,Locomotor Disability,60,80,179,28,207
Uttar Pradesh,Gautam Buddha Nagar,Locomotor Disability,80,100,8,1,9
Chhattisgarh,Gaurella Pendra Marwahi,Locomotor Disability,0,6,3,9,12
Chhattisgarh,Gaurella Pendra Marwahi,Locomotor Disability,6,15,30,16,46
Chhattisgarh,Gaurella Pendra Marwahi,Locomotor Disability,15,35,133,57,190
Chhattisgarh,Gaurella Pendra Marwahi,Locomotor Disability,35,60,210,77,287
Chhattisgarh,Gaurella Pendra Marwahi,Locomotor Disability,60,80,47,25,72
Chhattisgarh,Gaurella Pendra Marwahi,Locomotor Disability,80,100,0,4,4
Chhattisgarh,Gariyaband,Locomotor Disability,0,6,40,21,61
Chhattisgarh,Gariyaband,Locomotor Disability,6,15,265,179,444
Chhattisgarh,Gariyaband,Locomotor Disability,15,35,963,525,1488
Chhattisgarh,Gariyaband,Locomotor Disability,35,60,1558,657,2215
Chhattisgarh,Gariyaband,Locomotor Disability,60,80,380,132,512
Chhattisgarh,Gariyaband,Locomotor Disability,80,100,11,2,13
Jharkhand,Garhwa,Locomotor Disability,0,6,47,19,66
Jharkhand,Garhwa,Locomotor Disability,6,15,278,204,482
Jharkhand,Garhwa,Locomotor Disability,15,35,1280,633,1913
Jharkhand,Garhwa,Locomotor Disability,35,60,1286,533,1819
Jharkhand,Garhwa,Locomotor Disability,60,80,173,95,268
Jharkhand,Garhwa,Locomotor Disability,80,100,8,3,11
Odisha,Ganjam,Locomotor Disability,0,6,166,98,264
Odisha,Ganjam,Locomotor Disability,6,15,905,553,1458
Odisha,Ganjam,Locomotor Disability,15,35,3430,1989,5419
Odisha,Ganjam,Locomotor Disability,35,60,6210,2644,8854
Odisha,Ganjam,Locomotor Disability,60,80,1760,538,2298
Odisha,Ganjam,Locomotor Disability,80,100,56,19,75
Sikkim,Gangtok,Locomotor Disability,0,6,0,2,2
Sikkim,Gangtok,Locomotor Disability,6,15,15,14,29
Sikkim,Gangtok,Locomotor Disability,15,35,89,64,153
Sikkim,Gangtok,Locomotor Disability,35,60,145,96,241
Sikkim,Gangtok,Locomotor Disability,60,80,34,12,46
Sikkim,Gangtok,Locomotor Disability,80,100,3,2,5
Rajasthan,Ganganagar,Locomotor Disability,0,6,44,16,60
Rajasthan,Ganganagar,Locomotor Disability,6,15,413,237,650
Rajasthan,Ganganagar,Locomotor Disability,15,35,2749,1411,4160
Rajasthan,Ganganagar,Locomotor Disability,35,60,4405,2140,6545
Rajasthan,Ganganagar,Locomotor Disability,60,80,1043,414,1457
Rajasthan,Ganganagar,Locomotor Disability,80,100,87,36,123
Gujarat,Gandhinagar,Locomotor Disability,0,6,17,7,24
Gujarat,Gandhinagar,Locomotor Disability,6,15,185,105,290
Gujarat,Gandhinagar,Locomotor Disability,15,35,478,216,694
Gujarat,Gandhinagar,Locomotor Disability,35,60,1015,398,1413
Gujarat,Gandhinagar,Locomotor Disability,60,80,219,39,258
Gujarat,Gandhinagar,Locomotor Disability,80,100,1,0,1
Jammu And Kashmir,Ganderbal,Locomotor Disability,0,6,24,14,38
Jammu And Kashmir,Ganderbal,Locomotor Disability,6,15,75,60,135
Jammu And Kashmir,Ganderbal,Locomotor Disability,15,35,311,274,585
Jammu And Kashmir,Ganderbal,Locomotor Disability,35,60,509,393,902
Jammu And Kashmir,Ganderbal,Locomotor Disability,60,80,95,61,156
Jammu And Kashmir,Ganderbal,Locomotor Disability,80,100,7,6,13
Odisha,Gajapati,Locomotor Disability,0,6,78,45,123
Odisha,Gajapati,Locomotor Disability,6,15,454,325,779
Odisha,Gajapati,Locomotor Disability,15,35,1685,1042,2727
Odisha,Gajapati,Locomotor Disability,35,60,3030,1778,4808
Odisha,Gajapati,Locomotor Disability,60,80,1193,719,1912
Odisha,Gajapati,Locomotor Disability,80,100,75,55,130
Maharashtra,Gadchiroli,Locomotor Disability,0,6,105,74,179
Maharashtra,Gadchiroli,Locomotor Disability,6,15,394,284,678
Maharashtra,Gadchiroli,Locomotor Disability,15,35,1669,1001,2670
Maharashtra,Gadchiroli,Locomotor Disability,35,60,2775,1392,4167
Maharashtra,Gadchiroli,Locomotor Disability,60,80,795,326,1121
Maharashtra,Gadchiroli,Locomotor Disability,80,100,30,10,40
Karnataka,Gadag,Locomotor Disability,0,6,64,34,98
Karnataka,Gadag,Locomotor Disability,6,15,386,252,638
Karnataka,Gadag,Locomotor Disability,15,35,1601,1000,2601
Karnataka,Gadag,Locomotor Disability,35,60,3563,1597,5160
Karnataka,Gadag,Locomotor Disability,60,80,792,215,1007
Karnataka,Gadag,Locomotor Disability,80,100,30,7,37
Uttar Pradesh,Firozabad,Locomotor Disability,0,6,33,19,52
Uttar Pradesh,Firozabad,Locomotor Disability,6,15,433,236,669
Uttar Pradesh,Firozabad,Locomotor Disability,15,35,4778,1739,6517
Uttar Pradesh,Firozabad,Locomotor Disability,35,60,8389,2841,11230
Uttar Pradesh,Firozabad,Locomotor Disability,60,80,913,164,1077
Uttar Pradesh,Firozabad,Locomotor Disability,80,100,30,7,37
Punjab,Ferozepur,Locomotor Disability,0,6,16,3,19
Punjab,Ferozepur,Locomotor Disability,6,15,121,76,197
Punjab,Ferozepur,Locomotor Disability,15,35,1210,572,1782
Punjab,Ferozepur,Locomotor Disability,35,60,1939,896,2835
Punjab,Ferozepur,Locomotor Disability,60,80,403,82,485
Punjab,Ferozepur,Locomotor Disability,80,100,21,5,26
Punjab,Fazilka,Locomotor Disability,0,6,59,24,83
Punjab,Fazilka,Locomotor Disability,6,15,271,148,419
Punjab,Fazilka,Locomotor Disability,15,35,1902,1077,2979
Punjab,Fazilka,Locomotor Disability,35,60,3102,1484,4586
Punjab,Fazilka,Locomotor Disability,60,80,636,143,779
Punjab,Fazilka,Locomotor Disability,80,100,38,12,50
Uttar Pradesh,Fatehpur,Locomotor Disability,0,6,30,16,46
Uttar Pradesh,Fatehpur,Locomotor Disability,6,15,368,206,574
Uttar Pradesh,Fatehpur,Locomotor Disability,15,35,3731,1243,4974
Uttar Pradesh,Fatehpur,Locomotor Disability,35,60,5275,1325,6600
Uttar Pradesh,Fatehpur,Locomotor Disability,60,80,1658,331,1989
Uttar Pradesh,Fatehpur,Locomotor Disability,80,100,81,11,92
Punjab,Fatehgarh Sahib,Locomotor Disability,0,6,9,10,19
Punjab,Fatehgarh Sahib,Locomotor Disability,6,15,95,55,150
Punjab,Fatehgarh Sahib,Locomotor Disability,15,35,692,332,1024
Punjab,Fatehgarh Sahib,Locomotor Disability,35,60,1973,830,2803
Punjab,Fatehgarh Sahib,Locomotor Disability,60,80,608,120,728
Punjab,Fatehgarh Sahib,Locomotor Disability,80,100,39,15,54
Haryana,Fatehabad,Locomotor Disability,0,6,32,25,57
Haryana,Fatehabad,Locomotor Disability,6,15,196,102,298
Haryana,Fatehabad,Locomotor Disability,15,35,863,410,1273
Haryana,Fatehabad,Locomotor Disability,35,60,1376,592,1968
Haryana,Fatehabad,Locomotor Disability,60,80,213,61,274
Haryana,Fatehabad,Locomotor Disability,80,100,10,4,14
Uttar Pradesh,Farrukhabad,Locomotor Disability,0,6,10,3,13
Uttar Pradesh,Farrukhabad,Locomotor Disability,6,15,205,149,354
Uttar Pradesh,Farrukhabad,Locomotor Disability,15,35,3400,1306,4706
Uttar Pradesh,Farrukhabad,Locomotor Disability,35,60,3705,1247,4952
Uttar Pradesh,Farrukhabad,Locomotor Disability,60,80,795,195,990
Uttar Pradesh,Farrukhabad,Locomotor Disability,80,100,32,5,37
Punjab,Faridkot,Locomotor Disability,0,6,31,15,46
Punjab,Faridkot,Locomotor Disability,6,15,96,58,154
Punjab,Faridkot,Locomotor Disability,15,35,699,386,1085
Punjab,Faridkot,Locomotor Disability,35,60,1626,802,2428
Punjab,Faridkot,Locomotor Disability,60,80,457,125,582
Punjab,Faridkot,Locomotor Disability,80,100,34,11,45
Haryana,Faridabad,Locomotor Disability,0,6,38,26,64
Haryana,Faridabad,Locomotor Disability,6,15,213,125,338
Haryana,Faridabad,Locomotor Disability,15,35,823,445,1268
Haryana,Faridabad,Locomotor Disability,35,60,1188,498,1686
Haryana,Faridabad,Locomotor Disability,60,80,178,35,213
Haryana,Faridabad,Locomotor Disability,80,100,5,3,8
Uttar Pradesh,Etawah,Locomotor Disability,0,6,13,12,25
Uttar Pradesh,Etawah,Locomotor Disability,6,15,209,151,360
Uttar Pradesh,Etawah,Locomotor Disability,15,35,2014,838,2852
Uttar Pradesh,Etawah,Locomotor Disability,35,60,2991,909,3900
Uttar Pradesh,Etawah,Locomotor Disability,60,80,699,168,867
Uttar Pradesh,Etawah,Locomotor Disability,80,100,55,7,62
Uttar Pradesh,Etah,Locomotor Disability,0,6,7,2,9
Uttar Pradesh,Etah,Locomotor Disability,6,15,117,45,162
Uttar Pradesh,Etah,Locomotor Disability,15,35,2654,849,3503
Uttar Pradesh,Etah,Locomotor Disability,35,60,2603,770,3373
Uttar Pradesh,Etah,Locomotor Disability,60,80,520,125,645
Uttar Pradesh,Etah,Locomotor Disability,80,100,39,2,41
Tamil Nadu,Erode,Locomotor Disability,0,6,15,10,25
Tamil Nadu,Erode,Locomotor Disability,6,15,139,92,231
Tamil Nadu,Erode,Locomotor Disability,15,35,690,451,1141
Tamil Nadu,Erode,Locomotor Disability,35,60,3000,1585,4585
Tamil Nadu,Erode,Locomotor Disability,60,80,1153,347,1500
Tamil Nadu,Erode,Locomotor Disability,80,100,45,13,58
Kerala,Ernakulam,Locomotor Disability,0,6,12,11,23
Kerala,Ernakulam,Locomotor Disability,6,15,84,73,157
Kerala,Ernakulam,Locomotor Disability,15,35,545,377,922
Kerala,Ernakulam,Locomotor Disability,35,60,2100,1178,3278
Kerala,Ernakulam,Locomotor Disability,60,80,1367,565,1932
Kerala,Ernakulam,Locomotor Disability,80,100,75,48,123
Meghalaya,Eastern West Khasi Hills,Locomotor Disability,0,6,8,11,19
Meghalaya,Eastern West Khasi Hills,Locomotor Disability,6,15,31,22,53
Meghalaya,Eastern West Khasi Hills,Locomotor Disability,15,35,123,90,213
Meghalaya,Eastern West Khasi Hills,Locomotor Disability,35,60,78,52,130
Meghalaya,Eastern West Khasi Hills,Locomotor Disability,60,80,15,8,23
Meghalaya,Eastern West Khasi Hills,Locomotor Disability,80,100,0,1,1
Jharkhand,East Singhbum,Locomotor Disability,0,6,25,28,53
Jharkhand,East Singhbum,Locomotor Disability,6,15,210,163,373
Jharkhand,East Singhbum,Locomotor Disability,15,35,1011,609,1620
Jharkhand,East Singhbum,Locomotor Disability,35,60,1654,788,2442
Jharkhand,East Singhbum,Locomotor Disability,60,80,444,160,604
Jharkhand,East Singhbum,Locomotor Disability,80,100,23,6,29
Arunachal Pradesh,East Siang,Locomotor Disability,0,6,1,3,4
Arunachal Pradesh,East Siang,Locomotor Disability,6,15,4,1,5
Arunachal Pradesh,East Siang,Locomotor Disability,15,35,48,20,68
Arunachal Pradesh,East Siang,Locomotor Disability,35,60,38,27,65
Arunachal Pradesh,East Siang,Locomotor Disability,60,80,14,5,19
Arunachal Pradesh,East Siang,Locomotor Disability,80,100,1,1,2
Madhya Pradesh,East Nimar,Locomotor Disability,0,6,2,4,6
Madhya Pradesh,East Nimar,Locomotor Disability,6,15,168,116,284
Madhya Pradesh,East Nimar,Locomotor Disability,15,35,1721,941,2662
Madhya Pradesh,East Nimar,Locomotor Disability,35,60,2791,1084,3875
Madhya Pradesh,East Nimar,Locomotor Disability,60,80,754,215,969
Madhya Pradesh,East Nimar,Locomotor Disability,80,100,31,9,40
Meghalaya,East Khasi Hills,Locomotor Disability,0,6,18,26,44
Meghalaya,East Khasi Hills,Locomotor Disability,6,15,119,70,189
Meghalaya,East Khasi Hills,Locomotor Disability,15,35,611,489,1100
Meghalaya,East Khasi Hills,Locomotor Disability,35,60,524,328,852
Meghalaya,East Khasi Hills,Locomotor Disability,60,80,120,72,192
Meghalaya,East Khasi Hills,Locomotor Disability,80,100,12,9,21
Arunachal Pradesh,East Kameng,Locomotor Disability,0,6,1,1,2
Arunachal Pradesh,East Kameng,Locomotor Disability,6,15,10,2,12
Arunachal Pradesh,East Kameng,Locomotor Disability,15,35,46,17,63
Arunachal Pradesh,East Kameng,Locomotor Disability,35,60,34,9,43
Arunachal Pradesh,East Kameng,Locomotor Disability,60,80,5,2,7
Meghalaya,East Jaintia Hills,Locomotor Disability,0,6,10,10,20
Meghalaya,East Jaintia Hills,Locomotor Disability,6,15,30,25,55
Meghalaya,East Jaintia Hills,Locomotor Disability,15,35,146,94,240
Meghalaya,East Jaintia Hills,Locomotor Disability,35,60,92,65,157
Meghalaya,East Jaintia Hills,Locomotor Disability,60,80,26,19,45
Meghalaya,East Jaintia Hills,Locomotor Disability,80,100,1,2,3
Andhra Pradesh,East Godavari,Locomotor Disability,0,6,135,70,205
Andhra Pradesh,East Godavari,Locomotor Disability,6,15,900,509,1409
Andhra Pradesh,East Godavari,Locomotor Disability,15,35,3204,1003,4207
Andhra Pradesh,East Godavari,Locomotor Disability,35,60,13446,1169,14615
Andhra Pradesh,East Godavari,Locomotor Disability,60,80,4166,327,4493
Andhra Pradesh,East Godavari,Locomotor Disability,80,100,211,16,227
Meghalaya,East Garo Hills,Locomotor Disability,0,6,9,7,16
Meghalaya,East Garo Hills,Locomotor Disability,6,15,34,24,58
Meghalaya,East Garo Hills,Locomotor Disability,15,35,162,125,287
Meghalaya,East Garo Hills,Locomotor Disability,35,60,179,89,268
Meghalaya,East Garo Hills,Locomotor Disability,60,80,69,22,91
Meghalaya,East Garo Hills,Locomotor Disability,80,100,5,2,7
Delhi,East,Locomotor Disability,0,6,6,13,19
Delhi,East,Locomotor Disability,6,15,133,120,253
Delhi,East,Locomotor Disability,15,35,589,334,923
Delhi,East,Locomotor Disability,35,60,847,276,1123
Delhi,East,Locomotor Disability,60,80,169,36,205
Delhi,East,Locomotor Disability,80,100,4,0,4
Chhattisgarh,Durg,Locomotor Disability,0,6,12,15,27
Chhattisgarh,Durg,Locomotor Disability,6,15,208,145,353
Chhattisgarh,Durg,Locomotor Disability,15,35,1512,945,2457
Chhattisgarh,Durg,Locomotor Disability,35,60,3137,1393,4530
Chhattisgarh,Durg,Locomotor Disability,60,80,662,216,878
Chhattisgarh,Durg,Locomotor Disability,80,100,42,25,67
Rajasthan,Dungarpur,Locomotor Disability,0,6,15,5,20
Rajasthan,Dungarpur,Locomotor Disability,6,15,160,108,268
Rajasthan,Dungarpur,Locomotor Disability,15,35,900,509,1409
Rajasthan,Dungarpur,Locomotor Disability,35,60,1336,606,1942
Rajasthan,Dungarpur,Locomotor Disability,60,80,318,152,470
Rajasthan,Dungarpur,Locomotor Disability,80,100,16,8,24
Jharkhand,Dumka,Locomotor Disability,0,6,20,17,37
Jharkhand,Dumka,Locomotor Disability,6,15,226,166,392
Jharkhand,Dumka,Locomotor Disability,15,35,717,347,1064
Jharkhand,Dumka,Locomotor Disability,35,60,1069,415,1484
Jharkhand,Dumka,Locomotor Disability,60,80,229,102,331
Jharkhand,Dumka,Locomotor Disability,80,100,9,3,12
Gujarat,Dohad,Locomotor Disability,0,6,37,26,63
Gujarat,Dohad,Locomotor Disability,6,15,559,440,999
Gujarat,Dohad,Locomotor Disability,15,35,1668,1030,2698
Gujarat,Dohad,Locomotor Disability,35,60,1940,809,2749
Gujarat,Dohad,Locomotor Disability,60,80,304,70,374
Gujarat,Dohad,Locomotor Disability,80,100,8,0,8
Jammu And Kashmir,Doda,Locomotor Disability,0,6,28,19,47
Jammu And Kashmir,Doda,Locomotor Disability,6,15,213,128,341
Jammu And Kashmir,Doda,Locomotor Disability,15,35,1047,589,1636
Jammu And Kashmir,Doda,Locomotor Disability,35,60,1431,773,2204
Jammu And Kashmir,Doda,Locomotor Disability,60,80,289,184,473
Jammu And Kashmir,Doda,Locomotor Disability,80,100,18,24,42
Dadra Nagar Haveli And Daman And Diu,Diu,Locomotor Disability,6,15,7,7,14
Dadra Nagar Haveli And Daman And Diu,Diu,Locomotor Disability,15,35,26,20,46
Dadra Nagar Haveli And Daman And Diu,Diu,Locomotor Disability,35,60,102,50,152
Dadra Nagar Haveli And Daman And Diu,Diu,Locomotor Disability,60,80,28,13,41
Dadra Nagar Haveli And Daman And Diu,Diu,Locomotor Disability,80,100,0,1,1
Madhya Pradesh,Dindori,Locomotor Disability,0,6,9,9,18
Madhya Pradesh,Dindori,Locomotor Disability,6,15,136,119,255
Madhya Pradesh,Dindori,Locomotor Disability,15,35,1031,711,1742
Madhya Pradesh,Dindori,Locomotor Disability,35,60,1326,717,2043
Madhya Pradesh,Dindori,Locomotor Disability,60,80,322,137,459
Madhya Pradesh,Dindori,Locomotor Disability,80,100,18,4,22
Tamil Nadu,Dindigul,Locomotor Disability,0,6,24,23,47
Tamil Nadu,Dindigul,Locomotor Disability,6,15,211,121,332
Tamil Nadu,Dindigul,Locomotor Disability,15,35,1160,701,1861
Tamil Nadu,Dindigul,Locomotor Disability,35,60,3931,2113,6044
Tamil Nadu,Dindigul,Locomotor Disability,60,80,1501,544,2045
Tamil Nadu,Dindigul,Locomotor Disability,80,100,75,18,93
Nagaland,Dimapur,Locomotor Disability,0,6,1,0,1
Nagaland,Dimapur,Locomotor Disability,6,15,7,2,9
Nagaland,Dimapur,Locomotor Disability,15,35,36,14,50
Nagaland,Dimapur,Locomotor Disability,35,60,30,7,37
Nagaland,Dimapur,Locomotor Disability,60,80,9,1,10
Nagaland,Dimapur,Locomotor Disability,80,100,3,2,5
Assam,Dima Hasao,Locomotor Disability,6,15,4,10,14
Assam,Dima Hasao,Locomotor Disability,15,35,42,33,75
Assam,Dima Hasao,Locomotor Disability,35,60,43,22,65
Assam,Dima Hasao,Locomotor Disability,60,80,1,6,7
Assam,Dima Hasao,Locomotor Disability,80,100,1,0,1
Assam,Dibrugarh,Locomotor Disability,0,6,14,10,24
Assam,Dibrugarh,Locomotor Disability,6,15,62,51,113
Assam,Dibrugarh,Locomotor Disability,15,35,319,206,525
Assam,Dibrugarh,Locomotor Disability,35,60,433,214,647
Assam,Dibrugarh,Locomotor Disability,60,80,91,40,131
Assam,Dibrugarh,Locomotor Disability,80,100,1,0,1
Arunachal Pradesh,Dibang Valley,Locomotor Disability,15,35,1,0,1
Maharashtra,Dhule,Locomotor Disability,0,6,60,29,89
Maharashtra,Dhule,Locomotor Disability,6,15,622,354,976
Maharashtra,Dhule,Locomotor Disability,15,35,2659,1266,3925
Maharashtra,Dhule,Locomotor Disability,35,60,6109,1811,7920
Maharashtra,Dhule,Locomotor Disability,60,80,1676,314,1990
Maharashtra,Dhule,Locomotor Disability,80,100,92,9,101
Assam,Dhubri,Locomotor Disability,0,6,28,25,53
Assam,Dhubri,Locomotor Disability,6,15,188,110,298
Assam,Dhubri,Locomotor Disability,15,35,548,345,893
Assam,Dhubri,Locomotor Disability,35,60,629,243,872
Assam,Dhubri,Locomotor Disability,60,80,132,37,169
Assam,Dhubri,Locomotor Disability,80,100,3,2,5
Rajasthan,Dholpur,Locomotor Disability,0,6,20,10,30
Rajasthan,Dholpur,Locomotor Disability,6,15,354,128,482
Rajasthan,Dholpur,Locomotor Disability,15,35,1909,892,2801
Rajasthan,Dholpur,Locomotor Disability,35,60,1923,907,2830
Rajasthan,Dholpur,Locomotor Disability,60,80,392,161,553
Rajasthan,Dholpur,Locomotor Disability,80,100,12,8,20
Odisha,Dhenkanal,Locomotor Disability,0,6,74,48,122
Odisha,Dhenkanal,Locomotor Disability,6,15,460,243,703
Odisha,Dhenkanal,Locomotor Disability,15,35,1343,624,1967
Odisha,Dhenkanal,Locomotor Disability,35,60,3369,1181,4550
Odisha,Dhenkanal,Locomotor Disability,60,80,1054,425,1479
Odisha,Dhenkanal,Locomotor Disability,80,100,51,13,64
Assam,Dhemaji,Locomotor Disability,0,6,19,13,32
Assam,Dhemaji,Locomotor Disability,6,15,135,67,202
Assam,Dhemaji,Locomotor Disability,15,35,301,174,475
Assam,Dhemaji,Locomotor Disability,35,60,402,180,582
Assam,Dhemaji,Locomotor Disability,60,80,100,35,135
Assam,Dhemaji,Locomotor Disability,80,100,6,4,10
Karnataka,Dharwad,Locomotor Disability,0,6,122,89,211
Karnataka,Dharwad,Locomotor Disability,6,15,619,346,965
Karnataka,Dharwad,Locomotor Disability,15,35,2158,1460,3618
Karnataka,Dharwad,Locomotor Disability,35,60,5234,2628,7862
Karnataka,Dharwad,Locomotor Disability,60,80,1232,301,1533
Karnataka,Dharwad,Locomotor Disability,80,100,48,14,62
Tamil Nadu,Dharmapuri,Locomotor Disability,0,6,23,12,35
Tamil Nadu,Dharmapuri,Locomotor Disability,6,15,178,116,294
Tamil Nadu,Dharmapuri,Locomotor Disability,15,35,954,485,1439
Tamil Nadu,Dharmapuri,Locomotor Disability,35,60,2932,1359,4291
Tamil Nadu,Dharmapuri,Locomotor Disability,60,80,1071,398,1469
Tamil Nadu,Dharmapuri,Locomotor Disability,80,100,51,29,80
Madhya Pradesh,Dhar,Locomotor Disability,0,6,17,12,29
Madhya Pradesh,Dhar,Locomotor Disability,6,15,265,191,456
Madhya Pradesh,Dhar,Locomotor Disability,15,35,3279,1749,5028
Madhya Pradesh,Dhar,Locomotor Disability,35,60,4560,1979,6539
Madhya Pradesh,Dhar,Locomotor Disability,60,80,809,278,1087
Madhya Pradesh,Dhar,Locomotor Disability,80,100,41,27,68
Jharkhand,Dhanbad,Locomotor Disability,0,6,9,3,12
Jharkhand,Dhanbad,Locomotor Disability,6,15,111,70,181
Jharkhand,Dhanbad,Locomotor Disability,15,35,903,443,1346
Jharkhand,Dhanbad,Locomotor Disability,35,60,860,378,1238
Jharkhand,Dhanbad,Locomotor Disability,60,80,147,43,190
Jharkhand,Dhanbad,Locomotor Disability,80,100,4,1,5
Chhattisgarh,Dhamtari,Locomotor Disability,0,6,6,10,16
Chhattisgarh,Dhamtari,Locomotor Disability,6,15,141,101,242
Chhattisgarh,Dhamtari,Locomotor Disability,15,35,1059,567,1626
Chhattisgarh,Dhamtari,Locomotor Disability,35,60,1835,852,2687
Chhattisgarh,Dhamtari,Locomotor Disability,60,80,476,132,608
Chhattisgarh,Dhamtari,Locomotor Disability,80,100,21,11,32
Tripura,Dhalai,Locomotor Disability,0,6,19,8,27
Tripura,Dhalai,Locomotor Disability,6,15,180,94,274
Tripura,Dhalai,Locomotor Disability,15,35,476,257,733
Tripura,Dhalai,Locomotor Disability,35,60,753,355,1108
Tripura,Dhalai,Locomotor Disability,60,80,292,102,394
Tripura,Dhalai,Locomotor Disability,80,100,19,17,36
Madhya Pradesh,Dewas,Locomotor Disability,0,6,3,7,10
Madhya Pradesh,Dewas,Locomotor Disability,6,15,238,134,372
Madhya Pradesh,Dewas,Locomotor Disability,15,35,1922,949,2871
Madhya Pradesh,Dewas,Locomotor Disability,35,60,3398,1453,4851
Madhya Pradesh,Dewas,Locomotor Disability,60,80,737,220,957
Madhya Pradesh,Dewas,Locomotor Disability,80,100,41,14,55
Gujarat,Devbhumi Dwarka,Locomotor Disability,0,6,7,8,15
Gujarat,Devbhumi Dwarka,Locomotor Disability,6,15,105,63,168
Gujarat,Devbhumi Dwarka,Locomotor Disability,15,35,358,196,554
Gujarat,Devbhumi Dwarka,Locomotor Disability,35,60,785,294,1079
Gujarat,Devbhumi Dwarka,Locomotor Disability,60,80,222,46,268
Gujarat,Devbhumi Dwarka,Locomotor Disability,80,100,9,1,10
Uttar Pradesh,Deoria,Locomotor Disability,0,6,30,22,52
Uttar Pradesh,Deoria,Locomotor Disability,6,15,387,226,613
Uttar Pradesh,Deoria,Locomotor Disability,15,35,3425,1233,4658
Uttar Pradesh,Deoria,Locomotor Disability,35,60,4019,1054,5073
Uttar Pradesh,Deoria,Locomotor Disability,60,80,1218,242,1460
Uttar Pradesh,Deoria,Locomotor Disability,80,100,44,3,47
Jharkhand,Deoghar,Locomotor Disability,0,6,17,6,23
Jharkhand,Deoghar,Locomotor Disability,6,15,109,68,177
Jharkhand,Deoghar,Locomotor Disability,15,35,330,135,465
Jharkhand,Deoghar,Locomotor Disability,35,60,280,113,393
Jharkhand,Deoghar,Locomotor Disability,60,80,61,18,79
Jharkhand,Deoghar,Locomotor Disability,80,100,5,3,8
Odisha,Deogarh,Locomotor Disability,0,6,20,13,33
Odisha,Deogarh,Locomotor Disability,6,15,100,65,165
Odisha,Deogarh,Locomotor Disability,15,35,421,176,597
Odisha,Deogarh,Locomotor Disability,35,60,801,474,1275
Odisha,Deogarh,Locomotor Disability,60,80,197,105,302
Odisha,Deogarh,Locomotor Disability,80,100,6,7,13
Uttarakhand,Dehradun,Locomotor Disability,0,6,26,21,47
Uttarakhand,Dehradun,Locomotor Disability,6,15,154,95,249
Uttarakhand,Dehradun,Locomotor Disability,15,35,1033,507,1540
Uttarakhand,Dehradun,Locomotor Disability,35,60,1706,732,2438
Uttarakhand,Dehradun,Locomotor Disability,60,80,431,155,586
Uttarakhand,Dehradun,Locomotor Disability,80,100,26,5,31
Karnataka,Davangere,Locomotor Disability,0,6,99,60,159
Karnataka,Davangere,Locomotor Disability,6,15,426,286,712
Karnataka,Davangere,Locomotor Disability,15,35,1656,1142,2798
Karnataka,Davangere,Locomotor Disability,35,60,4509,2140,6649
Karnataka,Davangere,Locomotor Disability,60,80,1051,315,1366
Karnataka,Davangere,Locomotor Disability,80,100,34,10,44
Rajasthan,Dausa,Locomotor Disability,0,6,29,18,47
Rajasthan,Dausa,Locomotor Disability,6,15,445,272,717
Rajasthan,Dausa,Locomotor Disability,15,35,3276,2145,5421
Rajasthan,Dausa,Locomotor Disability,35,60,3960,1755,5715
Rajasthan,Dausa,Locomotor Disability,60,80,726,266,992
Rajasthan,Dausa,Locomotor Disability,80,100,43,22,65
Madhya Pradesh,Datia,Locomotor Disability,0,6,16,15,31
Madhya Pradesh,Datia,Locomotor Disability,6,15,254,163,417
Madhya Pradesh,Datia,Locomotor Disability,15,35,2006,862,2868
Madhya Pradesh,Datia,Locomotor Disability,35,60,2870,1098,3968
Madhya Pradesh,Datia,Locomotor Disability,60,80,841,296,1137
Madhya Pradesh,Datia,Locomotor Disability,80,100,50,18,68
Assam,Darrang,Locomotor Disability,0,6,26,7,33
Assam,Darrang,Locomotor Disability,6,15,217,146,363
Assam,Darrang,Locomotor Disability,15,35,807,496,1303
Assam,Darrang,Locomotor Disability,35,60,1051,509,1560
Assam,Darrang,Locomotor Disability,60,80,248,79,327
Assam,Darrang,Locomotor Disability,80,100,20,8,28
Bihar,Darbhanga,Locomotor Disability,0,6,19,17,36
Bihar,Darbhanga,Locomotor Disability,6,15,397,260,657
Bihar,Darbhanga,Locomotor Disability,15,35,2243,998,3241
Bihar,Darbhanga,Locomotor Disability,35,60,1895,613,2508
Bihar,Darbhanga,Locomotor Disability,60,80,586,160,746
Bihar,Darbhanga,Locomotor Disability,80,100,20,3,23
Chhattisgarh,Dantewada,Locomotor Disability,0,6,14,6,20
Chhattisgarh,Dantewada,Locomotor Disability,6,15,93,79,172
Chhattisgarh,Dantewada,Locomotor Disability,15,35,539,257,796
Chhattisgarh,Dantewada,Locomotor Disability,35,60,493,226,719
Chhattisgarh,Dantewada,Locomotor Disability,60,80,114,65,179
Chhattisgarh,Dantewada,Locomotor Disability,80,100,5,5,10
Gujarat,Dang,Locomotor Disability,0,6,3,1,4
Gujarat,Dang,Locomotor Disability,6,15,45,32,77
Gujarat,Dang,Locomotor Disability,15,35,147,79,226
Gujarat,Dang,Locomotor Disability,35,60,223,72,295
Gujarat,Dang,Locomotor Disability,60,80,42,11,53
Gujarat,Dang,Locomotor Disability,80,100,1,1,2
Madhya Pradesh,Damoh,Locomotor Disability,0,6,2,4,6
Madhya Pradesh,Damoh,Locomotor Disability,6,15,134,100,234
Madhya Pradesh,Damoh,Locomotor Disability,15,35,2250,899,3149
Madhya Pradesh,Damoh,Locomotor Disability,35,60,3331,1246,4577
Madhya Pradesh,Damoh,Locomotor Disability,60,80,737,315,1052
Madhya Pradesh,Damoh,Locomotor Disability,80,100,23,13,36
Dadra Nagar Haveli And Daman And Diu,Daman,Locomotor Disability,0,6,2,2,4
Dadra Nagar Haveli And Daman And Diu,Daman,Locomotor Disability,6,15,29,16,45
Dadra Nagar Haveli And Daman And Diu,Daman,Locomotor Disability,15,35,145,48,193
Dadra Nagar Haveli And Daman And Diu,Daman,Locomotor Disability,35,60,169,64,233
Dadra Nagar Haveli And Daman And Diu,Daman,Locomotor Disability,60,80,36,14,50
Dadra Nagar Haveli And Daman And Diu,Daman,Locomotor Disability,80,100,0,3,3
Karnataka,Dakshina Kannada,Locomotor Disability,0,6,39,27,66
Karnataka,Dakshina Kannada,Locomotor Disability,6,15,189,160,349
Karnataka,Dakshina Kannada,Locomotor Disability,15,35,718,463,1181
Karnataka,Dakshina Kannada,Locomotor Disability,35,60,2713,1269,3982
Karnataka,Dakshina Kannada,Locomotor Disability,60,80,1076,387,1463
Karnataka,Dakshina Kannada,Locomotor Disability,80,100,44,19,63
Dadra Nagar Haveli And Daman And Diu,Dadra And Nagar Haveli,Locomotor Disability,0,6,4,1,5
Dadra Nagar Haveli And Daman And Diu,Dadra And Nagar Haveli,Locomotor Disability,6,15,38,26,64
Dadra Nagar Haveli And Daman And Diu,Dadra And Nagar Haveli,Locomotor Disability,15,35,93,37,130
Dadra Nagar Haveli And Daman And Diu,Dadra And Nagar Haveli,Locomotor Disability,35,60,194,61,255
Dadra Nagar Haveli And Daman And Diu,Dadra And Nagar Haveli,Locomotor Disability,60,80,36,6,42
Dadra Nagar Haveli And Daman And Diu,Dadra And Nagar Haveli,Locomotor Disability,80,100,1,1,2
Odisha,Cuttack,Locomotor Disability,0,6,99,72,171
Odisha,Cuttack,Locomotor Disability,6,15,517,393,910
Odisha,Cuttack,Locomotor Disability,15,35,1461,685,2146
Odisha,Cuttack,Locomotor Disability,35,60,3622,1293,4915
Odisha,Cuttack,Locomotor Disability,60,80,958,311,1269
Odisha,Cuttack,Locomotor Disability,80,100,41,19,60
Tamil Nadu,Cuddalore,Locomotor Disability,0,6,43,25,68
Tamil Nadu,Cuddalore,Locomotor Disability,6,15,342,211,553
Tamil Nadu,Cuddalore,Locomotor Disability,15,35,1589,931,2520
Tamil Nadu,Cuddalore,Locomotor Disability,35,60,5711,2872,8583
Tamil Nadu,Cuddalore,Locomotor Disability,60,80,2003,769,2772
Tamil Nadu,Cuddalore,Locomotor Disability,80,100,102,40,142
West Bengal,Coochbehar,Locomotor Disability,15,35,1,0,1
West Bengal,Coochbehar,Locomotor Disability,35,60,3,0,3
Tamil Nadu,Coimbatore,Locomotor Disability,0,6,11,10,21
Tamil Nadu,Coimbatore,Locomotor Disability,6,15,155,133,288
Tamil Nadu,Coimbatore,Locomotor Disability,15,35,742,504,1246
Tamil Nadu,Coimbatore,Locomotor Disability,35,60,2492,1153,3645
Tamil Nadu,Coimbatore,Locomotor Disability,60,80,813,193,1006
Tamil Nadu,Coimbatore,Locomotor Disability,80,100,34,7,41
Rajasthan,Churu,Locomotor Disability,0,6,26,23,49
Rajasthan,Churu,Locomotor Disability,6,15,317,161,478
Rajasthan,Churu,Locomotor Disability,15,35,1855,745,2600
Rajasthan,Churu,Locomotor Disability,35,60,2408,721,3129
Rajasthan,Churu,Locomotor Disability,60,80,481,114,595
Rajasthan,Churu,Locomotor Disability,80,100,13,9,22
Manipur,Churachandpur,Locomotor Disability,0,6,10,4,14
Manipur,Churachandpur,Locomotor Disability,6,15,29,10,39
Manipur,Churachandpur,Locomotor Disability,15,35,69,38,107
Manipur,Churachandpur,Locomotor Disability,35,60,80,42,122
Manipur,Churachandpur,Locomotor Disability,60,80,46,9,55
Manipur,Churachandpur,Locomotor Disability,80,100,4,1,5
Rajasthan,Chittorgarh,Locomotor Disability,0,6,17,17,34
Rajasthan,Chittorgarh,Locomotor Disability,6,15,326,191,517
Rajasthan,Chittorgarh,Locomotor Disability,15,35,1786,1006,2792
Rajasthan,Chittorgarh,Locomotor Disability,35,60,3498,1980,5478
Rajasthan,Chittorgarh,Locomotor Disability,60,80,1003,498,1501
Rajasthan,Chittorgarh,Locomotor Disability,80,100,66,61,127
Andhra Pradesh,Chittoor,Locomotor Disability,0,6,122,77,199
Andhra Pradesh,Chittoor,Locomotor Disability,6,15,1092,658,1750
Andhra Pradesh,Chittoor,Locomotor Disability,15,35,4450,1951,6401
Andhra Pradesh,Chittoor,Locomotor Disability,35,60,16863,3855,20718
Andhra Pradesh,Chittoor,Locomotor Disability,60,80,8907,2379,11286
Andhra Pradesh,Chittoor,Locomotor Disability,80,100,1294,495,1789
Uttar Pradesh,Chitrakoot,Locomotor Disability,0,6,24,11,35
Uttar Pradesh,Chitrakoot,Locomotor Disability,6,15,210,134,344
Uttar Pradesh,Chitrakoot,Locomotor Disability,15,35,1675,567,2242
Uttar Pradesh,Chitrakoot,Locomotor Disability,35,60,1935,509,2444
Uttar Pradesh,Chitrakoot,Locomotor Disability,60,80,420,107,527
Uttar Pradesh,Chitrakoot,Locomotor Disability,80,100,34,4,38
Karnataka,Chitradurga,Locomotor Disability,0,6,83,56,139
Karnataka,Chitradurga,Locomotor Disability,6,15,569,339,908
Karnataka,Chitradurga,Locomotor Disability,15,35,1837,1201,3038
Karnataka,Chitradurga,Locomotor Disability,35,60,4259,1935,6194
Karnataka,Chitradurga,Locomotor Disability,60,80,912,285,1197
Karnataka,Chitradurga,Locomotor Disability,80,100,36,9,45
Assam,Chirang,Locomotor Disability,0,6,26,15,41
Assam,Chirang,Locomotor Disability,6,15,152,99,251
Assam,Chirang,Locomotor Disability,15,35,451,267,718
Assam,Chirang,Locomotor Disability,35,60,606,346,952
Assam,Chirang,Locomotor Disability,60,80,148,88,236
Assam,Chirang,Locomotor Disability,80,100,8,5,13
Karnataka,Chikkamagaluru,Locomotor Disability,0,6,28,21,49
Karnataka,Chikkamagaluru,Locomotor Disability,6,15,214,127,341
Karnataka,Chikkamagaluru,Locomotor Disability,15,35,900,564,1464
Karnataka,Chikkamagaluru,Locomotor Disability,35,60,2849,1496,4345
Karnataka,Chikkamagaluru,Locomotor Disability,60,80,955,411,1366
Karnataka,Chikkamagaluru,Locomotor Disability,80,100,42,22,64
Karnataka,Chikkaballapura,Locomotor Disability,0,6,24,10,34
Karnataka,Chikkaballapura,Locomotor Disability,6,15,214,126,340
Karnataka,Chikkaballapura,Locomotor Disability,15,35,1098,653,1751
Karnataka,Chikkaballapura,Locomotor Disability,35,60,3409,1539,4948
Karnataka,Chikkaballapura,Locomotor Disability,60,80,1110,299,1409
Karnataka,Chikkaballapura,Locomotor Disability,80,100,52,7,59
Gujarat,Chhotaudepur,Locomotor Disability,0,6,19,7,26
Gujarat,Chhotaudepur,Locomotor Disability,6,15,201,144,345
Gujarat,Chhotaudepur,Locomotor Disability,15,35,541,314,855
Gujarat,Chhotaudepur,Locomotor Disability,35,60,1003,351,1354
Gujarat,Chhotaudepur,Locomotor Disability,60,80,215,38,253
Gujarat,Chhotaudepur,Locomotor Disability,80,100,7,0,7
Madhya Pradesh,Chhindwara,Locomotor Disability,0,6,11,6,17
Madhya Pradesh,Chhindwara,Locomotor Disability,6,15,281,185,466
Madhya Pradesh,Chhindwara,Locomotor Disability,15,35,3400,1946,5346
Madhya Pradesh,Chhindwara,Locomotor Disability,35,60,6021,2436,8457
Madhya Pradesh,Chhindwara,Locomotor Disability,60,80,1616,547,2163
Madhya Pradesh,Chhindwara,Locomotor Disability,80,100,90,30,120
Madhya Pradesh,Chhatarpur,Locomotor Disability,0,6,43,26,69
Madhya Pradesh,Chhatarpur,Locomotor Disability,6,15,388,227,615
Madhya Pradesh,Chhatarpur,Locomotor Disability,15,35,3300,1365,4665
Madhya Pradesh,Chhatarpur,Locomotor Disability,35,60,3894,1598,5492
Madhya Pradesh,Chhatarpur,Locomotor Disability,60,80,929,327,1256
Madhya Pradesh,Chhatarpur,Locomotor Disability,80,100,60,23,83
Tamil Nadu,Chennai,Locomotor Disability,0,6,21,16,37
Tamil Nadu,Chennai,Locomotor Disability,6,15,187,137,324
Tamil Nadu,Chennai,Locomotor Disability,15,35,1057,637,1694
Tamil Nadu,Chennai,Locomotor Disability,35,60,5346,2735,8081
Tamil Nadu,Chennai,Locomotor Disability,60,80,1367,309,1676
Tamil Nadu,Chennai,Locomotor Disability,80,100,32,5,37
Tamil Nadu,Chengalpattu,Locomotor Disability,0,6,13,10,23
Tamil Nadu,Chengalpattu,Locomotor Disability,6,15,110,66,176
Tamil Nadu,Chengalpattu,Locomotor Disability,15,35,506,309,815
Tamil Nadu,Chengalpattu,Locomotor Disability,35,60,2126,1091,3217
Tamil Nadu,Chengalpattu,Locomotor Disability,60,80,722,243,965
Tamil Nadu,Chengalpattu,Locomotor Disability,80,100,32,6,38
Jharkhand,Chatra,Locomotor Disability,0,6,12,1,13
Jharkhand,Chatra,Locomotor Disability,6,15,51,38,89
Jharkhand,Chatra,Locomotor Disability,15,35,177,66,243
Jharkhand,Chatra,Locomotor Disability,35,60,156,62,218
Jharkhand,Chatra,Locomotor Disability,60,80,22,8,30
Haryana,Charki Dadri,Locomotor Disability,0,6,4,2,6
Haryana,Charki Dadri,Locomotor Disability,6,15,20,7,27
Haryana,Charki Dadri,Locomotor Disability,15,35,213,99,312
Haryana,Charki Dadri,Locomotor Disability,35,60,541,169,710
Haryana,Charki Dadri,Locomotor Disability,60,80,80,28,108
Haryana,Charki Dadri,Locomotor Disability,80,100,4,0,4
Assam,Charaideo,Locomotor Disability,0,6,13,5,18
Assam,Charaideo,Locomotor Disability,6,15,59,46,105
Assam,Charaideo,Locomotor Disability,15,35,191,139,330
Assam,Charaideo,Locomotor Disability,35,60,217,112,329
Assam,Charaideo,Locomotor Disability,60,80,53,32,85
Assam,Charaideo,Locomotor Disability,80,100,3,1,4
Arunachal Pradesh,Changlang,Locomotor Disability,6,15,6,1,7
Arunachal Pradesh,Changlang,Locomotor Disability,15,35,26,20,46
Arunachal Pradesh,Changlang,Locomotor Disability,35,60,16,16,32
Arunachal Pradesh,Changlang,Locomotor Disability,60,80,3,4,7
Maharashtra,Chandrapur,Locomotor Disability,0,6,14,11,25
Maharashtra,Chandrapur,Locomotor Disability,6,15,327,201,528
Maharashtra,Chandrapur,Locomotor Disability,15,35,1677,755,2432
Maharashtra,Chandrapur,Locomotor Disability,35,60,4212,1229,5441
Maharashtra,Chandrapur,Locomotor Disability,60,80,1151,209,1360
Maharashtra,Chandrapur,Locomotor Disability,80,100,37,3,40
Chandigarh,Chandigarh,Locomotor Disability,0,6,13,8,21
Chandigarh,Chandigarh,Locomotor Disability,6,15,105,72,177
Chandigarh,Chandigarh,Locomotor Disability,15,35,700,374,1074
Chandigarh,Chandigarh,Locomotor Disability,35,60,1357,573,1930
Chandigarh,Chandigarh,Locomotor Disability,60,80,334,88,422
Chandigarh,Chandigarh,Locomotor Disability,80,100,10,3,13
Manipur,Chandel,Locomotor Disability,0,6,1,0,1
Manipur,Chandel,Locomotor Disability,6,15,3,3,6
Manipur,Chandel,Locomotor Disability,15,35,25,11,36
Manipur,Chandel,Locomotor Disability,35,60,24,19,43
Manipur,Chandel,Locomotor Disability,60,80,11,9,20
Manipur,Chandel,Locomotor Disability,80,100,1,2,3
Uttar Pradesh,Chandauli,Locomotor Disability,0,6,13,11,24
Uttar Pradesh,Chandauli,Locomotor Disability,6,15,192,95,287
Uttar Pradesh,Chandauli,Locomotor Disability,15,35,2084,713,2797
Uttar Pradesh,Chandauli,Locomotor Disability,35,60,2097,547,2644
Uttar Pradesh,Chandauli,Locomotor Disability,60,80,469,93,562
Uttar Pradesh,Chandauli,Locomotor Disability,80,100,22,4,26
Mizoram,Champhai,Locomotor Disability,6,15,3,2,5
Mizoram,Champhai,Locomotor Disability,15,35,19,6,25
Mizoram,Champhai,Locomotor Disability,35,60,22,7,29
Mizoram,Champhai,Locomotor Disability,60,80,1,3,4
Uttarakhand,Champawat,Locomotor Disability,0,6,1,2,3
Uttarakhand,Champawat,Locomotor Disability,6,15,41,27,68
Uttarakhand,Champawat,Locomotor Disability,15,35,375,191,566
Uttarakhand,Champawat,Locomotor Disability,35,60,694,332,1026
Uttarakhand,Champawat,Locomotor Disability,60,80,113,78,191
Uttarakhand,Champawat,Locomotor Disability,80,100,4,4,8
Uttarakhand,Chamoli,Locomotor Disability,0,6,13,6,19
Uttarakhand,Chamoli,Locomotor Disability,6,15,81,48,129
Uttarakhand,Chamoli,Locomotor Disability,15,35,528,331,859
Uttarakhand,Chamoli,Locomotor Disability,35,60,1087,488,1575
Uttarakhand,Chamoli,Locomotor Disability,60,80,229,120,349
Uttarakhand,Chamoli,Locomotor Disability,80,100,15,11,26
Himachal Pradesh,Chamba,Locomotor Disability,0,6,25,23,48
Himachal Pradesh,Chamba,Locomotor Disability,6,15,85,63,148
Himachal Pradesh,Chamba,Locomotor Disability,15,35,662,254,916
Himachal Pradesh,Chamba,Locomotor Disability,35,60,958,270,1228
Himachal Pradesh,Chamba,Locomotor Disability,60,80,241,71,312
Himachal Pradesh,Chamba,Locomotor Disability,80,100,10,1,11
Karnataka,Chamarajanagara,Locomotor Disability,0,6,40,38,78
Karnataka,Chamarajanagara,Locomotor Disability,6,15,365,220,585
Karnataka,Chamarajanagara,Locomotor Disability,15,35,1271,680,1951
Karnataka,Chamarajanagara,Locomotor Disability,35,60,3620,1584,5204
Karnataka,Chamarajanagara,Locomotor Disability,60,80,936,270,1206
Karnataka,Chamarajanagara,Locomotor Disability,80,100,44,4,48
Delhi,Central,Locomotor Disability,0,6,4,7,11
Delhi,Central,Locomotor Disability,6,15,36,35,71
Delhi,Central,Locomotor Disability,15,35,212,89,301
Delhi,Central,Locomotor Disability,35,60,406,102,508
Delhi,Central,Locomotor Disability,60,80,68,17,85
Delhi,Central,Locomotor Disability,80,100,0,1,1
Assam,Cachar,Locomotor Disability,0,6,47,33,80
Assam,Cachar,Locomotor Disability,6,15,200,149,349
Assam,Cachar,Locomotor Disability,15,35,828,494,1322
Assam,Cachar,Locomotor Disability,35,60,1133,475,1608
Assam,Cachar,Locomotor Disability,60,80,233,65,298
Assam,Cachar,Locomotor Disability,80,100,7,2,9
Bihar,Buxar,Locomotor Disability,0,6,29,20,49
Bihar,Buxar,Locomotor Disability,6,15,288,174,462
Bihar,Buxar,Locomotor Disability,15,35,1603,527,2130
Bihar,Buxar,Locomotor Disability,35,60,1453,463,1916
Bihar,Buxar,Locomotor Disability,60,80,391,78,469
Bihar,Buxar,Locomotor Disability,80,100,16,6,22
Madhya Pradesh,Burhanpur,Locomotor Disability,0,6,15,13,28
Madhya Pradesh,Burhanpur,Locomotor Disability,6,15,161,102,263
Madhya Pradesh,Burhanpur,Locomotor Disability,15,35,996,532,1528
Madhya Pradesh,Burhanpur,Locomotor Disability,35,60,1447,590,2037
Madhya Pradesh,Burhanpur,Locomotor Disability,60,80,361,96,457
Madhya Pradesh,Burhanpur,Locomotor Disability,80,100,26,4,30
Rajasthan,Bundi,Locomotor Disability,0,6,21,18,39
Rajasthan,Bundi,Locomotor Disability,6,15,262,183,445
Rajasthan,Bundi,Locomotor Disability,15,35,1853,933,2786
Rajasthan,Bundi,Locomotor Disability,35,60,2941,1378,4319
Rajasthan,Bundi,Locomotor Disability,60,80,736,301,1037
Rajasthan,Bundi,Locomotor Disability,80,100,46,27,73
Maharashtra,Buldhana,Locomotor Disability,0,6,93,58,151
Maharashtra,Buldhana,Locomotor Disability,6,15,946,505,1451
Maharashtra,Buldhana,Locomotor Disability,15,35,5358,2010,7368
Maharashtra,Buldhana,Locomotor Disability,35,60,11632,3313,14945
Maharashtra,Buldhana,Locomotor Disability,60,80,3665,814,4479
Maharashtra,Buldhana,Locomotor Disability,80,100,178,37,215
Uttar Pradesh,Bulandshahr,Locomotor Disability,0,6,63,60,123
Uttar Pradesh,Bulandshahr,Locomotor Disability,6,15,646,355,1001
Uttar Pradesh,Bulandshahr,Locomotor Disability,15,35,5614,2116,7730
Uttar Pradesh,Bulandshahr,Locomotor Disability,35,60,5989,1912,7901
Uttar Pradesh,Bulandshahr,Locomotor Disability,60,80,1211,276,1487
Uttar Pradesh,Bulandshahr,Locomotor Disability,80,100,63,12,75
Jammu And Kashmir,Budgam,Locomotor Disability,0,6,30,24,54
Jammu And Kashmir,Budgam,Locomotor Disability,6,15,144,97,241
Jammu And Kashmir,Budgam,Locomotor Disability,15,35,623,450,1073
Jammu And Kashmir,Budgam,Locomotor Disability,35,60,890,525,1415
Jammu And Kashmir,Budgam,Locomotor Disability,60,80,155,100,255
Jammu And Kashmir,Budgam,Locomotor Disability,80,100,6,4,10
Uttar Pradesh,Budaun,Locomotor Disability,0,6,26,13,39
Uttar Pradesh,Budaun,Locomotor Disability,6,15,427,207,634
Uttar Pradesh,Budaun,Locomotor Disability,15,35,5963,2023,7986
Uttar Pradesh,Budaun,Locomotor Disability,35,60,5758,1575,7333
Uttar Pradesh,Budaun,Locomotor Disability,60,80,989,199,1188
Uttar Pradesh,Budaun,Locomotor Disability,80,100,31,4,35
Odisha,Boudh,Locomotor Disability,0,6,31,32,63
Odisha,Boudh,Locomotor Disability,6,15,183,123,306
Odisha,Boudh,Locomotor Disability,15,35,463,247,710
Odisha,Boudh,Locomotor Disability,35,60,852,446,1298
Odisha,Boudh,Locomotor Disability,60,80,246,94,340
Odisha,Boudh,Locomotor Disability,80,100,11,5,16
Gujarat,Botad,Locomotor Disability,0,6,12,11,23
Gujarat,Botad,Locomotor Disability,6,15,114,88,202
Gujarat,Botad,Locomotor Disability,15,35,540,288,828
Gujarat,Botad,Locomotor Disability,35,60,1072,548,1620
Gujarat,Botad,Locomotor Disability,60,80,219,41,260
Gujarat,Botad,Locomotor Disability,80,100,12,1,13
Assam,Bongaigaon,Locomotor Disability,0,6,29,22,51
Assam,Bongaigaon,Locomotor Disability,6,15,218,133,351
Assam,Bongaigaon,Locomotor Disability,15,35,614,356,970
Assam,Bongaigaon,Locomotor Disability,35,60,843,300,1143
Assam,Bongaigaon,Locomotor Disability,60,80,169,51,220
Assam,Bongaigaon,Locomotor Disability,80,100,7,3,10
Jharkhand,Bokaro,Locomotor Disability,0,6,15,3,18
Jharkhand,Bokaro,Locomotor Disability,6,15,73,31,104
Jharkhand,Bokaro,Locomotor Disability,15,35,828,329,1157
Jharkhand,Bokaro,Locomotor Disability,35,60,801,291,1092
Jharkhand,Bokaro,Locomotor Disability,60,80,128,48,176
Jharkhand,Bokaro,Locomotor Disability,80,100,7,2,9
Assam,Biswanath,Locomotor Disability,0,6,16,14,30
Assam,Biswanath,Locomotor Disability,6,15,44,28,72
Assam,Biswanath,Locomotor Disability,15,35,175,104,279
Assam,Biswanath,Locomotor Disability,35,60,204,69,273
Assam,Biswanath,Locomotor Disability,60,80,32,12,44
Assam,Biswanath,Locomotor Disability,80,100,4,0,4
Manipur,Bishnupur,Locomotor Disability,0,6,2,2,4
Manipur,Bishnupur,Locomotor Disability,6,15,13,9,22
Manipur,Bishnupur,Locomotor Disability,15,35,46,25,71
Manipur,Bishnupur,Locomotor Disability,35,60,119,60,179
Manipur,Bishnupur,Locomotor Disability,60,80,58,42,100
Manipur,Bishnupur,Locomotor Disability,80,100,4,4,8
West Bengal,Birbhum,Locomotor Disability,6,15,0,1,1
West Bengal,Birbhum,Locomotor Disability,15,35,2,0,2
West Bengal,Birbhum,Locomotor Disability,35,60,2,0,2
Chhattisgarh,Bilaspur,Locomotor Disability,0,6,37,25,62
Chhattisgarh,Bilaspur,Locomotor Disability,6,15,461,305,766
Chhattisgarh,Bilaspur,Locomotor Disability,15,35,2636,1734,4370
Chhattisgarh,Bilaspur,Locomotor Disability,35,60,3804,1709,5513
Chhattisgarh,Bilaspur,Locomotor Disability,60,80,922,357,1279
Chhattisgarh,Bilaspur,Locomotor Disability,80,100,42,24,66
Himachal Pradesh,Bilaspur,Locomotor Disability,0,6,23,12,35
Himachal Pradesh,Bilaspur,Locomotor Disability,6,15,56,50,106
Himachal Pradesh,Bilaspur,Locomotor Disability,15,35,336,161,497
Himachal Pradesh,Bilaspur,Locomotor Disability,35,60,856,310,1166
Himachal Pradesh,Bilaspur,Locomotor Disability,60,80,382,120,502
Himachal Pradesh,Bilaspur,Locomotor Disability,80,100,13,11,24
Rajasthan,Bikaner,Locomotor Disability,0,6,25,14,39
Rajasthan,Bikaner,Locomotor Disability,6,15,336,204,540
Rajasthan,Bikaner,Locomotor Disability,15,35,2159,875,3034
Rajasthan,Bikaner,Locomotor Disability,35,60,2814,1094,3908
Rajasthan,Bikaner,Locomotor Disability,60,80,632,205,837
Rajasthan,Bikaner,Locomotor Disability,80,100,36,21,57
Uttar Pradesh,Bijnor,Locomotor Disability,0,6,37,36,73
Uttar Pradesh,Bijnor,Locomotor Disability,6,15,431,251,682
Uttar Pradesh,Bijnor,Locomotor Disability,15,35,5194,2302,7496
Uttar Pradesh,Bijnor,Locomotor Disability,35,60,5106,1732,6838
Uttar Pradesh,Bijnor,Locomotor Disability,60,80,1070,207,1277
Uttar Pradesh,Bijnor,Locomotor Disability,80,100,59,7,66
Chhattisgarh,Bijapur,Locomotor Disability,0,6,6,6,12
Chhattisgarh,Bijapur,Locomotor Disability,6,15,74,45,119
Chhattisgarh,Bijapur,Locomotor Disability,15,35,274,138,412
Chhattisgarh,Bijapur,Locomotor Disability,35,60,279,128,407
Chhattisgarh,Bijapur,Locomotor Disability,60,80,83,65,148
Chhattisgarh,Bijapur,Locomotor Disability,80,100,3,3,6
Karnataka,Bidar,Locomotor Disability,0,6,99,62,161
Karnataka,Bidar,Locomotor Disability,6,15,392,256,648
Karnataka,Bidar,Locomotor Disability,15,35,1882,1049,2931
Karnataka,Bidar,Locomotor Disability,35,60,3933,1383,5316
Karnataka,Bidar,Locomotor Disability,60,80,863,217,1080
Karnataka,Bidar,Locomotor Disability,80,100,43,7,50
Madhya Pradesh,Bhopal,Locomotor Disability,0,6,33,22,55
Madhya Pradesh,Bhopal,Locomotor Disability,6,15,208,120,328
Madhya Pradesh,Bhopal,Locomotor Disability,15,35,1811,905,2716
Madhya Pradesh,Bhopal,Locomotor Disability,35,60,3004,1204,4208
Madhya Pradesh,Bhopal,Locomotor Disability,60,80,532,156,688
Madhya Pradesh,Bhopal,Locomotor Disability,80,100,20,8,28
Bihar,Bhojpur,Locomotor Disability,0,6,35,30,65
Bihar,Bhojpur,Locomotor Disability,6,15,354,217,571
Bihar,Bhojpur,Locomotor Disability,15,35,2148,648,2796
Bihar,Bhojpur,Locomotor Disability,35,60,1865,484,2349
Bihar,Bhojpur,Locomotor Disability,60,80,313,85,398
Bihar,Bhojpur,Locomotor Disability,80,100,11,3,14
Haryana,Bhiwani,Locomotor Disability,0,6,19,14,33
Haryana,Bhiwani,Locomotor Disability,6,15,134,65,199
Haryana,Bhiwani,Locomotor Disability,15,35,1142,466,1608
Haryana,Bhiwani,Locomotor Disability,35,60,2450,780,3230
Haryana,Bhiwani,Locomotor Disability,60,80,437,158,595
Haryana,Bhiwani,Locomotor Disability,80,100,23,9,32
Madhya Pradesh,Bhind,Locomotor Disability,0,6,45,17,62
Madhya Pradesh,Bhind,Locomotor Disability,6,15,401,192,593
Madhya Pradesh,Bhind,Locomotor Disability,15,35,4266,1779,6045
Madhya Pradesh,Bhind,Locomotor Disability,35,60,8036,4307,12343
Madhya Pradesh,Bhind,Locomotor Disability,60,80,3081,1341,4422
Madhya Pradesh,Bhind,Locomotor Disability,80,100,145,33,178
Rajasthan,Bhilwara,Locomotor Disability,0,6,55,34,89
Rajasthan,Bhilwara,Locomotor Disability,6,15,548,309,857
Rajasthan,Bhilwara,Locomotor Disability,15,35,2925,1574,4499
Rajasthan,Bhilwara,Locomotor Disability,35,60,4720,2572,7292
Rajasthan,Bhilwara,Locomotor Disability,60,80,1420,833,2253
Rajasthan,Bhilwara,Locomotor Disability,80,100,97,81,178
Gujarat,Bhavnagar,Locomotor Disability,0,6,32,34,66
Gujarat,Bhavnagar,Locomotor Disability,6,15,267,183,450
Gujarat,Bhavnagar,Locomotor Disability,15,35,1154,579,1733
Gujarat,Bhavnagar,Locomotor Disability,35,60,1875,845,2720
Gujarat,Bhavnagar,Locomotor Disability,60,80,312,66,378
Gujarat,Bhavnagar,Locomotor Disability,80,100,5,2,7
Gujarat,Bharuch,Locomotor Disability,0,6,19,12,31
Gujarat,Bharuch,Locomotor Disability,6,15,142,106,248
Gujarat,Bharuch,Locomotor Disability,15,35,581,283,864
Gujarat,Bharuch,Locomotor Disability,35,60,1414,481,1895
Gujarat,Bharuch,Locomotor Disability,60,80,461,80,541
Gujarat,Bharuch,Locomotor Disability,80,100,14,5,19
Rajasthan,Bharatpur,Locomotor Disability,0,6,53,29,82
Rajasthan,Bharatpur,Locomotor Disability,6,15,588,288,876
Rajasthan,Bharatpur,Locomotor Disability,15,35,3907,1744,5651
Rajasthan,Bharatpur,Locomotor Disability,35,60,4255,1758,6013
Rajasthan,Bharatpur,Locomotor Disability,60,80,876,394,1270
Rajasthan,Bharatpur,Locomotor Disability,80,100,91,41,132
Maharashtra,Bhandara,Locomotor Disability,0,6,92,61,153
Maharashtra,Bhandara,Locomotor Disability,6,15,714,397,1111
Maharashtra,Bhandara,Locomotor Disability,15,35,2593,1081,3674
Maharashtra,Bhandara,Locomotor Disability,35,60,5093,1787,6880
Maharashtra,Bhandara,Locomotor Disability,60,80,1510,417,1927
Maharashtra,Bhandara,Locomotor Disability,80,100,34,8,42
Bihar,Bhagalpur,Locomotor Disability,0,6,154,93,247
Bihar,Bhagalpur,Locomotor Disability,6,15,690,399,1089
Bihar,Bhagalpur,Locomotor Disability,15,35,1709,605,2314
Bihar,Bhagalpur,Locomotor Disability,35,60,1355,390,1745
Bihar,Bhagalpur,Locomotor Disability,60,80,219,45,264
Bihar,Bhagalpur,Locomotor Disability,80,100,10,0,10
Odisha,Bhadrak,Locomotor Disability,0,6,119,45,164
Odisha,Bhadrak,Locomotor Disability,6,15,402,267,669
Odisha,Bhadrak,Locomotor Disability,15,35,1343,706,2049
Odisha,Bhadrak,Locomotor Disability,35,60,2686,1113,3799
Odisha,Bhadrak,Locomotor Disability,60,80,945,310,1255
Odisha,Bhadrak,Locomotor Disability,80,100,60,14,74
Telangana,Bhadradri Kothagudem,Locomotor Disability,0,6,3,2,5
Telangana,Bhadradri Kothagudem,Locomotor Disability,6,15,280,182,462
Telangana,Bhadradri Kothagudem,Locomotor Disability,15,35,1124,748,1872
Telangana,Bhadradri Kothagudem,Locomotor Disability,35,60,1936,1146,3082
Telangana,Bhadradri Kothagudem,Locomotor Disability,60,80,866,438,1304
Telangana,Bhadradri Kothagudem,Locomotor Disability,80,100,97,59,156
Uttar Pradesh,Bhadohi,Locomotor Disability,0,6,4,3,7
Uttar Pradesh,Bhadohi,Locomotor Disability,6,15,162,101,263
Uttar Pradesh,Bhadohi,Locomotor Disability,15,35,1944,719,2663
Uttar Pradesh,Bhadohi,Locomotor Disability,35,60,1865,465,2330
Uttar Pradesh,Bhadohi,Locomotor Disability,60,80,382,83,465
Uttar Pradesh,Bhadohi,Locomotor Disability,80,100,16,1,17
Madhya Pradesh,Betul,Locomotor Disability,0,6,18,18,36
Madhya Pradesh,Betul,Locomotor Disability,6,15,257,179,436
Madhya Pradesh,Betul,Locomotor Disability,15,35,2128,1178,3306
Madhya Pradesh,Betul,Locomotor Disability,35,60,3617,1291,4908
Madhya Pradesh,Betul,Locomotor Disability,60,80,830,228,1058
Madhya Pradesh,Betul,Locomotor Disability,80,100,39,17,56
Karnataka,Bengaluru Urban,Locomotor Disability,0,6,63,38,101
Karnataka,Bengaluru Urban,Locomotor Disability,6,15,344,228,572
Karnataka,Bengaluru Urban,Locomotor Disability,15,35,1713,1007,2720
Karnataka,Bengaluru Urban,Locomotor Disability,35,60,5795,2249,8044
Karnataka,Bengaluru Urban,Locomotor Disability,60,80,1522,294,1816
Karnataka,Bengaluru Urban,Locomotor Disability,80,100,47,10,57
Karnataka,Bengaluru Rural,Locomotor Disability,0,6,30,16,46
Karnataka,Bengaluru Rural,Locomotor Disability,6,15,182,140,322
Karnataka,Bengaluru Rural,Locomotor Disability,15,35,941,619,1560
Karnataka,Bengaluru Rural,Locomotor Disability,35,60,3142,1316,4458
Karnataka,Bengaluru Rural,Locomotor Disability,60,80,1000,338,1338
Karnataka,Bengaluru Rural,Locomotor Disability,80,100,83,21,104
Chhattisgarh,Bemetara,Locomotor Disability,0,6,9,5,14
Chhattisgarh,Bemetara,Locomotor Disability,6,15,95,44,139
Chhattisgarh,Bemetara,Locomotor Disability,15,35,572,396,968
Chhattisgarh,Bemetara,Locomotor Disability,35,60,810,371,1181
Chhattisgarh,Bemetara,Locomotor Disability,60,80,176,54,230
Chhattisgarh,Bemetara,Locomotor Disability,80,100,9,6,15
Karnataka,Belagavi,Locomotor Disability,0,6,239,141,380
Karnataka,Belagavi,Locomotor Disability,6,15,1699,1006,2705
Karnataka,Belagavi,Locomotor Disability,15,35,6558,3609,10167
Karnataka,Belagavi,Locomotor Disability,35,60,12663,5519,18182
Karnataka,Belagavi,Locomotor Disability,60,80,2775,768,3543
Karnataka,Belagavi,Locomotor Disability,80,100,116,31,147
Bihar,Begusarai,Locomotor Disability,0,6,136,88,224
Bihar,Begusarai,Locomotor Disability,6,15,779,491,1270
Bihar,Begusarai,Locomotor Disability,15,35,2085,803,2888
Bihar,Begusarai,Locomotor Disability,35,60,1496,418,1914
Bihar,Begusarai,Locomotor Disability,60,80,273,60,333
Bihar,Begusarai,Locomotor Disability,80,100,8,2,10
Maharashtra,Beed,Locomotor Disability,0,6,64,34,98
Maharashtra,Beed,Locomotor Disability,6,15,644,316,960
Maharashtra,Beed,Locomotor Disability,15,35,2634,1084,3718
Maharashtra,Beed,Locomotor Disability,35,60,4564,1319,5883
Maharashtra,Beed,Locomotor Disability,60,80,1306,313,1619
Maharashtra,Beed,Locomotor Disability,80,100,132,25,157
Punjab,Bathinda,Locomotor Disability,0,6,59,33,92
Punjab,Bathinda,Locomotor Disability,6,15,287,170,457
Punjab,Bathinda,Locomotor Disability,15,35,1577,858,2435
Punjab,Bathinda,Locomotor Disability,35,60,3648,1859,5507
Punjab,Bathinda,Locomotor Disability,60,80,1024,255,1279
Punjab,Bathinda,Locomotor Disability,80,100,52,11,63
Uttar Pradesh,Basti,Locomotor Disability,0,6,37,19,56
Uttar Pradesh,Basti,Locomotor Disability,6,15,226,132,358
Uttar Pradesh,Basti,Locomotor Disability,15,35,2408,890,3298
Uttar Pradesh,Basti,Locomotor Disability,35,60,2871,725,3596
Uttar Pradesh,Basti,Locomotor Disability,60,80,661,120,781
Uttar Pradesh,Basti,Locomotor Disability,80,100,16,4,20
Chhattisgarh,Bastar,Locomotor Disability,0,6,39,32,71
Chhattisgarh,Bastar,Locomotor Disability,6,15,406,262,668
Chhattisgarh,Bastar,Locomotor Disability,15,35,1232,711,1943
Chhattisgarh,Bastar,Locomotor Disability,35,60,1525,658,2183
Chhattisgarh,Bastar,Locomotor Disability,60,80,480,225,705
Chhattisgarh,Bastar,Locomotor Disability,80,100,22,9,31
Madhya Pradesh,Barwani,Locomotor Disability,0,6,12,9,21
Madhya Pradesh,Barwani,Locomotor Disability,6,15,332,190,522
Madhya Pradesh,Barwani,Locomotor Disability,15,35,2405,1512,3917
Madhya Pradesh,Barwani,Locomotor Disability,35,60,3116,1462,4578
Madhya Pradesh,Barwani,Locomotor Disability,60,80,640,273,913
Madhya Pradesh,Barwani,Locomotor Disability,80,100,29,16,45
Assam,Barpeta,Locomotor Disability,0,6,103,75,178
Assam,Barpeta,Locomotor Disability,6,15,465,314,779
Assam,Barpeta,Locomotor Disability,15,35,1399,827,2226
Assam,Barpeta,Locomotor Disability,35,60,1977,867,2844
Assam,Barpeta,Locomotor Disability,60,80,540,173,713
Assam,Barpeta,Locomotor Disability,80,100,20,22,42
Punjab,Barnala,Locomotor Disability,0,6,19,12,31
Punjab,Barnala,Locomotor Disability,6,15,106,67,173
Punjab,Barnala,Locomotor Disability,15,35,639,329,968
Punjab,Barnala,Locomotor Disability,35,60,1618,757,2375
Punjab,Barnala,Locomotor Disability,60,80,470,114,584
Punjab,Barnala,Locomotor Disability,80,100,19,6,25
Rajasthan,Barmer,Locomotor Disability,0,6,54,31,85
Rajasthan,Barmer,Locomotor Disability,6,15,651,371,1022
Rajasthan,Barmer,Locomotor Disability,15,35,2946,1208,4154
Rajasthan,Barmer,Locomotor Disability,35,60,3552,1251,4803
Rajasthan,Barmer,Locomotor Disability,60,80,830,288,1118
Rajasthan,Barmer,Locomotor Disability,80,100,44,23,67
Odisha,Bargarh,Locomotor Disability,0,6,105,63,168
Odisha,Bargarh,Locomotor Disability,6,15,523,313,836
Odisha,Bargarh,Locomotor Disability,15,35,1520,884,2404
Odisha,Bargarh,Locomotor Disability,35,60,3318,1542,4860
Odisha,Bargarh,Locomotor Disability,60,80,1038,393,1431
Odisha,Bargarh,Locomotor Disability,80,100,60,22,82
Uttar Pradesh,Bareilly,Locomotor Disability,0,6,40,32,72
Uttar Pradesh,Bareilly,Locomotor Disability,6,15,319,196,515
Uttar Pradesh,Bareilly,Locomotor Disability,15,35,5156,1962,7118
Uttar Pradesh,Bareilly,Locomotor Disability,35,60,4878,1423,6301
Uttar Pradesh,Bareilly,Locomotor Disability,60,80,713,161,874
Uttar Pradesh,Bareilly,Locomotor Disability,80,100,17,8,25
Rajasthan,Baran,Locomotor Disability,0,6,11,11,22
Rajasthan,Baran,Locomotor Disability,6,15,224,117,341
Rajasthan,Baran,Locomotor Disability,15,35,1344,653,1997
Rajasthan,Baran,Locomotor Disability,35,60,2198,1039,3237
Rajasthan,Baran,Locomotor Disability,60,80,514,183,697
Rajasthan,Baran,Locomotor Disability,80,100,36,16,52
Jammu And Kashmir,Baramulla,Locomotor Disability,0,6,48,29,77
Jammu And Kashmir,Baramulla,Locomotor Disability,6,15,209,157,366
Jammu And Kashmir,Baramulla,Locomotor Disability,15,35,946,691,1637
Jammu And Kashmir,Baramulla,Locomotor Disability,35,60,1275,692,1967
Jammu And Kashmir,Baramulla,Locomotor Disability,60,80,239,133,372
Jammu And Kashmir,Baramulla,Locomotor Disability,80,100,22,8,30
Uttar Pradesh,Barabanki,Locomotor Disability,0,6,37,29,66
Uttar Pradesh,Barabanki,Locomotor Disability,6,15,514,308,822
Uttar Pradesh,Barabanki,Locomotor Disability,15,35,4002,1658,5660
Uttar Pradesh,Barabanki,Locomotor Disability,35,60,4927,1477,6404
Uttar Pradesh,Barabanki,Locomotor Disability,60,80,982,218,1200
Uttar Pradesh,Barabanki,Locomotor Disability,80,100,31,8,39
Rajasthan,Banswara,Locomotor Disability,0,6,31,13,44
Rajasthan,Banswara,Locomotor Disability,6,15,417,270,687
Rajasthan,Banswara,Locomotor Disability,15,35,2611,1592,4203
Rajasthan,Banswara,Locomotor Disability,35,60,3152,1776,4928
Rajasthan,Banswara,Locomotor Disability,60,80,825,481,1306
Rajasthan,Banswara,Locomotor Disability,80,100,51,57,108
West Bengal,Bankura,Locomotor Disability,15,35,1,0,1
Bihar,Banka,Locomotor Disability,0,6,23,13,36
Bihar,Banka,Locomotor Disability,6,15,325,198,523
Bihar,Banka,Locomotor Disability,15,35,1544,586,2130
Bihar,Banka,Locomotor Disability,35,60,1455,458,1913
Bihar,Banka,Locomotor Disability,60,80,385,90,475
Bihar,Banka,Locomotor Disability,80,100,26,2,28
Jammu And Kashmir,Bandipora,Locomotor Disability,0,6,24,14,38
Jammu And Kashmir,Bandipora,Locomotor Disability,6,15,76,43,119
Jammu And Kashmir,Bandipora,Locomotor Disability,15,35,326,260,586
Jammu And Kashmir,Bandipora,Locomotor Disability,35,60,446,268,714
Jammu And Kashmir,Bandipora,Locomotor Disability,60,80,68,46,114
Jammu And Kashmir,Bandipora,Locomotor Disability,80,100,6,2,8
Uttar Pradesh,Banda,Locomotor Disability,0,6,25,14,39
Uttar Pradesh,Banda,Locomotor Disability,6,15,185,128,313
Uttar Pradesh,Banda,Locomotor Disability,15,35,2184,749,2933
Uttar Pradesh,Banda,Locomotor Disability,35,60,2911,860,3771
Uttar Pradesh,Banda,Locomotor Disability,60,80,797,181,978
Uttar Pradesh,Banda,Locomotor Disability,80,100,38,14,52
Gujarat,Banas Kantha,Locomotor Disability,0,6,43,28,71
Gujarat,Banas Kantha,Locomotor Disability,6,15,731,430,1161
Gujarat,Banas Kantha,Locomotor Disability,15,35,2226,1006,3232
Gujarat,Banas Kantha,Locomotor Disability,35,60,3072,956,4028
Gujarat,Banas Kantha,Locomotor Disability,60,80,626,119,745
Gujarat,Banas Kantha,Locomotor Disability,80,100,15,6,21
Chhattisgarh,Balrampur,Locomotor Disability,0,6,20,23,43
Chhattisgarh,Balrampur,Locomotor Disability,6,15,383,226,609
Chhattisgarh,Balrampur,Locomotor Disability,15,35,1404,738,2142
Chhattisgarh,Balrampur,Locomotor Disability,35,60,1481,635,2116
Chhattisgarh,Balrampur,Locomotor Disability,60,80,372,134,506
Chhattisgarh,Balrampur,Locomotor Disability,80,100,25,9,34
Uttar Pradesh,Balrampur,Locomotor Disability,0,6,14,11,25
Uttar Pradesh,Balrampur,Locomotor Disability,6,15,205,113,318
Uttar Pradesh,Balrampur,Locomotor Disability,15,35,1571,597,2168
Uttar Pradesh,Balrampur,Locomotor Disability,35,60,1393,449,1842
Uttar Pradesh,Balrampur,Locomotor Disability,60,80,274,47,321
Uttar Pradesh,Balrampur,Locomotor Disability,80,100,12,3,15
Chhattisgarh,Baloda Bazar,Locomotor Disability,0,6,1,6,7
Chhattisgarh,Baloda Bazar,Locomotor Disability,6,15,119,80,199
Chhattisgarh,Baloda Bazar,Locomotor Disability,15,35,993,651,1644
Chhattisgarh,Baloda Bazar,Locomotor Disability,35,60,1597,659,2256
Chhattisgarh,Baloda Bazar,Locomotor Disability,60,80,334,108,442
Chhattisgarh,Baloda Bazar,Locomotor Disability,80,100,12,4,16
Chhattisgarh,Balod,Locomotor Disability,0,6,3,2,5
Chhattisgarh,Balod,Locomotor Disability,6,15,96,52,148
Chhattisgarh,Balod,Locomotor Disability,15,35,544,400,944
Chhattisgarh,Balod,Locomotor Disability,35,60,1442,704,2146
Chhattisgarh,Balod,Locomotor Disability,60,80,300,82,382
Chhattisgarh,Balod,Locomotor Disability,80,100,5,5,10
Uttar Pradesh,Ballia,Locomotor Disability,0,6,60,46,106
Uttar Pradesh,Ballia,Locomotor Disability,6,15,493,285,778
Uttar Pradesh,Ballia,Locomotor Disability,15,35,3908,1562,5470
Uttar Pradesh,Ballia,Locomotor Disability,35,60,4522,1453,5975
Uttar Pradesh,Ballia,Locomotor Disability,60,80,1238,265,1503
Uttar Pradesh,Ballia,Locomotor Disability,80,100,66,16,82
Karnataka,Ballari,Locomotor Disability,0,6,136,113,249
Karnataka,Ballari,Locomotor Disability,6,15,773,506,1279
Karnataka,Ballari,Locomotor Disability,15,35,3485,2289,5774
Karnataka,Ballari,Locomotor Disability,35,60,6022,2580,8602
Karnataka,Ballari,Locomotor Disability,60,80,960,278,1238
Karnataka,Ballari,Locomotor Disability,80,100,25,8,33
Odisha,Baleshwar,Locomotor Disability,0,6,208,134,342
Odisha,Baleshwar,Locomotor Disability,6,15,1199,688,1887
Odisha,Baleshwar,Locomotor Disability,15,35,3312,1929,5241
Odisha,Baleshwar,Locomotor Disability,35,60,7220,3567,10787
Odisha,Baleshwar,Locomotor Disability,60,80,2783,1153,3936
Odisha,Baleshwar,Locomotor Disability,80,100,161,46,207
Odisha,Balangir,Locomotor Disability,0,6,111,85,196
Odisha,Balangir,Locomotor Disability,6,15,626,451,1077
Odisha,Balangir,Locomotor Disability,15,35,1843,1071,2914
Odisha,Balangir,Locomotor Disability,35,60,3229,1341,4570
Odisha,Balangir,Locomotor Disability,60,80,1049,432,1481
Odisha,Balangir,Locomotor Disability,80,100,68,31,99
Madhya Pradesh,Balaghat,Locomotor Disability,0,6,84,35,119
Madhya Pradesh,Balaghat,Locomotor Disability,6,15,584,403,987
Madhya Pradesh,Balaghat,Locomotor Disability,15,35,3062,1880,4942
Madhya Pradesh,Balaghat,Locomotor Disability,35,60,4360,1902,6262
Madhya Pradesh,Balaghat,Locomotor Disability,60,80,1088,371,1459
Madhya Pradesh,Balaghat,Locomotor Disability,80,100,34,13,47
Assam,Baksa,Locomotor Disability,0,6,47,21,68
Assam,Baksa,Locomotor Disability,6,15,177,92,269
Assam,Baksa,Locomotor Disability,15,35,697,341,1038
Assam,Baksa,Locomotor Disability,35,60,1055,477,1532
Assam,Baksa,Locomotor Disability,60,80,204,84,288
Assam,Baksa,Locomotor Disability,80,100,6,6,12
Assam,Bajali,Locomotor Disability,0,6,8,1,9
Assam,Bajali,Locomotor Disability,6,15,12,3,15
Assam,Bajali,Locomotor Disability,15,35,22,12,34
Assam,Bajali,Locomotor Disability,35,60,33,27,60
Assam,Bajali,Locomotor Disability,60,80,13,7,20
Assam,Bajali,Locomotor Disability,80,100,2,0,2
Uttar Pradesh,Bahraich,Locomotor Disability,0,6,39,24,63
Uttar Pradesh,Bahraich,Locomotor Disability,6,15,550,345,895
Uttar Pradesh,Bahraich,Locomotor Disability,15,35,4105,1528,5633
Uttar Pradesh,Bahraich,Locomotor Disability,35,60,4708,1318,6026
Uttar Pradesh,Bahraich,Locomotor Disability,60,80,1042,225,1267
Uttar Pradesh,Bahraich,Locomotor Disability,80,100,41,11,52
Uttar Pradesh,Baghpat,Locomotor Disability,0,6,2,6,8
Uttar Pradesh,Baghpat,Locomotor Disability,6,15,64,31,95
Uttar Pradesh,Baghpat,Locomotor Disability,15,35,1628,552,2180
Uttar Pradesh,Baghpat,Locomotor Disability,35,60,1558,518,2076
Uttar Pradesh,Baghpat,Locomotor Disability,60,80,290,58,348
Uttar Pradesh,Baghpat,Locomotor Disability,80,100,21,4,25
Uttarakhand,Bageshwar,Locomotor Disability,0,6,7,3,10
Uttarakhand,Bageshwar,Locomotor Disability,6,15,27,31,58
Uttarakhand,Bageshwar,Locomotor Disability,15,35,223,127,350
Uttarakhand,Bageshwar,Locomotor Disability,35,60,619,263,882
Uttarakhand,Bageshwar,Locomotor Disability,60,80,126,65,191
Uttarakhand,Bageshwar,Locomotor Disability,80,100,5,8,13
Karnataka,Bagalkote,Locomotor Disability,0,6,66,43,109
Karnataka,Bagalkote,Locomotor Disability,6,15,619,359,978
Karnataka,Bagalkote,Locomotor Disability,15,35,2991,1781,4772
Karnataka,Bagalkote,Locomotor Disability,35,60,5105,2390,7495
Karnataka,Bagalkote,Locomotor Disability,60,80,931,282,1213
Karnataka,Bagalkote,Locomotor Disability,80,100,30,7,37
Uttar Pradesh,Azamgarh,Locomotor Disability,0,6,21,24,45
Uttar Pradesh,Azamgarh,Locomotor Disability,6,15,415,254,669
Uttar Pradesh,Azamgarh,Locomotor Disability,15,35,4429,1535,5964
Uttar Pradesh,Azamgarh,Locomotor Disability,35,60,4445,1103,5548
Uttar Pradesh,Azamgarh,Locomotor Disability,60,80,1166,217,1383
Uttar Pradesh,Azamgarh,Locomotor Disability,80,100,52,9,61
Uttar Pradesh,Ayodhya,Locomotor Disability,0,6,7,8,15
Uttar Pradesh,Ayodhya,Locomotor Disability,6,15,201,130,331
Uttar Pradesh,Ayodhya,Locomotor Disability,15,35,1934,803,2737
Uttar Pradesh,Ayodhya,Locomotor Disability,35,60,2168,654,2822
Uttar Pradesh,Ayodhya,Locomotor Disability,60,80,383,65,448
Uttar Pradesh,Ayodhya,Locomotor Disability,80,100,22,3,25
Bihar,Aurangabad,Locomotor Disability,0,6,14,3,17
Bihar,Aurangabad,Locomotor Disability,6,15,242,127,369
Bihar,Aurangabad,Locomotor Disability,15,35,1384,484,1868
Bihar,Aurangabad,Locomotor Disability,35,60,1094,374,1468
Bihar,Aurangabad,Locomotor Disability,60,80,284,87,371
Bihar,Aurangabad,Locomotor Disability,80,100,5,0,5
Maharashtra,Aurangabad,Locomotor Disability,0,6,150,62,212
Maharashtra,Aurangabad,Locomotor Disability,6,15,851,531,1382
Maharashtra,Aurangabad,Locomotor Disability,15,35,2748,1346,4094
Maharashtra,Aurangabad,Locomotor Disability,35,60,5363,1781,7144
Maharashtra,Aurangabad,Locomotor Disability,60,80,1460,320,1780
Maharashtra,Aurangabad,Locomotor Disability,80,100,93,20,113
Uttar Pradesh,Auraiya,Locomotor Disability,0,6,15,14,29
Uttar Pradesh,Auraiya,Locomotor Disability,6,15,206,107,313
Uttar Pradesh,Auraiya,Locomotor Disability,15,35,1831,682,2513
Uttar Pradesh,Auraiya,Locomotor Disability,35,60,2584,798,3382
Uttar Pradesh,Auraiya,Locomotor Disability,60,80,555,112,667
Uttar Pradesh,Auraiya,Locomotor Disability,80,100,34,4,38
Madhya Pradesh,Ashoknagar,Locomotor Disability,0,6,17,10,27
Madhya Pradesh,Ashoknagar,Locomotor Disability,6,15,175,107,282
Madhya Pradesh,Ashoknagar,Locomotor Disability,15,35,1351,607,1958
Madhya Pradesh,Ashoknagar,Locomotor Disability,35,60,2297,756,3053
Madhya Pradesh,Ashoknagar,Locomotor Disability,60,80,625,199,824
Madhya Pradesh,Ashoknagar,Locomotor Disability,80,100,37,13,50
Bihar,Arwal,Locomotor Disability,0,6,8,5,13
Bihar,Arwal,Locomotor Disability,6,15,106,56,162
Bihar,Arwal,Locomotor Disability,15,35,724,234,958
Bihar,Arwal,Locomotor Disability,35,60,715,261,976
Bihar,Arwal,Locomotor Disability,60,80,177,71,248
Bihar,Arwal,Locomotor Disability,80,100,15,7,22
Gujarat,Arvalli,Locomotor Disability,0,6,18,7,25
Gujarat,Arvalli,Locomotor Disability,6,15,315,225,540
Gujarat,Arvalli,Locomotor Disability,15,35,960,493,1453
Gujarat,Arvalli,Locomotor Disability,35,60,1990,856,2846
Gujarat,Arvalli,Locomotor Disability,60,80,579,107,686
Gujarat,Arvalli,Locomotor Disability,80,100,18,4,22
Tamil Nadu,Ariyalur,Locomotor Disability,0,6,11,13,24
Tamil Nadu,Ariyalur,Locomotor Disability,6,15,118,73,191
Tamil Nadu,Ariyalur,Locomotor Disability,15,35,670,347,1017
Tamil Nadu,Ariyalur,Locomotor Disability,35,60,1955,953,2908
Tamil Nadu,Ariyalur,Locomotor Disability,60,80,972,418,1390
Tamil Nadu,Ariyalur,Locomotor Disability,80,100,73,25,98
Bihar,Araria,Locomotor Disability,0,6,38,19,57
Bihar,Araria,Locomotor Disability,6,15,218,151,369
Bihar,Araria,Locomotor Disability,15,35,929,425,1354
Bihar,Araria,Locomotor Disability,35,60,722,263,985
Bihar,Araria,Locomotor Disability,60,80,152,36,188
Bihar,Araria,Locomotor Disability,80,100,6,1,7
Madhya Pradesh,Anuppur,Locomotor Disability,0,6,15,8,23
Madhya Pradesh,Anuppur,Locomotor Disability,6,15,131,93,224
Madhya Pradesh,Anuppur,Locomotor Disability,15,35,975,532,1507
Madhya Pradesh,Anuppur,Locomotor Disability,35,60,1275,527,1802
Madhya Pradesh,Anuppur,Locomotor Disability,60,80,305,118,423
Madhya Pradesh,Anuppur,Locomotor Disability,80,100,12,4,16
Odisha,Anugul,Locomotor Disability,0,6,58,27,85
Odisha,Anugul,Locomotor Disability,6,15,361,180,541
Odisha,Anugul,Locomotor Disability,15,35,1294,618,1912
Odisha,Anugul,Locomotor Disability,35,60,2972,1356,4328
Odisha,Anugul,Locomotor Disability,60,80,923,404,1327
Odisha,Anugul,Locomotor Disability,80,100,38,18,56
Andhra Pradesh,Annamayya,Locomotor Disability,35,60,1,0,1
Arunachal Pradesh,Anjaw,Locomotor Disability,6,15,4,1,5
Arunachal Pradesh,Anjaw,Locomotor Disability,15,35,10,6,16
Arunachal Pradesh,Anjaw,Locomotor Disability,35,60,15,3,18
Arunachal Pradesh,Anjaw,Locomotor Disability,60,80,2,0,2
Jammu And Kashmir,Anantnag,Locomotor Disability,0,6,28,25,53
Jammu And Kashmir,Anantnag,Locomotor Disability,6,15,153,97,250
Jammu And Kashmir,Anantnag,Locomotor Disability,15,35,734,498,1232
Jammu And Kashmir,Anantnag,Locomotor Disability,35,60,1237,764,2001
Jammu And Kashmir,Anantnag,Locomotor Disability,60,80,234,149,383
Jammu And Kashmir,Anantnag,Locomotor Disability,80,100,26,14,40
Andhra Pradesh,Anantapur,Locomotor Disability,0,6,177,125,302
Andhra Pradesh,Anantapur,Locomotor Disability,6,15,807,549,1356
Andhra Pradesh,Anantapur,Locomotor Disability,15,35,2039,696,2735
Andhra Pradesh,Anantapur,Locomotor Disability,35,60,7436,1069,8505
Andhra Pradesh,Anantapur,Locomotor Disability,60,80,2333,263,2596
Andhra Pradesh,Anantapur,Locomotor Disability,80,100,138,13,151
Gujarat,Anand,Locomotor Disability,0,6,64,34,98
Gujarat,Anand,Locomotor Disability,6,15,477,283,760
Gujarat,Anand,Locomotor Disability,15,35,1279,559,1838
Gujarat,Anand,Locomotor Disability,35,60,2442,937,3379
Gujarat,Anand,Locomotor Disability,60,80,621,158,779
Gujarat,Anand,Locomotor Disability,80,100,34,5,39
Uttar Pradesh,Amroha,Locomotor Disability,0,6,26,30,56
Uttar Pradesh,Amroha,Locomotor Disability,6,15,284,167,451
Uttar Pradesh,Amroha,Locomotor Disability,15,35,2423,1051,3474
Uttar Pradesh,Amroha,Locomotor Disability,35,60,2239,801,3040
Uttar Pradesh,Amroha,Locomotor Disability,60,80,433,119,552
Uttar Pradesh,Amroha,Locomotor Disability,80,100,24,4,28
Punjab,Amritsar,Locomotor Disability,0,6,46,28,74
Punjab,Amritsar,Locomotor Disability,6,15,311,179,490
Punjab,Amritsar,Locomotor Disability,15,35,2886,1509,4395
Punjab,Amritsar,Locomotor Disability,35,60,6504,3120,9624
Punjab,Amritsar,Locomotor Disability,60,80,1567,330,1897
Punjab,Amritsar,Locomotor Disability,80,100,103,15,118
Gujarat,Amreli,Locomotor Disability,0,6,16,5,21
Gujarat,Amreli,Locomotor Disability,6,15,319,194,513
Gujarat,Amreli,Locomotor Disability,15,35,1398,735,2133
Gujarat,Amreli,Locomotor Disability,35,60,3026,1279,4305
Gujarat,Amreli,Locomotor Disability,60,80,821,167,988
Gujarat,Amreli,Locomotor Disability,80,100,70,5,75
Maharashtra,Amravati,Locomotor Disability,0,6,92,49,141
Maharashtra,Amravati,Locomotor Disability,6,15,753,444,1197
Maharashtra,Amravati,Locomotor Disability,15,35,3507,1626,5133
Maharashtra,Amravati,Locomotor Disability,35,60,9204,3273,12477
Maharashtra,Amravati,Locomotor Disability,60,80,3446,994,4440
Maharashtra,Amravati,Locomotor Disability,80,100,172,48,220
Uttar Pradesh,Amethi,Locomotor Disability,0,6,28,18,46
Uttar Pradesh,Amethi,Locomotor Disability,6,15,258,140,398
Uttar Pradesh,Amethi,Locomotor Disability,15,35,1817,770,2587
Uttar Pradesh,Amethi,Locomotor Disability,35,60,2433,675,3108
Uttar Pradesh,Amethi,Locomotor Disability,60,80,499,96,595
Uttar Pradesh,Amethi,Locomotor Disability,80,100,27,6,33
Uttar Pradesh,Ambedkar Nagar,Locomotor Disability,0,6,11,11,22
Uttar Pradesh,Ambedkar Nagar,Locomotor Disability,6,15,179,125,304
Uttar Pradesh,Ambedkar Nagar,Locomotor Disability,15,35,2204,912,3116
Uttar Pradesh,Ambedkar Nagar,Locomotor Disability,35,60,2532,648,3180
Uttar Pradesh,Ambedkar Nagar,Locomotor Disability,60,80,421,69,490
Uttar Pradesh,Ambedkar Nagar,Locomotor Disability,80,100,20,0,20
Haryana,Ambala,Locomotor Disability,0,6,18,12,30
Haryana,Ambala,Locomotor Disability,6,15,128,73,201
Haryana,Ambala,Locomotor Disability,15,35,588,310,898
Haryana,Ambala,Locomotor Disability,35,60,1575,684,2259
Haryana,Ambala,Locomotor Disability,60,80,268,91,359
Haryana,Ambala,Locomotor Disability,80,100,10,5,15
Rajasthan,Alwar,Locomotor Disability,0,6,59,37,96
Rajasthan,Alwar,Locomotor Disability,6,15,776,443,1219
Rajasthan,Alwar,Locomotor Disability,15,35,4517,2174,6691
Rajasthan,Alwar,Locomotor Disability,35,60,6372,2901,9273
Rajasthan,Alwar,Locomotor Disability,60,80,1633,675,2308
Rajasthan,Alwar,Locomotor Disability,80,100,104,63,167
Uttarakhand,Almora,Locomotor Disability,0,6,10,10,20
Uttarakhand,Almora,Locomotor Disability,6,15,83,80,163
Uttarakhand,Almora,Locomotor Disability,15,35,525,284,809
Uttarakhand,Almora,Locomotor Disability,35,60,1393,561,1954
Uttarakhand,Almora,Locomotor Disability,60,80,312,137,449
Uttarakhand,Almora,Locomotor Disability,80,100,11,9,20
Madhya Pradesh,Alirajpur,Locomotor Disability,0,6,4,2,6
Madhya Pradesh,Alirajpur,Locomotor Disability,6,15,131,95,226
Madhya Pradesh,Alirajpur,Locomotor Disability,15,35,1047,594,1641
Madhya Pradesh,Alirajpur,Locomotor Disability,35,60,1258,495,1753
Madhya Pradesh,Alirajpur,Locomotor Disability,60,80,342,118,460
Madhya Pradesh,Alirajpur,Locomotor Disability,80,100,10,7,17
Uttar Pradesh,Aligarh,Locomotor Disability,0,6,65,28,93
Uttar Pradesh,Aligarh,Locomotor Disability,6,15,632,344,976
Uttar Pradesh,Aligarh,Locomotor Disability,15,35,6386,2289,8675
Uttar Pradesh,Aligarh,Locomotor Disability,35,60,5950,1909,7859
Uttar Pradesh,Aligarh,Locomotor Disability,60,80,997,209,1206
Uttar Pradesh,Aligarh,Locomotor Disability,80,100,42,3,45
Kerala,Alappuzha,Locomotor Disability,0,6,6,4,10
Kerala,Alappuzha,Locomotor Disability,6,15,65,36,101
Kerala,Alappuzha,Locomotor Disability,15,35,429,266,695
Kerala,Alappuzha,Locomotor Disability,35,60,1845,1008,2853
Kerala,Alappuzha,Locomotor Disability,60,80,1102,407,1509
Kerala,Alappuzha,Locomotor Disability,80,100,31,29,60
Maharashtra,Akola,Locomotor Disability,0,6,59,38,97
Maharashtra,Akola,Locomotor Disability,6,15,370,289,659
Maharashtra,Akola,Locomotor Disability,15,35,2885,1271,4156
Maharashtra,Akola,Locomotor Disability,35,60,6717,2037,8754
Maharashtra,Akola,Locomotor Disability,60,80,2228,446,2674
Maharashtra,Akola,Locomotor Disability,80,100,79,10,89
Rajasthan,Ajmer,Locomotor Disability,0,6,67,51,118
Rajasthan,Ajmer,Locomotor Disability,6,15,520,330,850
Rajasthan,Ajmer,Locomotor Disability,15,35,2865,1408,4273
Rajasthan,Ajmer,Locomotor Disability,35,60,4637,2105,6742
Rajasthan,Ajmer,Locomotor Disability,60,80,868,328,1196
Rajasthan,Ajmer,Locomotor Disability,80,100,36,14,50
Mizoram,Aizawl,Locomotor Disability,0,6,1,3,4
Mizoram,Aizawl,Locomotor Disability,6,15,13,13,26
Mizoram,Aizawl,Locomotor Disability,15,35,89,50,139
Mizoram,Aizawl,Locomotor Disability,35,60,181,53,234
Mizoram,Aizawl,Locomotor Disability,60,80,28,20,48
Mizoram,Aizawl,Locomotor Disability,80,100,5,1,6
Maharashtra,Ahmednagar,Locomotor Disability,0,6,123,83,206
Maharashtra,Ahmednagar,Locomotor Disability,6,15,1003,589,1592
Maharashtra,Ahmednagar,Locomotor Disability,15,35,3712,1651,5363
Maharashtra,Ahmednagar,Locomotor Disability,35,60,7699,2463,10162
Maharashtra,Ahmednagar,Locomotor Disability,60,80,2559,458,3017
Maharashtra,Ahmednagar,Locomotor Disability,80,100,157,22,179
Gujarat,Ahmadabad,Locomotor Disability,0,6,91,68,159
Gujarat,Ahmadabad,Locomotor Disability,6,15,580,346,926
Gujarat,Ahmadabad,Locomotor Disability,15,35,1850,921,2771
Gujarat,Ahmadabad,Locomotor Disability,35,60,4536,2097,6633
Gujarat,Ahmadabad,Locomotor Disability,60,80,945,202,1147
Gujarat,Ahmadabad,Locomotor Disability,80,100,32,6,38
Uttar Pradesh,Agra,Locomotor Disability,0,6,56,48,104
Uttar Pradesh,Agra,Locomotor Disability,6,15,592,327,919
Uttar Pradesh,Agra,Locomotor Disability,15,35,5751,2148,7899
Uttar Pradesh,Agra,Locomotor Disability,35,60,6036,1907,7943
Uttar Pradesh,Agra,Locomotor Disability,60,80,1039,177,1216
Uttar Pradesh,Agra,Locomotor Disability,80,100,33,10,43
Madhya Pradesh,Agar Malwa,Locomotor Disability,0,6,15,8,23
Madhya Pradesh,Agar Malwa,Locomotor Disability,6,15,150,79,229
Madhya Pradesh,Agar Malwa,Locomotor Disability,15,35,730,307,1037
Madhya Pradesh,Agar Malwa,Locomotor Disability,35,60,1367,542,1909
Madhya Pradesh,Agar Malwa,Locomotor Disability,60,80,299,88,387
Madhya Pradesh,Agar Malwa,Locomotor Disability,80,100,19,2,21
Telangana,Adilabad,Locomotor Disability,6,15,133,93,226
Telangana,Adilabad,Locomotor Disability,15,35,669,425,1094
Telangana,Adilabad,Locomotor Disability,35,60,1228,581,1809
Telangana,Adilabad,Locomotor Disability,60,80,512,244,756
Telangana,Adilabad,Locomotor Disability,80,100,34,31,65
West Bengal,24 Paraganas South,Locomotor Disability,15,35,3,5,8
West Bengal,24 Paraganas South,Locomotor Disability,35,60,3,0,3
West Bengal,24 Paraganas North,Locomotor Disability,15,35,1,0,1
Maharashtra,Yavatmal,Low Vision,0,6,6,7,13
Maharashtra,Yavatmal,Low Vision,6,15,54,52,106
Maharashtra,Yavatmal,Low Vision,15,35,331,147,478
Maharashtra,Yavatmal,Low Vision,35,60,424,131,555
Maharashtra,Yavatmal,Low Vision,60,80,180,36,216
Maharashtra,Yavatmal,Low Vision,80,100,9,1,10
Puducherry,Yanam,Low Vision,15,35,1,1,2
Puducherry,Yanam,Low Vision,35,60,4,2,6
Puducherry,Yanam,Low Vision,60,80,2,0,2
Haryana,Yamunanagar,Low Vision,6,15,1,1,2
Haryana,Yamunanagar,Low Vision,15,35,12,9,21
Haryana,Yamunanagar,Low Vision,35,60,16,3,19
Haryana,Yamunanagar,Low Vision,60,80,2,1,3
Karnataka,Yadgir,Low Vision,0,6,1,0,1
Karnataka,Yadgir,Low Vision,6,15,27,13,40
Karnataka,Yadgir,Low Vision,15,35,120,45,165
Karnataka,Yadgir,Low Vision,35,60,80,51,131
Karnataka,Yadgir,Low Vision,60,80,14,8,22
Telangana,Yadadri Bhuvanagiri,Low Vision,6,15,6,6,12
Telangana,Yadadri Bhuvanagiri,Low Vision,15,35,106,93,199
Telangana,Yadadri Bhuvanagiri,Low Vision,35,60,344,214,558
Telangana,Yadadri Bhuvanagiri,Low Vision,60,80,329,217,546
Telangana,Yadadri Bhuvanagiri,Low Vision,80,100,108,51,159
Andhra Pradesh,Y.S.R.,Low Vision,6,15,8,1,9
Andhra Pradesh,Y.S.R.,Low Vision,15,35,139,103,242
Andhra Pradesh,Y.S.R.,Low Vision,35,60,383,307,690
Andhra Pradesh,Y.S.R.,Low Vision,60,80,273,116,389
Andhra Pradesh,Y.S.R.,Low Vision,80,100,25,17,42
Nagaland,Wokha,Low Vision,15,35,1,1,2
Tripura,West Tripura,Low Vision,6,15,36,19,55
Tripura,West Tripura,Low Vision,15,35,127,87,214
Tripura,West Tripura,Low Vision,35,60,169,72,241
Tripura,West Tripura,Low Vision,60,80,30,14,44
Tripura,West Tripura,Low Vision,80,100,2,1,3
Jharkhand,West Singhbhum,Low Vision,0,6,1,1,2
Jharkhand,West Singhbhum,Low Vision,6,15,35,16,51
Jharkhand,West Singhbhum,Low Vision,15,35,45,28,73
Jharkhand,West Singhbhum,Low Vision,35,60,43,15,58
Jharkhand,West Singhbhum,Low Vision,60,80,6,2,8
Arunachal Pradesh,West Siang,Low Vision,15,35,11,2,13
Arunachal Pradesh,West Siang,Low Vision,35,60,5,2,7
Arunachal Pradesh,West Siang,Low Vision,60,80,1,1,2
Meghalaya,West Khasi Hills,Low Vision,6,15,7,1,8
Meghalaya,West Khasi Hills,Low Vision,15,35,19,8,27
Meghalaya,West Khasi Hills,Low Vision,35,60,8,8,16
Meghalaya,West Khasi Hills,Low Vision,60,80,5,2,7
Meghalaya,West Khasi Hills,Low Vision,80,100,1,1,2
Assam,West Karbi Anglong,Low Vision,0,6,1,0,1
Assam,West Karbi Anglong,Low Vision,6,15,2,1,3
Assam,West Karbi Anglong,Low Vision,15,35,6,4,10
Assam,West Karbi Anglong,Low Vision,35,60,7,4,11
Assam,West Karbi Anglong,Low Vision,60,80,3,3,6
Meghalaya,West Jaintia Hills,Low Vision,0,6,3,3,6
Meghalaya,West Jaintia Hills,Low Vision,6,15,29,20,49
Meghalaya,West Jaintia Hills,Low Vision,15,35,80,73,153
Meghalaya,West Jaintia Hills,Low Vision,35,60,50,56,106
Meghalaya,West Jaintia Hills,Low Vision,60,80,14,17,31
Meghalaya,West Jaintia Hills,Low Vision,80,100,2,2,4
Andhra Pradesh,West Godavari,Low Vision,0,6,3,2,5
Andhra Pradesh,West Godavari,Low Vision,6,15,43,34,77
Andhra Pradesh,West Godavari,Low Vision,15,35,252,185,437
Andhra Pradesh,West Godavari,Low Vision,35,60,587,347,934
Andhra Pradesh,West Godavari,Low Vision,60,80,320,176,496
Andhra Pradesh,West Godavari,Low Vision,80,100,80,32,112
Meghalaya,West Garo Hills,Low Vision,6,15,1,8,9
Meghalaya,West Garo Hills,Low Vision,15,35,5,8,13
Meghalaya,West Garo Hills,Low Vision,35,60,10,5,15
Meghalaya,West Garo Hills,Low Vision,60,80,3,3,6
Meghalaya,West Garo Hills,Low Vision,80,100,1,1,2
Delhi,West,Low Vision,0,6,3,1,4
Delhi,West,Low Vision,6,15,33,33,66
Delhi,West,Low Vision,15,35,80,50,130
Delhi,West,Low Vision,35,60,54,23,77
Delhi,West,Low Vision,60,80,13,4,17
Kerala,Wayanad,Low Vision,6,15,8,6,14
Kerala,Wayanad,Low Vision,15,35,40,16,56
Kerala,Wayanad,Low Vision,35,60,57,36,93
Kerala,Wayanad,Low Vision,60,80,22,17,39
Kerala,Wayanad,Low Vision,80,100,2,0,2
Maharashtra,Washim,Low Vision,0,6,2,5,7
Maharashtra,Washim,Low Vision,6,15,113,69,182
Maharashtra,Washim,Low Vision,15,35,375,133,508
Maharashtra,Washim,Low Vision,35,60,361,157,518
Maharashtra,Washim,Low Vision,60,80,158,72,230
Maharashtra,Washim,Low Vision,80,100,12,5,17
Maharashtra,Wardha,Low Vision,0,6,9,3,12
Maharashtra,Wardha,Low Vision,6,15,66,63,129
Maharashtra,Wardha,Low Vision,15,35,308,168,476
Maharashtra,Wardha,Low Vision,35,60,446,232,678
Maharashtra,Wardha,Low Vision,60,80,222,83,305
Maharashtra,Wardha,Low Vision,80,100,13,10,23
Telangana,Warangal,Low Vision,0,6,2,1,3
Telangana,Warangal,Low Vision,6,15,12,9,21
Telangana,Warangal,Low Vision,15,35,207,171,378
Telangana,Warangal,Low Vision,35,60,502,386,888
Telangana,Warangal,Low Vision,60,80,642,381,1023
Telangana,Warangal,Low Vision,80,100,148,83,231
Telangana,Wanaparthy,Low Vision,6,15,10,9,19
Telangana,Wanaparthy,Low Vision,15,35,97,59,156
Telangana,Wanaparthy,Low Vision,35,60,278,264,542
Telangana,Wanaparthy,Low Vision,60,80,298,206,504
Telangana,Wanaparthy,Low Vision,80,100,55,132,187
Andhra Pradesh,Vizianagaram,Low Vision,0,6,1,2,3
Andhra Pradesh,Vizianagaram,Low Vision,6,15,21,16,37
Andhra Pradesh,Vizianagaram,Low Vision,15,35,149,93,242
Andhra Pradesh,Vizianagaram,Low Vision,35,60,333,284,617
Andhra Pradesh,Vizianagaram,Low Vision,60,80,268,201,469
Andhra Pradesh,Vizianagaram,Low Vision,80,100,25,31,56
Andhra Pradesh,Visakhapatanam,Low Vision,6,15,27,10,37
Andhra Pradesh,Visakhapatanam,Low Vision,15,35,189,123,312
Andhra Pradesh,Visakhapatanam,Low Vision,35,60,344,250,594
Andhra Pradesh,Visakhapatanam,Low Vision,60,80,201,113,314
Andhra Pradesh,Visakhapatanam,Low Vision,80,100,21,12,33
Tamil Nadu,Virudhunagar,Low Vision,0,6,4,1,5
Tamil Nadu,Virudhunagar,Low Vision,6,15,36,23,59
Tamil Nadu,Virudhunagar,Low Vision,15,35,91,68,159
Tamil Nadu,Virudhunagar,Low Vision,35,60,103,78,181
Tamil Nadu,Virudhunagar,Low Vision,60,80,65,31,96
Tamil Nadu,Virudhunagar,Low Vision,80,100,3,1,4
Tamil Nadu,Villupuram,Low Vision,0,6,2,4,6
Tamil Nadu,Villupuram,Low Vision,6,15,42,40,82
Tamil Nadu,Villupuram,Low Vision,15,35,117,94,211
Tamil Nadu,Villupuram,Low Vision,35,60,253,200,453
Tamil Nadu,Villupuram,Low Vision,60,80,155,91,246
Tamil Nadu,Villupuram,Low Vision,80,100,25,9,34
Telangana,Vikarabad,Low Vision,6,15,30,32,62
Telangana,Vikarabad,Low Vision,15,35,279,232,511
Telangana,Vikarabad,Low Vision,35,60,492,280,772
Telangana,Vikarabad,Low Vision,60,80,280,185,465
Telangana,Vikarabad,Low Vision,80,100,33,17,50
Karnataka,Vijayapura,Low Vision,0,6,4,1,5
Karnataka,Vijayapura,Low Vision,6,15,33,20,53
Karnataka,Vijayapura,Low Vision,15,35,138,80,218
Karnataka,Vijayapura,Low Vision,35,60,125,45,170
Karnataka,Vijayapura,Low Vision,60,80,19,3,22
Karnataka,Vijayapura,Low Vision,80,100,2,0,2
Madhya Pradesh,Vidisha,Low Vision,0,6,5,10,15
Madhya Pradesh,Vidisha,Low Vision,6,15,104,83,187
Madhya Pradesh,Vidisha,Low Vision,15,35,326,163,489
Madhya Pradesh,Vidisha,Low Vision,35,60,351,144,495
Madhya Pradesh,Vidisha,Low Vision,60,80,149,46,195
Madhya Pradesh,Vidisha,Low Vision,80,100,16,2,18
Tamil Nadu,Vellore,Low Vision,0,6,2,2,4
Tamil Nadu,Vellore,Low Vision,6,15,21,23,44
Tamil Nadu,Vellore,Low Vision,15,35,120,74,194
Tamil Nadu,Vellore,Low Vision,35,60,239,114,353
Tamil Nadu,Vellore,Low Vision,60,80,112,36,148
Tamil Nadu,Vellore,Low Vision,80,100,7,2,9
Uttar Pradesh,Varanasi,Low Vision,0,6,1,4,5
Uttar Pradesh,Varanasi,Low Vision,6,15,29,14,43
Uttar Pradesh,Varanasi,Low Vision,15,35,251,132,383
Uttar Pradesh,Varanasi,Low Vision,35,60,172,67,239
Uttar Pradesh,Varanasi,Low Vision,60,80,44,10,54
Uttar Pradesh,Varanasi,Low Vision,80,100,3,0,3
Gujarat,Valsad,Low Vision,0,6,1,1,2
Gujarat,Valsad,Low Vision,6,15,51,36,87
Gujarat,Valsad,Low Vision,15,35,86,55,141
Gujarat,Valsad,Low Vision,35,60,47,9,56
Gujarat,Valsad,Low Vision,60,80,17,5,22
Gujarat,Valsad,Low Vision,80,100,0,1,1
Bihar,Vaishali,Low Vision,0,6,4,2,6
Bihar,Vaishali,Low Vision,6,15,30,22,52
Bihar,Vaishali,Low Vision,15,35,118,47,165
Bihar,Vaishali,Low Vision,35,60,88,26,114
Bihar,Vaishali,Low Vision,60,80,14,4,18
Bihar,Vaishali,Low Vision,80,100,1,0,1
Gujarat,Vadodara,Low Vision,0,6,11,7,18
Gujarat,Vadodara,Low Vision,6,15,81,76,157
Gujarat,Vadodara,Low Vision,15,35,223,90,313
Gujarat,Vadodara,Low Vision,35,60,148,70,218
Gujarat,Vadodara,Low Vision,60,80,56,21,77
Gujarat,Vadodara,Low Vision,80,100,2,1,3
Karnataka,Uttara Kannada,Low Vision,0,6,11,11,22
Karnataka,Uttara Kannada,Low Vision,6,15,95,84,179
Karnataka,Uttara Kannada,Low Vision,15,35,337,186,523
Karnataka,Uttara Kannada,Low Vision,35,60,514,379,893
Karnataka,Uttara Kannada,Low Vision,60,80,158,104,262
Karnataka,Uttara Kannada,Low Vision,80,100,2,4,6
Uttarakhand,Uttar Kashi,Low Vision,0,6,0,2,2
Uttarakhand,Uttar Kashi,Low Vision,6,15,15,10,25
Uttarakhand,Uttar Kashi,Low Vision,15,35,69,34,103
Uttarakhand,Uttar Kashi,Low Vision,35,60,68,43,111
Uttarakhand,Uttar Kashi,Low Vision,60,80,12,5,17
Arunachal Pradesh,Upper Siang,Low Vision,6,15,0,1,1
Arunachal Pradesh,Upper Siang,Low Vision,15,35,1,0,1
Arunachal Pradesh,Upper Siang,Low Vision,35,60,1,0,1
Uttar Pradesh,Unnao,Low Vision,0,6,1,2,3
Uttar Pradesh,Unnao,Low Vision,6,15,10,8,18
Uttar Pradesh,Unnao,Low Vision,15,35,106,54,160
Uttar Pradesh,Unnao,Low Vision,35,60,108,38,146
Uttar Pradesh,Unnao,Low Vision,60,80,44,11,55
Uttar Pradesh,Unnao,Low Vision,80,100,2,5,7
Tripura,Unakoti,Low Vision,0,6,1,0,1
Tripura,Unakoti,Low Vision,6,15,18,5,23
Tripura,Unakoti,Low Vision,15,35,128,59,187
Tripura,Unakoti,Low Vision,35,60,93,81,174
Tripura,Unakoti,Low Vision,60,80,13,11,24
Tripura,Unakoti,Low Vision,80,100,2,4,6
Himachal Pradesh,Una,Low Vision,0,6,3,0,3
Himachal Pradesh,Una,Low Vision,6,15,10,2,12
Himachal Pradesh,Una,Low Vision,15,35,56,32,88
Himachal Pradesh,Una,Low Vision,35,60,81,24,105
Himachal Pradesh,Una,Low Vision,60,80,59,20,79
Himachal Pradesh,Una,Low Vision,80,100,5,2,7
Madhya Pradesh,Umaria,Low Vision,6,15,18,13,31
Madhya Pradesh,Umaria,Low Vision,15,35,74,51,125
Madhya Pradesh,Umaria,Low Vision,35,60,102,35,137
Madhya Pradesh,Umaria,Low Vision,60,80,30,10,40
Madhya Pradesh,Umaria,Low Vision,80,100,1,0,1
Manipur,Ukhrul,Low Vision,35,60,0,1,1
Manipur,Ukhrul,Low Vision,60,80,2,1,3
Manipur,Ukhrul,Low Vision,80,100,0,1,1
Madhya Pradesh,Ujjain,Low Vision,0,6,3,3,6
Madhya Pradesh,Ujjain,Low Vision,6,15,36,23,59
Madhya Pradesh,Ujjain,Low Vision,15,35,129,73,202
Madhya Pradesh,Ujjain,Low Vision,35,60,136,41,177
Madhya Pradesh,Ujjain,Low Vision,60,80,33,8,41
Karnataka,Udupi,Low Vision,0,6,1,2,3
Karnataka,Udupi,Low Vision,6,15,23,14,37
Karnataka,Udupi,Low Vision,15,35,93,49,142
Karnataka,Udupi,Low Vision,35,60,122,98,220
Karnataka,Udupi,Low Vision,60,80,64,48,112
Karnataka,Udupi,Low Vision,80,100,4,0,4
Jammu And Kashmir,Udhampur,Low Vision,0,6,0,1,1
Jammu And Kashmir,Udhampur,Low Vision,6,15,22,20,42
Jammu And Kashmir,Udhampur,Low Vision,15,35,108,58,166
Jammu And Kashmir,Udhampur,Low Vision,35,60,141,90,231
Jammu And Kashmir,Udhampur,Low Vision,60,80,47,13,60
Jammu And Kashmir,Udhampur,Low Vision,80,100,4,3,7
Uttarakhand,Udam Singh Nagar,Low Vision,6,15,4,3,7
Uttarakhand,Udam Singh Nagar,Low Vision,15,35,23,13,36
Uttarakhand,Udam Singh Nagar,Low Vision,35,60,29,10,39
Uttarakhand,Udam Singh Nagar,Low Vision,60,80,4,2,6
Uttarakhand,Udam Singh Nagar,Low Vision,80,100,0,1,1
Assam,Udalguri,Low Vision,0,6,0,2,2
Assam,Udalguri,Low Vision,6,15,5,7,12
Assam,Udalguri,Low Vision,15,35,16,13,29
Assam,Udalguri,Low Vision,35,60,26,15,41
Assam,Udalguri,Low Vision,60,80,4,4,8
Assam,Udalguri,Low Vision,80,100,0,1,1
Rajasthan,Udaipur,Low Vision,6,15,13,9,22
Rajasthan,Udaipur,Low Vision,15,35,33,27,60
Rajasthan,Udaipur,Low Vision,35,60,38,22,60
Rajasthan,Udaipur,Low Vision,60,80,17,15,32
Rajasthan,Udaipur,Low Vision,80,100,3,1,4
Tamil Nadu,Tuticorin,Low Vision,0,6,3,1,4
Tamil Nadu,Tuticorin,Low Vision,6,15,15,14,29
Tamil Nadu,Tuticorin,Low Vision,15,35,52,40,92
Tamil Nadu,Tuticorin,Low Vision,35,60,49,43,92
Tamil Nadu,Tuticorin,Low Vision,60,80,24,21,45
Tamil Nadu,Tuticorin,Low Vision,80,100,5,1,6
Karnataka,Tumakuru,Low Vision,0,6,4,3,7
Karnataka,Tumakuru,Low Vision,6,15,43,36,79
Karnataka,Tumakuru,Low Vision,15,35,259,151,410
Karnataka,Tumakuru,Low Vision,35,60,344,185,529
Karnataka,Tumakuru,Low Vision,60,80,81,29,110
Karnataka,Tumakuru,Low Vision,80,100,4,2,6
Nagaland,Tuensang,Low Vision,15,35,1,0,1
Nagaland,Tuensang,Low Vision,35,60,0,1,1
Nagaland,Tuensang,Low Vision,60,80,1,0,1
Rajasthan,Tonk,Low Vision,6,15,8,1,9
Rajasthan,Tonk,Low Vision,15,35,96,49,145
Rajasthan,Tonk,Low Vision,35,60,58,21,79
Rajasthan,Tonk,Low Vision,60,80,5,4,9
Rajasthan,Tonk,Low Vision,80,100,3,0,3
Tamil Nadu,Tiruvannamalai,Low Vision,0,6,3,5,8
Tamil Nadu,Tiruvannamalai,Low Vision,6,15,54,52,106
Tamil Nadu,Tiruvannamalai,Low Vision,15,35,209,148,357
Tamil Nadu,Tiruvannamalai,Low Vision,35,60,400,239,639
Tamil Nadu,Tiruvannamalai,Low Vision,60,80,223,146,369
Tamil Nadu,Tiruvannamalai,Low Vision,80,100,25,9,34
Tamil Nadu,Tiruppur,Low Vision,6,15,18,20,38
Tamil Nadu,Tiruppur,Low Vision,15,35,37,30,67
Tamil Nadu,Tiruppur,Low Vision,35,60,44,48,92
Tamil Nadu,Tiruppur,Low Vision,60,80,25,10,35
Tamil Nadu,Tiruppur,Low Vision,80,100,5,0,5
Tamil Nadu,Tirupathur,Low Vision,0,6,3,1,4
Tamil Nadu,Tirupathur,Low Vision,6,15,22,20,42
Tamil Nadu,Tirupathur,Low Vision,15,35,65,50,115
Tamil Nadu,Tirupathur,Low Vision,35,60,123,85,208
Tamil Nadu,Tirupathur,Low Vision,60,80,66,29,95
Tamil Nadu,Tirupathur,Low Vision,80,100,4,2,6
Tamil Nadu,Tirunelveli,Low Vision,6,15,10,9,19
Tamil Nadu,Tirunelveli,Low Vision,15,35,38,17,55
Tamil Nadu,Tirunelveli,Low Vision,35,60,44,24,68
Tamil Nadu,Tirunelveli,Low Vision,60,80,10,9,19
Tamil Nadu,Tiruchirappalli,Low Vision,0,6,10,4,14
Tamil Nadu,Tiruchirappalli,Low Vision,6,15,73,71,144
Tamil Nadu,Tiruchirappalli,Low Vision,15,35,205,142,347
Tamil Nadu,Tiruchirappalli,Low Vision,35,60,198,135,333
Tamil Nadu,Tiruchirappalli,Low Vision,60,80,100,51,151
Tamil Nadu,Tiruchirappalli,Low Vision,80,100,8,2,10
Arunachal Pradesh,Tirap,Low Vision,15,35,0,1,1
Arunachal Pradesh,Tirap,Low Vision,35,60,1,1,2
Assam,Tinsukia,Low Vision,0,6,1,0,1
Assam,Tinsukia,Low Vision,6,15,4,5,9
Assam,Tinsukia,Low Vision,15,35,18,10,28
Assam,Tinsukia,Low Vision,35,60,13,8,21
Assam,Tinsukia,Low Vision,60,80,2,1,3
Assam,Tinsukia,Low Vision,80,100,1,0,1
Madhya Pradesh,Tikamgarh,Low Vision,0,6,2,7,9
Madhya Pradesh,Tikamgarh,Low Vision,6,15,31,27,58
Madhya Pradesh,Tikamgarh,Low Vision,15,35,195,123,318
Madhya Pradesh,Tikamgarh,Low Vision,35,60,249,143,392
Madhya Pradesh,Tikamgarh,Low Vision,60,80,144,58,202
Madhya Pradesh,Tikamgarh,Low Vision,80,100,14,4,18
Kerala,Thrissur,Low Vision,0,6,3,4,7
Kerala,Thrissur,Low Vision,6,15,27,20,47
Kerala,Thrissur,Low Vision,15,35,107,83,190
Kerala,Thrissur,Low Vision,35,60,237,161,398
Kerala,Thrissur,Low Vision,60,80,115,101,216
Kerala,Thrissur,Low Vision,80,100,8,3,11
Manipur,Thoubal,Low Vision,15,35,4,0,4
Tamil Nadu,Thiruvarur,Low Vision,0,6,1,1,2
Tamil Nadu,Thiruvarur,Low Vision,6,15,20,26,46
Tamil Nadu,Thiruvarur,Low Vision,15,35,48,55,103
Tamil Nadu,Thiruvarur,Low Vision,35,60,52,34,86
Tamil Nadu,Thiruvarur,Low Vision,60,80,14,3,17
Tamil Nadu,Thiruvarur,Low Vision,80,100,2,0,2
Kerala,Thiruvananthapuram,Low Vision,0,6,8,5,13
Kerala,Thiruvananthapuram,Low Vision,6,15,24,23,47
Kerala,Thiruvananthapuram,Low Vision,15,35,150,95,245
Kerala,Thiruvananthapuram,Low Vision,35,60,134,108,242
Kerala,Thiruvananthapuram,Low Vision,60,80,85,38,123
Kerala,Thiruvananthapuram,Low Vision,80,100,1,5,6
Tamil Nadu,Thiruvallur,Low Vision,0,6,1,3,4
Tamil Nadu,Thiruvallur,Low Vision,6,15,38,34,72
Tamil Nadu,Thiruvallur,Low Vision,15,35,141,85,226
Tamil Nadu,Thiruvallur,Low Vision,35,60,169,99,268
Tamil Nadu,Thiruvallur,Low Vision,60,80,58,36,94
Tamil Nadu,Thiruvallur,Low Vision,80,100,1,2,3
Tamil Nadu,Theni,Low Vision,0,6,4,3,7
Tamil Nadu,Theni,Low Vision,6,15,46,45,91
Tamil Nadu,Theni,Low Vision,15,35,103,79,182
Tamil Nadu,Theni,Low Vision,35,60,127,95,222
Tamil Nadu,Theni,Low Vision,60,80,83,47,130
Tamil Nadu,Theni,Low Vision,80,100,5,2,7
Tamil Nadu,The Nilgiris,Low Vision,0,6,1,0,1
Tamil Nadu,The Nilgiris,Low Vision,6,15,9,9,18
Tamil Nadu,The Nilgiris,Low Vision,15,35,40,29,69
Tamil Nadu,The Nilgiris,Low Vision,35,60,74,50,124
Tamil Nadu,The Nilgiris,Low Vision,60,80,39,25,64
Tamil Nadu,The Nilgiris,Low Vision,80,100,4,2,6
Tamil Nadu,Thanjavur,Low Vision,0,6,1,2,3
Tamil Nadu,Thanjavur,Low Vision,6,15,61,50,111
Tamil Nadu,Thanjavur,Low Vision,15,35,158,107,265
Tamil Nadu,Thanjavur,Low Vision,35,60,159,126,285
Tamil Nadu,Thanjavur,Low Vision,60,80,68,31,99
Tamil Nadu,Thanjavur,Low Vision,80,100,4,2,6
Maharashtra,Thane,Low Vision,0,6,4,2,6
Maharashtra,Thane,Low Vision,6,15,50,40,90
Maharashtra,Thane,Low Vision,15,35,162,87,249
Maharashtra,Thane,Low Vision,35,60,173,51,224
Maharashtra,Thane,Low Vision,60,80,39,13,52
Maharashtra,Thane,Low Vision,80,100,3,0,3
Tamil Nadu,Tenkasi,Low Vision,0,6,1,3,4
Tamil Nadu,Tenkasi,Low Vision,6,15,7,8,15
Tamil Nadu,Tenkasi,Low Vision,15,35,15,14,29
Tamil Nadu,Tenkasi,Low Vision,35,60,26,20,46
Tamil Nadu,Tenkasi,Low Vision,60,80,9,3,12
Manipur,Tengnoupal,Low Vision,6,15,1,0,1
Uttarakhand,Tehri Garhwal,Low Vision,0,6,1,4,5
Uttarakhand,Tehri Garhwal,Low Vision,6,15,22,13,35
Uttarakhand,Tehri Garhwal,Low Vision,15,35,149,74,223
Uttarakhand,Tehri Garhwal,Low Vision,35,60,207,123,330
Uttarakhand,Tehri Garhwal,Low Vision,60,80,53,27,80
Uttarakhand,Tehri Garhwal,Low Vision,80,100,2,0,2
Arunachal Pradesh,Tawang,Low Vision,15,35,0,1,1
Punjab,Tarn Taran,Low Vision,0,6,1,0,1
Punjab,Tarn Taran,Low Vision,6,15,22,8,30
Punjab,Tarn Taran,Low Vision,15,35,57,46,103
Punjab,Tarn Taran,Low Vision,35,60,106,50,156
Punjab,Tarn Taran,Low Vision,60,80,16,4,20
Punjab,Tarn Taran,Low Vision,80,100,1,0,1
Gujarat,Tapi,Low Vision,0,6,0,1,1
Gujarat,Tapi,Low Vision,6,15,4,8,12
Gujarat,Tapi,Low Vision,15,35,5,9,14
Gujarat,Tapi,Low Vision,35,60,5,1,6
Gujarat,Tapi,Low Vision,60,80,1,0,1
Manipur,Tamenglong,Low Vision,15,35,4,1,5
Manipur,Tamenglong,Low Vision,35,60,6,3,9
Manipur,Tamenglong,Low Vision,60,80,0,1,1
Telangana,Suryapet,Low Vision,6,15,16,12,28
Telangana,Suryapet,Low Vision,15,35,225,168,393
Telangana,Suryapet,Low Vision,35,60,464,328,792
Telangana,Suryapet,Low Vision,60,80,394,317,711
Telangana,Suryapet,Low Vision,80,100,110,68,178
Chhattisgarh,Surguja,Low Vision,0,6,1,0,1
Chhattisgarh,Surguja,Low Vision,6,15,15,5,20
Chhattisgarh,Surguja,Low Vision,15,35,26,21,47
Chhattisgarh,Surguja,Low Vision,35,60,17,6,23
Chhattisgarh,Surguja,Low Vision,60,80,1,0,1
Gujarat,Surendranagar,Low Vision,0,6,0,1,1
Gujarat,Surendranagar,Low Vision,6,15,36,17,53
Gujarat,Surendranagar,Low Vision,15,35,111,40,151
Gujarat,Surendranagar,Low Vision,35,60,20,14,34
Gujarat,Surendranagar,Low Vision,60,80,11,3,14
Gujarat,Surendranagar,Low Vision,80,100,2,3,5
Gujarat,Surat,Low Vision,0,6,6,3,9
Gujarat,Surat,Low Vision,6,15,127,71,198
Gujarat,Surat,Low Vision,15,35,373,199,572
Gujarat,Surat,Low Vision,35,60,196,57,253
Gujarat,Surat,Low Vision,60,80,52,21,73
Gujarat,Surat,Low Vision,80,100,1,1,2
Chhattisgarh,Surajpur,Low Vision,6,15,23,10,33
Chhattisgarh,Surajpur,Low Vision,15,35,91,75,166
Chhattisgarh,Surajpur,Low Vision,35,60,42,22,64
Chhattisgarh,Surajpur,Low Vision,60,80,8,3,11
Chhattisgarh,Surajpur,Low Vision,80,100,2,1,3
Bihar,Supaul,Low Vision,0,6,2,2,4
Bihar,Supaul,Low Vision,6,15,72,63,135
Bihar,Supaul,Low Vision,15,35,120,67,187
Bihar,Supaul,Low Vision,35,60,98,68,166
Bihar,Supaul,Low Vision,60,80,31,23,54
Bihar,Supaul,Low Vision,80,100,3,1,4
Odisha,Sundargarh,Low Vision,0,6,10,8,18
Odisha,Sundargarh,Low Vision,6,15,133,109,242
Odisha,Sundargarh,Low Vision,15,35,316,272,588
Odisha,Sundargarh,Low Vision,35,60,424,247,671
Odisha,Sundargarh,Low Vision,60,80,141,63,204
Odisha,Sundargarh,Low Vision,80,100,14,13,27
Uttar Pradesh,Sultanpur,Low Vision,6,15,17,11,28
Uttar Pradesh,Sultanpur,Low Vision,15,35,161,94,255
Uttar Pradesh,Sultanpur,Low Vision,35,60,160,56,216
Uttar Pradesh,Sultanpur,Low Vision,60,80,47,14,61
Uttar Pradesh,Sultanpur,Low Vision,80,100,7,0,7
Chhattisgarh,Sukma,Low Vision,6,15,6,0,6
Chhattisgarh,Sukma,Low Vision,15,35,12,8,20
Chhattisgarh,Sukma,Low Vision,35,60,11,13,24
Chhattisgarh,Sukma,Low Vision,60,80,8,15,23
Jammu And Kashmir,Srinagar,Low Vision,0,6,3,4,7
Jammu And Kashmir,Srinagar,Low Vision,6,15,18,17,35
Jammu And Kashmir,Srinagar,Low Vision,15,35,69,38,107
Jammu And Kashmir,Srinagar,Low Vision,35,60,82,56,138
Jammu And Kashmir,Srinagar,Low Vision,60,80,11,11,22
Jammu And Kashmir,Srinagar,Low Vision,80,100,1,0,1
Andhra Pradesh,Srikakulam,Low Vision,6,15,2,0,2
Andhra Pradesh,Srikakulam,Low Vision,15,35,70,35,105
Andhra Pradesh,Srikakulam,Low Vision,35,60,153,117,270
Andhra Pradesh,Srikakulam,Low Vision,60,80,86,34,120
Andhra Pradesh,Srikakulam,Low Vision,80,100,10,1,11
Punjab,Sri Muktsar Sahib,Low Vision,0,6,0,1,1
Punjab,Sri Muktsar Sahib,Low Vision,6,15,9,7,16
Punjab,Sri Muktsar Sahib,Low Vision,15,35,40,22,62
Punjab,Sri Muktsar Sahib,Low Vision,35,60,37,15,52
Punjab,Sri Muktsar Sahib,Low Vision,60,80,14,3,17
Punjab,Sri Muktsar Sahib,Low Vision,80,100,1,0,1
Andhra Pradesh,Spsr Nellore,Low Vision,0,6,1,1,2
Andhra Pradesh,Spsr Nellore,Low Vision,6,15,2,4,6
Andhra Pradesh,Spsr Nellore,Low Vision,15,35,37,11,48
Andhra Pradesh,Spsr Nellore,Low Vision,35,60,68,42,110
Andhra Pradesh,Spsr Nellore,Low Vision,60,80,19,14,33
Andhra Pradesh,Spsr Nellore,Low Vision,80,100,4,0,4
Meghalaya,South West Khasi Hills,Low Vision,6,15,5,2,7
Meghalaya,South West Khasi Hills,Low Vision,15,35,14,11,25
Meghalaya,South West Khasi Hills,Low Vision,35,60,11,8,19
Meghalaya,South West Khasi Hills,Low Vision,60,80,0,5,5
Meghalaya,South West Garo Hills,Low Vision,0,6,0,2,2
Meghalaya,South West Garo Hills,Low Vision,6,15,1,1,2
Meghalaya,South West Garo Hills,Low Vision,15,35,5,6,11
Meghalaya,South West Garo Hills,Low Vision,35,60,4,4,8
Meghalaya,South West Garo Hills,Low Vision,60,80,2,0,2
Delhi,South West,Low Vision,0,6,5,3,8
Delhi,South West,Low Vision,6,15,49,42,91
Delhi,South West,Low Vision,15,35,104,64,168
Delhi,South West,Low Vision,35,60,74,22,96
Delhi,South West,Low Vision,60,80,11,2,13
Delhi,South West,Low Vision,80,100,0,1,1
Tripura,South Tripura,Low Vision,0,6,3,1,4
Tripura,South Tripura,Low Vision,6,15,24,14,38
Tripura,South Tripura,Low Vision,15,35,135,50,185
Tripura,South Tripura,Low Vision,35,60,112,52,164
Tripura,South Tripura,Low Vision,60,80,26,9,35
Tripura,South Tripura,Low Vision,80,100,1,2,3
Assam,South Salmara Mancachar,Low Vision,6,15,0,1,1
Assam,South Salmara Mancachar,Low Vision,15,35,5,6,11
Assam,South Salmara Mancachar,Low Vision,35,60,2,0,2
Goa,South Goa,Low Vision,0,6,1,0,1
Goa,South Goa,Low Vision,6,15,4,4,8
Goa,South Goa,Low Vision,15,35,15,7,22
Goa,South Goa,Low Vision,35,60,23,10,33
Goa,South Goa,Low Vision,60,80,10,3,13
Meghalaya,South Garo Hills,Low Vision,0,6,1,0,1
Meghalaya,South Garo Hills,Low Vision,15,35,2,0,2
Delhi,South East,Low Vision,0,6,1,0,1
Delhi,South East,Low Vision,6,15,6,16,22
Delhi,South East,Low Vision,15,35,15,17,32
Delhi,South East,Low Vision,35,60,4,5,9
Delhi,South East,Low Vision,60,80,2,1,3
Andaman And Nicobar Islands,South Andamans,Low Vision,6,15,2,2,4
Andaman And Nicobar Islands,South Andamans,Low Vision,15,35,13,9,22
Andaman And Nicobar Islands,South Andamans,Low Vision,35,60,16,11,27
Andaman And Nicobar Islands,South Andamans,Low Vision,60,80,2,3,5
Delhi,South,Low Vision,0,6,7,1,8
Delhi,South,Low Vision,6,15,20,14,34
Delhi,South,Low Vision,15,35,46,18,64
Delhi,South,Low Vision,35,60,17,4,21
Delhi,South,Low Vision,60,80,3,0,3
Assam,Sonitpur,Low Vision,0,6,1,0,1
Assam,Sonitpur,Low Vision,6,15,8,5,13
Assam,Sonitpur,Low Vision,15,35,49,27,76
Assam,Sonitpur,Low Vision,35,60,57,19,76
Assam,Sonitpur,Low Vision,60,80,9,3,12
Haryana,Sonipat,Low Vision,6,15,7,7,14
Haryana,Sonipat,Low Vision,15,35,36,18,54
Haryana,Sonipat,Low Vision,35,60,12,4,16
Haryana,Sonipat,Low Vision,60,80,1,1,2
Odisha,Sonepur,Low Vision,0,6,1,6,7
Odisha,Sonepur,Low Vision,6,15,50,42,92
Odisha,Sonepur,Low Vision,15,35,117,75,192
Odisha,Sonepur,Low Vision,35,60,87,41,128
Odisha,Sonepur,Low Vision,60,80,29,10,39
Odisha,Sonepur,Low Vision,80,100,2,3,5
Uttar Pradesh,Sonbhadra,Low Vision,0,6,3,0,3
Uttar Pradesh,Sonbhadra,Low Vision,6,15,10,5,15
Uttar Pradesh,Sonbhadra,Low Vision,15,35,105,42,147
Uttar Pradesh,Sonbhadra,Low Vision,35,60,76,30,106
Uttar Pradesh,Sonbhadra,Low Vision,60,80,20,7,27
Uttar Pradesh,Sonbhadra,Low Vision,80,100,2,0,2
Maharashtra,Solapur,Low Vision,0,6,6,2,8
Maharashtra,Solapur,Low Vision,6,15,60,35,95
Maharashtra,Solapur,Low Vision,15,35,190,79,269
Maharashtra,Solapur,Low Vision,35,60,123,37,160
Maharashtra,Solapur,Low Vision,60,80,39,9,48
Maharashtra,Solapur,Low Vision,80,100,1,2,3
Himachal Pradesh,Solan,Low Vision,0,6,1,2,3
Himachal Pradesh,Solan,Low Vision,6,15,16,11,27
Himachal Pradesh,Solan,Low Vision,15,35,89,55,144
Himachal Pradesh,Solan,Low Vision,35,60,152,62,214
Himachal Pradesh,Solan,Low Vision,60,80,54,17,71
Himachal Pradesh,Solan,Low Vision,80,100,10,1,11
Bihar,Siwan,Low Vision,0,6,6,2,8
Bihar,Siwan,Low Vision,6,15,48,43,91
Bihar,Siwan,Low Vision,15,35,135,59,194
Bihar,Siwan,Low Vision,35,60,91,41,132
Bihar,Siwan,Low Vision,60,80,19,8,27
Bihar,Siwan,Low Vision,80,100,3,1,4
Assam,Sivasagar,Low Vision,0,6,2,0,2
Assam,Sivasagar,Low Vision,6,15,12,12,24
Assam,Sivasagar,Low Vision,15,35,78,51,129
Assam,Sivasagar,Low Vision,35,60,68,28,96
Assam,Sivasagar,Low Vision,60,80,15,2,17
Assam,Sivasagar,Low Vision,80,100,2,0,2
Tamil Nadu,Sivaganga,Low Vision,0,6,3,1,4
Tamil Nadu,Sivaganga,Low Vision,6,15,32,17,49
Tamil Nadu,Sivaganga,Low Vision,15,35,67,42,109
Tamil Nadu,Sivaganga,Low Vision,35,60,80,39,119
Tamil Nadu,Sivaganga,Low Vision,60,80,48,16,64
Tamil Nadu,Sivaganga,Low Vision,80,100,5,1,6
Uttar Pradesh,Sitapur,Low Vision,6,15,15,15,30
Uttar Pradesh,Sitapur,Low Vision,15,35,70,32,102
Uttar Pradesh,Sitapur,Low Vision,35,60,63,23,86
Uttar Pradesh,Sitapur,Low Vision,60,80,25,4,29
Bihar,Sitamarhi,Low Vision,0,6,2,2,4
Bihar,Sitamarhi,Low Vision,6,15,79,63,142
Bihar,Sitamarhi,Low Vision,15,35,301,163,464
Bihar,Sitamarhi,Low Vision,35,60,265,183,448
Bihar,Sitamarhi,Low Vision,60,80,111,61,172
Bihar,Sitamarhi,Low Vision,80,100,2,1,3
Haryana,Sirsa,Low Vision,6,15,10,14,24
Haryana,Sirsa,Low Vision,15,35,27,19,46
Haryana,Sirsa,Low Vision,35,60,23,8,31
Haryana,Sirsa,Low Vision,60,80,3,2,5
Rajasthan,Sirohi,Low Vision,0,6,4,2,6
Rajasthan,Sirohi,Low Vision,6,15,24,22,46
Rajasthan,Sirohi,Low Vision,15,35,138,68,206
Rajasthan,Sirohi,Low Vision,35,60,174,72,246
Rajasthan,Sirohi,Low Vision,60,80,22,13,35
Rajasthan,Sirohi,Low Vision,80,100,1,0,1
Himachal Pradesh,Sirmaur,Low Vision,0,6,0,3,3
Himachal Pradesh,Sirmaur,Low Vision,6,15,21,9,30
Himachal Pradesh,Sirmaur,Low Vision,15,35,140,73,213
Himachal Pradesh,Sirmaur,Low Vision,35,60,197,68,265
Himachal Pradesh,Sirmaur,Low Vision,60,80,64,18,82
Himachal Pradesh,Sirmaur,Low Vision,80,100,6,1,7
Madhya Pradesh,Singrauli,Low Vision,0,6,0,1,1
Madhya Pradesh,Singrauli,Low Vision,6,15,29,17,46
Madhya Pradesh,Singrauli,Low Vision,15,35,154,87,241
Madhya Pradesh,Singrauli,Low Vision,35,60,134,69,203
Madhya Pradesh,Singrauli,Low Vision,60,80,23,13,36
Madhya Pradesh,Singrauli,Low Vision,80,100,2,1,3
Maharashtra,Sindhudurg,Low Vision,0,6,1,0,1
Maharashtra,Sindhudurg,Low Vision,6,15,32,14,46
Maharashtra,Sindhudurg,Low Vision,15,35,107,41,148
Maharashtra,Sindhudurg,Low Vision,35,60,154,43,197
Maharashtra,Sindhudurg,Low Vision,60,80,61,16,77
Maharashtra,Sindhudurg,Low Vision,80,100,4,0,4
Jharkhand,Simdega,Low Vision,6,15,1,0,1
Jharkhand,Simdega,Low Vision,15,35,2,1,3
Jharkhand,Simdega,Low Vision,35,60,2,3,5
Jharkhand,Simdega,Low Vision,60,80,3,0,3
Rajasthan,Sikar,Low Vision,0,6,0,1,1
Rajasthan,Sikar,Low Vision,6,15,15,13,28
Rajasthan,Sikar,Low Vision,15,35,94,40,134
Rajasthan,Sikar,Low Vision,35,60,56,16,72
Rajasthan,Sikar,Low Vision,60,80,12,2,14
Rajasthan,Sikar,Low Vision,80,100,1,0,1
Madhya Pradesh,Sidhi,Low Vision,0,6,1,1,2
Madhya Pradesh,Sidhi,Low Vision,6,15,24,27,51
Madhya Pradesh,Sidhi,Low Vision,15,35,211,113,324
Madhya Pradesh,Sidhi,Low Vision,35,60,199,90,289
Madhya Pradesh,Sidhi,Low Vision,60,80,54,21,75
Madhya Pradesh,Sidhi,Low Vision,80,100,3,2,5
Telangana,Siddipet,Low Vision,6,15,15,11,26
Telangana,Siddipet,Low Vision,15,35,196,117,313
Telangana,Siddipet,Low Vision,35,60,436,329,765
Telangana,Siddipet,Low Vision,60,80,408,302,710
Telangana,Siddipet,Low Vision,80,100,106,58,164
Uttar Pradesh,Siddharth Nagar,Low Vision,0,6,0,3,3
Uttar Pradesh,Siddharth Nagar,Low Vision,6,15,29,19,48
Uttar Pradesh,Siddharth Nagar,Low Vision,15,35,148,75,223
Uttar Pradesh,Siddharth Nagar,Low Vision,35,60,133,73,206
Uttar Pradesh,Siddharth Nagar,Low Vision,60,80,46,19,65
Uttar Pradesh,Siddharth Nagar,Low Vision,80,100,1,2,3
Arunachal Pradesh,Siang,Low Vision,15,35,2,0,2
Arunachal Pradesh,Siang,Low Vision,35,60,1,0,1
Uttar Pradesh,Shravasti,Low Vision,6,15,3,2,5
Uttar Pradesh,Shravasti,Low Vision,15,35,37,12,49
Uttar Pradesh,Shravasti,Low Vision,35,60,35,8,43
Uttar Pradesh,Shravasti,Low Vision,60,80,10,5,15
Uttar Pradesh,Shravasti,Low Vision,80,100,2,0,2
Jammu And Kashmir,Shopian,Low Vision,0,6,5,3,8
Jammu And Kashmir,Shopian,Low Vision,6,15,26,17,43
Jammu And Kashmir,Shopian,Low Vision,15,35,148,83,231
Jammu And Kashmir,Shopian,Low Vision,35,60,59,54,113
Jammu And Kashmir,Shopian,Low Vision,60,80,30,16,46
Jammu And Kashmir,Shopian,Low Vision,80,100,1,1,2
Madhya Pradesh,Shivpuri,Low Vision,0,6,6,4,10
Madhya Pradesh,Shivpuri,Low Vision,6,15,43,41,84
Madhya Pradesh,Shivpuri,Low Vision,15,35,150,78,228
Madhya Pradesh,Shivpuri,Low Vision,35,60,141,61,202
Madhya Pradesh,Shivpuri,Low Vision,60,80,36,16,52
Madhya Pradesh,Shivpuri,Low Vision,80,100,5,2,7
Karnataka,Shivamogga,Low Vision,0,6,0,3,3
Karnataka,Shivamogga,Low Vision,6,15,22,21,43
Karnataka,Shivamogga,Low Vision,15,35,84,44,128
Karnataka,Shivamogga,Low Vision,35,60,93,43,136
Karnataka,Shivamogga,Low Vision,60,80,21,7,28
Himachal Pradesh,Shimla,Low Vision,0,6,1,2,3
Himachal Pradesh,Shimla,Low Vision,6,15,20,17,37
Himachal Pradesh,Shimla,Low Vision,15,35,168,112,280
Himachal Pradesh,Shimla,Low Vision,35,60,295,200,495
Himachal Pradesh,Shimla,Low Vision,60,80,169,67,236
Himachal Pradesh,Shimla,Low Vision,80,100,21,2,23
Madhya Pradesh,Sheopur,Low Vision,6,15,7,10,17
Madhya Pradesh,Sheopur,Low Vision,15,35,33,27,60
Madhya Pradesh,Sheopur,Low Vision,35,60,50,28,78
Madhya Pradesh,Sheopur,Low Vision,60,80,13,9,22
Madhya Pradesh,Sheopur,Low Vision,80,100,0,1,1
Bihar,Sheohar,Low Vision,0,6,7,6,13
Bihar,Sheohar,Low Vision,6,15,90,95,185
Bihar,Sheohar,Low Vision,15,35,65,50,115
Bihar,Sheohar,Low Vision,35,60,53,34,87
Bihar,Sheohar,Low Vision,60,80,15,10,25
Bihar,Sheohar,Low Vision,80,100,2,1,3
Bihar,Sheikhpura,Low Vision,0,6,2,0,2
Bihar,Sheikhpura,Low Vision,6,15,15,12,27
Bihar,Sheikhpura,Low Vision,15,35,40,18,58
Bihar,Sheikhpura,Low Vision,35,60,15,14,29
Bihar,Sheikhpura,Low Vision,60,80,8,3,11
Bihar,Sheikhpura,Low Vision,80,100,1,0,1
Uttar Pradesh,Shamli,Low Vision,6,15,5,1,6
Uttar Pradesh,Shamli,Low Vision,15,35,63,22,85
Uttar Pradesh,Shamli,Low Vision,35,60,49,11,60
Uttar Pradesh,Shamli,Low Vision,60,80,24,2,26
Uttar Pradesh,Shamli,Low Vision,80,100,4,0,4
Madhya Pradesh,Shajapur,Low Vision,0,6,0,2,2
Madhya Pradesh,Shajapur,Low Vision,6,15,13,11,24
Madhya Pradesh,Shajapur,Low Vision,15,35,66,30,96
Madhya Pradesh,Shajapur,Low Vision,35,60,57,19,76
Madhya Pradesh,Shajapur,Low Vision,60,80,17,4,21
Madhya Pradesh,Shajapur,Low Vision,80,100,2,0,2
Uttar Pradesh,Shahjahanpur,Low Vision,6,15,58,46,104
Uttar Pradesh,Shahjahanpur,Low Vision,15,35,362,145,507
Uttar Pradesh,Shahjahanpur,Low Vision,35,60,337,133,470
Uttar Pradesh,Shahjahanpur,Low Vision,60,80,121,42,163
Uttar Pradesh,Shahjahanpur,Low Vision,80,100,7,2,9
Punjab,Shahid Bhagat Singh Nagar,Low Vision,0,6,0,1,1
Punjab,Shahid Bhagat Singh Nagar,Low Vision,6,15,4,5,9
Punjab,Shahid Bhagat Singh Nagar,Low Vision,15,35,30,17,47
Punjab,Shahid Bhagat Singh Nagar,Low Vision,35,60,37,11,48
Punjab,Shahid Bhagat Singh Nagar,Low Vision,60,80,23,8,31
Punjab,Shahid Bhagat Singh Nagar,Low Vision,80,100,1,0,1
Madhya Pradesh,Shahdol,Low Vision,0,6,0,1,1
Madhya Pradesh,Shahdol,Low Vision,6,15,10,13,23
Madhya Pradesh,Shahdol,Low Vision,15,35,101,55,156
Madhya Pradesh,Shahdol,Low Vision,35,60,105,59,164
Madhya Pradesh,Shahdol,Low Vision,60,80,35,22,57
Madhya Pradesh,Shahdol,Low Vision,80,100,1,0,1
Delhi,Shahdara,Low Vision,0,6,3,1,4
Delhi,Shahdara,Low Vision,6,15,1,6,7
Delhi,Shahdara,Low Vision,15,35,15,14,29
Delhi,Shahdara,Low Vision,35,60,10,3,13
Delhi,Shahdara,Low Vision,60,80,2,1,3
Mizoram,Serchhip,Low Vision,15,35,3,0,3
Mizoram,Serchhip,Low Vision,60,80,1,1,2
Tripura,Sepahijala,Low Vision,0,6,0,1,1
Tripura,Sepahijala,Low Vision,6,15,9,9,18
Tripura,Sepahijala,Low Vision,15,35,76,39,115
Tripura,Sepahijala,Low Vision,35,60,83,28,111
Tripura,Sepahijala,Low Vision,60,80,10,5,15
Tripura,Sepahijala,Low Vision,80,100,0,2,2
Madhya Pradesh,Seoni,Low Vision,6,15,24,21,45
Madhya Pradesh,Seoni,Low Vision,15,35,284,175,459
Madhya Pradesh,Seoni,Low Vision,35,60,230,84,314
Madhya Pradesh,Seoni,Low Vision,60,80,73,28,101
Madhya Pradesh,Seoni,Low Vision,80,100,4,1,5
Manipur,Senapati,Low Vision,15,35,3,1,4
Madhya Pradesh,Sehore,Low Vision,0,6,1,1,2
Madhya Pradesh,Sehore,Low Vision,6,15,36,19,55
Madhya Pradesh,Sehore,Low Vision,15,35,293,136,429
Madhya Pradesh,Sehore,Low Vision,35,60,358,153,511
Madhya Pradesh,Sehore,Low Vision,60,80,175,78,253
Madhya Pradesh,Sehore,Low Vision,80,100,19,8,27
Rajasthan,Sawai Madhopur,Low Vision,6,15,1,4,5
Rajasthan,Sawai Madhopur,Low Vision,15,35,15,4,19
Rajasthan,Sawai Madhopur,Low Vision,35,60,8,3,11
Rajasthan,Sawai Madhopur,Low Vision,60,80,3,2,5
Madhya Pradesh,Satna,Low Vision,0,6,2,2,4
Madhya Pradesh,Satna,Low Vision,6,15,31,37,68
Madhya Pradesh,Satna,Low Vision,15,35,326,172,498
Madhya Pradesh,Satna,Low Vision,35,60,517,295,812
Madhya Pradesh,Satna,Low Vision,60,80,204,96,300
Madhya Pradesh,Satna,Low Vision,80,100,15,6,21
Maharashtra,Satara,Low Vision,0,6,4,1,5
Maharashtra,Satara,Low Vision,6,15,103,68,171
Maharashtra,Satara,Low Vision,15,35,428,189,617
Maharashtra,Satara,Low Vision,35,60,494,192,686
Maharashtra,Satara,Low Vision,60,80,203,65,268
Maharashtra,Satara,Low Vision,80,100,14,0,14
Bihar,Saran,Low Vision,0,6,11,7,18
Bihar,Saran,Low Vision,6,15,99,64,163
Bihar,Saran,Low Vision,15,35,123,74,197
Bihar,Saran,Low Vision,35,60,103,68,171
Bihar,Saran,Low Vision,60,80,32,12,44
Jharkhand,Saraikela Kharsawan,Low Vision,6,15,3,8,11
Jharkhand,Saraikela Kharsawan,Low Vision,15,35,24,14,38
Jharkhand,Saraikela Kharsawan,Low Vision,35,60,42,15,57
Jharkhand,Saraikela Kharsawan,Low Vision,60,80,2,5,7
Jharkhand,Saraikela Kharsawan,Low Vision,80,100,0,1,1
Uttar Pradesh,Sant Kabeer Nagar,Low Vision,0,6,1,0,1
Uttar Pradesh,Sant Kabeer Nagar,Low Vision,6,15,7,4,11
Uttar Pradesh,Sant Kabeer Nagar,Low Vision,15,35,48,30,78
Uttar Pradesh,Sant Kabeer Nagar,Low Vision,35,60,45,14,59
Uttar Pradesh,Sant Kabeer Nagar,Low Vision,60,80,4,3,7
Punjab,Sangrur,Low Vision,0,6,2,7,9
Punjab,Sangrur,Low Vision,6,15,86,77,163
Punjab,Sangrur,Low Vision,15,35,262,153,415
Punjab,Sangrur,Low Vision,35,60,423,189,612
Punjab,Sangrur,Low Vision,60,80,182,36,218
Punjab,Sangrur,Low Vision,80,100,16,4,20
Maharashtra,Sangli,Low Vision,0,6,6,4,10
Maharashtra,Sangli,Low Vision,6,15,113,69,182
Maharashtra,Sangli,Low Vision,15,35,513,201,714
Maharashtra,Sangli,Low Vision,35,60,480,157,637
Maharashtra,Sangli,Low Vision,60,80,168,46,214
Maharashtra,Sangli,Low Vision,80,100,7,7,14
Telangana,Sangareddy,Low Vision,6,15,10,13,23
Telangana,Sangareddy,Low Vision,15,35,121,88,209
Telangana,Sangareddy,Low Vision,35,60,196,100,296
Telangana,Sangareddy,Low Vision,60,80,130,80,210
Telangana,Sangareddy,Low Vision,80,100,33,25,58
Uttar Pradesh,Sambhal,Low Vision,0,6,2,1,3
Uttar Pradesh,Sambhal,Low Vision,6,15,2,3,5
Uttar Pradesh,Sambhal,Low Vision,15,35,13,3,16
Uttar Pradesh,Sambhal,Low Vision,35,60,12,3,15
Uttar Pradesh,Sambhal,Low Vision,60,80,6,1,7
Uttar Pradesh,Sambhal,Low Vision,80,100,1,0,1
Odisha,Sambalpur,Low Vision,0,6,1,0,1
Odisha,Sambalpur,Low Vision,6,15,26,20,46
Odisha,Sambalpur,Low Vision,15,35,96,75,171
Odisha,Sambalpur,Low Vision,35,60,136,73,209
Odisha,Sambalpur,Low Vision,60,80,47,16,63
Odisha,Sambalpur,Low Vision,80,100,3,1,4
Jammu And Kashmir,Samba,Low Vision,6,15,3,3,6
Jammu And Kashmir,Samba,Low Vision,15,35,36,14,50
Jammu And Kashmir,Samba,Low Vision,35,60,70,31,101
Jammu And Kashmir,Samba,Low Vision,60,80,23,7,30
Jammu And Kashmir,Samba,Low Vision,80,100,2,0,2
Bihar,Samastipur,Low Vision,0,6,6,3,9
Bihar,Samastipur,Low Vision,6,15,67,46,113
Bihar,Samastipur,Low Vision,15,35,211,118,329
Bihar,Samastipur,Low Vision,35,60,139,74,213
Bihar,Samastipur,Low Vision,60,80,44,20,64
Bihar,Samastipur,Low Vision,80,100,3,2,5
Tamil Nadu,Salem,Low Vision,0,6,1,2,3
Tamil Nadu,Salem,Low Vision,6,15,38,44,82
Tamil Nadu,Salem,Low Vision,15,35,102,66,168
Tamil Nadu,Salem,Low Vision,35,60,148,89,237
Tamil Nadu,Salem,Low Vision,60,80,65,31,96
Tamil Nadu,Salem,Low Vision,80,100,3,4,7
Mizoram,Saitual,Low Vision,15,35,0,1,1
Mizoram,Saiha,Low Vision,6,15,1,0,1
Jharkhand,Sahebganj,Low Vision,0,6,3,3,6
Jharkhand,Sahebganj,Low Vision,6,15,37,30,67
Jharkhand,Sahebganj,Low Vision,15,35,96,53,149
Jharkhand,Sahebganj,Low Vision,35,60,90,41,131
Jharkhand,Sahebganj,Low Vision,60,80,10,3,13
Jharkhand,Sahebganj,Low Vision,80,100,0,1,1
Bihar,Saharsa,Low Vision,0,6,1,1,2
Bihar,Saharsa,Low Vision,6,15,31,22,53
Bihar,Saharsa,Low Vision,15,35,91,42,133
Bihar,Saharsa,Low Vision,35,60,59,30,89
Bihar,Saharsa,Low Vision,60,80,23,7,30
Uttar Pradesh,Saharanpur,Low Vision,0,6,2,2,4
Uttar Pradesh,Saharanpur,Low Vision,6,15,11,5,16
Uttar Pradesh,Saharanpur,Low Vision,15,35,101,42,143
Uttar Pradesh,Saharanpur,Low Vision,35,60,98,34,132
Uttar Pradesh,Saharanpur,Low Vision,60,80,25,9,34
Uttar Pradesh,Saharanpur,Low Vision,80,100,1,0,1
Madhya Pradesh,Sagar,Low Vision,6,15,41,42,83
Madhya Pradesh,Sagar,Low Vision,15,35,420,252,672
Madhya Pradesh,Sagar,Low Vision,35,60,308,121,429
Madhya Pradesh,Sagar,Low Vision,60,80,97,41,138
Madhya Pradesh,Sagar,Low Vision,80,100,6,2,8
Gujarat,Sabar Kantha,Low Vision,0,6,5,6,11
Gujarat,Sabar Kantha,Low Vision,6,15,83,64,147
Gujarat,Sabar Kantha,Low Vision,15,35,141,71,212
Gujarat,Sabar Kantha,Low Vision,35,60,74,22,96
Gujarat,Sabar Kantha,Low Vision,60,80,30,6,36
Gujarat,Sabar Kantha,Low Vision,80,100,0,1,1
Punjab,S.A.S Nagar,Low Vision,0,6,1,0,1
Punjab,S.A.S Nagar,Low Vision,6,15,22,32,54
Punjab,S.A.S Nagar,Low Vision,15,35,77,68,145
Punjab,S.A.S Nagar,Low Vision,35,60,62,27,89
Punjab,S.A.S Nagar,Low Vision,60,80,19,7,26
Punjab,S.A.S Nagar,Low Vision,80,100,2,0,2
Punjab,Rupnagar,Low Vision,0,6,0,2,2
Punjab,Rupnagar,Low Vision,6,15,14,5,19
Punjab,Rupnagar,Low Vision,15,35,42,23,65
Punjab,Rupnagar,Low Vision,35,60,66,15,81
Punjab,Rupnagar,Low Vision,60,80,37,6,43
Uttarakhand,Rudra Prayag,Low Vision,6,15,1,1,2
Uttarakhand,Rudra Prayag,Low Vision,15,35,15,8,23
Uttarakhand,Rudra Prayag,Low Vision,35,60,13,8,21
Uttarakhand,Rudra Prayag,Low Vision,60,80,4,0,4
Bihar,Rohtas,Low Vision,0,6,1,4,5
Bihar,Rohtas,Low Vision,6,15,41,20,61
Bihar,Rohtas,Low Vision,15,35,207,88,295
Bihar,Rohtas,Low Vision,35,60,147,90,237
Bihar,Rohtas,Low Vision,60,80,36,32,68
Bihar,Rohtas,Low Vision,80,100,4,2,6
Haryana,Rohtak,Low Vision,0,6,2,0,2
Haryana,Rohtak,Low Vision,6,15,17,11,28
Haryana,Rohtak,Low Vision,15,35,78,44,122
Haryana,Rohtak,Low Vision,35,60,65,25,90
Haryana,Rohtak,Low Vision,60,80,13,5,18
Meghalaya,Ri Bhoi,Low Vision,0,6,1,0,1
Meghalaya,Ri Bhoi,Low Vision,6,15,2,8,10
Meghalaya,Ri Bhoi,Low Vision,15,35,12,12,24
Meghalaya,Ri Bhoi,Low Vision,35,60,4,2,6
Meghalaya,Ri Bhoi,Low Vision,60,80,2,1,3
Meghalaya,Ri Bhoi,Low Vision,80,100,1,0,1
Haryana,Rewari,Low Vision,6,15,10,8,18
Haryana,Rewari,Low Vision,15,35,27,10,37
Haryana,Rewari,Low Vision,35,60,35,7,42
Haryana,Rewari,Low Vision,60,80,5,1,6
Madhya Pradesh,Rewa,Low Vision,0,6,2,0,2
Madhya Pradesh,Rewa,Low Vision,6,15,22,18,40
Madhya Pradesh,Rewa,Low Vision,15,35,213,113,326
Madhya Pradesh,Rewa,Low Vision,35,60,247,96,343
Madhya Pradesh,Rewa,Low Vision,60,80,53,23,76
Madhya Pradesh,Rewa,Low Vision,80,100,4,1,5
Jammu And Kashmir,Reasi,Low Vision,0,6,1,1,2
Jammu And Kashmir,Reasi,Low Vision,6,15,7,8,15
Jammu And Kashmir,Reasi,Low Vision,15,35,50,28,78
Jammu And Kashmir,Reasi,Low Vision,35,60,53,27,80
Jammu And Kashmir,Reasi,Low Vision,60,80,7,4,11
Odisha,Rayagada,Low Vision,0,6,5,4,9
Odisha,Rayagada,Low Vision,6,15,39,44,83
Odisha,Rayagada,Low Vision,15,35,156,100,256
Odisha,Rayagada,Low Vision,35,60,195,115,310
Odisha,Rayagada,Low Vision,60,80,51,27,78
Odisha,Rayagada,Low Vision,80,100,4,1,5
Maharashtra,Ratnagiri,Low Vision,0,6,3,3,6
Maharashtra,Ratnagiri,Low Vision,6,15,28,30,58
Maharashtra,Ratnagiri,Low Vision,15,35,127,73,200
Maharashtra,Ratnagiri,Low Vision,35,60,173,91,264
Maharashtra,Ratnagiri,Low Vision,60,80,76,23,99
Maharashtra,Ratnagiri,Low Vision,80,100,1,2,3
Madhya Pradesh,Ratlam,Low Vision,0,6,1,0,1
Madhya Pradesh,Ratlam,Low Vision,6,15,9,10,19
Madhya Pradesh,Ratlam,Low Vision,15,35,65,27,92
Madhya Pradesh,Ratlam,Low Vision,35,60,79,25,104
Madhya Pradesh,Ratlam,Low Vision,60,80,22,8,30
Madhya Pradesh,Ratlam,Low Vision,80,100,3,2,5
Tamil Nadu,Ranipet,Low Vision,0,6,1,4,5
Tamil Nadu,Ranipet,Low Vision,6,15,14,14,28
Tamil Nadu,Ranipet,Low Vision,15,35,51,32,83
Tamil Nadu,Ranipet,Low Vision,35,60,103,75,178
Tamil Nadu,Ranipet,Low Vision,60,80,44,22,66
Tamil Nadu,Ranipet,Low Vision,80,100,5,1,6
Telangana,Ranga Reddy,Low Vision,6,15,40,37,77
Telangana,Ranga Reddy,Low Vision,15,35,385,261,646
Telangana,Ranga Reddy,Low Vision,35,60,837,467,1304
Telangana,Ranga Reddy,Low Vision,60,80,572,328,900
Telangana,Ranga Reddy,Low Vision,80,100,97,30,127
Jharkhand,Ranchi,Low Vision,0,6,0,2,2
Jharkhand,Ranchi,Low Vision,6,15,55,33,88
Jharkhand,Ranchi,Low Vision,15,35,156,103,259
Jharkhand,Ranchi,Low Vision,35,60,144,100,244
Jharkhand,Ranchi,Low Vision,60,80,19,5,24
Uttar Pradesh,Rampur,Low Vision,6,15,8,4,12
Uttar Pradesh,Rampur,Low Vision,15,35,58,19,77
Uttar Pradesh,Rampur,Low Vision,35,60,45,13,58
Uttar Pradesh,Rampur,Low Vision,60,80,5,2,7
Uttar Pradesh,Rampur,Low Vision,80,100,1,0,1
Jharkhand,Ramgarh,Low Vision,0,6,1,0,1
Jharkhand,Ramgarh,Low Vision,6,15,23,16,39
Jharkhand,Ramgarh,Low Vision,15,35,166,69,235
Jharkhand,Ramgarh,Low Vision,35,60,126,62,188
Jharkhand,Ramgarh,Low Vision,60,80,32,19,51
Jharkhand,Ramgarh,Low Vision,80,100,6,1,7
Jammu And Kashmir,Ramban,Low Vision,0,6,4,1,5
Jammu And Kashmir,Ramban,Low Vision,6,15,57,21,78
Jammu And Kashmir,Ramban,Low Vision,15,35,195,114,309
Jammu And Kashmir,Ramban,Low Vision,35,60,199,108,307
Jammu And Kashmir,Ramban,Low Vision,60,80,37,25,62
Jammu And Kashmir,Ramban,Low Vision,80,100,1,1,2
Tamil Nadu,Ramanathapuram,Low Vision,0,6,2,1,3
Tamil Nadu,Ramanathapuram,Low Vision,6,15,34,24,58
Tamil Nadu,Ramanathapuram,Low Vision,15,35,65,21,86
Tamil Nadu,Ramanathapuram,Low Vision,35,60,61,41,102
Tamil Nadu,Ramanathapuram,Low Vision,60,80,28,14,42
Tamil Nadu,Ramanathapuram,Low Vision,80,100,0,1,1
Karnataka,Ramanagara,Low Vision,0,6,1,1,2
Karnataka,Ramanagara,Low Vision,6,15,24,8,32
Karnataka,Ramanagara,Low Vision,15,35,56,31,87
Karnataka,Ramanagara,Low Vision,35,60,74,38,112
Karnataka,Ramanagara,Low Vision,60,80,16,4,20
Karnataka,Ramanagara,Low Vision,80,100,1,0,1
Rajasthan,Rajsamand,Low Vision,0,6,1,1,2
Rajasthan,Rajsamand,Low Vision,6,15,21,13,34
Rajasthan,Rajsamand,Low Vision,15,35,91,68,159
Rajasthan,Rajsamand,Low Vision,35,60,103,70,173
Rajasthan,Rajsamand,Low Vision,60,80,36,35,71
Rajasthan,Rajsamand,Low Vision,80,100,5,6,11
Jammu And Kashmir,Rajouri,Low Vision,0,6,8,4,12
Jammu And Kashmir,Rajouri,Low Vision,6,15,68,39,107
Jammu And Kashmir,Rajouri,Low Vision,15,35,321,167,488
Jammu And Kashmir,Rajouri,Low Vision,35,60,361,173,534
Jammu And Kashmir,Rajouri,Low Vision,60,80,67,22,89
Jammu And Kashmir,Rajouri,Low Vision,80,100,10,4,14
Chhattisgarh,Rajnandgaon,Low Vision,6,15,72,46,118
Chhattisgarh,Rajnandgaon,Low Vision,15,35,349,210,559
Chhattisgarh,Rajnandgaon,Low Vision,35,60,213,110,323
Chhattisgarh,Rajnandgaon,Low Vision,60,80,70,30,100
Chhattisgarh,Rajnandgaon,Low Vision,80,100,0,2,2
Gujarat,Rajkot,Low Vision,0,6,3,2,5
Gujarat,Rajkot,Low Vision,6,15,39,26,65
Gujarat,Rajkot,Low Vision,15,35,132,69,201
Gujarat,Rajkot,Low Vision,35,60,107,41,148
Gujarat,Rajkot,Low Vision,60,80,49,18,67
Gujarat,Rajkot,Low Vision,80,100,5,1,6
Madhya Pradesh,Rajgarh,Low Vision,0,6,3,3,6
Madhya Pradesh,Rajgarh,Low Vision,6,15,57,29,86
Madhya Pradesh,Rajgarh,Low Vision,15,35,331,157,488
Madhya Pradesh,Rajgarh,Low Vision,35,60,390,172,562
Madhya Pradesh,Rajgarh,Low Vision,60,80,143,74,217
Madhya Pradesh,Rajgarh,Low Vision,80,100,21,8,29
Telangana,Rajanna Sircilla,Low Vision,6,15,11,7,18
Telangana,Rajanna Sircilla,Low Vision,15,35,117,59,176
Telangana,Rajanna Sircilla,Low Vision,35,60,305,181,486
Telangana,Rajanna Sircilla,Low Vision,60,80,339,192,531
Telangana,Rajanna Sircilla,Low Vision,80,100,69,45,114
Madhya Pradesh,Raisen,Low Vision,0,6,0,3,3
Madhya Pradesh,Raisen,Low Vision,6,15,24,22,46
Madhya Pradesh,Raisen,Low Vision,15,35,195,109,304
Madhya Pradesh,Raisen,Low Vision,35,60,170,75,245
Madhya Pradesh,Raisen,Low Vision,60,80,49,24,73
Madhya Pradesh,Raisen,Low Vision,80,100,4,2,6
Chhattisgarh,Raipur,Low Vision,6,15,0,1,1
Chhattisgarh,Raipur,Low Vision,15,35,0,4,4
Chhattisgarh,Raipur,Low Vision,35,60,2,1,3
Chhattisgarh,Raigarh,Low Vision,0,6,10,9,19
Chhattisgarh,Raigarh,Low Vision,6,15,151,170,321
Chhattisgarh,Raigarh,Low Vision,15,35,512,363,875
Chhattisgarh,Raigarh,Low Vision,35,60,351,132,483
Chhattisgarh,Raigarh,Low Vision,60,80,128,45,173
Chhattisgarh,Raigarh,Low Vision,80,100,8,3,11
Maharashtra,Raigad,Low Vision,0,6,3,1,4
Maharashtra,Raigad,Low Vision,6,15,48,38,86
Maharashtra,Raigad,Low Vision,15,35,190,105,295
Maharashtra,Raigad,Low Vision,35,60,273,123,396
Maharashtra,Raigad,Low Vision,60,80,95,31,126
Maharashtra,Raigad,Low Vision,80,100,4,1,5
Karnataka,Raichur,Low Vision,0,6,6,10,16
Karnataka,Raichur,Low Vision,6,15,53,48,101
Karnataka,Raichur,Low Vision,15,35,218,99,317
Karnataka,Raichur,Low Vision,35,60,164,79,243
Karnataka,Raichur,Low Vision,60,80,22,9,31
Karnataka,Raichur,Low Vision,80,100,0,2,2
Uttar Pradesh,Rae Bareli,Low Vision,6,15,16,5,21
Uttar Pradesh,Rae Bareli,Low Vision,15,35,102,50,152
Uttar Pradesh,Rae Bareli,Low Vision,35,60,114,35,149
Uttar Pradesh,Rae Bareli,Low Vision,60,80,35,4,39
Uttar Pradesh,Rae Bareli,Low Vision,80,100,2,0,2
Bihar,Purnia,Low Vision,0,6,2,1,3
Bihar,Purnia,Low Vision,6,15,20,14,34
Bihar,Purnia,Low Vision,15,35,72,83,155
Bihar,Purnia,Low Vision,35,60,78,59,137
Bihar,Purnia,Low Vision,60,80,22,20,42
Bihar,Purnia,Low Vision,80,100,1,1,2
Odisha,Puri,Low Vision,0,6,2,4,6
Odisha,Puri,Low Vision,6,15,69,43,112
Odisha,Puri,Low Vision,15,35,293,155,448
Odisha,Puri,Low Vision,35,60,392,197,589
Odisha,Puri,Low Vision,60,80,110,48,158
Odisha,Puri,Low Vision,80,100,7,2,9
Bihar,Purbi Champaran,Low Vision,0,6,1,2,3
Bihar,Purbi Champaran,Low Vision,6,15,97,64,161
Bihar,Purbi Champaran,Low Vision,15,35,439,176,615
Bihar,Purbi Champaran,Low Vision,35,60,286,124,410
Bihar,Purbi Champaran,Low Vision,60,80,105,32,137
Bihar,Purbi Champaran,Low Vision,80,100,3,0,3
Maharashtra,Pune,Low Vision,0,6,20,9,29
Maharashtra,Pune,Low Vision,6,15,159,78,237
Maharashtra,Pune,Low Vision,15,35,480,246,726
Maharashtra,Pune,Low Vision,35,60,575,239,814
Maharashtra,Pune,Low Vision,60,80,178,57,235
Maharashtra,Pune,Low Vision,80,100,16,5,21
Jammu And Kashmir,Pulwama,Low Vision,0,6,8,3,11
Jammu And Kashmir,Pulwama,Low Vision,6,15,33,23,56
Jammu And Kashmir,Pulwama,Low Vision,15,35,150,97,247
Jammu And Kashmir,Pulwama,Low Vision,35,60,163,105,268
Jammu And Kashmir,Pulwama,Low Vision,60,80,63,30,93
Jammu And Kashmir,Pulwama,Low Vision,80,100,14,4,18
Tamil Nadu,Pudukkottai,Low Vision,6,15,41,40,81
Tamil Nadu,Pudukkottai,Low Vision,15,35,71,47,118
Tamil Nadu,Pudukkottai,Low Vision,35,60,63,33,96
Tamil Nadu,Pudukkottai,Low Vision,60,80,33,13,46
Tamil Nadu,Pudukkottai,Low Vision,80,100,5,1,6
Uttar Pradesh,Prayagraj,Low Vision,0,6,1,2,3
Uttar Pradesh,Prayagraj,Low Vision,6,15,36,29,65
Uttar Pradesh,Prayagraj,Low Vision,15,35,364,150,514
Uttar Pradesh,Prayagraj,Low Vision,35,60,251,109,360
Uttar Pradesh,Prayagraj,Low Vision,60,80,57,21,78
Uttar Pradesh,Prayagraj,Low Vision,80,100,0,1,1
Rajasthan,Pratapgarh,Low Vision,6,15,8,2,10
Rajasthan,Pratapgarh,Low Vision,15,35,31,20,51
Rajasthan,Pratapgarh,Low Vision,35,60,38,33,71
Rajasthan,Pratapgarh,Low Vision,60,80,20,20,40
Rajasthan,Pratapgarh,Low Vision,80,100,0,2,2
Uttar Pradesh,Pratapgarh,Low Vision,6,15,14,8,22
Uttar Pradesh,Pratapgarh,Low Vision,15,35,298,150,448
Uttar Pradesh,Pratapgarh,Low Vision,35,60,379,143,522
Uttar Pradesh,Pratapgarh,Low Vision,60,80,91,20,111
Andhra Pradesh,Prakasam,Low Vision,6,15,19,24,43
Andhra Pradesh,Prakasam,Low Vision,15,35,163,111,274
Andhra Pradesh,Prakasam,Low Vision,35,60,332,208,540
Andhra Pradesh,Prakasam,Low Vision,60,80,197,97,294
Andhra Pradesh,Prakasam,Low Vision,80,100,20,9,29
Gujarat,Porbandar,Low Vision,6,15,4,5,9
Gujarat,Porbandar,Low Vision,15,35,17,7,24
Gujarat,Porbandar,Low Vision,35,60,2,1,3
Gujarat,Porbandar,Low Vision,60,80,4,0,4
Jammu And Kashmir,Poonch,Low Vision,0,6,13,12,25
Jammu And Kashmir,Poonch,Low Vision,6,15,84,60,144
Jammu And Kashmir,Poonch,Low Vision,15,35,231,193,424
Jammu And Kashmir,Poonch,Low Vision,35,60,248,164,412
Jammu And Kashmir,Poonch,Low Vision,60,80,29,21,50
Jammu And Kashmir,Poonch,Low Vision,80,100,4,3,7
Puducherry,Pondicherry,Low Vision,0,6,1,0,1
Puducherry,Pondicherry,Low Vision,6,15,14,10,24
Puducherry,Pondicherry,Low Vision,15,35,90,48,138
Puducherry,Pondicherry,Low Vision,35,60,164,106,270
Puducherry,Pondicherry,Low Vision,60,80,43,47,90
Puducherry,Pondicherry,Low Vision,80,100,6,14,20
Uttarakhand,Pithoragarh,Low Vision,6,15,4,4,8
Uttarakhand,Pithoragarh,Low Vision,15,35,42,21,63
Uttarakhand,Pithoragarh,Low Vision,35,60,42,14,56
Uttarakhand,Pithoragarh,Low Vision,60,80,6,6,12
Uttarakhand,Pithoragarh,Low Vision,80,100,1,0,1
Uttar Pradesh,Pilibhit,Low Vision,0,6,1,1,2
Uttar Pradesh,Pilibhit,Low Vision,6,15,24,23,47
Uttar Pradesh,Pilibhit,Low Vision,15,35,190,104,294
Uttar Pradesh,Pilibhit,Low Vision,35,60,249,107,356
Uttar Pradesh,Pilibhit,Low Vision,60,80,92,37,129
Uttar Pradesh,Pilibhit,Low Vision,80,100,5,1,6
Tamil Nadu,Perambalur,Low Vision,6,15,1,2,3
Tamil Nadu,Perambalur,Low Vision,15,35,3,7,10
Tamil Nadu,Perambalur,Low Vision,35,60,15,11,26
Tamil Nadu,Perambalur,Low Vision,60,80,4,3,7
Tamil Nadu,Perambalur,Low Vision,80,100,1,0,1
Telangana,Peddapalli,Low Vision,0,6,2,0,2
Telangana,Peddapalli,Low Vision,6,15,13,14,27
Telangana,Peddapalli,Low Vision,15,35,227,159,386
Telangana,Peddapalli,Low Vision,35,60,568,325,893
Telangana,Peddapalli,Low Vision,60,80,488,327,815
Telangana,Peddapalli,Low Vision,80,100,90,58,148
Uttarakhand,Pauri Garhwal,Low Vision,0,6,3,1,4
Uttarakhand,Pauri Garhwal,Low Vision,6,15,10,11,21
Uttarakhand,Pauri Garhwal,Low Vision,15,35,61,26,87
Uttarakhand,Pauri Garhwal,Low Vision,35,60,84,45,129
Uttarakhand,Pauri Garhwal,Low Vision,60,80,14,10,24
Uttarakhand,Pauri Garhwal,Low Vision,80,100,1,0,1
Bihar,Patna,Low Vision,0,6,5,6,11
Bihar,Patna,Low Vision,6,15,44,31,75
Bihar,Patna,Low Vision,15,35,193,70,263
Bihar,Patna,Low Vision,35,60,95,47,142
Bihar,Patna,Low Vision,60,80,16,9,25
Punjab,Patiala,Low Vision,0,6,2,7,9
Punjab,Patiala,Low Vision,6,15,68,58,126
Punjab,Patiala,Low Vision,15,35,210,105,315
Punjab,Patiala,Low Vision,35,60,271,107,378
Punjab,Patiala,Low Vision,60,80,77,29,106
Punjab,Patiala,Low Vision,80,100,5,3,8
Punjab,Pathankot,Low Vision,0,6,1,1,2
Punjab,Pathankot,Low Vision,6,15,23,16,39
Punjab,Pathankot,Low Vision,15,35,123,37,160
Punjab,Pathankot,Low Vision,35,60,99,41,140
Punjab,Pathankot,Low Vision,60,80,35,18,53
Punjab,Pathankot,Low Vision,80,100,3,0,3
Kerala,Pathanamthitta,Low Vision,0,6,3,1,4
Kerala,Pathanamthitta,Low Vision,6,15,16,15,31
Kerala,Pathanamthitta,Low Vision,15,35,78,62,140
Kerala,Pathanamthitta,Low Vision,35,60,76,74,150
Kerala,Pathanamthitta,Low Vision,60,80,46,24,70
Kerala,Pathanamthitta,Low Vision,80,100,4,3,7
Gujarat,Patan,Low Vision,6,15,8,4,12
Gujarat,Patan,Low Vision,15,35,31,13,44
Gujarat,Patan,Low Vision,35,60,7,3,10
Gujarat,Patan,Low Vision,60,80,1,0,1
Bihar,Pashchim Champaran,Low Vision,0,6,4,7,11
Bihar,Pashchim Champaran,Low Vision,6,15,90,46,136
Bihar,Pashchim Champaran,Low Vision,15,35,312,150,462
Bihar,Pashchim Champaran,Low Vision,35,60,223,171,394
Bihar,Pashchim Champaran,Low Vision,60,80,45,18,63
Bihar,Pashchim Champaran,Low Vision,80,100,1,0,1
Maharashtra,Parbhani,Low Vision,0,6,3,4,7
Maharashtra,Parbhani,Low Vision,6,15,39,59,98
Maharashtra,Parbhani,Low Vision,15,35,270,133,403
Maharashtra,Parbhani,Low Vision,35,60,240,106,346
Maharashtra,Parbhani,Low Vision,60,80,171,96,267
Maharashtra,Parbhani,Low Vision,80,100,15,6,21
Arunachal Pradesh,Papum Pare,Low Vision,0,6,0,2,2
Arunachal Pradesh,Papum Pare,Low Vision,6,15,2,4,6
Arunachal Pradesh,Papum Pare,Low Vision,15,35,21,9,30
Arunachal Pradesh,Papum Pare,Low Vision,35,60,3,5,8
Arunachal Pradesh,Papum Pare,Low Vision,60,80,1,0,1
Madhya Pradesh,Panna,Low Vision,0,6,0,1,1
Madhya Pradesh,Panna,Low Vision,6,15,26,23,49
Madhya Pradesh,Panna,Low Vision,15,35,145,74,219
Madhya Pradesh,Panna,Low Vision,35,60,123,56,179
Madhya Pradesh,Panna,Low Vision,60,80,23,20,43
Madhya Pradesh,Panna,Low Vision,80,100,2,1,3
Haryana,Panipat,Low Vision,0,6,1,1,2
Haryana,Panipat,Low Vision,6,15,10,5,15
Haryana,Panipat,Low Vision,15,35,39,13,52
Haryana,Panipat,Low Vision,35,60,38,18,56
Haryana,Panipat,Low Vision,60,80,4,1,5
Haryana,Panchkula,Low Vision,0,6,1,0,1
Haryana,Panchkula,Low Vision,6,15,5,4,9
Haryana,Panchkula,Low Vision,15,35,23,11,34
Haryana,Panchkula,Low Vision,35,60,23,11,34
Haryana,Panchkula,Low Vision,60,80,9,5,14
Haryana,Panchkula,Low Vision,80,100,1,0,1
Gujarat,Panch Mahals,Low Vision,0,6,4,0,4
Gujarat,Panch Mahals,Low Vision,6,15,54,45,99
Gujarat,Panch Mahals,Low Vision,15,35,120,60,180
Gujarat,Panch Mahals,Low Vision,35,60,54,20,74
Gujarat,Panch Mahals,Low Vision,60,80,14,4,18
Gujarat,Panch Mahals,Low Vision,80,100,1,0,1
Haryana,Palwal,Low Vision,0,6,1,0,1
Haryana,Palwal,Low Vision,6,15,5,2,7
Haryana,Palwal,Low Vision,15,35,10,5,15
Haryana,Palwal,Low Vision,35,60,5,1,6
Haryana,Palwal,Low Vision,60,80,0,1,1
Rajasthan,Pali,Low Vision,6,15,18,9,27
Rajasthan,Pali,Low Vision,15,35,83,36,119
Rajasthan,Pali,Low Vision,35,60,81,31,112
Rajasthan,Pali,Low Vision,60,80,30,16,46
Rajasthan,Pali,Low Vision,80,100,6,3,9
Maharashtra,Palghar,Low Vision,0,6,0,4,4
Maharashtra,Palghar,Low Vision,6,15,13,14,27
Maharashtra,Palghar,Low Vision,15,35,43,32,75
Maharashtra,Palghar,Low Vision,35,60,41,13,54
Maharashtra,Palghar,Low Vision,60,80,12,2,14
Jharkhand,Palamu,Low Vision,0,6,3,4,7
Jharkhand,Palamu,Low Vision,6,15,53,44,97
Jharkhand,Palamu,Low Vision,15,35,232,127,359
Jharkhand,Palamu,Low Vision,35,60,195,92,287
Jharkhand,Palamu,Low Vision,60,80,32,15,47
Jharkhand,Palamu,Low Vision,80,100,1,0,1
Kerala,Palakkad,Low Vision,0,6,2,5,7
Kerala,Palakkad,Low Vision,6,15,49,40,89
Kerala,Palakkad,Low Vision,15,35,267,163,430
Kerala,Palakkad,Low Vision,35,60,349,263,612
Kerala,Palakkad,Low Vision,60,80,176,127,303
Kerala,Palakkad,Low Vision,80,100,15,12,27
Jharkhand,Pakur,Low Vision,6,15,8,10,18
Jharkhand,Pakur,Low Vision,15,35,18,11,29
Jharkhand,Pakur,Low Vision,35,60,20,13,33
Jharkhand,Pakur,Low Vision,60,80,3,1,4
Maharashtra,Osmanabad,Low Vision,0,6,5,2,7
Maharashtra,Osmanabad,Low Vision,6,15,84,45,129
Maharashtra,Osmanabad,Low Vision,15,35,393,161,554
Maharashtra,Osmanabad,Low Vision,35,60,596,269,865
Maharashtra,Osmanabad,Low Vision,60,80,361,117,478
Maharashtra,Osmanabad,Low Vision,80,100,49,7,56
Haryana,Nuh,Low Vision,6,15,6,3,9
Haryana,Nuh,Low Vision,15,35,7,6,13
Haryana,Nuh,Low Vision,35,60,5,1,6
Haryana,Nuh,Low Vision,60,80,3,0,3
Odisha,Nuapada,Low Vision,0,6,11,9,20
Odisha,Nuapada,Low Vision,6,15,131,89,220
Odisha,Nuapada,Low Vision,15,35,255,103,358
Odisha,Nuapada,Low Vision,35,60,134,60,194
Odisha,Nuapada,Low Vision,60,80,38,13,51
Odisha,Nuapada,Low Vision,80,100,1,2,3
Delhi,North West,Low Vision,0,6,1,3,4
Delhi,North West,Low Vision,6,15,34,43,77
Delhi,North West,Low Vision,15,35,83,47,130
Delhi,North West,Low Vision,35,60,29,6,35
Delhi,North West,Low Vision,60,80,8,4,12
Tripura,North Tripura,Low Vision,0,6,1,1,2
Tripura,North Tripura,Low Vision,6,15,24,29,53
Tripura,North Tripura,Low Vision,15,35,94,58,152
Tripura,North Tripura,Low Vision,35,60,85,49,134
Tripura,North Tripura,Low Vision,60,80,11,1,12
Goa,North Goa,Low Vision,6,15,3,2,5
Goa,North Goa,Low Vision,15,35,17,9,26
Goa,North Goa,Low Vision,35,60,27,11,38
Goa,North Goa,Low Vision,60,80,2,2,4
Meghalaya,North Garo Hills,Low Vision,15,35,1,1,2
Meghalaya,North Garo Hills,Low Vision,35,60,2,0,2
Delhi,North East,Low Vision,0,6,4,4,8
Delhi,North East,Low Vision,6,15,53,49,102
Delhi,North East,Low Vision,15,35,93,75,168
Delhi,North East,Low Vision,35,60,33,24,57
Delhi,North East,Low Vision,60,80,12,2,14
Delhi,North East,Low Vision,80,100,1,1,2
Andaman And Nicobar Islands,North And Middle Andaman,Low Vision,6,15,5,2,7
Andaman And Nicobar Islands,North And Middle Andaman,Low Vision,15,35,14,14,28
Andaman And Nicobar Islands,North And Middle Andaman,Low Vision,35,60,29,13,42
Andaman And Nicobar Islands,North And Middle Andaman,Low Vision,60,80,6,1,7
Andaman And Nicobar Islands,North And Middle Andaman,Low Vision,80,100,2,0,2
Delhi,North,Low Vision,0,6,0,1,1
Delhi,North,Low Vision,6,15,7,6,13
Delhi,North,Low Vision,15,35,31,22,53
Delhi,North,Low Vision,35,60,10,7,17
Delhi,North,Low Vision,60,80,3,0,3
Delhi,North,Low Vision,80,100,0,1,1
Manipur,Noney,Low Vision,15,35,1,2,3
Manipur,Noney,Low Vision,35,60,1,2,3
Manipur,Noney,Low Vision,60,80,2,2,4
Manipur,Noney,Low Vision,80,100,0,1,1
Telangana,Nizamabad,Low Vision,0,6,0,2,2
Telangana,Nizamabad,Low Vision,6,15,22,36,58
Telangana,Nizamabad,Low Vision,15,35,273,178,451
Telangana,Nizamabad,Low Vision,35,60,587,432,1019
Telangana,Nizamabad,Low Vision,60,80,627,470,1097
Telangana,Nizamabad,Low Vision,80,100,102,78,180
Madhya Pradesh,Niwari,Low Vision,6,15,8,8,16
Madhya Pradesh,Niwari,Low Vision,15,35,47,23,70
Madhya Pradesh,Niwari,Low Vision,35,60,74,30,104
Madhya Pradesh,Niwari,Low Vision,60,80,24,12,36
Madhya Pradesh,Niwari,Low Vision,80,100,2,2,4
Telangana,Nirmal,Low Vision,6,15,11,9,20
Telangana,Nirmal,Low Vision,15,35,100,75,175
Telangana,Nirmal,Low Vision,35,60,245,146,391
Telangana,Nirmal,Low Vision,60,80,170,145,315
Telangana,Nirmal,Low Vision,80,100,24,22,46
Andaman And Nicobar Islands,Nicobars,Low Vision,0,6,1,0,1
Andaman And Nicobar Islands,Nicobars,Low Vision,6,15,1,0,1
Andaman And Nicobar Islands,Nicobars,Low Vision,15,35,1,1,2
Andaman And Nicobar Islands,Nicobars,Low Vision,35,60,4,3,7
Delhi,New Delhi,Low Vision,0,6,1,0,1
Delhi,New Delhi,Low Vision,6,15,2,4,6
Delhi,New Delhi,Low Vision,15,35,5,4,9
Delhi,New Delhi,Low Vision,35,60,3,2,5
Delhi,New Delhi,Low Vision,60,80,1,0,1
Madhya Pradesh,Neemuch,Low Vision,6,15,4,6,10
Madhya Pradesh,Neemuch,Low Vision,15,35,64,28,92
Madhya Pradesh,Neemuch,Low Vision,35,60,50,22,72
Madhya Pradesh,Neemuch,Low Vision,60,80,17,5,22
Madhya Pradesh,Neemuch,Low Vision,80,100,0,1,1
Odisha,Nayagarh,Low Vision,0,6,10,4,14
Odisha,Nayagarh,Low Vision,6,15,127,76,203
Odisha,Nayagarh,Low Vision,15,35,392,197,589
Odisha,Nayagarh,Low Vision,35,60,500,261,761
Odisha,Nayagarh,Low Vision,60,80,179,74,253
Odisha,Nayagarh,Low Vision,80,100,10,6,16
Bihar,Nawada,Low Vision,0,6,1,3,4
Bihar,Nawada,Low Vision,6,15,37,24,61
Bihar,Nawada,Low Vision,15,35,132,64,196
Bihar,Nawada,Low Vision,35,60,69,39,108
Bihar,Nawada,Low Vision,60,80,19,10,29
Bihar,Nawada,Low Vision,80,100,1,2,3
Gujarat,Navsari,Low Vision,0,6,1,0,1
Gujarat,Navsari,Low Vision,6,15,31,28,59
Gujarat,Navsari,Low Vision,15,35,58,24,82
Gujarat,Navsari,Low Vision,35,60,37,19,56
Gujarat,Navsari,Low Vision,60,80,16,5,21
Maharashtra,Nashik,Low Vision,0,6,6,2,8
Maharashtra,Nashik,Low Vision,6,15,93,68,161
Maharashtra,Nashik,Low Vision,15,35,425,156,581
Maharashtra,Nashik,Low Vision,35,60,432,213,645
Maharashtra,Nashik,Low Vision,60,80,142,47,189
Maharashtra,Nashik,Low Vision,80,100,5,2,7
Madhya Pradesh,Narsinghpur,Low Vision,0,6,0,1,1
Madhya Pradesh,Narsinghpur,Low Vision,6,15,28,29,57
Madhya Pradesh,Narsinghpur,Low Vision,15,35,200,119,319
Madhya Pradesh,Narsinghpur,Low Vision,35,60,249,128,377
Madhya Pradesh,Narsinghpur,Low Vision,60,80,90,47,137
Madhya Pradesh,Narsinghpur,Low Vision,80,100,7,2,9
Madhya Pradesh,Narmadapuram,Low Vision,0,6,1,0,1
Madhya Pradesh,Narmadapuram,Low Vision,6,15,23,12,35
Madhya Pradesh,Narmadapuram,Low Vision,15,35,154,106,260
Madhya Pradesh,Narmadapuram,Low Vision,35,60,132,56,188
Madhya Pradesh,Narmadapuram,Low Vision,60,80,43,14,57
Gujarat,Narmada,Low Vision,6,15,2,0,2
Gujarat,Narmada,Low Vision,15,35,4,3,7
Gujarat,Narmada,Low Vision,35,60,2,0,2
Chhattisgarh,Narayanpur,Low Vision,6,15,5,2,7
Chhattisgarh,Narayanpur,Low Vision,15,35,14,7,21
Chhattisgarh,Narayanpur,Low Vision,35,60,9,2,11
Chhattisgarh,Narayanpur,Low Vision,60,80,3,1,4
Telangana,Narayanpet,Low Vision,60,80,0,1,1
Telangana,Narayanpet,Low Vision,80,100,1,0,1
Maharashtra,Nandurbar,Low Vision,0,6,2,1,3
Maharashtra,Nandurbar,Low Vision,6,15,14,11,25
Maharashtra,Nandurbar,Low Vision,15,35,101,50,151
Maharashtra,Nandurbar,Low Vision,35,60,139,65,204
Maharashtra,Nandurbar,Low Vision,60,80,59,18,77
Maharashtra,Nandurbar,Low Vision,80,100,5,3,8
Maharashtra,Nanded,Low Vision,0,6,9,5,14
Maharashtra,Nanded,Low Vision,6,15,117,118,235
Maharashtra,Nanded,Low Vision,15,35,547,221,768
Maharashtra,Nanded,Low Vision,35,60,329,142,471
Maharashtra,Nanded,Low Vision,60,80,98,41,139
Maharashtra,Nanded,Low Vision,80,100,3,3,6
Arunachal Pradesh,Namsai,Low Vision,6,15,2,0,2
Arunachal Pradesh,Namsai,Low Vision,15,35,2,3,5
Arunachal Pradesh,Namsai,Low Vision,60,80,0,2,2
Arunachal Pradesh,Namsai,Low Vision,80,100,0,1,1
Sikkim,Namchi,Low Vision,6,15,4,4,8
Sikkim,Namchi,Low Vision,15,35,26,16,42
Sikkim,Namchi,Low Vision,35,60,19,9,28
Sikkim,Namchi,Low Vision,60,80,5,1,6
Tamil Nadu,Namakkal,Low Vision,0,6,2,1,3
Tamil Nadu,Namakkal,Low Vision,6,15,20,21,41
Tamil Nadu,Namakkal,Low Vision,15,35,43,45,88
Tamil Nadu,Namakkal,Low Vision,35,60,70,76,146
Tamil Nadu,Namakkal,Low Vision,60,80,50,21,71
Tamil Nadu,Namakkal,Low Vision,80,100,3,0,3
Telangana,Nalgonda,Low Vision,0,6,0,1,1
Telangana,Nalgonda,Low Vision,6,15,31,22,53
Telangana,Nalgonda,Low Vision,15,35,349,243,592
Telangana,Nalgonda,Low Vision,35,60,670,480,1150
Telangana,Nalgonda,Low Vision,60,80,730,487,1217
Telangana,Nalgonda,Low Vision,80,100,226,87,313
Assam,Nalbari,Low Vision,0,6,9,4,13
Assam,Nalbari,Low Vision,6,15,54,33,87
Assam,Nalbari,Low Vision,15,35,213,143,356
Assam,Nalbari,Low Vision,35,60,300,171,471
Assam,Nalbari,Low Vision,60,80,78,38,116
Assam,Nalbari,Low Vision,80,100,4,2,6
Bihar,Nalanda,Low Vision,0,6,10,8,18
Bihar,Nalanda,Low Vision,6,15,48,24,72
Bihar,Nalanda,Low Vision,15,35,180,53,233
Bihar,Nalanda,Low Vision,35,60,51,16,67
Bihar,Nalanda,Low Vision,60,80,11,5,16
Uttarakhand,Nainital,Low Vision,0,6,0,1,1
Uttarakhand,Nainital,Low Vision,6,15,25,9,34
Uttarakhand,Nainital,Low Vision,15,35,94,51,145
Uttarakhand,Nainital,Low Vision,35,60,114,53,167
Uttarakhand,Nainital,Low Vision,60,80,15,11,26
Maharashtra,Nagpur,Low Vision,0,6,11,6,17
Maharashtra,Nagpur,Low Vision,6,15,87,72,159
Maharashtra,Nagpur,Low Vision,15,35,284,154,438
Maharashtra,Nagpur,Low Vision,35,60,229,71,300
Maharashtra,Nagpur,Low Vision,60,80,43,10,53
Rajasthan,Nagaur,Low Vision,0,6,1,0,1
Rajasthan,Nagaur,Low Vision,6,15,26,16,42
Rajasthan,Nagaur,Low Vision,15,35,172,96,268
Rajasthan,Nagaur,Low Vision,35,60,170,57,227
Rajasthan,Nagaur,Low Vision,60,80,43,18,61
Rajasthan,Nagaur,Low Vision,80,100,2,2,4
Telangana,Nagarkurnool,Low Vision,6,15,10,14,24
Telangana,Nagarkurnool,Low Vision,15,35,121,97,218
Telangana,Nagarkurnool,Low Vision,35,60,319,214,533
Telangana,Nagarkurnool,Low Vision,60,80,334,236,570
Telangana,Nagarkurnool,Low Vision,80,100,67,30,97
Tamil Nadu,Nagapattinam,Low Vision,0,6,0,1,1
Tamil Nadu,Nagapattinam,Low Vision,6,15,17,12,29
Tamil Nadu,Nagapattinam,Low Vision,15,35,80,57,137
Tamil Nadu,Nagapattinam,Low Vision,35,60,92,49,141
Tamil Nadu,Nagapattinam,Low Vision,60,80,37,9,46
Tamil Nadu,Nagapattinam,Low Vision,80,100,3,0,3
Assam,Nagaon,Low Vision,0,6,5,4,9
Assam,Nagaon,Low Vision,6,15,46,39,85
Assam,Nagaon,Low Vision,15,35,185,117,302
Assam,Nagaon,Low Vision,35,60,188,145,333
Assam,Nagaon,Low Vision,60,80,64,38,102
Assam,Nagaon,Low Vision,80,100,2,2,4
Odisha,Nabarangpur,Low Vision,0,6,11,8,19
Odisha,Nabarangpur,Low Vision,6,15,111,60,171
Odisha,Nabarangpur,Low Vision,15,35,156,84,240
Odisha,Nabarangpur,Low Vision,35,60,135,74,209
Odisha,Nabarangpur,Low Vision,60,80,37,19,56
Odisha,Nabarangpur,Low Vision,80,100,1,0,1
Karnataka,Mysuru,Low Vision,0,6,1,0,1
Karnataka,Mysuru,Low Vision,6,15,42,21,63
Karnataka,Mysuru,Low Vision,15,35,143,57,200
Karnataka,Mysuru,Low Vision,35,60,196,107,303
Karnataka,Mysuru,Low Vision,60,80,75,19,94
Karnataka,Mysuru,Low Vision,80,100,3,1,4
Bihar,Muzaffarpur,Low Vision,0,6,1,0,1
Bihar,Muzaffarpur,Low Vision,6,15,23,23,46
Bihar,Muzaffarpur,Low Vision,15,35,62,31,93
Bihar,Muzaffarpur,Low Vision,35,60,25,13,38
Bihar,Muzaffarpur,Low Vision,60,80,4,1,5
Uttar Pradesh,Muzaffarnagar,Low Vision,6,15,11,12,23
Uttar Pradesh,Muzaffarnagar,Low Vision,15,35,159,55,214
Uttar Pradesh,Muzaffarnagar,Low Vision,35,60,105,45,150
Uttar Pradesh,Muzaffarnagar,Low Vision,60,80,61,15,76
Uttar Pradesh,Muzaffarnagar,Low Vision,80,100,5,1,6
West Bengal,Murshidabad,Low Vision,15,35,3,0,3
West Bengal,Murshidabad,Low Vision,35,60,1,0,1
Bihar,Munger,Low Vision,0,6,5,3,8
Bihar,Munger,Low Vision,6,15,64,52,116
Bihar,Munger,Low Vision,15,35,330,91,421
Bihar,Munger,Low Vision,35,60,159,69,228
Bihar,Munger,Low Vision,60,80,38,13,51
Bihar,Munger,Low Vision,80,100,2,1,3
Chhattisgarh,Mungeli,Low Vision,0,6,1,1,2
Chhattisgarh,Mungeli,Low Vision,6,15,41,29,70
Chhattisgarh,Mungeli,Low Vision,15,35,200,127,327
Chhattisgarh,Mungeli,Low Vision,35,60,85,35,120
Chhattisgarh,Mungeli,Low Vision,60,80,11,6,17
Chhattisgarh,Mungeli,Low Vision,80,100,1,0,1
Maharashtra,Mumbai Suburban,Low Vision,0,6,3,0,3
Maharashtra,Mumbai Suburban,Low Vision,6,15,64,48,112
Maharashtra,Mumbai Suburban,Low Vision,15,35,184,100,284
Maharashtra,Mumbai Suburban,Low Vision,35,60,150,31,181
Maharashtra,Mumbai Suburban,Low Vision,60,80,34,5,39
Maharashtra,Mumbai Suburban,Low Vision,80,100,1,0,1
Maharashtra,Mumbai,Low Vision,0,6,0,1,1
Maharashtra,Mumbai,Low Vision,6,15,25,15,40
Maharashtra,Mumbai,Low Vision,15,35,79,45,124
Maharashtra,Mumbai,Low Vision,35,60,70,26,96
Maharashtra,Mumbai,Low Vision,60,80,33,4,37
Maharashtra,Mumbai,Low Vision,80,100,1,0,1
Telangana,Mulugu,Low Vision,35,60,0,1,1
Madhya Pradesh,Morena,Low Vision,0,6,0,2,2
Madhya Pradesh,Morena,Low Vision,6,15,27,23,50
Madhya Pradesh,Morena,Low Vision,15,35,199,70,269
Madhya Pradesh,Morena,Low Vision,35,60,154,55,209
Madhya Pradesh,Morena,Low Vision,60,80,50,24,74
Madhya Pradesh,Morena,Low Vision,80,100,4,0,4
Gujarat,Morbi,Low Vision,0,6,0,1,1
Gujarat,Morbi,Low Vision,6,15,7,9,16
Gujarat,Morbi,Low Vision,15,35,14,7,21
Gujarat,Morbi,Low Vision,35,60,5,1,6
Gujarat,Morbi,Low Vision,60,80,1,0,1
Gujarat,Morbi,Low Vision,80,100,1,0,1
Uttar Pradesh,Moradabad,Low Vision,0,6,2,0,2
Uttar Pradesh,Moradabad,Low Vision,6,15,12,5,17
Uttar Pradesh,Moradabad,Low Vision,15,35,56,23,79
Uttar Pradesh,Moradabad,Low Vision,35,60,45,16,61
Uttar Pradesh,Moradabad,Low Vision,60,80,7,3,10
Uttar Pradesh,Moradabad,Low Vision,80,100,1,1,2
Nagaland,Mon,Low Vision,6,15,0,2,2
Nagaland,Mon,Low Vision,15,35,12,5,17
Nagaland,Mon,Low Vision,35,60,6,3,9
Nagaland,Mon,Low Vision,60,80,4,3,7
Nagaland,Mokokchung,Low Vision,6,15,1,0,1
Nagaland,Mokokchung,Low Vision,15,35,5,4,9
Nagaland,Mokokchung,Low Vision,35,60,3,2,5
Nagaland,Mokokchung,Low Vision,60,80,0,2,2
Nagaland,Mokokchung,Low Vision,80,100,1,1,2
Punjab,Moga,Low Vision,0,6,0,1,1
Punjab,Moga,Low Vision,6,15,11,15,26
Punjab,Moga,Low Vision,15,35,49,24,73
Punjab,Moga,Low Vision,35,60,67,23,90
Punjab,Moga,Low Vision,60,80,16,2,18
Uttar Pradesh,Mirzapur,Low Vision,6,15,7,8,15
Uttar Pradesh,Mirzapur,Low Vision,15,35,97,38,135
Uttar Pradesh,Mirzapur,Low Vision,35,60,85,33,118
Uttar Pradesh,Mirzapur,Low Vision,60,80,21,12,33
Uttar Pradesh,Meerut,Low Vision,0,6,0,1,1
Uttar Pradesh,Meerut,Low Vision,6,15,7,5,12
Uttar Pradesh,Meerut,Low Vision,15,35,79,22,101
Uttar Pradesh,Meerut,Low Vision,35,60,65,26,91
Uttar Pradesh,Meerut,Low Vision,60,80,44,9,53
Uttar Pradesh,Meerut,Low Vision,80,100,2,0,2
West Bengal,Medinipur West,Low Vision,15,35,1,0,1
Telangana,Medchal Malkajgiri,Low Vision,6,15,33,37,70
Telangana,Medchal Malkajgiri,Low Vision,15,35,413,231,644
Telangana,Medchal Malkajgiri,Low Vision,35,60,711,457,1168
Telangana,Medchal Malkajgiri,Low Vision,60,80,448,193,641
Telangana,Medchal Malkajgiri,Low Vision,80,100,29,19,48
Telangana,Medak,Low Vision,6,15,10,10,20
Telangana,Medak,Low Vision,15,35,95,78,173
Telangana,Medak,Low Vision,35,60,196,142,338
Telangana,Medak,Low Vision,60,80,167,113,280
Telangana,Medak,Low Vision,80,100,36,23,59
Odisha,Mayurbhanj,Low Vision,0,6,15,14,29
Odisha,Mayurbhanj,Low Vision,6,15,195,154,349
Odisha,Mayurbhanj,Low Vision,15,35,610,444,1054
Odisha,Mayurbhanj,Low Vision,35,60,829,463,1292
Odisha,Mayurbhanj,Low Vision,60,80,381,184,565
Odisha,Mayurbhanj,Low Vision,80,100,29,16,45
Tamil Nadu,Mayiladuthurai,Low Vision,0,6,0,3,3
Tamil Nadu,Mayiladuthurai,Low Vision,6,15,19,12,31
Tamil Nadu,Mayiladuthurai,Low Vision,15,35,13,8,21
Tamil Nadu,Mayiladuthurai,Low Vision,35,60,32,17,49
Tamil Nadu,Mayiladuthurai,Low Vision,60,80,15,6,21
Uttar Pradesh,Mau,Low Vision,0,6,2,1,3
Uttar Pradesh,Mau,Low Vision,6,15,25,17,42
Uttar Pradesh,Mau,Low Vision,15,35,429,209,638
Uttar Pradesh,Mau,Low Vision,35,60,359,180,539
Uttar Pradesh,Mau,Low Vision,60,80,97,31,128
Uttar Pradesh,Mau,Low Vision,80,100,3,2,5
Uttar Pradesh,Mathura,Low Vision,6,15,10,3,13
Uttar Pradesh,Mathura,Low Vision,15,35,136,39,175
Uttar Pradesh,Mathura,Low Vision,35,60,63,21,84
Uttar Pradesh,Mathura,Low Vision,60,80,15,4,19
Uttar Pradesh,Mathura,Low Vision,80,100,2,1,3
Assam,Marigaon,Low Vision,0,6,0,3,3
Assam,Marigaon,Low Vision,6,15,18,18,36
Assam,Marigaon,Low Vision,15,35,111,77,188
Assam,Marigaon,Low Vision,35,60,107,43,150
Assam,Marigaon,Low Vision,60,80,12,10,22
Assam,Marigaon,Low Vision,80,100,1,2,3
Punjab,Mansa,Low Vision,0,6,2,3,5
Punjab,Mansa,Low Vision,6,15,25,22,47
Punjab,Mansa,Low Vision,15,35,93,46,139
Punjab,Mansa,Low Vision,35,60,98,53,151
Punjab,Mansa,Low Vision,60,80,22,8,30
Punjab,Mansa,Low Vision,80,100,4,1,5
Sikkim,Mangan,Low Vision,15,35,14,6,20
Sikkim,Mangan,Low Vision,35,60,4,4,8
Karnataka,Mandya,Low Vision,0,6,3,0,3
Karnataka,Mandya,Low Vision,6,15,31,22,53
Karnataka,Mandya,Low Vision,15,35,158,91,249
Karnataka,Mandya,Low Vision,35,60,282,144,426
Karnataka,Mandya,Low Vision,60,80,71,27,98
Karnataka,Mandya,Low Vision,80,100,6,1,7
Madhya Pradesh,Mandsaur,Low Vision,0,6,0,1,1
Madhya Pradesh,Mandsaur,Low Vision,6,15,11,17,28
Madhya Pradesh,Mandsaur,Low Vision,15,35,111,43,154
Madhya Pradesh,Mandsaur,Low Vision,35,60,125,43,168
Madhya Pradesh,Mandsaur,Low Vision,60,80,55,21,76
Madhya Pradesh,Mandsaur,Low Vision,80,100,6,2,8
Madhya Pradesh,Mandla,Low Vision,0,6,3,3,6
Madhya Pradesh,Mandla,Low Vision,6,15,27,17,44
Madhya Pradesh,Mandla,Low Vision,15,35,197,98,295
Madhya Pradesh,Mandla,Low Vision,35,60,138,91,229
Madhya Pradesh,Mandla,Low Vision,60,80,67,24,91
Madhya Pradesh,Mandla,Low Vision,80,100,2,0,2
Himachal Pradesh,Mandi,Low Vision,0,6,4,5,9
Himachal Pradesh,Mandi,Low Vision,6,15,58,39,97
Himachal Pradesh,Mandi,Low Vision,15,35,331,181,512
Himachal Pradesh,Mandi,Low Vision,35,60,513,310,823
Himachal Pradesh,Mandi,Low Vision,60,80,194,81,275
Himachal Pradesh,Mandi,Low Vision,80,100,28,5,33
Telangana,Mancherial,Low Vision,6,15,27,22,49
Telangana,Mancherial,Low Vision,15,35,195,155,350
Telangana,Mancherial,Low Vision,35,60,419,276,695
Telangana,Mancherial,Low Vision,60,80,296,217,513
Telangana,Mancherial,Low Vision,80,100,42,32,74
Mizoram,Mamit,Low Vision,6,15,0,2,2
Mizoram,Mamit,Low Vision,15,35,2,1,3
Mizoram,Mamit,Low Vision,35,60,2,1,3
Odisha,Malkangiri,Low Vision,0,6,16,6,22
Odisha,Malkangiri,Low Vision,6,15,101,70,171
Odisha,Malkangiri,Low Vision,15,35,175,144,319
Odisha,Malkangiri,Low Vision,35,60,307,213,520
Odisha,Malkangiri,Low Vision,60,80,158,107,265
Odisha,Malkangiri,Low Vision,80,100,9,14,23
Punjab,Malerkotla,Low Vision,0,6,1,1,2
Punjab,Malerkotla,Low Vision,6,15,10,12,22
Punjab,Malerkotla,Low Vision,15,35,7,6,13
Punjab,Malerkotla,Low Vision,35,60,21,7,28
Punjab,Malerkotla,Low Vision,60,80,9,1,10
Kerala,Malappuram,Low Vision,0,6,2,2,4
Kerala,Malappuram,Low Vision,6,15,49,29,78
Kerala,Malappuram,Low Vision,15,35,245,125,370
Kerala,Malappuram,Low Vision,35,60,321,201,522
Kerala,Malappuram,Low Vision,60,80,116,64,180
Kerala,Malappuram,Low Vision,80,100,7,5,12
Assam,Majuli,Low Vision,6,15,5,0,5
Assam,Majuli,Low Vision,15,35,22,6,28
Assam,Majuli,Low Vision,35,60,20,9,29
Assam,Majuli,Low Vision,60,80,7,1,8
Assam,Majuli,Low Vision,80,100,1,0,1
Uttar Pradesh,Mainpuri,Low Vision,6,15,14,7,21
Uttar Pradesh,Mainpuri,Low Vision,15,35,181,87,268
Uttar Pradesh,Mainpuri,Low Vision,35,60,161,71,232
Uttar Pradesh,Mainpuri,Low Vision,60,80,87,25,112
Uttar Pradesh,Mainpuri,Low Vision,80,100,5,0,5
Uttar Pradesh,Mahoba,Low Vision,6,15,1,3,4
Uttar Pradesh,Mahoba,Low Vision,15,35,54,19,73
Uttar Pradesh,Mahoba,Low Vision,35,60,33,13,46
Uttar Pradesh,Mahoba,Low Vision,60,80,8,1,9
Gujarat,Mahisagar,Low Vision,0,6,0,1,1
Gujarat,Mahisagar,Low Vision,6,15,40,26,66
Gujarat,Mahisagar,Low Vision,15,35,123,74,197
Gujarat,Mahisagar,Low Vision,35,60,60,23,83
Gujarat,Mahisagar,Low Vision,60,80,25,9,34
Gujarat,Mahisagar,Low Vision,80,100,0,1,1
Gujarat,Mahesana,Low Vision,0,6,1,2,3
Gujarat,Mahesana,Low Vision,6,15,59,37,96
Gujarat,Mahesana,Low Vision,15,35,137,56,193
Gujarat,Mahesana,Low Vision,35,60,90,29,119
Gujarat,Mahesana,Low Vision,60,80,43,8,51
Gujarat,Mahesana,Low Vision,80,100,2,0,2
Haryana,Mahendragarh,Low Vision,0,6,1,0,1
Haryana,Mahendragarh,Low Vision,6,15,15,9,24
Haryana,Mahendragarh,Low Vision,15,35,64,28,92
Haryana,Mahendragarh,Low Vision,35,60,78,25,103
Haryana,Mahendragarh,Low Vision,60,80,17,9,26
Haryana,Mahendragarh,Low Vision,80,100,1,0,1
Puducherry,Mahe,Low Vision,15,35,1,0,1
Puducherry,Mahe,Low Vision,35,60,0,1,1
Puducherry,Mahe,Low Vision,60,80,0,1,1
Chhattisgarh,Mahasamund,Low Vision,0,6,1,3,4
Chhattisgarh,Mahasamund,Low Vision,6,15,73,88,161
Chhattisgarh,Mahasamund,Low Vision,15,35,243,177,420
Chhattisgarh,Mahasamund,Low Vision,35,60,141,69,210
Chhattisgarh,Mahasamund,Low Vision,60,80,61,26,87
Chhattisgarh,Mahasamund,Low Vision,80,100,5,1,6
Uttar Pradesh,Maharajganj,Low Vision,0,6,3,1,4
Uttar Pradesh,Maharajganj,Low Vision,6,15,19,16,35
Uttar Pradesh,Maharajganj,Low Vision,15,35,168,88,256
Uttar Pradesh,Maharajganj,Low Vision,35,60,169,83,252
Uttar Pradesh,Maharajganj,Low Vision,60,80,37,14,51
Uttar Pradesh,Maharajganj,Low Vision,80,100,2,1,3
Telangana,Mahabubnagar,Low Vision,6,15,22,31,53
Telangana,Mahabubnagar,Low Vision,15,35,247,214,461
Telangana,Mahabubnagar,Low Vision,35,60,511,383,894
Telangana,Mahabubnagar,Low Vision,60,80,472,291,763
Telangana,Mahabubnagar,Low Vision,80,100,101,57,158
Telangana,Mahabubabad,Low Vision,6,15,10,19,29
Telangana,Mahabubabad,Low Vision,15,35,264,153,417
Telangana,Mahabubabad,Low Vision,35,60,628,387,1015
Telangana,Mahabubabad,Low Vision,60,80,602,393,995
Telangana,Mahabubabad,Low Vision,80,100,136,73,209
Tamil Nadu,Madurai,Low Vision,0,6,4,2,6
Tamil Nadu,Madurai,Low Vision,6,15,43,32,75
Tamil Nadu,Madurai,Low Vision,15,35,116,69,185
Tamil Nadu,Madurai,Low Vision,35,60,139,89,228
Tamil Nadu,Madurai,Low Vision,60,80,75,45,120
Tamil Nadu,Madurai,Low Vision,80,100,6,1,7
Bihar,Madhubani,Low Vision,0,6,0,1,1
Bihar,Madhubani,Low Vision,6,15,14,5,19
Bihar,Madhubani,Low Vision,15,35,77,13,90
Bihar,Madhubani,Low Vision,35,60,39,10,49
Bihar,Madhubani,Low Vision,60,80,3,3,6
Bihar,Madhepura,Low Vision,0,6,2,0,2
Bihar,Madhepura,Low Vision,6,15,14,15,29
Bihar,Madhepura,Low Vision,15,35,80,41,121
Bihar,Madhepura,Low Vision,35,60,82,48,130
Bihar,Madhepura,Low Vision,60,80,34,20,54
Bihar,Madhepura,Low Vision,80,100,1,0,1
Mizoram,Lunglei,Low Vision,6,15,1,2,3
Mizoram,Lunglei,Low Vision,15,35,2,2,4
Punjab,Ludhiana,Low Vision,0,6,3,1,4
Punjab,Ludhiana,Low Vision,6,15,82,84,166
Punjab,Ludhiana,Low Vision,15,35,268,152,420
Punjab,Ludhiana,Low Vision,35,60,365,185,550
Punjab,Ludhiana,Low Vision,60,80,167,87,254
Punjab,Ludhiana,Low Vision,80,100,7,7,14
Uttar Pradesh,Lucknow,Low Vision,0,6,1,2,3
Uttar Pradesh,Lucknow,Low Vision,6,15,10,4,14
Uttar Pradesh,Lucknow,Low Vision,15,35,122,57,179
Uttar Pradesh,Lucknow,Low Vision,35,60,103,35,138
Uttar Pradesh,Lucknow,Low Vision,60,80,27,5,32
Uttar Pradesh,Lucknow,Low Vision,80,100,3,0,3
Arunachal Pradesh,Lower Subansiri,Low Vision,6,15,1,0,1
Arunachal Pradesh,Lower Subansiri,Low Vision,15,35,1,2,3
Arunachal Pradesh,Lower Siang,Low Vision,15,35,2,0,2
Arunachal Pradesh,Lower Dibang Valley,Low Vision,6,15,0,1,1
Arunachal Pradesh,Lower Dibang Valley,Low Vision,15,35,6,5,11
Arunachal Pradesh,Lower Dibang Valley,Low Vision,35,60,3,2,5
Arunachal Pradesh,Lower Dibang Valley,Low Vision,60,80,2,4,6
Nagaland,Longleng,Low Vision,15,35,1,0,1
Arunachal Pradesh,Lohit,Low Vision,15,35,2,0,2
Jharkhand,Lohardaga,Low Vision,6,15,3,4,7
Jharkhand,Lohardaga,Low Vision,15,35,22,3,25
Jharkhand,Lohardaga,Low Vision,35,60,14,14,28
Jharkhand,Lohardaga,Low Vision,60,80,2,1,3
Jharkhand,Lohardaga,Low Vision,80,100,1,0,1
Ladakh,Leh Ladakh,Low Vision,6,15,1,1,2
Ladakh,Leh Ladakh,Low Vision,15,35,12,10,22
Ladakh,Leh Ladakh,Low Vision,35,60,7,10,17
Ladakh,Leh Ladakh,Low Vision,60,80,23,6,29
Ladakh,Leh Ladakh,Low Vision,80,100,5,1,6
Mizoram,Lawngtlai,Low Vision,0,6,0,1,1
Maharashtra,Latur,Low Vision,0,6,4,5,9
Maharashtra,Latur,Low Vision,6,15,89,56,145
Maharashtra,Latur,Low Vision,15,35,441,208,649
Maharashtra,Latur,Low Vision,35,60,516,223,739
Maharashtra,Latur,Low Vision,60,80,220,70,290
Maharashtra,Latur,Low Vision,80,100,33,3,36
Jharkhand,Latehar,Low Vision,0,6,0,2,2
Jharkhand,Latehar,Low Vision,6,15,3,1,4
Jharkhand,Latehar,Low Vision,15,35,21,14,35
Jharkhand,Latehar,Low Vision,35,60,16,3,19
Jharkhand,Latehar,Low Vision,60,80,2,0,2
Uttar Pradesh,Lalitpur,Low Vision,0,6,1,2,3
Uttar Pradesh,Lalitpur,Low Vision,6,15,12,12,24
Uttar Pradesh,Lalitpur,Low Vision,15,35,125,42,167
Uttar Pradesh,Lalitpur,Low Vision,35,60,59,20,79
Uttar Pradesh,Lalitpur,Low Vision,60,80,3,4,7
Lakshadweep,Lakshadweep District,Low Vision,6,15,1,0,1
Lakshadweep,Lakshadweep District,Low Vision,15,35,13,7,20
Lakshadweep,Lakshadweep District,Low Vision,35,60,19,17,36
Lakshadweep,Lakshadweep District,Low Vision,60,80,2,5,7
Bihar,Lakhisarai,Low Vision,0,6,1,0,1
Bihar,Lakhisarai,Low Vision,6,15,8,1,9
Bihar,Lakhisarai,Low Vision,15,35,55,42,97
Bihar,Lakhisarai,Low Vision,35,60,63,59,122
Bihar,Lakhisarai,Low Vision,60,80,41,16,57
Assam,Lakhimpur,Low Vision,0,6,1,0,1
Assam,Lakhimpur,Low Vision,6,15,11,5,16
Assam,Lakhimpur,Low Vision,15,35,19,7,26
Assam,Lakhimpur,Low Vision,35,60,18,9,27
Assam,Lakhimpur,Low Vision,60,80,6,1,7
Himachal Pradesh,Lahul And Spiti,Low Vision,6,15,1,1,2
Himachal Pradesh,Lahul And Spiti,Low Vision,15,35,2,2,4
Himachal Pradesh,Lahul And Spiti,Low Vision,35,60,8,2,10
Himachal Pradesh,Lahul And Spiti,Low Vision,60,80,6,1,7
Himachal Pradesh,Lahul And Spiti,Low Vision,80,100,1,0,1
Uttar Pradesh,Kushi Nagar,Low Vision,0,6,1,0,1
Uttar Pradesh,Kushi Nagar,Low Vision,6,15,9,9,18
Uttar Pradesh,Kushi Nagar,Low Vision,15,35,167,70,237
Uttar Pradesh,Kushi Nagar,Low Vision,35,60,97,36,133
Uttar Pradesh,Kushi Nagar,Low Vision,60,80,23,5,28
Arunachal Pradesh,Kurung Kumey,Low Vision,15,35,2,0,2
Haryana,Kurukshetra,Low Vision,0,6,1,0,1
Haryana,Kurukshetra,Low Vision,6,15,18,20,38
Haryana,Kurukshetra,Low Vision,15,35,38,14,52
Haryana,Kurukshetra,Low Vision,35,60,41,10,51
Haryana,Kurukshetra,Low Vision,60,80,2,0,2
Andhra Pradesh,Kurnool,Low Vision,0,6,1,6,7
Andhra Pradesh,Kurnool,Low Vision,6,15,37,40,77
Andhra Pradesh,Kurnool,Low Vision,15,35,154,75,229
Andhra Pradesh,Kurnool,Low Vision,35,60,239,155,394
Andhra Pradesh,Kurnool,Low Vision,60,80,65,32,97
Andhra Pradesh,Kurnool,Low Vision,80,100,7,2,9
Jammu And Kashmir,Kupwara,Low Vision,0,6,17,23,40
Jammu And Kashmir,Kupwara,Low Vision,6,15,195,108,303
Jammu And Kashmir,Kupwara,Low Vision,15,35,512,340,852
Jammu And Kashmir,Kupwara,Low Vision,35,60,303,191,494
Jammu And Kashmir,Kupwara,Low Vision,60,80,44,29,73
Jammu And Kashmir,Kupwara,Low Vision,80,100,7,5,12
Telangana,Kumuram Bheem Asifabad,Low Vision,6,15,17,23,40
Telangana,Kumuram Bheem Asifabad,Low Vision,15,35,138,116,254
Telangana,Kumuram Bheem Asifabad,Low Vision,35,60,219,140,359
Telangana,Kumuram Bheem Asifabad,Low Vision,60,80,152,92,244
Telangana,Kumuram Bheem Asifabad,Low Vision,80,100,23,20,43
Himachal Pradesh,Kullu,Low Vision,0,6,4,2,6
Himachal Pradesh,Kullu,Low Vision,6,15,24,13,37
Himachal Pradesh,Kullu,Low Vision,15,35,83,65,148
Himachal Pradesh,Kullu,Low Vision,35,60,120,89,209
Himachal Pradesh,Kullu,Low Vision,60,80,43,17,60
Himachal Pradesh,Kullu,Low Vision,80,100,10,3,13
Jammu And Kashmir,Kulgam,Low Vision,0,6,1,2,3
Jammu And Kashmir,Kulgam,Low Vision,6,15,13,13,26
Jammu And Kashmir,Kulgam,Low Vision,15,35,53,47,100
Jammu And Kashmir,Kulgam,Low Vision,35,60,53,46,99
Jammu And Kashmir,Kulgam,Low Vision,60,80,21,12,33
Jammu And Kashmir,Kulgam,Low Vision,80,100,1,0,1
Tamil Nadu,Krishnagiri,Low Vision,0,6,5,5,10
Tamil Nadu,Krishnagiri,Low Vision,6,15,53,47,100
Tamil Nadu,Krishnagiri,Low Vision,15,35,141,78,219
Tamil Nadu,Krishnagiri,Low Vision,35,60,120,85,205
Tamil Nadu,Krishnagiri,Low Vision,60,80,72,21,93
Tamil Nadu,Krishnagiri,Low Vision,80,100,2,4,6
Andhra Pradesh,Krishna,Low Vision,0,6,5,0,5
Andhra Pradesh,Krishna,Low Vision,6,15,25,17,42
Andhra Pradesh,Krishna,Low Vision,15,35,78,40,118
Andhra Pradesh,Krishna,Low Vision,35,60,305,173,478
Andhra Pradesh,Krishna,Low Vision,60,80,137,52,189
Andhra Pradesh,Krishna,Low Vision,80,100,3,1,4
Kerala,Kozhikode,Low Vision,0,6,2,2,4
Kerala,Kozhikode,Low Vision,6,15,22,25,47
Kerala,Kozhikode,Low Vision,15,35,192,91,283
Kerala,Kozhikode,Low Vision,35,60,272,166,438
Kerala,Kozhikode,Low Vision,60,80,158,69,227
Kerala,Kozhikode,Low Vision,80,100,11,7,18
Kerala,Kottayam,Low Vision,0,6,2,1,3
Kerala,Kottayam,Low Vision,6,15,25,18,43
Kerala,Kottayam,Low Vision,15,35,120,79,199
Kerala,Kottayam,Low Vision,35,60,179,131,310
Kerala,Kottayam,Low Vision,60,80,134,95,229
Kerala,Kottayam,Low Vision,80,100,4,6,10
Rajasthan,Kota,Low Vision,0,6,1,0,1
Rajasthan,Kota,Low Vision,6,15,3,4,7
Rajasthan,Kota,Low Vision,15,35,37,19,56
Rajasthan,Kota,Low Vision,35,60,23,5,28
Rajasthan,Kota,Low Vision,60,80,7,3,10
Rajasthan,Kota,Low Vision,80,100,0,1,1
Chhattisgarh,Korea,Low Vision,6,15,2,1,3
Chhattisgarh,Korea,Low Vision,15,35,9,8,17
Chhattisgarh,Korea,Low Vision,35,60,4,2,6
Chhattisgarh,Korea,Low Vision,60,80,1,0,1
Chhattisgarh,Korba,Low Vision,6,15,2,1,3
Chhattisgarh,Korba,Low Vision,15,35,8,7,15
Chhattisgarh,Korba,Low Vision,35,60,8,2,10
Chhattisgarh,Korba,Low Vision,60,80,2,0,2
Odisha,Koraput,Low Vision,0,6,7,5,12
Odisha,Koraput,Low Vision,6,15,114,65,179
Odisha,Koraput,Low Vision,15,35,202,151,353
Odisha,Koraput,Low Vision,35,60,229,152,381
Odisha,Koraput,Low Vision,60,80,109,87,196
Odisha,Koraput,Low Vision,80,100,8,13,21
Karnataka,Koppal,Low Vision,0,6,5,0,5
Karnataka,Koppal,Low Vision,6,15,56,38,94
Karnataka,Koppal,Low Vision,15,35,191,102,293
Karnataka,Koppal,Low Vision,35,60,162,64,226
Karnataka,Koppal,Low Vision,60,80,34,14,48
Karnataka,Koppal,Low Vision,80,100,1,1,2
Chhattisgarh,Kondagaon,Low Vision,0,6,2,1,3
Chhattisgarh,Kondagaon,Low Vision,6,15,82,59,141
Chhattisgarh,Kondagaon,Low Vision,15,35,145,97,242
Chhattisgarh,Kondagaon,Low Vision,35,60,92,40,132
Chhattisgarh,Kondagaon,Low Vision,60,80,24,12,36
Chhattisgarh,Kondagaon,Low Vision,80,100,1,0,1
Kerala,Kollam,Low Vision,0,6,3,1,4
Kerala,Kollam,Low Vision,6,15,34,23,57
Kerala,Kollam,Low Vision,15,35,178,118,296
Kerala,Kollam,Low Vision,35,60,208,165,373
Kerala,Kollam,Low Vision,60,80,167,82,249
Kerala,Kollam,Low Vision,80,100,9,7,16
Maharashtra,Kolhapur,Low Vision,0,6,2,1,3
Maharashtra,Kolhapur,Low Vision,6,15,120,65,185
Maharashtra,Kolhapur,Low Vision,15,35,445,179,624
Maharashtra,Kolhapur,Low Vision,35,60,490,174,664
Maharashtra,Kolhapur,Low Vision,60,80,145,38,183
Maharashtra,Kolhapur,Low Vision,80,100,6,0,6
Mizoram,Kolasib,Low Vision,6,15,3,0,3
Mizoram,Kolasib,Low Vision,15,35,3,1,4
Mizoram,Kolasib,Low Vision,35,60,3,1,4
Karnataka,Kolar,Low Vision,0,6,1,0,1
Karnataka,Kolar,Low Vision,6,15,6,7,13
Karnataka,Kolar,Low Vision,15,35,34,20,54
Karnataka,Kolar,Low Vision,35,60,66,21,87
Karnataka,Kolar,Low Vision,60,80,18,4,22
Karnataka,Kolar,Low Vision,80,100,1,0,1
Assam,Kokrajhar,Low Vision,0,6,3,1,4
Assam,Kokrajhar,Low Vision,6,15,17,9,26
Assam,Kokrajhar,Low Vision,15,35,105,56,161
Assam,Kokrajhar,Low Vision,35,60,102,55,157
Assam,Kokrajhar,Low Vision,60,80,14,12,26
Assam,Kokrajhar,Low Vision,80,100,1,0,1
Nagaland,Kohima,Low Vision,15,35,3,2,5
Nagaland,Kohima,Low Vision,35,60,2,1,3
Jharkhand,Koderma,Low Vision,0,6,2,1,3
Jharkhand,Koderma,Low Vision,6,15,22,11,33
Jharkhand,Koderma,Low Vision,15,35,58,22,80
Jharkhand,Koderma,Low Vision,35,60,35,20,55
Jharkhand,Koderma,Low Vision,60,80,7,3,10
Jharkhand,Koderma,Low Vision,80,100,1,0,1
Karnataka,Kodagu,Low Vision,0,6,1,0,1
Karnataka,Kodagu,Low Vision,6,15,10,13,23
Karnataka,Kodagu,Low Vision,15,35,38,33,71
Karnataka,Kodagu,Low Vision,35,60,72,44,116
Karnataka,Kodagu,Low Vision,60,80,34,17,51
Karnataka,Kodagu,Low Vision,80,100,1,0,1
Jammu And Kashmir,Kishtwar,Low Vision,0,6,4,5,9
Jammu And Kashmir,Kishtwar,Low Vision,6,15,21,26,47
Jammu And Kashmir,Kishtwar,Low Vision,15,35,127,86,213
Jammu And Kashmir,Kishtwar,Low Vision,35,60,144,80,224
Jammu And Kashmir,Kishtwar,Low Vision,60,80,45,22,67
Jammu And Kashmir,Kishtwar,Low Vision,80,100,6,1,7
Bihar,Kishanganj,Low Vision,6,15,11,12,23
Bihar,Kishanganj,Low Vision,15,35,43,38,81
Bihar,Kishanganj,Low Vision,35,60,34,14,48
Bihar,Kishanganj,Low Vision,60,80,13,2,15
Nagaland,Kiphire,Low Vision,15,35,1,0,1
Himachal Pradesh,Kinnaur,Low Vision,6,15,1,1,2
Himachal Pradesh,Kinnaur,Low Vision,15,35,19,7,26
Himachal Pradesh,Kinnaur,Low Vision,35,60,24,13,37
Himachal Pradesh,Kinnaur,Low Vision,60,80,13,9,22
Himachal Pradesh,Kinnaur,Low Vision,80,100,3,1,4
Jharkhand,Khunti,Low Vision,6,15,4,4,8
Jharkhand,Khunti,Low Vision,15,35,12,14,26
Jharkhand,Khunti,Low Vision,35,60,11,5,16
Jharkhand,Khunti,Low Vision,60,80,2,3,5
Tripura,Khowai,Low Vision,6,15,8,12,20
Tripura,Khowai,Low Vision,15,35,43,31,74
Tripura,Khowai,Low Vision,35,60,36,24,60
Tripura,Khowai,Low Vision,60,80,7,6,13
Tripura,Khowai,Low Vision,80,100,1,0,1
Odisha,Khordha,Low Vision,0,6,7,0,7
Odisha,Khordha,Low Vision,6,15,154,81,235
Odisha,Khordha,Low Vision,15,35,442,262,704
Odisha,Khordha,Low Vision,35,60,601,287,888
Odisha,Khordha,Low Vision,60,80,174,52,226
Odisha,Khordha,Low Vision,80,100,8,4,12
Uttar Pradesh,Kheri,Low Vision,6,15,3,5,8
Uttar Pradesh,Kheri,Low Vision,15,35,147,53,200
Uttar Pradesh,Kheri,Low Vision,35,60,102,44,146
Uttar Pradesh,Kheri,Low Vision,60,80,31,7,38
Uttar Pradesh,Kheri,Low Vision,80,100,3,0,3
Gujarat,Kheda,Low Vision,6,15,11,7,18
Gujarat,Kheda,Low Vision,15,35,12,12,24
Gujarat,Kheda,Low Vision,35,60,5,1,6
Gujarat,Kheda,Low Vision,60,80,3,0,3
Gujarat,Kheda,Low Vision,80,100,1,0,1
Mizoram,Khawzawl,Low Vision,15,35,1,0,1
Madhya Pradesh,Khargone,Low Vision,0,6,1,0,1
Madhya Pradesh,Khargone,Low Vision,6,15,12,10,22
Madhya Pradesh,Khargone,Low Vision,15,35,122,69,191
Madhya Pradesh,Khargone,Low Vision,35,60,150,78,228
Madhya Pradesh,Khargone,Low Vision,60,80,77,38,115
Madhya Pradesh,Khargone,Low Vision,80,100,5,2,7
Telangana,Khammam,Low Vision,6,15,30,18,48
Telangana,Khammam,Low Vision,15,35,218,161,379
Telangana,Khammam,Low Vision,35,60,443,307,750
Telangana,Khammam,Low Vision,60,80,367,209,576
Telangana,Khammam,Low Vision,80,100,88,47,135
Bihar,Khagaria,Low Vision,0,6,1,0,1
Bihar,Khagaria,Low Vision,6,15,4,7,11
Bihar,Khagaria,Low Vision,15,35,28,28,56
Bihar,Khagaria,Low Vision,35,60,38,12,50
Bihar,Khagaria,Low Vision,60,80,8,7,15
Bihar,Khagaria,Low Vision,80,100,0,1,1
Odisha,Kendujhar,Low Vision,0,6,4,1,5
Odisha,Kendujhar,Low Vision,6,15,96,58,154
Odisha,Kendujhar,Low Vision,15,35,239,136,375
Odisha,Kendujhar,Low Vision,35,60,289,118,407
Odisha,Kendujhar,Low Vision,60,80,67,14,81
Odisha,Kendujhar,Low Vision,80,100,0,1,1
Odisha,Kendrapara,Low Vision,0,6,1,2,3
Odisha,Kendrapara,Low Vision,6,15,34,17,51
Odisha,Kendrapara,Low Vision,15,35,108,89,197
Odisha,Kendrapara,Low Vision,35,60,192,97,289
Odisha,Kendrapara,Low Vision,60,80,67,31,98
Odisha,Kendrapara,Low Vision,80,100,4,1,5
Uttar Pradesh,Kaushambi,Low Vision,6,15,14,12,26
Uttar Pradesh,Kaushambi,Low Vision,15,35,104,58,162
Uttar Pradesh,Kaushambi,Low Vision,35,60,77,29,106
Uttar Pradesh,Kaushambi,Low Vision,60,80,19,3,22
Madhya Pradesh,Katni,Low Vision,0,6,2,6,8
Madhya Pradesh,Katni,Low Vision,6,15,72,54,126
Madhya Pradesh,Katni,Low Vision,15,35,516,354,870
Madhya Pradesh,Katni,Low Vision,35,60,521,304,825
Madhya Pradesh,Katni,Low Vision,60,80,340,147,487
Madhya Pradesh,Katni,Low Vision,80,100,22,8,30
Bihar,Katihar,Low Vision,0,6,4,2,6
Bihar,Katihar,Low Vision,6,15,49,36,85
Bihar,Katihar,Low Vision,15,35,55,42,97
Bihar,Katihar,Low Vision,35,60,58,38,96
Bihar,Katihar,Low Vision,60,80,24,18,42
Bihar,Katihar,Low Vision,80,100,1,0,1
Jammu And Kashmir,Kathua,Low Vision,0,6,1,1,2
Jammu And Kashmir,Kathua,Low Vision,6,15,26,23,49
Jammu And Kashmir,Kathua,Low Vision,15,35,111,72,183
Jammu And Kashmir,Kathua,Low Vision,35,60,152,73,225
Jammu And Kashmir,Kathua,Low Vision,60,80,35,19,54
Jammu And Kashmir,Kathua,Low Vision,80,100,3,2,5
Uttar Pradesh,Kasganj,Low Vision,6,15,2,2,4
Uttar Pradesh,Kasganj,Low Vision,15,35,33,8,41
Uttar Pradesh,Kasganj,Low Vision,35,60,53,15,68
Uttar Pradesh,Kasganj,Low Vision,60,80,21,5,26
Uttar Pradesh,Kasganj,Low Vision,80,100,1,0,1
Kerala,Kasaragod,Low Vision,0,6,5,3,8
Kerala,Kasaragod,Low Vision,6,15,34,23,57
Kerala,Kasaragod,Low Vision,15,35,143,66,209
Kerala,Kasaragod,Low Vision,35,60,199,152,351
Kerala,Kasaragod,Low Vision,60,80,98,77,175
Kerala,Kasaragod,Low Vision,80,100,9,6,15
Tamil Nadu,Karur,Low Vision,0,6,0,1,1
Tamil Nadu,Karur,Low Vision,6,15,12,9,21
Tamil Nadu,Karur,Low Vision,15,35,33,15,48
Tamil Nadu,Karur,Low Vision,35,60,30,31,61
Tamil Nadu,Karur,Low Vision,60,80,16,11,27
Haryana,Karnal,Low Vision,0,6,1,1,2
Haryana,Karnal,Low Vision,6,15,8,13,21
Haryana,Karnal,Low Vision,15,35,22,17,39
Haryana,Karnal,Low Vision,35,60,23,8,31
Haryana,Karnal,Low Vision,60,80,4,2,6
Telangana,Karimnagar,Low Vision,6,15,23,26,49
Telangana,Karimnagar,Low Vision,15,35,257,154,411
Telangana,Karimnagar,Low Vision,35,60,642,376,1018
Telangana,Karimnagar,Low Vision,60,80,504,319,823
Telangana,Karimnagar,Low Vision,80,100,120,51,171
Assam,Karimganj,Low Vision,0,6,1,1,2
Assam,Karimganj,Low Vision,6,15,27,14,41
Assam,Karimganj,Low Vision,15,35,67,39,106
Assam,Karimganj,Low Vision,35,60,41,23,64
Assam,Karimganj,Low Vision,60,80,6,3,9
Assam,Karimganj,Low Vision,80,100,1,0,1
Ladakh,Kargil,Low Vision,0,6,1,0,1
Ladakh,Kargil,Low Vision,6,15,5,1,6
Ladakh,Kargil,Low Vision,15,35,16,12,28
Ladakh,Kargil,Low Vision,35,60,13,18,31
Ladakh,Kargil,Low Vision,60,80,7,6,13
Assam,Karbi Anglong,Low Vision,0,6,2,2,4
Assam,Karbi Anglong,Low Vision,6,15,15,8,23
Assam,Karbi Anglong,Low Vision,15,35,45,50,95
Assam,Karbi Anglong,Low Vision,35,60,55,89,144
Assam,Karbi Anglong,Low Vision,60,80,29,41,70
Assam,Karbi Anglong,Low Vision,80,100,4,2,6
Rajasthan,Karauli,Low Vision,6,15,7,3,10
Rajasthan,Karauli,Low Vision,15,35,56,15,71
Rajasthan,Karauli,Low Vision,35,60,25,12,37
Rajasthan,Karauli,Low Vision,60,80,6,2,8
Puducherry,Karaikal,Low Vision,15,35,1,3,4
Puducherry,Karaikal,Low Vision,35,60,7,3,10
Puducherry,Karaikal,Low Vision,60,80,1,0,1
Punjab,Kapurthala,Low Vision,6,15,8,10,18
Punjab,Kapurthala,Low Vision,15,35,47,18,65
Punjab,Kapurthala,Low Vision,35,60,56,22,78
Punjab,Kapurthala,Low Vision,60,80,26,7,33
Punjab,Kapurthala,Low Vision,80,100,4,0,4
Uttar Pradesh,Kanpur Nagar,Low Vision,0,6,1,2,3
Uttar Pradesh,Kanpur Nagar,Low Vision,6,15,33,20,53
Uttar Pradesh,Kanpur Nagar,Low Vision,15,35,508,224,732
Uttar Pradesh,Kanpur Nagar,Low Vision,35,60,346,149,495
Uttar Pradesh,Kanpur Nagar,Low Vision,60,80,136,37,173
Uttar Pradesh,Kanpur Nagar,Low Vision,80,100,5,0,5
Uttar Pradesh,Kanpur Dehat,Low Vision,6,15,10,8,18
Uttar Pradesh,Kanpur Dehat,Low Vision,15,35,178,88,266
Uttar Pradesh,Kanpur Dehat,Low Vision,35,60,174,62,236
Uttar Pradesh,Kanpur Dehat,Low Vision,60,80,58,17,75
Uttar Pradesh,Kanpur Dehat,Low Vision,80,100,3,3,6
Kerala,Kannur,Low Vision,0,6,0,3,3
Kerala,Kannur,Low Vision,6,15,30,19,49
Kerala,Kannur,Low Vision,15,35,157,91,248
Kerala,Kannur,Low Vision,35,60,218,135,353
Kerala,Kannur,Low Vision,60,80,95,47,142
Kerala,Kannur,Low Vision,80,100,5,7,12
Tamil Nadu,Kanniyakumari,Low Vision,0,6,1,2,3
Tamil Nadu,Kanniyakumari,Low Vision,6,15,16,7,23
Tamil Nadu,Kanniyakumari,Low Vision,15,35,24,22,46
Tamil Nadu,Kanniyakumari,Low Vision,35,60,24,16,40
Tamil Nadu,Kanniyakumari,Low Vision,60,80,16,12,28
Uttar Pradesh,Kannauj,Low Vision,0,6,0,1,1
Uttar Pradesh,Kannauj,Low Vision,6,15,22,17,39
Uttar Pradesh,Kannauj,Low Vision,15,35,239,125,364
Uttar Pradesh,Kannauj,Low Vision,35,60,420,165,585
Uttar Pradesh,Kannauj,Low Vision,60,80,278,93,371
Uttar Pradesh,Kannauj,Low Vision,80,100,18,3,21
Chhattisgarh,Kanker,Low Vision,0,6,1,1,2
Chhattisgarh,Kanker,Low Vision,6,15,22,23,45
Chhattisgarh,Kanker,Low Vision,15,35,46,29,75
Chhattisgarh,Kanker,Low Vision,35,60,31,15,46
Chhattisgarh,Kanker,Low Vision,60,80,7,2,9
Himachal Pradesh,Kangra,Low Vision,0,6,3,0,3
Himachal Pradesh,Kangra,Low Vision,6,15,40,19,59
Himachal Pradesh,Kangra,Low Vision,15,35,180,102,282
Himachal Pradesh,Kangra,Low Vision,35,60,258,159,417
Himachal Pradesh,Kangra,Low Vision,60,80,81,36,117
Himachal Pradesh,Kangra,Low Vision,80,100,7,2,9
Manipur,Kangpokpi,Low Vision,15,35,2,0,2
Manipur,Kangpokpi,Low Vision,35,60,0,1,1
Odisha,Kandhamal,Low Vision,0,6,8,8,16
Odisha,Kandhamal,Low Vision,6,15,88,83,171
Odisha,Kandhamal,Low Vision,15,35,209,161,370
Odisha,Kandhamal,Low Vision,35,60,288,192,480
Odisha,Kandhamal,Low Vision,60,80,126,69,195
Odisha,Kandhamal,Low Vision,80,100,7,6,13
Tamil Nadu,Kanchipuram,Low Vision,0,6,0,1,1
Tamil Nadu,Kanchipuram,Low Vision,6,15,18,4,22
Tamil Nadu,Kanchipuram,Low Vision,15,35,53,37,90
Tamil Nadu,Kanchipuram,Low Vision,35,60,81,63,144
Tamil Nadu,Kanchipuram,Low Vision,60,80,28,15,43
Tamil Nadu,Kanchipuram,Low Vision,80,100,1,1,2
Assam,Kamrup Metro,Low Vision,0,6,1,0,1
Assam,Kamrup Metro,Low Vision,6,15,5,8,13
Assam,Kamrup Metro,Low Vision,15,35,44,20,64
Assam,Kamrup Metro,Low Vision,35,60,18,12,30
Assam,Kamrup Metro,Low Vision,60,80,4,1,5
Assam,Kamrup Metro,Low Vision,80,100,1,0,1
Assam,Kamrup,Low Vision,0,6,0,1,1
Assam,Kamrup,Low Vision,6,15,19,9,28
Assam,Kamrup,Low Vision,15,35,122,72,194
Assam,Kamrup,Low Vision,35,60,119,67,186
Assam,Kamrup,Low Vision,60,80,28,23,51
Assam,Kamrup,Low Vision,80,100,0,4,4
Arunachal Pradesh,Kamle,Low Vision,15,35,1,0,1
Telangana,Kamareddy,Low Vision,0,6,2,1,3
Telangana,Kamareddy,Low Vision,6,15,41,36,77
Telangana,Kamareddy,Low Vision,15,35,346,233,579
Telangana,Kamareddy,Low Vision,35,60,802,523,1325
Telangana,Kamareddy,Low Vision,60,80,691,450,1141
Telangana,Kamareddy,Low Vision,80,100,94,73,167
Tamil Nadu,Kallakurichi,Low Vision,0,6,7,3,10
Tamil Nadu,Kallakurichi,Low Vision,6,15,35,27,62
Tamil Nadu,Kallakurichi,Low Vision,15,35,64,44,108
Tamil Nadu,Kallakurichi,Low Vision,35,60,120,69,189
Tamil Nadu,Kallakurichi,Low Vision,60,80,64,52,116
Tamil Nadu,Kallakurichi,Low Vision,80,100,10,4,14
Odisha,Kalahandi,Low Vision,0,6,15,11,26
Odisha,Kalahandi,Low Vision,6,15,125,75,200
Odisha,Kalahandi,Low Vision,15,35,279,138,417
Odisha,Kalahandi,Low Vision,35,60,306,172,478
Odisha,Kalahandi,Low Vision,60,80,97,37,134
Odisha,Kalahandi,Low Vision,80,100,3,3,6
Karnataka,Kalaburagi,Low Vision,0,6,3,3,6
Karnataka,Kalaburagi,Low Vision,6,15,48,36,84
Karnataka,Kalaburagi,Low Vision,15,35,193,102,295
Karnataka,Kalaburagi,Low Vision,35,60,186,82,268
Karnataka,Kalaburagi,Low Vision,60,80,46,11,57
Karnataka,Kalaburagi,Low Vision,80,100,2,1,3
Manipur,Kakching,Low Vision,6,15,1,2,3
Manipur,Kakching,Low Vision,15,35,1,2,3
Manipur,Kakching,Low Vision,35,60,1,2,3
Manipur,Kakching,Low Vision,60,80,0,1,1
Haryana,Kaithal,Low Vision,0,6,0,1,1
Haryana,Kaithal,Low Vision,6,15,7,3,10
Haryana,Kaithal,Low Vision,15,35,40,24,64
Haryana,Kaithal,Low Vision,35,60,46,28,74
Haryana,Kaithal,Low Vision,60,80,2,3,5
Bihar,Kaimur (Bhabua),Low Vision,0,6,6,3,9
Bihar,Kaimur (Bhabua),Low Vision,6,15,36,20,56
Bihar,Kaimur (Bhabua),Low Vision,15,35,86,32,118
Bihar,Kaimur (Bhabua),Low Vision,35,60,50,35,85
Bihar,Kaimur (Bhabua),Low Vision,60,80,18,13,31
Gujarat,Kachchh,Low Vision,0,6,0,1,1
Gujarat,Kachchh,Low Vision,6,15,33,22,55
Gujarat,Kachchh,Low Vision,15,35,92,36,128
Gujarat,Kachchh,Low Vision,35,60,34,6,40
Gujarat,Kachchh,Low Vision,60,80,7,3,10
Chhattisgarh,Kabirdham,Low Vision,0,6,2,2,4
Chhattisgarh,Kabirdham,Low Vision,6,15,17,6,23
Chhattisgarh,Kabirdham,Low Vision,15,35,87,28,115
Chhattisgarh,Kabirdham,Low Vision,35,60,64,23,87
Chhattisgarh,Kabirdham,Low Vision,60,80,19,7,26
Chhattisgarh,Kabirdham,Low Vision,80,100,1,0,1
Gujarat,Junagadh,Low Vision,0,6,2,2,4
Gujarat,Junagadh,Low Vision,6,15,38,27,65
Gujarat,Junagadh,Low Vision,15,35,80,36,116
Gujarat,Junagadh,Low Vision,35,60,43,25,68
Gujarat,Junagadh,Low Vision,60,80,22,4,26
Gujarat,Junagadh,Low Vision,80,100,3,0,3
Assam,Jorhat,Low Vision,0,6,2,1,3
Assam,Jorhat,Low Vision,6,15,9,8,17
Assam,Jorhat,Low Vision,15,35,59,32,91
Assam,Jorhat,Low Vision,35,60,57,30,87
Assam,Jorhat,Low Vision,60,80,9,3,12
Telangana,Jogulamba Gadwal,Low Vision,0,6,0,2,2
Telangana,Jogulamba Gadwal,Low Vision,6,15,13,14,27
Telangana,Jogulamba Gadwal,Low Vision,15,35,114,98,212
Telangana,Jogulamba Gadwal,Low Vision,35,60,231,184,415
Telangana,Jogulamba Gadwal,Low Vision,60,80,183,136,319
Telangana,Jogulamba Gadwal,Low Vision,80,100,30,13,43
Rajasthan,Jodhpur,Low Vision,0,6,1,1,2
Rajasthan,Jodhpur,Low Vision,6,15,20,15,35
Rajasthan,Jodhpur,Low Vision,15,35,94,26,120
Rajasthan,Jodhpur,Low Vision,35,60,60,18,78
Rajasthan,Jodhpur,Low Vision,60,80,22,3,25
Rajasthan,Jodhpur,Low Vision,80,100,0,1,1
Haryana,Jind,Low Vision,6,15,8,4,12
Haryana,Jind,Low Vision,15,35,39,15,54
Haryana,Jind,Low Vision,35,60,16,7,23
Haryana,Jind,Low Vision,60,80,1,0,1
Rajasthan,Jhunjhunu,Low Vision,0,6,2,0,2
Rajasthan,Jhunjhunu,Low Vision,6,15,19,10,29
Rajasthan,Jhunjhunu,Low Vision,15,35,63,35,98
Rajasthan,Jhunjhunu,Low Vision,35,60,63,14,77
Rajasthan,Jhunjhunu,Low Vision,60,80,21,16,37
Rajasthan,Jhunjhunu,Low Vision,80,100,2,3,5
Odisha,Jharsuguda,Low Vision,0,6,1,0,1
Odisha,Jharsuguda,Low Vision,6,15,16,17,33
Odisha,Jharsuguda,Low Vision,15,35,84,41,125
Odisha,Jharsuguda,Low Vision,35,60,82,41,123
Odisha,Jharsuguda,Low Vision,60,80,34,21,55
Odisha,Jharsuguda,Low Vision,80,100,2,2,4
Uttar Pradesh,Jhansi,Low Vision,6,15,9,10,19
Uttar Pradesh,Jhansi,Low Vision,15,35,185,43,228
Uttar Pradesh,Jhansi,Low Vision,35,60,79,23,102
Uttar Pradesh,Jhansi,Low Vision,60,80,17,5,22
Rajasthan,Jhalawar,Low Vision,6,15,1,0,1
Rajasthan,Jhalawar,Low Vision,15,35,30,15,45
Rajasthan,Jhalawar,Low Vision,35,60,31,20,51
Rajasthan,Jhalawar,Low Vision,60,80,16,1,17
Rajasthan,Jhalawar,Low Vision,80,100,1,1,2
Haryana,Jhajjar,Low Vision,6,15,5,4,9
Haryana,Jhajjar,Low Vision,15,35,39,12,51
Haryana,Jhajjar,Low Vision,35,60,24,9,33
Haryana,Jhajjar,Low Vision,60,80,2,2,4
Haryana,Jhajjar,Low Vision,80,100,0,1,1
Madhya Pradesh,Jhabua,Low Vision,0,6,1,0,1
Madhya Pradesh,Jhabua,Low Vision,6,15,23,17,40
Madhya Pradesh,Jhabua,Low Vision,15,35,112,76,188
Madhya Pradesh,Jhabua,Low Vision,35,60,113,57,170
Madhya Pradesh,Jhabua,Low Vision,60,80,42,9,51
Madhya Pradesh,Jhabua,Low Vision,80,100,1,0,1
Bihar,Jehanabad,Low Vision,0,6,3,6,9
Bihar,Jehanabad,Low Vision,6,15,68,51,119
Bihar,Jehanabad,Low Vision,15,35,102,31,133
Bihar,Jehanabad,Low Vision,35,60,29,22,51
Bihar,Jehanabad,Low Vision,60,80,18,5,23
Bihar,Jehanabad,Low Vision,80,100,3,1,4
Telangana,Jayashankar Bhupalapally,Low Vision,6,15,20,12,32
Telangana,Jayashankar Bhupalapally,Low Vision,15,35,217,173,390
Telangana,Jayashankar Bhupalapally,Low Vision,35,60,438,334,772
Telangana,Jayashankar Bhupalapally,Low Vision,60,80,374,304,678
Telangana,Jayashankar Bhupalapally,Low Vision,80,100,65,49,114
Uttar Pradesh,Jaunpur,Low Vision,0,6,3,3,6
Uttar Pradesh,Jaunpur,Low Vision,6,15,48,17,65
Uttar Pradesh,Jaunpur,Low Vision,15,35,813,407,1220
Uttar Pradesh,Jaunpur,Low Vision,35,60,524,199,723
Uttar Pradesh,Jaunpur,Low Vision,60,80,96,28,124
Uttar Pradesh,Jaunpur,Low Vision,80,100,3,1,4
Chhattisgarh,Jashpur,Low Vision,0,6,1,2,3
Chhattisgarh,Jashpur,Low Vision,6,15,28,28,56
Chhattisgarh,Jashpur,Low Vision,15,35,97,79,176
Chhattisgarh,Jashpur,Low Vision,35,60,83,39,122
Chhattisgarh,Jashpur,Low Vision,60,80,21,17,38
Chhattisgarh,Jashpur,Low Vision,80,100,1,0,1
Chhattisgarh,Janjgir-Champa,Low Vision,6,15,16,10,26
Chhattisgarh,Janjgir-Champa,Low Vision,15,35,87,45,132
Chhattisgarh,Janjgir-Champa,Low Vision,35,60,53,24,77
Chhattisgarh,Janjgir-Champa,Low Vision,60,80,14,5,19
Chhattisgarh,Janjgir-Champa,Low Vision,80,100,1,0,1
Telangana,Jangoan,Low Vision,6,15,11,11,22
Telangana,Jangoan,Low Vision,15,35,154,103,257
Telangana,Jangoan,Low Vision,35,60,400,327,727
Telangana,Jangoan,Low Vision,60,80,537,355,892
Telangana,Jangoan,Low Vision,80,100,145,59,204
Bihar,Jamui,Low Vision,0,6,0,2,2
Bihar,Jamui,Low Vision,6,15,26,27,53
Bihar,Jamui,Low Vision,15,35,92,29,121
Bihar,Jamui,Low Vision,35,60,54,39,93
Bihar,Jamui,Low Vision,60,80,14,12,26
Jharkhand,Jamtara,Low Vision,0,6,1,2,3
Jharkhand,Jamtara,Low Vision,6,15,9,7,16
Jharkhand,Jamtara,Low Vision,15,35,50,14,64
Jharkhand,Jamtara,Low Vision,35,60,45,11,56
Jharkhand,Jamtara,Low Vision,60,80,1,2,3
Jharkhand,Jamtara,Low Vision,80,100,0,1,1
Gujarat,Jamnagar,Low Vision,6,15,13,10,23
Gujarat,Jamnagar,Low Vision,15,35,30,9,39
Gujarat,Jamnagar,Low Vision,35,60,38,5,43
Gujarat,Jamnagar,Low Vision,60,80,24,1,25
Gujarat,Jamnagar,Low Vision,80,100,5,2,7
Jammu And Kashmir,Jammu,Low Vision,0,6,4,2,6
Jammu And Kashmir,Jammu,Low Vision,6,15,33,18,51
Jammu And Kashmir,Jammu,Low Vision,15,35,175,95,270
Jammu And Kashmir,Jammu,Low Vision,35,60,243,117,360
Jammu And Kashmir,Jammu,Low Vision,60,80,79,29,108
Jammu And Kashmir,Jammu,Low Vision,80,100,11,3,14
Rajasthan,Jalore,Low Vision,0,6,0,1,1
Rajasthan,Jalore,Low Vision,6,15,24,12,36
Rajasthan,Jalore,Low Vision,15,35,100,46,146
Rajasthan,Jalore,Low Vision,35,60,175,100,275
Rajasthan,Jalore,Low Vision,60,80,87,42,129
Rajasthan,Jalore,Low Vision,80,100,7,5,12
Maharashtra,Jalna,Low Vision,0,6,1,2,3
Maharashtra,Jalna,Low Vision,6,15,4,4,8
Maharashtra,Jalna,Low Vision,15,35,18,15,33
Maharashtra,Jalna,Low Vision,35,60,25,19,44
Maharashtra,Jalna,Low Vision,60,80,25,19,44
Maharashtra,Jalna,Low Vision,80,100,4,0,4
Maharashtra,Jalgaon,Low Vision,0,6,17,16,33
Maharashtra,Jalgaon,Low Vision,6,15,186,86,272
Maharashtra,Jalgaon,Low Vision,15,35,636,239,875
Maharashtra,Jalgaon,Low Vision,35,60,705,322,1027
Maharashtra,Jalgaon,Low Vision,60,80,220,123,343
Maharashtra,Jalgaon,Low Vision,80,100,11,6,17
Uttar Pradesh,Jalaun,Low Vision,0,6,2,1,3
Uttar Pradesh,Jalaun,Low Vision,6,15,7,4,11
Uttar Pradesh,Jalaun,Low Vision,15,35,202,76,278
Uttar Pradesh,Jalaun,Low Vision,35,60,150,77,227
Uttar Pradesh,Jalaun,Low Vision,60,80,67,17,84
Uttar Pradesh,Jalaun,Low Vision,80,100,4,0,4
Punjab,Jalandhar,Low Vision,0,6,2,2,4
Punjab,Jalandhar,Low Vision,6,15,24,22,46
Punjab,Jalandhar,Low Vision,15,35,84,51,135
Punjab,Jalandhar,Low Vision,35,60,140,47,187
Punjab,Jalandhar,Low Vision,60,80,74,11,85
Punjab,Jalandhar,Low Vision,80,100,7,3,10
Odisha,Jajapur,Low Vision,0,6,9,6,15
Odisha,Jajapur,Low Vision,6,15,102,74,176
Odisha,Jajapur,Low Vision,15,35,374,207,581
Odisha,Jajapur,Low Vision,35,60,512,232,744
Odisha,Jajapur,Low Vision,60,80,136,72,208
Odisha,Jajapur,Low Vision,80,100,9,1,10
Rajasthan,Jaisalmer,Low Vision,6,15,3,0,3
Rajasthan,Jaisalmer,Low Vision,15,35,13,7,20
Rajasthan,Jaisalmer,Low Vision,35,60,11,2,13
Rajasthan,Jaisalmer,Low Vision,60,80,1,2,3
Rajasthan,Jaisalmer,Low Vision,80,100,0,1,1
Rajasthan,Jaipur,Low Vision,0,6,5,2,7
Rajasthan,Jaipur,Low Vision,6,15,41,24,65
Rajasthan,Jaipur,Low Vision,15,35,369,176,545
Rajasthan,Jaipur,Low Vision,35,60,183,57,240
Rajasthan,Jaipur,Low Vision,60,80,40,12,52
Rajasthan,Jaipur,Low Vision,80,100,2,0,2
Telangana,Jagitial,Low Vision,6,15,21,18,39
Telangana,Jagitial,Low Vision,15,35,117,90,207
Telangana,Jagitial,Low Vision,35,60,306,241,547
Telangana,Jagitial,Low Vision,60,80,368,289,657
Telangana,Jagitial,Low Vision,80,100,72,60,132
Odisha,Jagatsinghapur,Low Vision,0,6,4,1,5
Odisha,Jagatsinghapur,Low Vision,6,15,42,37,79
Odisha,Jagatsinghapur,Low Vision,15,35,149,72,221
Odisha,Jagatsinghapur,Low Vision,35,60,219,87,306
Odisha,Jagatsinghapur,Low Vision,60,80,47,23,70
Odisha,Jagatsinghapur,Low Vision,80,100,6,2,8
Madhya Pradesh,Jabalpur,Low Vision,0,6,2,0,2
Madhya Pradesh,Jabalpur,Low Vision,6,15,61,37,98
Madhya Pradesh,Jabalpur,Low Vision,15,35,285,200,485
Madhya Pradesh,Jabalpur,Low Vision,35,60,353,169,522
Madhya Pradesh,Jabalpur,Low Vision,60,80,129,43,172
Madhya Pradesh,Jabalpur,Low Vision,80,100,5,2,7
Madhya Pradesh,Indore,Low Vision,6,15,18,21,39
Madhya Pradesh,Indore,Low Vision,15,35,90,62,152
Madhya Pradesh,Indore,Low Vision,35,60,76,31,107
Madhya Pradesh,Indore,Low Vision,60,80,26,11,37
Madhya Pradesh,Indore,Low Vision,80,100,1,0,1
Manipur,Imphal West,Low Vision,6,15,5,0,5
Manipur,Imphal West,Low Vision,15,35,10,5,15
Manipur,Imphal West,Low Vision,35,60,4,4,8
Manipur,Imphal West,Low Vision,60,80,2,2,4
Manipur,Imphal West,Low Vision,80,100,1,1,2
Manipur,Imphal East,Low Vision,6,15,1,1,2
Manipur,Imphal East,Low Vision,15,35,12,3,15
Manipur,Imphal East,Low Vision,35,60,5,2,7
Manipur,Imphal East,Low Vision,60,80,0,1,1
Kerala,Idukki,Low Vision,6,15,18,10,28
Kerala,Idukki,Low Vision,15,35,92,46,138
Kerala,Idukki,Low Vision,35,60,105,70,175
Kerala,Idukki,Low Vision,60,80,52,42,94
Kerala,Idukki,Low Vision,80,100,5,2,7
Telangana,Hyderabad,Low Vision,6,15,47,31,78
Telangana,Hyderabad,Low Vision,15,35,397,290,687
Telangana,Hyderabad,Low Vision,35,60,683,455,1138
Telangana,Hyderabad,Low Vision,60,80,366,180,546
Telangana,Hyderabad,Low Vision,80,100,45,42,87
West Bengal,Howrah,Low Vision,15,35,0,1,1
Punjab,Hoshiarpur,Low Vision,0,6,0,1,1
Punjab,Hoshiarpur,Low Vision,6,15,16,17,33
Punjab,Hoshiarpur,Low Vision,15,35,113,66,179
Punjab,Hoshiarpur,Low Vision,35,60,201,72,273
Punjab,Hoshiarpur,Low Vision,60,80,98,14,112
Punjab,Hoshiarpur,Low Vision,80,100,2,0,2
Assam,Hojai,Low Vision,0,6,6,1,7
Assam,Hojai,Low Vision,6,15,20,8,28
Assam,Hojai,Low Vision,15,35,71,52,123
Assam,Hojai,Low Vision,35,60,82,40,122
Assam,Hojai,Low Vision,60,80,22,16,38
Assam,Hojai,Low Vision,80,100,1,1,2
Mizoram,Hnahthial,Low Vision,35,60,4,1,5
Haryana,Hisar,Low Vision,6,15,7,5,12
Haryana,Hisar,Low Vision,15,35,58,23,81
Haryana,Hisar,Low Vision,35,60,45,14,59
Haryana,Hisar,Low Vision,60,80,10,4,14
Haryana,Hisar,Low Vision,80,100,0,2,2
Maharashtra,Hingoli,Low Vision,0,6,4,1,5
Maharashtra,Hingoli,Low Vision,6,15,61,47,108
Maharashtra,Hingoli,Low Vision,15,35,234,137,371
Maharashtra,Hingoli,Low Vision,35,60,223,96,319
Maharashtra,Hingoli,Low Vision,60,80,83,56,139
Maharashtra,Hingoli,Low Vision,80,100,6,3,9
Jharkhand,Hazaribagh,Low Vision,6,15,19,16,35
Jharkhand,Hazaribagh,Low Vision,15,35,68,37,105
Jharkhand,Hazaribagh,Low Vision,35,60,70,24,94
Jharkhand,Hazaribagh,Low Vision,60,80,4,1,5
Karnataka,Haveri,Low Vision,0,6,6,2,8
Karnataka,Haveri,Low Vision,6,15,45,22,67
Karnataka,Haveri,Low Vision,15,35,191,78,269
Karnataka,Haveri,Low Vision,35,60,214,105,319
Karnataka,Haveri,Low Vision,60,80,58,16,74
Uttar Pradesh,Hathras,Low Vision,0,6,1,0,1
Uttar Pradesh,Hathras,Low Vision,6,15,16,4,20
Uttar Pradesh,Hathras,Low Vision,15,35,85,27,112
Uttar Pradesh,Hathras,Low Vision,35,60,48,18,66
Uttar Pradesh,Hathras,Low Vision,60,80,24,3,27
Uttar Pradesh,Hathras,Low Vision,80,100,0,1,1
Karnataka,Hassan,Low Vision,0,6,2,3,5
Karnataka,Hassan,Low Vision,6,15,45,23,68
Karnataka,Hassan,Low Vision,15,35,205,130,335
Karnataka,Hassan,Low Vision,35,60,342,268,610
Karnataka,Hassan,Low Vision,60,80,111,56,167
Karnataka,Hassan,Low Vision,80,100,8,1,9
Uttarakhand,Haridwar,Low Vision,6,15,7,3,10
Uttarakhand,Haridwar,Low Vision,15,35,46,21,67
Uttarakhand,Haridwar,Low Vision,35,60,54,15,69
Uttarakhand,Haridwar,Low Vision,60,80,8,0,8
Uttar Pradesh,Hardoi,Low Vision,0,6,3,2,5
Uttar Pradesh,Hardoi,Low Vision,6,15,94,55,149
Uttar Pradesh,Hardoi,Low Vision,15,35,772,367,1139
Uttar Pradesh,Hardoi,Low Vision,35,60,717,270,987
Uttar Pradesh,Hardoi,Low Vision,60,80,283,60,343
Uttar Pradesh,Hardoi,Low Vision,80,100,13,2,15
Madhya Pradesh,Harda,Low Vision,6,15,11,10,21
Madhya Pradesh,Harda,Low Vision,15,35,168,103,271
Madhya Pradesh,Harda,Low Vision,35,60,176,69,245
Madhya Pradesh,Harda,Low Vision,60,80,104,45,149
Madhya Pradesh,Harda,Low Vision,80,100,13,12,25
Uttar Pradesh,Hapur,Low Vision,6,15,3,0,3
Uttar Pradesh,Hapur,Low Vision,15,35,30,12,42
Uttar Pradesh,Hapur,Low Vision,35,60,18,7,25
Uttar Pradesh,Hapur,Low Vision,60,80,7,3,10
Uttar Pradesh,Hapur,Low Vision,80,100,0,1,1
Rajasthan,Hanumangarh,Low Vision,0,6,0,2,2
Rajasthan,Hanumangarh,Low Vision,6,15,21,12,33
Rajasthan,Hanumangarh,Low Vision,15,35,93,44,137
Rajasthan,Hanumangarh,Low Vision,35,60,70,43,113
Rajasthan,Hanumangarh,Low Vision,60,80,20,9,29
Rajasthan,Hanumangarh,Low Vision,80,100,1,0,1
Telangana,Hanumakonda,Low Vision,0,6,0,1,1
Telangana,Hanumakonda,Low Vision,6,15,20,16,36
Telangana,Hanumakonda,Low Vision,15,35,254,188,442
Telangana,Hanumakonda,Low Vision,35,60,592,455,1047
Telangana,Hanumakonda,Low Vision,60,80,582,323,905
Telangana,Hanumakonda,Low Vision,80,100,145,74,219
Himachal Pradesh,Hamirpur,Low Vision,6,15,6,4,10
Himachal Pradesh,Hamirpur,Low Vision,15,35,35,23,58
Himachal Pradesh,Hamirpur,Low Vision,35,60,52,31,83
Himachal Pradesh,Hamirpur,Low Vision,60,80,38,8,46
Himachal Pradesh,Hamirpur,Low Vision,80,100,6,3,9
Uttar Pradesh,Hamirpur,Low Vision,6,15,7,6,13
Uttar Pradesh,Hamirpur,Low Vision,15,35,74,19,93
Uttar Pradesh,Hamirpur,Low Vision,35,60,99,20,119
Uttar Pradesh,Hamirpur,Low Vision,60,80,36,5,41
Uttar Pradesh,Hamirpur,Low Vision,80,100,2,0,2
Assam,Hailakandi,Low Vision,0,6,2,1,3
Assam,Hailakandi,Low Vision,6,15,17,15,32
Assam,Hailakandi,Low Vision,15,35,51,25,76
Assam,Hailakandi,Low Vision,35,60,44,15,59
Assam,Hailakandi,Low Vision,60,80,6,4,10
Sikkim,Gyalshing,Low Vision,6,15,6,8,14
Sikkim,Gyalshing,Low Vision,15,35,33,15,48
Sikkim,Gyalshing,Low Vision,35,60,20,12,32
Sikkim,Gyalshing,Low Vision,60,80,5,1,6
Sikkim,Gyalshing,Low Vision,80,100,1,0,1
Madhya Pradesh,Gwalior,Low Vision,0,6,0,1,1
Madhya Pradesh,Gwalior,Low Vision,6,15,20,14,34
Madhya Pradesh,Gwalior,Low Vision,15,35,118,38,156
Madhya Pradesh,Gwalior,Low Vision,35,60,50,21,71
Madhya Pradesh,Gwalior,Low Vision,60,80,15,6,21
Madhya Pradesh,Gwalior,Low Vision,80,100,4,3,7
Haryana,Gurugram,Low Vision,0,6,2,0,2
Haryana,Gurugram,Low Vision,6,15,9,23,32
Haryana,Gurugram,Low Vision,15,35,56,28,84
Haryana,Gurugram,Low Vision,35,60,30,5,35
Haryana,Gurugram,Low Vision,60,80,4,2,6
Haryana,Gurugram,Low Vision,80,100,1,0,1
Punjab,Gurdaspur,Low Vision,0,6,5,5,10
Punjab,Gurdaspur,Low Vision,6,15,40,35,75
Punjab,Gurdaspur,Low Vision,15,35,247,119,366
Punjab,Gurdaspur,Low Vision,35,60,437,182,619
Punjab,Gurdaspur,Low Vision,60,80,214,74,288
Punjab,Gurdaspur,Low Vision,80,100,16,10,26
Andhra Pradesh,Guntur,Low Vision,0,6,3,1,4
Andhra Pradesh,Guntur,Low Vision,6,15,23,12,35
Andhra Pradesh,Guntur,Low Vision,15,35,62,54,116
Andhra Pradesh,Guntur,Low Vision,35,60,248,122,370
Andhra Pradesh,Guntur,Low Vision,60,80,100,50,150
Andhra Pradesh,Guntur,Low Vision,80,100,4,1,5
Madhya Pradesh,Guna,Low Vision,0,6,3,5,8
Madhya Pradesh,Guna,Low Vision,6,15,53,43,96
Madhya Pradesh,Guna,Low Vision,15,35,208,102,310
Madhya Pradesh,Guna,Low Vision,35,60,198,87,285
Madhya Pradesh,Guna,Low Vision,60,80,66,40,106
Madhya Pradesh,Guna,Low Vision,80,100,3,0,3
Jharkhand,Gumla,Low Vision,0,6,1,0,1
Jharkhand,Gumla,Low Vision,6,15,21,13,34
Jharkhand,Gumla,Low Vision,15,35,69,53,122
Jharkhand,Gumla,Low Vision,35,60,100,44,144
Jharkhand,Gumla,Low Vision,60,80,24,15,39
Jharkhand,Gumla,Low Vision,80,100,2,1,3
Uttar Pradesh,Gorakhpur,Low Vision,0,6,0,1,1
Uttar Pradesh,Gorakhpur,Low Vision,6,15,33,21,54
Uttar Pradesh,Gorakhpur,Low Vision,15,35,323,149,472
Uttar Pradesh,Gorakhpur,Low Vision,35,60,245,93,338
Uttar Pradesh,Gorakhpur,Low Vision,60,80,48,15,63
Uttar Pradesh,Gorakhpur,Low Vision,80,100,3,0,3
Bihar,Gopalganj,Low Vision,0,6,14,15,29
Bihar,Gopalganj,Low Vision,6,15,142,113,255
Bihar,Gopalganj,Low Vision,15,35,258,141,399
Bihar,Gopalganj,Low Vision,35,60,136,76,212
Bihar,Gopalganj,Low Vision,60,80,27,7,34
Bihar,Gopalganj,Low Vision,80,100,1,0,1
Maharashtra,Gondia,Low Vision,0,6,7,6,13
Maharashtra,Gondia,Low Vision,6,15,79,56,135
Maharashtra,Gondia,Low Vision,15,35,265,123,388
Maharashtra,Gondia,Low Vision,35,60,200,95,295
Maharashtra,Gondia,Low Vision,60,80,31,14,45
Maharashtra,Gondia,Low Vision,80,100,0,1,1
Uttar Pradesh,Gonda,Low Vision,0,6,0,1,1
Uttar Pradesh,Gonda,Low Vision,6,15,8,8,16
Uttar Pradesh,Gonda,Low Vision,15,35,121,43,164
Uttar Pradesh,Gonda,Low Vision,35,60,87,38,125
Uttar Pradesh,Gonda,Low Vision,60,80,19,9,28
Uttar Pradesh,Gonda,Low Vision,80,100,2,0,2
Tripura,Gomati,Low Vision,0,6,2,1,3
Tripura,Gomati,Low Vision,6,15,32,14,46
Tripura,Gomati,Low Vision,15,35,95,59,154
Tripura,Gomati,Low Vision,35,60,122,61,183
Tripura,Gomati,Low Vision,60,80,16,13,29
Tripura,Gomati,Low Vision,80,100,1,1,2
Assam,Golaghat,Low Vision,0,6,3,2,5
Assam,Golaghat,Low Vision,6,15,27,12,39
Assam,Golaghat,Low Vision,15,35,70,43,113
Assam,Golaghat,Low Vision,35,60,53,34,87
Assam,Golaghat,Low Vision,60,80,10,3,13
Assam,Golaghat,Low Vision,80,100,1,0,1
Jharkhand,Godda,Low Vision,0,6,4,3,7
Jharkhand,Godda,Low Vision,6,15,26,36,62
Jharkhand,Godda,Low Vision,15,35,177,122,299
Jharkhand,Godda,Low Vision,35,60,145,96,241
Jharkhand,Godda,Low Vision,60,80,61,40,101
Jharkhand,Godda,Low Vision,80,100,14,9,23
Assam,Goalpara,Low Vision,0,6,7,4,11
Assam,Goalpara,Low Vision,6,15,29,35,64
Assam,Goalpara,Low Vision,15,35,136,133,269
Assam,Goalpara,Low Vision,35,60,161,139,300
Assam,Goalpara,Low Vision,60,80,40,42,82
Assam,Goalpara,Low Vision,80,100,7,6,13
Jharkhand,Giridih,Low Vision,0,6,2,0,2
Jharkhand,Giridih,Low Vision,6,15,37,34,71
Jharkhand,Giridih,Low Vision,15,35,128,67,195
Jharkhand,Giridih,Low Vision,35,60,123,51,174
Jharkhand,Giridih,Low Vision,60,80,19,8,27
Jharkhand,Giridih,Low Vision,80,100,2,0,2
Gujarat,Gir Somnath,Low Vision,0,6,2,2,4
Gujarat,Gir Somnath,Low Vision,6,15,37,26,63
Gujarat,Gir Somnath,Low Vision,15,35,89,43,132
Gujarat,Gir Somnath,Low Vision,35,60,36,7,43
Gujarat,Gir Somnath,Low Vision,60,80,14,2,16
Gujarat,Gir Somnath,Low Vision,80,100,1,0,1
Uttar Pradesh,Ghazipur,Low Vision,0,6,0,2,2
Uttar Pradesh,Ghazipur,Low Vision,6,15,60,43,103
Uttar Pradesh,Ghazipur,Low Vision,15,35,616,329,945
Uttar Pradesh,Ghazipur,Low Vision,35,60,426,222,648
Uttar Pradesh,Ghazipur,Low Vision,60,80,91,36,127
Uttar Pradesh,Ghazipur,Low Vision,80,100,5,0,5
Uttar Pradesh,Ghaziabad,Low Vision,0,6,0,3,3
Uttar Pradesh,Ghaziabad,Low Vision,6,15,21,7,28
Uttar Pradesh,Ghaziabad,Low Vision,15,35,80,50,130
Uttar Pradesh,Ghaziabad,Low Vision,35,60,46,36,82
Uttar Pradesh,Ghaziabad,Low Vision,60,80,23,8,31
Uttar Pradesh,Ghaziabad,Low Vision,80,100,3,1,4
Bihar,Gaya,Low Vision,6,15,26,18,44
Bihar,Gaya,Low Vision,15,35,125,41,166
Bihar,Gaya,Low Vision,35,60,43,13,56
Bihar,Gaya,Low Vision,60,80,4,1,5
Bihar,Gaya,Low Vision,80,100,1,0,1
Uttar Pradesh,Gautam Buddha Nagar,Low Vision,0,6,1,0,1
Uttar Pradesh,Gautam Buddha Nagar,Low Vision,6,15,5,8,13
Uttar Pradesh,Gautam Buddha Nagar,Low Vision,15,35,33,16,49
Uttar Pradesh,Gautam Buddha Nagar,Low Vision,35,60,41,14,55
Uttar Pradesh,Gautam Buddha Nagar,Low Vision,60,80,12,1,13
Uttar Pradesh,Gautam Buddha Nagar,Low Vision,80,100,1,0,1
Chhattisgarh,Gaurella Pendra Marwahi,Low Vision,6,15,2,1,3
Chhattisgarh,Gaurella Pendra Marwahi,Low Vision,15,35,2,2,4
Chhattisgarh,Gaurella Pendra Marwahi,Low Vision,35,60,0,3,3
Chhattisgarh,Gariyaband,Low Vision,0,6,5,5,10
Chhattisgarh,Gariyaband,Low Vision,6,15,51,36,87
Chhattisgarh,Gariyaband,Low Vision,15,35,87,41,128
Chhattisgarh,Gariyaband,Low Vision,35,60,43,25,68
Chhattisgarh,Gariyaband,Low Vision,60,80,12,10,22
Chhattisgarh,Gariyaband,Low Vision,80,100,0,1,1
Jharkhand,Garhwa,Low Vision,0,6,0,1,1
Jharkhand,Garhwa,Low Vision,6,15,24,20,44
Jharkhand,Garhwa,Low Vision,15,35,71,43,114
Jharkhand,Garhwa,Low Vision,35,60,64,36,100
Jharkhand,Garhwa,Low Vision,60,80,10,3,13
Odisha,Ganjam,Low Vision,0,6,8,7,15
Odisha,Ganjam,Low Vision,6,15,238,126,364
Odisha,Ganjam,Low Vision,15,35,860,447,1307
Odisha,Ganjam,Low Vision,35,60,1001,658,1659
Odisha,Ganjam,Low Vision,60,80,326,181,507
Odisha,Ganjam,Low Vision,80,100,11,5,16
Sikkim,Gangtok,Low Vision,6,15,6,8,14
Sikkim,Gangtok,Low Vision,15,35,32,20,52
Sikkim,Gangtok,Low Vision,35,60,21,27,48
Sikkim,Gangtok,Low Vision,60,80,5,3,8
Rajasthan,Ganganagar,Low Vision,0,6,0,1,1
Rajasthan,Ganganagar,Low Vision,6,15,17,17,34
Rajasthan,Ganganagar,Low Vision,15,35,140,73,213
Rajasthan,Ganganagar,Low Vision,35,60,122,55,177
Rajasthan,Ganganagar,Low Vision,60,80,30,9,39
Rajasthan,Ganganagar,Low Vision,80,100,5,3,8
Gujarat,Gandhinagar,Low Vision,0,6,1,0,1
Gujarat,Gandhinagar,Low Vision,6,15,3,4,7
Gujarat,Gandhinagar,Low Vision,15,35,22,10,32
Gujarat,Gandhinagar,Low Vision,35,60,7,0,7
Gujarat,Gandhinagar,Low Vision,80,100,1,0,1
Jammu And Kashmir,Ganderbal,Low Vision,0,6,1,2,3
Jammu And Kashmir,Ganderbal,Low Vision,6,15,23,19,42
Jammu And Kashmir,Ganderbal,Low Vision,15,35,84,84,168
Jammu And Kashmir,Ganderbal,Low Vision,35,60,98,67,165
Jammu And Kashmir,Ganderbal,Low Vision,60,80,12,11,23
Jammu And Kashmir,Ganderbal,Low Vision,80,100,2,0,2
Odisha,Gajapati,Low Vision,0,6,8,7,15
Odisha,Gajapati,Low Vision,6,15,75,66,141
Odisha,Gajapati,Low Vision,15,35,247,206,453
Odisha,Gajapati,Low Vision,35,60,552,420,972
Odisha,Gajapati,Low Vision,60,80,277,216,493
Odisha,Gajapati,Low Vision,80,100,15,8,23
Maharashtra,Gadchiroli,Low Vision,0,6,2,6,8
Maharashtra,Gadchiroli,Low Vision,6,15,53,42,95
Maharashtra,Gadchiroli,Low Vision,15,35,146,72,218
Maharashtra,Gadchiroli,Low Vision,35,60,146,76,222
Maharashtra,Gadchiroli,Low Vision,60,80,31,17,48
Maharashtra,Gadchiroli,Low Vision,80,100,0,1,1
Karnataka,Gadag,Low Vision,0,6,4,3,7
Karnataka,Gadag,Low Vision,6,15,75,68,143
Karnataka,Gadag,Low Vision,15,35,372,199,571
Karnataka,Gadag,Low Vision,35,60,453,236,689
Karnataka,Gadag,Low Vision,60,80,131,38,169
Karnataka,Gadag,Low Vision,80,100,5,1,6
Uttar Pradesh,Firozabad,Low Vision,0,6,0,2,2
Uttar Pradesh,Firozabad,Low Vision,6,15,28,18,46
Uttar Pradesh,Firozabad,Low Vision,15,35,210,69,279
Uttar Pradesh,Firozabad,Low Vision,35,60,169,56,225
Uttar Pradesh,Firozabad,Low Vision,60,80,54,19,73
Uttar Pradesh,Firozabad,Low Vision,80,100,1,1,2
Punjab,Ferozepur,Low Vision,0,6,2,2,4
Punjab,Ferozepur,Low Vision,6,15,26,16,42
Punjab,Ferozepur,Low Vision,15,35,57,39,96
Punjab,Ferozepur,Low Vision,35,60,47,22,69
Punjab,Ferozepur,Low Vision,60,80,12,3,15
Punjab,Ferozepur,Low Vision,80,100,1,0,1
Punjab,Fazilka,Low Vision,0,6,5,5,10
Punjab,Fazilka,Low Vision,6,15,49,46,95
Punjab,Fazilka,Low Vision,15,35,184,109,293
Punjab,Fazilka,Low Vision,35,60,181,66,247
Punjab,Fazilka,Low Vision,60,80,47,6,53
Punjab,Fazilka,Low Vision,80,100,4,1,5
Uttar Pradesh,Fatehpur,Low Vision,6,15,26,24,50
Uttar Pradesh,Fatehpur,Low Vision,15,35,188,89,277
Uttar Pradesh,Fatehpur,Low Vision,35,60,275,113,388
Uttar Pradesh,Fatehpur,Low Vision,60,80,159,35,194
Uttar Pradesh,Fatehpur,Low Vision,80,100,5,1,6
Punjab,Fatehgarh Sahib,Low Vision,0,6,1,1,2
Punjab,Fatehgarh Sahib,Low Vision,6,15,19,12,31
Punjab,Fatehgarh Sahib,Low Vision,15,35,70,45,115
Punjab,Fatehgarh Sahib,Low Vision,35,60,98,35,133
Punjab,Fatehgarh Sahib,Low Vision,60,80,35,10,45
Punjab,Fatehgarh Sahib,Low Vision,80,100,1,0,1
Haryana,Fatehabad,Low Vision,0,6,1,3,4
Haryana,Fatehabad,Low Vision,6,15,16,8,24
Haryana,Fatehabad,Low Vision,15,35,61,27,88
Haryana,Fatehabad,Low Vision,35,60,51,16,67
Haryana,Fatehabad,Low Vision,60,80,7,2,9
Haryana,Fatehabad,Low Vision,80,100,0,1,1
Uttar Pradesh,Farrukhabad,Low Vision,0,6,2,2,4
Uttar Pradesh,Farrukhabad,Low Vision,6,15,33,17,50
Uttar Pradesh,Farrukhabad,Low Vision,15,35,191,127,318
Uttar Pradesh,Farrukhabad,Low Vision,35,60,312,141,453
Uttar Pradesh,Farrukhabad,Low Vision,60,80,173,66,239
Uttar Pradesh,Farrukhabad,Low Vision,80,100,10,5,15
Punjab,Faridkot,Low Vision,0,6,2,0,2
Punjab,Faridkot,Low Vision,6,15,22,13,35
Punjab,Faridkot,Low Vision,15,35,60,28,88
Punjab,Faridkot,Low Vision,35,60,58,26,84
Punjab,Faridkot,Low Vision,60,80,26,12,38
Punjab,Faridkot,Low Vision,80,100,4,0,4
Haryana,Faridabad,Low Vision,6,15,1,1,2
Haryana,Faridabad,Low Vision,15,35,3,2,5
Haryana,Faridabad,Low Vision,35,60,3,0,3
Haryana,Faridabad,Low Vision,60,80,1,0,1
Uttar Pradesh,Etawah,Low Vision,0,6,2,0,2
Uttar Pradesh,Etawah,Low Vision,6,15,7,5,12
Uttar Pradesh,Etawah,Low Vision,15,35,71,23,94
Uttar Pradesh,Etawah,Low Vision,35,60,75,37,112
Uttar Pradesh,Etawah,Low Vision,60,80,37,9,46
Uttar Pradesh,Etawah,Low Vision,80,100,3,1,4
Uttar Pradesh,Etah,Low Vision,6,15,2,1,3
Uttar Pradesh,Etah,Low Vision,15,35,46,15,61
Uttar Pradesh,Etah,Low Vision,35,60,39,16,55
Uttar Pradesh,Etah,Low Vision,60,80,20,3,23
Uttar Pradesh,Etah,Low Vision,80,100,3,1,4
Tamil Nadu,Erode,Low Vision,0,6,0,2,2
Tamil Nadu,Erode,Low Vision,6,15,33,18,51
Tamil Nadu,Erode,Low Vision,15,35,77,64,141
Tamil Nadu,Erode,Low Vision,35,60,163,100,263
Tamil Nadu,Erode,Low Vision,60,80,71,40,111
Tamil Nadu,Erode,Low Vision,80,100,4,2,6
Kerala,Ernakulam,Low Vision,6,15,12,9,21
Kerala,Ernakulam,Low Vision,15,35,113,71,184
Kerala,Ernakulam,Low Vision,35,60,173,104,277
Kerala,Ernakulam,Low Vision,60,80,107,61,168
Kerala,Ernakulam,Low Vision,80,100,6,5,11
Meghalaya,Eastern West Khasi Hills,Low Vision,6,15,4,2,6
Meghalaya,Eastern West Khasi Hills,Low Vision,15,35,8,10,18
Meghalaya,Eastern West Khasi Hills,Low Vision,35,60,1,4,5
Meghalaya,Eastern West Khasi Hills,Low Vision,60,80,3,0,3
Meghalaya,Eastern West Khasi Hills,Low Vision,80,100,0,1,1
Jharkhand,East Singhbum,Low Vision,6,15,5,2,7
Jharkhand,East Singhbum,Low Vision,15,35,50,34,84
Jharkhand,East Singhbum,Low Vision,35,60,52,25,77
Jharkhand,East Singhbum,Low Vision,60,80,11,6,17
Jharkhand,East Singhbum,Low Vision,80,100,2,0,2
Arunachal Pradesh,East Siang,Low Vision,6,15,4,0,4
Arunachal Pradesh,East Siang,Low Vision,15,35,7,8,15
Arunachal Pradesh,East Siang,Low Vision,35,60,5,0,5
Madhya Pradesh,East Nimar,Low Vision,0,6,0,1,1
Madhya Pradesh,East Nimar,Low Vision,6,15,13,18,31
Madhya Pradesh,East Nimar,Low Vision,15,35,226,116,342
Madhya Pradesh,East Nimar,Low Vision,35,60,222,93,315
Madhya Pradesh,East Nimar,Low Vision,60,80,85,37,122
Madhya Pradesh,East Nimar,Low Vision,80,100,11,1,12
Meghalaya,East Khasi Hills,Low Vision,0,6,0,1,1
Meghalaya,East Khasi Hills,Low Vision,6,15,11,17,28
Meghalaya,East Khasi Hills,Low Vision,15,35,42,41,83
Meghalaya,East Khasi Hills,Low Vision,35,60,28,23,51
Meghalaya,East Khasi Hills,Low Vision,60,80,8,5,13
Meghalaya,East Khasi Hills,Low Vision,80,100,3,2,5
Arunachal Pradesh,East Kameng,Low Vision,15,35,8,4,12
Arunachal Pradesh,East Kameng,Low Vision,35,60,3,1,4
Meghalaya,East Jaintia Hills,Low Vision,0,6,1,3,4
Meghalaya,East Jaintia Hills,Low Vision,6,15,14,10,24
Meghalaya,East Jaintia Hills,Low Vision,15,35,46,37,83
Meghalaya,East Jaintia Hills,Low Vision,35,60,29,29,58
Meghalaya,East Jaintia Hills,Low Vision,60,80,13,5,18
Meghalaya,East Jaintia Hills,Low Vision,80,100,1,0,1
Andhra Pradesh,East Godavari,Low Vision,0,6,5,1,6
Andhra Pradesh,East Godavari,Low Vision,6,15,29,27,56
Andhra Pradesh,East Godavari,Low Vision,15,35,126,72,198
Andhra Pradesh,East Godavari,Low Vision,35,60,349,158,507
Andhra Pradesh,East Godavari,Low Vision,60,80,147,53,200
Andhra Pradesh,East Godavari,Low Vision,80,100,3,6,9
Meghalaya,East Garo Hills,Low Vision,15,35,3,3,6
Meghalaya,East Garo Hills,Low Vision,35,60,1,2,3
Meghalaya,East Garo Hills,Low Vision,60,80,2,2,4
Delhi,East,Low Vision,0,6,1,3,4
Delhi,East,Low Vision,6,15,37,30,67
Delhi,East,Low Vision,15,35,52,38,90
Delhi,East,Low Vision,35,60,16,13,29
Delhi,East,Low Vision,60,80,6,3,9
Chhattisgarh,Durg,Low Vision,0,6,1,2,3
Chhattisgarh,Durg,Low Vision,6,15,17,17,34
Chhattisgarh,Durg,Low Vision,15,35,148,72,220
Chhattisgarh,Durg,Low Vision,35,60,92,29,121
Chhattisgarh,Durg,Low Vision,60,80,17,4,21
Chhattisgarh,Durg,Low Vision,80,100,2,1,3
Rajasthan,Dungarpur,Low Vision,0,6,1,1,2
Rajasthan,Dungarpur,Low Vision,6,15,6,11,17
Rajasthan,Dungarpur,Low Vision,15,35,31,23,54
Rajasthan,Dungarpur,Low Vision,35,60,21,11,32
Rajasthan,Dungarpur,Low Vision,60,80,9,5,14
Jharkhand,Dumka,Low Vision,0,6,4,4,8
Jharkhand,Dumka,Low Vision,6,15,58,38,96
Jharkhand,Dumka,Low Vision,15,35,144,100,244
Jharkhand,Dumka,Low Vision,35,60,136,109,245
Jharkhand,Dumka,Low Vision,60,80,22,13,35
Jharkhand,Dumka,Low Vision,80,100,1,0,1
Gujarat,Dohad,Low Vision,0,6,2,4,6
Gujarat,Dohad,Low Vision,6,15,141,131,272
Gujarat,Dohad,Low Vision,15,35,243,164,407
Gujarat,Dohad,Low Vision,35,60,111,40,151
Gujarat,Dohad,Low Vision,60,80,20,6,26
Jammu And Kashmir,Doda,Low Vision,0,6,9,14,23
Jammu And Kashmir,Doda,Low Vision,6,15,79,59,138
Jammu And Kashmir,Doda,Low Vision,15,35,264,163,427
Jammu And Kashmir,Doda,Low Vision,35,60,264,158,422
Jammu And Kashmir,Doda,Low Vision,60,80,79,42,121
Jammu And Kashmir,Doda,Low Vision,80,100,16,4,20
Dadra Nagar Haveli And Daman And Diu,Diu,Low Vision,6,15,1,6,7
Dadra Nagar Haveli And Daman And Diu,Diu,Low Vision,15,35,3,8,11
Dadra Nagar Haveli And Daman And Diu,Diu,Low Vision,35,60,2,5,7
Madhya Pradesh,Dindori,Low Vision,6,15,6,9,15
Madhya Pradesh,Dindori,Low Vision,15,35,50,25,75
Madhya Pradesh,Dindori,Low Vision,35,60,55,20,75
Madhya Pradesh,Dindori,Low Vision,60,80,6,4,10
Tamil Nadu,Dindigul,Low Vision,0,6,3,1,4
Tamil Nadu,Dindigul,Low Vision,6,15,28,35,63
Tamil Nadu,Dindigul,Low Vision,15,35,127,68,195
Tamil Nadu,Dindigul,Low Vision,35,60,115,87,202
Tamil Nadu,Dindigul,Low Vision,60,80,68,40,108
Tamil Nadu,Dindigul,Low Vision,80,100,7,1,8
Nagaland,Dimapur,Low Vision,15,35,1,2,3
Nagaland,Dimapur,Low Vision,35,60,1,0,1
Assam,Dima Hasao,Low Vision,6,15,1,0,1
Assam,Dima Hasao,Low Vision,15,35,5,7,12
Assam,Dima Hasao,Low Vision,35,60,3,3,6
Assam,Dima Hasao,Low Vision,60,80,0,1,1
Assam,Dibrugarh,Low Vision,6,15,3,5,8
Assam,Dibrugarh,Low Vision,15,35,18,11,29
Assam,Dibrugarh,Low Vision,35,60,19,4,23
Assam,Dibrugarh,Low Vision,60,80,4,1,5
Maharashtra,Dhule,Low Vision,0,6,9,4,13
Maharashtra,Dhule,Low Vision,6,15,100,74,174
Maharashtra,Dhule,Low Vision,15,35,455,166,621
Maharashtra,Dhule,Low Vision,35,60,540,242,782
Maharashtra,Dhule,Low Vision,60,80,180,77,257
Maharashtra,Dhule,Low Vision,80,100,5,2,7
Assam,Dhubri,Low Vision,0,6,5,2,7
Assam,Dhubri,Low Vision,6,15,19,16,35
Assam,Dhubri,Low Vision,15,35,72,50,122
Assam,Dhubri,Low Vision,35,60,77,48,125
Assam,Dhubri,Low Vision,60,80,22,4,26
Assam,Dhubri,Low Vision,80,100,1,0,1
Rajasthan,Dholpur,Low Vision,6,15,1,0,1
Rajasthan,Dholpur,Low Vision,15,35,14,5,19
Rajasthan,Dholpur,Low Vision,35,60,8,1,9
Odisha,Dhenkanal,Low Vision,0,6,1,2,3
Odisha,Dhenkanal,Low Vision,6,15,110,54,164
Odisha,Dhenkanal,Low Vision,15,35,218,118,336
Odisha,Dhenkanal,Low Vision,35,60,294,123,417
Odisha,Dhenkanal,Low Vision,60,80,88,22,110
Odisha,Dhenkanal,Low Vision,80,100,3,0,3
Assam,Dhemaji,Low Vision,0,6,1,0,1
Assam,Dhemaji,Low Vision,6,15,11,3,14
Assam,Dhemaji,Low Vision,15,35,20,20,40
Assam,Dhemaji,Low Vision,35,60,31,13,44
Assam,Dhemaji,Low Vision,60,80,10,7,17
Karnataka,Dharwad,Low Vision,0,6,6,6,12
Karnataka,Dharwad,Low Vision,6,15,92,62,154
Karnataka,Dharwad,Low Vision,15,35,296,237,533
Karnataka,Dharwad,Low Vision,35,60,531,395,926
Karnataka,Dharwad,Low Vision,60,80,128,46,174
Karnataka,Dharwad,Low Vision,80,100,9,1,10
Tamil Nadu,Dharmapuri,Low Vision,0,6,2,3,5
Tamil Nadu,Dharmapuri,Low Vision,6,15,18,12,30
Tamil Nadu,Dharmapuri,Low Vision,15,35,58,26,84
Tamil Nadu,Dharmapuri,Low Vision,35,60,94,55,149
Tamil Nadu,Dharmapuri,Low Vision,60,80,43,26,69
Tamil Nadu,Dharmapuri,Low Vision,80,100,2,2,4
Madhya Pradesh,Dhar,Low Vision,0,6,1,2,3
Madhya Pradesh,Dhar,Low Vision,6,15,31,11,42
Madhya Pradesh,Dhar,Low Vision,15,35,183,98,281
Madhya Pradesh,Dhar,Low Vision,35,60,157,77,234
Madhya Pradesh,Dhar,Low Vision,60,80,58,31,89
Madhya Pradesh,Dhar,Low Vision,80,100,4,2,6
Jharkhand,Dhanbad,Low Vision,6,15,3,4,7
Jharkhand,Dhanbad,Low Vision,15,35,68,27,95
Jharkhand,Dhanbad,Low Vision,35,60,46,27,73
Jharkhand,Dhanbad,Low Vision,60,80,8,3,11
Jharkhand,Dhanbad,Low Vision,80,100,1,0,1
Chhattisgarh,Dhamtari,Low Vision,0,6,1,0,1
Chhattisgarh,Dhamtari,Low Vision,6,15,9,11,20
Chhattisgarh,Dhamtari,Low Vision,15,35,53,21,74
Chhattisgarh,Dhamtari,Low Vision,35,60,24,16,40
Chhattisgarh,Dhamtari,Low Vision,60,80,9,5,14
Chhattisgarh,Dhamtari,Low Vision,80,100,2,0,2
Tripura,Dhalai,Low Vision,6,15,1,0,1
Tripura,Dhalai,Low Vision,15,35,6,3,9
Tripura,Dhalai,Low Vision,35,60,5,3,8
Tripura,Dhalai,Low Vision,60,80,5,4,9
Tripura,Dhalai,Low Vision,80,100,2,0,2
Madhya Pradesh,Dewas,Low Vision,0,6,1,1,2
Madhya Pradesh,Dewas,Low Vision,6,15,21,14,35
Madhya Pradesh,Dewas,Low Vision,15,35,213,90,303
Madhya Pradesh,Dewas,Low Vision,35,60,186,91,277
Madhya Pradesh,Dewas,Low Vision,60,80,95,28,123
Madhya Pradesh,Dewas,Low Vision,80,100,5,2,7
Gujarat,Devbhumi Dwarka,Low Vision,6,15,1,0,1
Gujarat,Devbhumi Dwarka,Low Vision,15,35,3,2,5
Gujarat,Devbhumi Dwarka,Low Vision,35,60,1,0,1
Uttar Pradesh,Deoria,Low Vision,0,6,3,1,4
Uttar Pradesh,Deoria,Low Vision,6,15,43,28,71
Uttar Pradesh,Deoria,Low Vision,15,35,444,218,662
Uttar Pradesh,Deoria,Low Vision,35,60,275,127,402
Uttar Pradesh,Deoria,Low Vision,60,80,53,14,67
Uttar Pradesh,Deoria,Low Vision,80,100,5,0,5
Jharkhand,Deoghar,Low Vision,0,6,2,0,2
Jharkhand,Deoghar,Low Vision,6,15,13,9,22
Jharkhand,Deoghar,Low Vision,15,35,57,30,87
Jharkhand,Deoghar,Low Vision,35,60,48,13,61
Jharkhand,Deoghar,Low Vision,60,80,19,9,28
Jharkhand,Deoghar,Low Vision,80,100,1,0,1
Odisha,Deogarh,Low Vision,6,15,17,11,28
Odisha,Deogarh,Low Vision,15,35,44,15,59
Odisha,Deogarh,Low Vision,35,60,47,33,80
Odisha,Deogarh,Low Vision,60,80,19,8,27
Odisha,Deogarh,Low Vision,80,100,1,1,2
Uttarakhand,Dehradun,Low Vision,0,6,4,1,5
Uttarakhand,Dehradun,Low Vision,6,15,9,7,16
Uttarakhand,Dehradun,Low Vision,15,35,36,27,63
Uttarakhand,Dehradun,Low Vision,35,60,35,9,44
Uttarakhand,Dehradun,Low Vision,60,80,3,1,4
Karnataka,Davangere,Low Vision,0,6,6,2,8
Karnataka,Davangere,Low Vision,6,15,41,37,78
Karnataka,Davangere,Low Vision,15,35,132,91,223
Karnataka,Davangere,Low Vision,35,60,157,93,250
Karnataka,Davangere,Low Vision,60,80,26,6,32
Karnataka,Davangere,Low Vision,80,100,0,1,1
Rajasthan,Dausa,Low Vision,0,6,2,1,3
Rajasthan,Dausa,Low Vision,6,15,19,11,30
Rajasthan,Dausa,Low Vision,15,35,184,94,278
Rajasthan,Dausa,Low Vision,35,60,134,58,192
Rajasthan,Dausa,Low Vision,60,80,27,10,37
Rajasthan,Dausa,Low Vision,80,100,2,1,3
Madhya Pradesh,Datia,Low Vision,0,6,1,1,2
Madhya Pradesh,Datia,Low Vision,6,15,28,24,52
Madhya Pradesh,Datia,Low Vision,15,35,99,56,155
Madhya Pradesh,Datia,Low Vision,35,60,128,56,184
Madhya Pradesh,Datia,Low Vision,60,80,53,24,77
Madhya Pradesh,Datia,Low Vision,80,100,3,1,4
Assam,Darrang,Low Vision,0,6,2,1,3
Assam,Darrang,Low Vision,6,15,17,12,29
Assam,Darrang,Low Vision,15,35,77,40,117
Assam,Darrang,Low Vision,35,60,76,42,118
Assam,Darrang,Low Vision,60,80,25,11,36
Assam,Darrang,Low Vision,80,100,3,1,4
Bihar,Darbhanga,Low Vision,0,6,0,2,2
Bihar,Darbhanga,Low Vision,6,15,29,20,49
Bihar,Darbhanga,Low Vision,15,35,167,67,234
Bihar,Darbhanga,Low Vision,35,60,119,53,172
Bihar,Darbhanga,Low Vision,60,80,44,21,65
Bihar,Darbhanga,Low Vision,80,100,1,0,1
Chhattisgarh,Dantewada,Low Vision,0,6,1,2,3
Chhattisgarh,Dantewada,Low Vision,6,15,10,10,20
Chhattisgarh,Dantewada,Low Vision,15,35,57,25,82
Chhattisgarh,Dantewada,Low Vision,35,60,24,22,46
Chhattisgarh,Dantewada,Low Vision,60,80,12,14,26
Gujarat,Dang,Low Vision,0,6,1,0,1
Gujarat,Dang,Low Vision,6,15,13,7,20
Gujarat,Dang,Low Vision,15,35,14,11,25
Gujarat,Dang,Low Vision,35,60,4,1,5
Gujarat,Dang,Low Vision,60,80,2,0,2
Madhya Pradesh,Damoh,Low Vision,0,6,1,0,1
Madhya Pradesh,Damoh,Low Vision,6,15,9,16,25
Madhya Pradesh,Damoh,Low Vision,15,35,167,97,264
Madhya Pradesh,Damoh,Low Vision,35,60,170,66,236
Madhya Pradesh,Damoh,Low Vision,60,80,45,23,68
Madhya Pradesh,Damoh,Low Vision,80,100,3,1,4
Dadra Nagar Haveli And Daman And Diu,Daman,Low Vision,6,15,1,0,1
Dadra Nagar Haveli And Daman And Diu,Daman,Low Vision,15,35,2,5,7
Dadra Nagar Haveli And Daman And Diu,Daman,Low Vision,35,60,1,0,1
Dadra Nagar Haveli And Daman And Diu,Daman,Low Vision,60,80,1,0,1
Karnataka,Dakshina Kannada,Low Vision,0,6,0,1,1
Karnataka,Dakshina Kannada,Low Vision,6,15,53,39,92
Karnataka,Dakshina Kannada,Low Vision,15,35,160,93,253
Karnataka,Dakshina Kannada,Low Vision,35,60,229,123,352
Karnataka,Dakshina Kannada,Low Vision,60,80,102,51,153
Karnataka,Dakshina Kannada,Low Vision,80,100,7,2,9
Dadra Nagar Haveli And Daman And Diu,Dadra And Nagar Haveli,Low Vision,0,6,0,1,1
Dadra Nagar Haveli And Daman And Diu,Dadra And Nagar Haveli,Low Vision,6,15,10,11,21
Dadra Nagar Haveli And Daman And Diu,Dadra And Nagar Haveli,Low Vision,15,35,14,4,18
Dadra Nagar Haveli And Daman And Diu,Dadra And Nagar Haveli,Low Vision,35,60,8,1,9
Dadra Nagar Haveli And Daman And Diu,Dadra And Nagar Haveli,Low Vision,60,80,1,0,1
Odisha,Cuttack,Low Vision,0,6,11,2,13
Odisha,Cuttack,Low Vision,6,15,113,65,178
Odisha,Cuttack,Low Vision,15,35,242,134,376
Odisha,Cuttack,Low Vision,35,60,248,119,367
Odisha,Cuttack,Low Vision,60,80,51,28,79
Odisha,Cuttack,Low Vision,80,100,3,1,4
Tamil Nadu,Cuddalore,Low Vision,0,6,0,2,2
Tamil Nadu,Cuddalore,Low Vision,6,15,24,21,45
Tamil Nadu,Cuddalore,Low Vision,15,35,78,57,135
Tamil Nadu,Cuddalore,Low Vision,35,60,116,88,204
Tamil Nadu,Cuddalore,Low Vision,60,80,65,35,100
Tamil Nadu,Cuddalore,Low Vision,80,100,3,4,7
Tamil Nadu,Coimbatore,Low Vision,0,6,1,4,5
Tamil Nadu,Coimbatore,Low Vision,6,15,32,14,46
Tamil Nadu,Coimbatore,Low Vision,15,35,53,31,84
Tamil Nadu,Coimbatore,Low Vision,35,60,57,40,97
Tamil Nadu,Coimbatore,Low Vision,60,80,21,10,31
Tamil Nadu,Coimbatore,Low Vision,80,100,1,0,1
Rajasthan,Churu,Low Vision,0,6,0,1,1
Rajasthan,Churu,Low Vision,6,15,8,3,11
Rajasthan,Churu,Low Vision,15,35,60,17,77
Rajasthan,Churu,Low Vision,35,60,34,12,46
Rajasthan,Churu,Low Vision,60,80,5,0,5
Rajasthan,Churu,Low Vision,80,100,1,0,1
Manipur,Churachandpur,Low Vision,6,15,2,5,7
Manipur,Churachandpur,Low Vision,15,35,6,3,9
Manipur,Churachandpur,Low Vision,35,60,2,0,2
Manipur,Churachandpur,Low Vision,60,80,2,0,2
Manipur,Churachandpur,Low Vision,80,100,0,1,1
Rajasthan,Chittorgarh,Low Vision,6,15,5,0,5
Rajasthan,Chittorgarh,Low Vision,15,35,27,14,41
Rajasthan,Chittorgarh,Low Vision,35,60,35,11,46
Rajasthan,Chittorgarh,Low Vision,60,80,10,7,17
Rajasthan,Chittorgarh,Low Vision,80,100,1,0,1
Andhra Pradesh,Chittoor,Low Vision,6,15,69,47,116
Andhra Pradesh,Chittoor,Low Vision,15,35,439,321,760
Andhra Pradesh,Chittoor,Low Vision,35,60,980,607,1587
Andhra Pradesh,Chittoor,Low Vision,60,80,682,395,1077
Andhra Pradesh,Chittoor,Low Vision,80,100,148,97,245
Uttar Pradesh,Chitrakoot,Low Vision,0,6,2,0,2
Uttar Pradesh,Chitrakoot,Low Vision,6,15,31,23,54
Uttar Pradesh,Chitrakoot,Low Vision,15,35,199,79,278
Uttar Pradesh,Chitrakoot,Low Vision,35,60,142,60,202
Uttar Pradesh,Chitrakoot,Low Vision,60,80,34,11,45
Uttar Pradesh,Chitrakoot,Low Vision,80,100,2,0,2
Karnataka,Chitradurga,Low Vision,0,6,17,19,36
Karnataka,Chitradurga,Low Vision,6,15,240,185,425
Karnataka,Chitradurga,Low Vision,15,35,890,751,1641
Karnataka,Chitradurga,Low Vision,35,60,1604,1356,2960
Karnataka,Chitradurga,Low Vision,60,80,263,118,381
Karnataka,Chitradurga,Low Vision,80,100,7,1,8
Assam,Chirang,Low Vision,0,6,1,3,4
Assam,Chirang,Low Vision,6,15,16,4,20
Assam,Chirang,Low Vision,15,35,67,55,122
Assam,Chirang,Low Vision,35,60,75,51,126
Assam,Chirang,Low Vision,60,80,24,10,34
Assam,Chirang,Low Vision,80,100,3,2,5
Karnataka,Chikkamagaluru,Low Vision,0,6,0,1,1
Karnataka,Chikkamagaluru,Low Vision,6,15,19,8,27
Karnataka,Chikkamagaluru,Low Vision,15,35,82,52,134
Karnataka,Chikkamagaluru,Low Vision,35,60,109,52,161
Karnataka,Chikkamagaluru,Low Vision,60,80,29,11,40
Karnataka,Chikkamagaluru,Low Vision,80,100,5,1,6
Karnataka,Chikkaballapura,Low Vision,6,15,4,1,5
Karnataka,Chikkaballapura,Low Vision,15,35,16,11,27
Karnataka,Chikkaballapura,Low Vision,35,60,33,13,46
Karnataka,Chikkaballapura,Low Vision,60,80,5,2,7
Karnataka,Chikkaballapura,Low Vision,80,100,1,1,2
Gujarat,Chhotaudepur,Low Vision,6,15,33,30,63
Gujarat,Chhotaudepur,Low Vision,15,35,74,31,105
Gujarat,Chhotaudepur,Low Vision,35,60,32,18,50
Gujarat,Chhotaudepur,Low Vision,60,80,5,1,6
Madhya Pradesh,Chhindwara,Low Vision,6,15,34,29,63
Madhya Pradesh,Chhindwara,Low Vision,15,35,449,266,715
Madhya Pradesh,Chhindwara,Low Vision,35,60,518,274,792
Madhya Pradesh,Chhindwara,Low Vision,60,80,177,100,277
Madhya Pradesh,Chhindwara,Low Vision,80,100,11,5,16
Madhya Pradesh,Chhatarpur,Low Vision,0,6,2,5,7
Madhya Pradesh,Chhatarpur,Low Vision,6,15,40,26,66
Madhya Pradesh,Chhatarpur,Low Vision,15,35,251,119,370
Madhya Pradesh,Chhatarpur,Low Vision,35,60,194,67,261
Madhya Pradesh,Chhatarpur,Low Vision,60,80,55,15,70
Madhya Pradesh,Chhatarpur,Low Vision,80,100,2,0,2
Tamil Nadu,Chennai,Low Vision,0,6,0,1,1
Tamil Nadu,Chennai,Low Vision,6,15,16,14,30
Tamil Nadu,Chennai,Low Vision,15,35,107,47,154
Tamil Nadu,Chennai,Low Vision,35,60,65,24,89
Tamil Nadu,Chennai,Low Vision,60,80,25,2,27
Tamil Nadu,Chennai,Low Vision,80,100,1,2,3
Tamil Nadu,Chengalpattu,Low Vision,0,6,2,1,3
Tamil Nadu,Chengalpattu,Low Vision,6,15,23,18,41
Tamil Nadu,Chengalpattu,Low Vision,15,35,62,41,103
Tamil Nadu,Chengalpattu,Low Vision,35,60,65,62,127
Tamil Nadu,Chengalpattu,Low Vision,60,80,39,16,55
Jharkhand,Chatra,Low Vision,0,6,1,0,1
Jharkhand,Chatra,Low Vision,6,15,8,4,12
Jharkhand,Chatra,Low Vision,15,35,20,12,32
Jharkhand,Chatra,Low Vision,35,60,20,13,33
Jharkhand,Chatra,Low Vision,60,80,3,1,4
Haryana,Charki Dadri,Low Vision,0,6,0,1,1
Haryana,Charki Dadri,Low Vision,6,15,5,1,6
Haryana,Charki Dadri,Low Vision,15,35,13,6,19
Haryana,Charki Dadri,Low Vision,35,60,7,2,9
Haryana,Charki Dadri,Low Vision,60,80,1,0,1
Assam,Charaideo,Low Vision,0,6,0,3,3
Assam,Charaideo,Low Vision,6,15,10,14,24
Assam,Charaideo,Low Vision,15,35,49,35,84
Assam,Charaideo,Low Vision,35,60,37,24,61
Assam,Charaideo,Low Vision,60,80,11,3,14
Arunachal Pradesh,Changlang,Low Vision,15,35,4,0,4
Arunachal Pradesh,Changlang,Low Vision,35,60,1,0,1
Maharashtra,Chandrapur,Low Vision,0,6,1,0,1
Maharashtra,Chandrapur,Low Vision,6,15,4,11,15
Maharashtra,Chandrapur,Low Vision,15,35,31,16,47
Maharashtra,Chandrapur,Low Vision,35,60,32,8,40
Maharashtra,Chandrapur,Low Vision,60,80,4,0,4
Chandigarh,Chandigarh,Low Vision,0,6,1,0,1
Chandigarh,Chandigarh,Low Vision,6,15,12,18,30
Chandigarh,Chandigarh,Low Vision,15,35,105,51,156
Chandigarh,Chandigarh,Low Vision,35,60,65,24,89
Chandigarh,Chandigarh,Low Vision,60,80,19,8,27
Chandigarh,Chandigarh,Low Vision,80,100,3,1,4
Manipur,Chandel,Low Vision,15,35,0,2,2
Manipur,Chandel,Low Vision,35,60,0,1,1
Uttar Pradesh,Chandauli,Low Vision,6,15,11,7,18
Uttar Pradesh,Chandauli,Low Vision,15,35,116,62,178
Uttar Pradesh,Chandauli,Low Vision,35,60,74,43,117
Uttar Pradesh,Chandauli,Low Vision,60,80,15,5,20
Uttar Pradesh,Chandauli,Low Vision,80,100,1,1,2
Mizoram,Champhai,Low Vision,15,35,3,2,5
Mizoram,Champhai,Low Vision,35,60,1,2,3
Uttarakhand,Champawat,Low Vision,0,6,2,0,2
Uttarakhand,Champawat,Low Vision,6,15,4,2,6
Uttarakhand,Champawat,Low Vision,15,35,50,23,73
Uttarakhand,Champawat,Low Vision,35,60,59,27,86
Uttarakhand,Champawat,Low Vision,60,80,6,7,13
Uttarakhand,Champawat,Low Vision,80,100,0,1,1
Uttarakhand,Chamoli,Low Vision,0,6,1,2,3
Uttarakhand,Chamoli,Low Vision,6,15,11,6,17
Uttarakhand,Chamoli,Low Vision,15,35,63,34,97
Uttarakhand,Chamoli,Low Vision,35,60,97,48,145
Uttarakhand,Chamoli,Low Vision,60,80,29,14,43
Uttarakhand,Chamoli,Low Vision,80,100,1,2,3
Himachal Pradesh,Chamba,Low Vision,0,6,2,0,2
Himachal Pradesh,Chamba,Low Vision,6,15,21,13,34
Himachal Pradesh,Chamba,Low Vision,15,35,116,42,158
Himachal Pradesh,Chamba,Low Vision,35,60,115,46,161
Himachal Pradesh,Chamba,Low Vision,60,80,28,9,37
Himachal Pradesh,Chamba,Low Vision,80,100,3,0,3
Karnataka,Chamarajanagara,Low Vision,0,6,0,2,2
Karnataka,Chamarajanagara,Low Vision,6,15,36,33,69
Karnataka,Chamarajanagara,Low Vision,15,35,111,79,190
Karnataka,Chamarajanagara,Low Vision,35,60,204,134,338
Karnataka,Chamarajanagara,Low Vision,60,80,33,13,46
Karnataka,Chamarajanagara,Low Vision,80,100,2,0,2
Delhi,Central,Low Vision,0,6,0,1,1
Delhi,Central,Low Vision,6,15,8,8,16
Delhi,Central,Low Vision,15,35,21,15,36
Delhi,Central,Low Vision,35,60,11,11,22
Delhi,Central,Low Vision,60,80,7,0,7
Assam,Cachar,Low Vision,6,15,18,7,25
Assam,Cachar,Low Vision,15,35,51,20,71
Assam,Cachar,Low Vision,35,60,33,14,47
Assam,Cachar,Low Vision,60,80,6,4,10
Assam,Cachar,Low Vision,80,100,0,1,1
Bihar,Buxar,Low Vision,0,6,7,9,16
Bihar,Buxar,Low Vision,6,15,104,63,167
Bihar,Buxar,Low Vision,15,35,206,131,337
Bihar,Buxar,Low Vision,35,60,161,98,259
Bihar,Buxar,Low Vision,60,80,55,26,81
Bihar,Buxar,Low Vision,80,100,2,0,2
Madhya Pradesh,Burhanpur,Low Vision,0,6,0,1,1
Madhya Pradesh,Burhanpur,Low Vision,6,15,15,10,25
Madhya Pradesh,Burhanpur,Low Vision,15,35,54,53,107
Madhya Pradesh,Burhanpur,Low Vision,35,60,58,30,88
Madhya Pradesh,Burhanpur,Low Vision,60,80,4,7,11
Madhya Pradesh,Burhanpur,Low Vision,80,100,0,1,1
Rajasthan,Bundi,Low Vision,0,6,0,1,1
Rajasthan,Bundi,Low Vision,6,15,8,5,13
Rajasthan,Bundi,Low Vision,15,35,38,23,61
Rajasthan,Bundi,Low Vision,35,60,38,19,57
Rajasthan,Bundi,Low Vision,60,80,7,12,19
Rajasthan,Bundi,Low Vision,80,100,4,0,4
Maharashtra,Buldhana,Low Vision,0,6,11,12,23
Maharashtra,Buldhana,Low Vision,6,15,266,198,464
Maharashtra,Buldhana,Low Vision,15,35,1863,741,2604
Maharashtra,Buldhana,Low Vision,35,60,1666,782,2448
Maharashtra,Buldhana,Low Vision,60,80,664,292,956
Maharashtra,Buldhana,Low Vision,80,100,40,19,59
Uttar Pradesh,Bulandshahr,Low Vision,0,6,2,2,4
Uttar Pradesh,Bulandshahr,Low Vision,6,15,18,18,36
Uttar Pradesh,Bulandshahr,Low Vision,15,35,143,55,198
Uttar Pradesh,Bulandshahr,Low Vision,35,60,136,53,189
Uttar Pradesh,Bulandshahr,Low Vision,60,80,62,17,79
Uttar Pradesh,Bulandshahr,Low Vision,80,100,3,1,4
Jammu And Kashmir,Budgam,Low Vision,0,6,4,6,10
Jammu And Kashmir,Budgam,Low Vision,6,15,70,46,116
Jammu And Kashmir,Budgam,Low Vision,15,35,166,118,284
Jammu And Kashmir,Budgam,Low Vision,35,60,156,100,256
Jammu And Kashmir,Budgam,Low Vision,60,80,15,9,24
Jammu And Kashmir,Budgam,Low Vision,80,100,4,1,5
Uttar Pradesh,Budaun,Low Vision,0,6,1,1,2
Uttar Pradesh,Budaun,Low Vision,6,15,39,24,63
Uttar Pradesh,Budaun,Low Vision,15,35,414,188,602
Uttar Pradesh,Budaun,Low Vision,35,60,469,144,613
Uttar Pradesh,Budaun,Low Vision,60,80,124,60,184
Uttar Pradesh,Budaun,Low Vision,80,100,5,2,7
Odisha,Boudh,Low Vision,0,6,5,7,12
Odisha,Boudh,Low Vision,6,15,79,43,122
Odisha,Boudh,Low Vision,15,35,125,75,200
Odisha,Boudh,Low Vision,35,60,83,37,120
Odisha,Boudh,Low Vision,60,80,32,8,40
Odisha,Boudh,Low Vision,80,100,2,0,2
Gujarat,Botad,Low Vision,0,6,1,0,1
Gujarat,Botad,Low Vision,6,15,45,29,74
Gujarat,Botad,Low Vision,15,35,61,38,99
Gujarat,Botad,Low Vision,35,60,64,18,82
Gujarat,Botad,Low Vision,60,80,31,8,39
Gujarat,Botad,Low Vision,80,100,1,0,1
Assam,Bongaigaon,Low Vision,0,6,2,0,2
Assam,Bongaigaon,Low Vision,6,15,9,6,15
Assam,Bongaigaon,Low Vision,15,35,49,32,81
Assam,Bongaigaon,Low Vision,35,60,47,27,74
Assam,Bongaigaon,Low Vision,60,80,11,5,16
Jharkhand,Bokaro,Low Vision,0,6,2,3,5
Jharkhand,Bokaro,Low Vision,6,15,26,24,50
Jharkhand,Bokaro,Low Vision,15,35,245,151,396
Jharkhand,Bokaro,Low Vision,35,60,254,100,354
Jharkhand,Bokaro,Low Vision,60,80,53,22,75
Jharkhand,Bokaro,Low Vision,80,100,5,1,6
Assam,Biswanath,Low Vision,0,6,1,0,1
Assam,Biswanath,Low Vision,6,15,4,8,12
Assam,Biswanath,Low Vision,15,35,18,12,30
Assam,Biswanath,Low Vision,35,60,21,15,36
Assam,Biswanath,Low Vision,60,80,1,0,1
Manipur,Bishnupur,Low Vision,6,15,1,2,3
Manipur,Bishnupur,Low Vision,15,35,2,1,3
Manipur,Bishnupur,Low Vision,35,60,4,3,7
Manipur,Bishnupur,Low Vision,60,80,2,2,4
West Bengal,Birbhum,Low Vision,0,6,1,0,1
Chhattisgarh,Bilaspur,Low Vision,0,6,1,0,1
Chhattisgarh,Bilaspur,Low Vision,6,15,34,34,68
Chhattisgarh,Bilaspur,Low Vision,15,35,178,109,287
Chhattisgarh,Bilaspur,Low Vision,35,60,115,39,154
Chhattisgarh,Bilaspur,Low Vision,60,80,25,8,33
Chhattisgarh,Bilaspur,Low Vision,80,100,3,1,4
Himachal Pradesh,Bilaspur,Low Vision,0,6,0,1,1
Himachal Pradesh,Bilaspur,Low Vision,6,15,11,2,13
Himachal Pradesh,Bilaspur,Low Vision,15,35,62,33,95
Himachal Pradesh,Bilaspur,Low Vision,35,60,81,23,104
Himachal Pradesh,Bilaspur,Low Vision,60,80,32,9,41
Himachal Pradesh,Bilaspur,Low Vision,80,100,3,1,4
Rajasthan,Bikaner,Low Vision,6,15,6,5,11
Rajasthan,Bikaner,Low Vision,15,35,48,40,88
Rajasthan,Bikaner,Low Vision,35,60,35,9,44
Rajasthan,Bikaner,Low Vision,60,80,3,2,5
Rajasthan,Bikaner,Low Vision,80,100,2,0,2
Uttar Pradesh,Bijnor,Low Vision,6,15,18,5,23
Uttar Pradesh,Bijnor,Low Vision,15,35,80,35,115
Uttar Pradesh,Bijnor,Low Vision,35,60,68,19,87
Uttar Pradesh,Bijnor,Low Vision,60,80,34,7,41
Uttar Pradesh,Bijnor,Low Vision,80,100,2,0,2
Chhattisgarh,Bijapur,Low Vision,0,6,0,1,1
Chhattisgarh,Bijapur,Low Vision,6,15,25,22,47
Chhattisgarh,Bijapur,Low Vision,15,35,61,51,112
Chhattisgarh,Bijapur,Low Vision,35,60,66,67,133
Chhattisgarh,Bijapur,Low Vision,60,80,29,51,80
Chhattisgarh,Bijapur,Low Vision,80,100,2,4,6
Karnataka,Bidar,Low Vision,0,6,2,1,3
Karnataka,Bidar,Low Vision,6,15,21,18,39
Karnataka,Bidar,Low Vision,15,35,87,42,129
Karnataka,Bidar,Low Vision,35,60,65,42,107
Karnataka,Bidar,Low Vision,60,80,31,6,37
Karnataka,Bidar,Low Vision,80,100,3,1,4
Madhya Pradesh,Bhopal,Low Vision,0,6,1,1,2
Madhya Pradesh,Bhopal,Low Vision,6,15,32,27,59
Madhya Pradesh,Bhopal,Low Vision,15,35,287,164,451
Madhya Pradesh,Bhopal,Low Vision,35,60,192,97,289
Madhya Pradesh,Bhopal,Low Vision,60,80,37,16,53
Madhya Pradesh,Bhopal,Low Vision,80,100,1,1,2
Bihar,Bhojpur,Low Vision,0,6,0,1,1
Bihar,Bhojpur,Low Vision,6,15,19,9,28
Bihar,Bhojpur,Low Vision,15,35,163,42,205
Bihar,Bhojpur,Low Vision,35,60,67,19,86
Bihar,Bhojpur,Low Vision,60,80,19,4,23
Bihar,Bhojpur,Low Vision,80,100,1,0,1
Haryana,Bhiwani,Low Vision,0,6,0,1,1
Haryana,Bhiwani,Low Vision,6,15,3,4,7
Haryana,Bhiwani,Low Vision,15,35,40,10,50
Haryana,Bhiwani,Low Vision,35,60,25,10,35
Haryana,Bhiwani,Low Vision,60,80,3,2,5
Haryana,Bhiwani,Low Vision,80,100,1,0,1
Madhya Pradesh,Bhind,Low Vision,0,6,0,2,2
Madhya Pradesh,Bhind,Low Vision,6,15,18,18,36
Madhya Pradesh,Bhind,Low Vision,15,35,188,100,288
Madhya Pradesh,Bhind,Low Vision,35,60,290,160,450
Madhya Pradesh,Bhind,Low Vision,60,80,203,91,294
Madhya Pradesh,Bhind,Low Vision,80,100,19,2,21
Rajasthan,Bhilwara,Low Vision,6,15,25,20,45
Rajasthan,Bhilwara,Low Vision,15,35,125,78,203
Rajasthan,Bhilwara,Low Vision,35,60,109,66,175
Rajasthan,Bhilwara,Low Vision,60,80,62,48,110
Rajasthan,Bhilwara,Low Vision,80,100,5,11,16
Gujarat,Bhavnagar,Low Vision,0,6,5,5,10
Gujarat,Bhavnagar,Low Vision,6,15,94,62,156
Gujarat,Bhavnagar,Low Vision,15,35,249,121,370
Gujarat,Bhavnagar,Low Vision,35,60,83,33,116
Gujarat,Bhavnagar,Low Vision,60,80,31,4,35
Gujarat,Bhavnagar,Low Vision,80,100,0,2,2
Gujarat,Bharuch,Low Vision,0,6,0,1,1
Gujarat,Bharuch,Low Vision,6,15,8,4,12
Gujarat,Bharuch,Low Vision,15,35,16,9,25
Gujarat,Bharuch,Low Vision,35,60,10,2,12
Gujarat,Bharuch,Low Vision,60,80,1,1,2
Gujarat,Bharuch,Low Vision,80,100,1,0,1
Rajasthan,Bharatpur,Low Vision,0,6,1,0,1
Rajasthan,Bharatpur,Low Vision,6,15,9,4,13
Rajasthan,Bharatpur,Low Vision,15,35,74,39,113
Rajasthan,Bharatpur,Low Vision,35,60,26,10,36
Rajasthan,Bharatpur,Low Vision,60,80,3,4,7
Maharashtra,Bhandara,Low Vision,0,6,7,2,9
Maharashtra,Bhandara,Low Vision,6,15,88,58,146
Maharashtra,Bhandara,Low Vision,15,35,282,127,409
Maharashtra,Bhandara,Low Vision,35,60,268,129,397
Maharashtra,Bhandara,Low Vision,60,80,58,26,84
Maharashtra,Bhandara,Low Vision,80,100,4,0,4
Bihar,Bhagalpur,Low Vision,0,6,16,22,38
Bihar,Bhagalpur,Low Vision,6,15,174,157,331
Bihar,Bhagalpur,Low Vision,15,35,257,136,393
Bihar,Bhagalpur,Low Vision,35,60,104,67,171
Bihar,Bhagalpur,Low Vision,60,80,12,1,13
Bihar,Bhagalpur,Low Vision,80,100,2,1,3
Odisha,Bhadrak,Low Vision,0,6,13,12,25
Odisha,Bhadrak,Low Vision,6,15,243,170,413
Odisha,Bhadrak,Low Vision,15,35,902,724,1626
Odisha,Bhadrak,Low Vision,35,60,717,455,1172
Odisha,Bhadrak,Low Vision,60,80,176,66,242
Odisha,Bhadrak,Low Vision,80,100,8,3,11
Telangana,Bhadradri Kothagudem,Low Vision,0,6,0,1,1
Telangana,Bhadradri Kothagudem,Low Vision,6,15,37,16,53
Telangana,Bhadradri Kothagudem,Low Vision,15,35,176,118,294
Telangana,Bhadradri Kothagudem,Low Vision,35,60,245,168,413
Telangana,Bhadradri Kothagudem,Low Vision,60,80,179,132,311
Telangana,Bhadradri Kothagudem,Low Vision,80,100,42,40,82
Uttar Pradesh,Bhadohi,Low Vision,0,6,0,1,1
Uttar Pradesh,Bhadohi,Low Vision,6,15,31,32,63
Uttar Pradesh,Bhadohi,Low Vision,15,35,257,194,451
Uttar Pradesh,Bhadohi,Low Vision,35,60,233,119,352
Uttar Pradesh,Bhadohi,Low Vision,60,80,72,31,103
Uttar Pradesh,Bhadohi,Low Vision,80,100,4,1,5
Madhya Pradesh,Betul,Low Vision,0,6,4,1,5
Madhya Pradesh,Betul,Low Vision,6,15,61,54,115
Madhya Pradesh,Betul,Low Vision,15,35,428,249,677
Madhya Pradesh,Betul,Low Vision,35,60,427,162,589
Madhya Pradesh,Betul,Low Vision,60,80,129,40,169
Madhya Pradesh,Betul,Low Vision,80,100,7,6,13
Karnataka,Bengaluru Urban,Low Vision,0,6,2,0,2
Karnataka,Bengaluru Urban,Low Vision,6,15,31,20,51
Karnataka,Bengaluru Urban,Low Vision,15,35,134,68,202
Karnataka,Bengaluru Urban,Low Vision,35,60,116,46,162
Karnataka,Bengaluru Urban,Low Vision,60,80,30,6,36
Karnataka,Bengaluru Urban,Low Vision,80,100,2,1,3
Karnataka,Bengaluru Rural,Low Vision,0,6,0,1,1
Karnataka,Bengaluru Rural,Low Vision,6,15,9,16,25
Karnataka,Bengaluru Rural,Low Vision,15,35,50,39,89
Karnataka,Bengaluru Rural,Low Vision,35,60,70,38,108
Karnataka,Bengaluru Rural,Low Vision,60,80,16,9,25
Karnataka,Bengaluru Rural,Low Vision,80,100,2,0,2
Chhattisgarh,Bemetara,Low Vision,6,15,2,4,6
Chhattisgarh,Bemetara,Low Vision,15,35,18,7,25
Chhattisgarh,Bemetara,Low Vision,35,60,9,5,14
Chhattisgarh,Bemetara,Low Vision,60,80,4,1,5
Karnataka,Belagavi,Low Vision,0,6,22,19,41
Karnataka,Belagavi,Low Vision,6,15,179,133,312
Karnataka,Belagavi,Low Vision,15,35,531,272,803
Karnataka,Belagavi,Low Vision,35,60,621,377,998
Karnataka,Belagavi,Low Vision,60,80,129,41,170
Karnataka,Belagavi,Low Vision,80,100,6,3,9
Bihar,Begusarai,Low Vision,0,6,19,19,38
Bihar,Begusarai,Low Vision,6,15,98,93,191
Bihar,Begusarai,Low Vision,15,35,141,57,198
Bihar,Begusarai,Low Vision,35,60,51,29,80
Bihar,Begusarai,Low Vision,60,80,12,6,18
Bihar,Begusarai,Low Vision,80,100,1,0,1
Maharashtra,Beed,Low Vision,0,6,5,4,9
Maharashtra,Beed,Low Vision,6,15,113,74,187
Maharashtra,Beed,Low Vision,15,35,511,202,713
Maharashtra,Beed,Low Vision,35,60,508,186,694
Maharashtra,Beed,Low Vision,60,80,273,107,380
Maharashtra,Beed,Low Vision,80,100,23,9,32
Punjab,Bathinda,Low Vision,0,6,4,2,6
Punjab,Bathinda,Low Vision,6,15,26,19,45
Punjab,Bathinda,Low Vision,15,35,44,34,78
Punjab,Bathinda,Low Vision,35,60,45,21,66
Punjab,Bathinda,Low Vision,60,80,8,4,12
Uttar Pradesh,Basti,Low Vision,6,15,8,4,12
Uttar Pradesh,Basti,Low Vision,15,35,79,30,109
Uttar Pradesh,Basti,Low Vision,35,60,59,23,82
Uttar Pradesh,Basti,Low Vision,60,80,16,5,21
Uttar Pradesh,Basti,Low Vision,80,100,1,0,1
Chhattisgarh,Bastar,Low Vision,0,6,7,3,10
Chhattisgarh,Bastar,Low Vision,6,15,34,63,97
Chhattisgarh,Bastar,Low Vision,15,35,118,73,191
Chhattisgarh,Bastar,Low Vision,35,60,99,43,142
Chhattisgarh,Bastar,Low Vision,60,80,40,10,50
Chhattisgarh,Bastar,Low Vision,80,100,2,2,4
Madhya Pradesh,Barwani,Low Vision,0,6,4,2,6
Madhya Pradesh,Barwani,Low Vision,6,15,51,37,88
Madhya Pradesh,Barwani,Low Vision,15,35,241,163,404
Madhya Pradesh,Barwani,Low Vision,35,60,230,123,353
Madhya Pradesh,Barwani,Low Vision,60,80,66,28,94
Madhya Pradesh,Barwani,Low Vision,80,100,6,9,15
Assam,Barpeta,Low Vision,0,6,4,3,7
Assam,Barpeta,Low Vision,6,15,29,29,58
Assam,Barpeta,Low Vision,15,35,138,81,219
Assam,Barpeta,Low Vision,35,60,142,92,234
Assam,Barpeta,Low Vision,60,80,21,10,31
Assam,Barpeta,Low Vision,80,100,1,1,2
Punjab,Barnala,Low Vision,0,6,0,1,1
Punjab,Barnala,Low Vision,6,15,22,3,25
Punjab,Barnala,Low Vision,15,35,68,42,110
Punjab,Barnala,Low Vision,35,60,130,46,176
Punjab,Barnala,Low Vision,60,80,52,9,61
Punjab,Barnala,Low Vision,80,100,1,0,1
Rajasthan,Barmer,Low Vision,0,6,0,3,3
Rajasthan,Barmer,Low Vision,6,15,26,8,34
Rajasthan,Barmer,Low Vision,15,35,88,34,122
Rajasthan,Barmer,Low Vision,35,60,109,37,146
Rajasthan,Barmer,Low Vision,60,80,22,6,28
Rajasthan,Barmer,Low Vision,80,100,2,2,4
Odisha,Bargarh,Low Vision,0,6,2,7,9
Odisha,Bargarh,Low Vision,6,15,135,83,218
Odisha,Bargarh,Low Vision,15,35,293,145,438
Odisha,Bargarh,Low Vision,35,60,288,159,447
Odisha,Bargarh,Low Vision,60,80,68,33,101
Odisha,Bargarh,Low Vision,80,100,5,0,5
Uttar Pradesh,Bareilly,Low Vision,0,6,1,0,1
Uttar Pradesh,Bareilly,Low Vision,6,15,21,15,36
Uttar Pradesh,Bareilly,Low Vision,15,35,148,59,207
Uttar Pradesh,Bareilly,Low Vision,35,60,151,34,185
Uttar Pradesh,Bareilly,Low Vision,60,80,54,17,71
Uttar Pradesh,Bareilly,Low Vision,80,100,2,0,2
Rajasthan,Baran,Low Vision,6,15,5,3,8
Rajasthan,Baran,Low Vision,15,35,23,9,32
Rajasthan,Baran,Low Vision,35,60,18,12,30
Rajasthan,Baran,Low Vision,60,80,9,5,14
Jammu And Kashmir,Baramulla,Low Vision,0,6,5,7,12
Jammu And Kashmir,Baramulla,Low Vision,6,15,90,67,157
Jammu And Kashmir,Baramulla,Low Vision,15,35,327,204,531
Jammu And Kashmir,Baramulla,Low Vision,35,60,206,121,327
Jammu And Kashmir,Baramulla,Low Vision,60,80,38,17,55
Jammu And Kashmir,Baramulla,Low Vision,80,100,6,2,8
Uttar Pradesh,Barabanki,Low Vision,0,6,1,1,2
Uttar Pradesh,Barabanki,Low Vision,6,15,28,14,42
Uttar Pradesh,Barabanki,Low Vision,15,35,225,101,326
Uttar Pradesh,Barabanki,Low Vision,35,60,211,86,297
Uttar Pradesh,Barabanki,Low Vision,60,80,87,25,112
Uttar Pradesh,Barabanki,Low Vision,80,100,5,1,6
Rajasthan,Banswara,Low Vision,0,6,1,0,1
Rajasthan,Banswara,Low Vision,6,15,8,5,13
Rajasthan,Banswara,Low Vision,15,35,43,30,73
Rajasthan,Banswara,Low Vision,35,60,25,10,35
Rajasthan,Banswara,Low Vision,60,80,6,8,14
Rajasthan,Banswara,Low Vision,80,100,0,1,1
Bihar,Banka,Low Vision,0,6,3,2,5
Bihar,Banka,Low Vision,6,15,47,34,81
Bihar,Banka,Low Vision,15,35,82,47,129
Bihar,Banka,Low Vision,35,60,52,34,86
Bihar,Banka,Low Vision,60,80,7,8,15
Bihar,Banka,Low Vision,80,100,2,0,2
Jammu And Kashmir,Bandipora,Low Vision,0,6,5,7,12
Jammu And Kashmir,Bandipora,Low Vision,6,15,26,23,49
Jammu And Kashmir,Bandipora,Low Vision,15,35,93,86,179
Jammu And Kashmir,Bandipora,Low Vision,35,60,104,87,191
Jammu And Kashmir,Bandipora,Low Vision,60,80,16,16,32
Jammu And Kashmir,Bandipora,Low Vision,80,100,0,2,2
Uttar Pradesh,Banda,Low Vision,6,15,0,3,3
Uttar Pradesh,Banda,Low Vision,15,35,96,37,133
Uttar Pradesh,Banda,Low Vision,35,60,83,42,125
Uttar Pradesh,Banda,Low Vision,60,80,32,12,44
Uttar Pradesh,Banda,Low Vision,80,100,2,0,2
Gujarat,Banas Kantha,Low Vision,0,6,6,5,11
Gujarat,Banas Kantha,Low Vision,6,15,55,41,96
Gujarat,Banas Kantha,Low Vision,15,35,142,48,190
Gujarat,Banas Kantha,Low Vision,35,60,53,8,61
Gujarat,Banas Kantha,Low Vision,60,80,12,4,16
Gujarat,Banas Kantha,Low Vision,80,100,1,0,1
Chhattisgarh,Balrampur,Low Vision,15,35,4,1,5
Chhattisgarh,Balrampur,Low Vision,35,60,3,0,3
Uttar Pradesh,Balrampur,Low Vision,6,15,12,16,28
Uttar Pradesh,Balrampur,Low Vision,15,35,118,32,150
Uttar Pradesh,Balrampur,Low Vision,35,60,39,14,53
Uttar Pradesh,Balrampur,Low Vision,60,80,5,4,9
Chhattisgarh,Baloda Bazar,Low Vision,0,6,1,0,1
Chhattisgarh,Baloda Bazar,Low Vision,6,15,28,29,57
Chhattisgarh,Baloda Bazar,Low Vision,15,35,132,109,241
Chhattisgarh,Baloda Bazar,Low Vision,35,60,91,49,140
Chhattisgarh,Baloda Bazar,Low Vision,60,80,33,16,49
Chhattisgarh,Baloda Bazar,Low Vision,80,100,3,0,3
Chhattisgarh,Balod,Low Vision,6,15,1,0,1
Chhattisgarh,Balod,Low Vision,15,35,0,1,1
Chhattisgarh,Balod,Low Vision,35,60,2,0,2
Uttar Pradesh,Ballia,Low Vision,0,6,2,0,2
Uttar Pradesh,Ballia,Low Vision,6,15,16,6,22
Uttar Pradesh,Ballia,Low Vision,15,35,148,70,218
Uttar Pradesh,Ballia,Low Vision,35,60,122,61,183
Uttar Pradesh,Ballia,Low Vision,60,80,33,12,45
Uttar Pradesh,Ballia,Low Vision,80,100,1,2,3
Karnataka,Ballari,Low Vision,6,15,13,24,37
Karnataka,Ballari,Low Vision,15,35,136,89,225
Karnataka,Ballari,Low Vision,35,60,124,54,178
Karnataka,Ballari,Low Vision,60,80,18,15,33
Karnataka,Ballari,Low Vision,80,100,1,0,1
Odisha,Baleshwar,Low Vision,0,6,4,10,14
Odisha,Baleshwar,Low Vision,6,15,158,91,249
Odisha,Baleshwar,Low Vision,15,35,736,473,1209
Odisha,Baleshwar,Low Vision,35,60,952,554,1506
Odisha,Baleshwar,Low Vision,60,80,379,163,542
Odisha,Baleshwar,Low Vision,80,100,28,9,37
Odisha,Balangir,Low Vision,0,6,10,10,20
Odisha,Balangir,Low Vision,6,15,163,124,287
Odisha,Balangir,Low Vision,15,35,403,216,619
Odisha,Balangir,Low Vision,35,60,296,110,406
Odisha,Balangir,Low Vision,60,80,109,40,149
Odisha,Balangir,Low Vision,80,100,6,1,7
Madhya Pradesh,Balaghat,Low Vision,0,6,14,7,21
Madhya Pradesh,Balaghat,Low Vision,6,15,181,100,281
Madhya Pradesh,Balaghat,Low Vision,15,35,727,444,1171
Madhya Pradesh,Balaghat,Low Vision,35,60,589,296,885
Madhya Pradesh,Balaghat,Low Vision,60,80,130,44,174
Madhya Pradesh,Balaghat,Low Vision,80,100,4,6,10
Assam,Baksa,Low Vision,0,6,4,1,5
Assam,Baksa,Low Vision,6,15,15,19,34
Assam,Baksa,Low Vision,15,35,98,62,160
Assam,Baksa,Low Vision,35,60,102,77,179
Assam,Baksa,Low Vision,60,80,26,25,51
Assam,Baksa,Low Vision,80,100,0,3,3
Assam,Bajali,Low Vision,6,15,2,1,3
Assam,Bajali,Low Vision,15,35,1,3,4
Assam,Bajali,Low Vision,35,60,2,0,2
Assam,Bajali,Low Vision,60,80,0,1,1
Uttar Pradesh,Bahraich,Low Vision,6,15,6,5,11
Uttar Pradesh,Bahraich,Low Vision,15,35,85,39,124
Uttar Pradesh,Bahraich,Low Vision,35,60,91,46,137
Uttar Pradesh,Bahraich,Low Vision,60,80,50,14,64
Uttar Pradesh,Bahraich,Low Vision,80,100,3,0,3
Uttar Pradesh,Baghpat,Low Vision,6,15,2,0,2
Uttar Pradesh,Baghpat,Low Vision,15,35,45,15,60
Uttar Pradesh,Baghpat,Low Vision,35,60,27,8,35
Uttar Pradesh,Baghpat,Low Vision,60,80,17,4,21
Uttar Pradesh,Baghpat,Low Vision,80,100,1,1,2
Uttarakhand,Bageshwar,Low Vision,6,15,8,8,16
Uttarakhand,Bageshwar,Low Vision,15,35,35,16,51
Uttarakhand,Bageshwar,Low Vision,35,60,77,38,115
Uttarakhand,Bageshwar,Low Vision,60,80,8,1,9
Uttarakhand,Bageshwar,Low Vision,80,100,1,1,2
Karnataka,Bagalkote,Low Vision,0,6,1,0,1
Karnataka,Bagalkote,Low Vision,6,15,32,41,73
Karnataka,Bagalkote,Low Vision,15,35,183,101,284
Karnataka,Bagalkote,Low Vision,35,60,198,107,305
Karnataka,Bagalkote,Low Vision,60,80,44,9,53
Karnataka,Bagalkote,Low Vision,80,100,2,0,2
Uttar Pradesh,Azamgarh,Low Vision,0,6,5,1,6
Uttar Pradesh,Azamgarh,Low Vision,6,15,90,46,136
Uttar Pradesh,Azamgarh,Low Vision,15,35,2239,1272,3511
Uttar Pradesh,Azamgarh,Low Vision,35,60,1290,599,1889
Uttar Pradesh,Azamgarh,Low Vision,60,80,215,58,273
Uttar Pradesh,Azamgarh,Low Vision,80,100,12,5,17
Uttar Pradesh,Ayodhya,Low Vision,0,6,1,0,1
Uttar Pradesh,Ayodhya,Low Vision,6,15,2,5,7
Uttar Pradesh,Ayodhya,Low Vision,15,35,70,35,105
Uttar Pradesh,Ayodhya,Low Vision,35,60,58,25,83
Uttar Pradesh,Ayodhya,Low Vision,60,80,18,12,30
Bihar,Aurangabad,Low Vision,6,15,8,5,13
Bihar,Aurangabad,Low Vision,15,35,49,24,73
Bihar,Aurangabad,Low Vision,35,60,29,13,42
Bihar,Aurangabad,Low Vision,60,80,10,2,12
Maharashtra,Aurangabad,Low Vision,0,6,6,5,11
Maharashtra,Aurangabad,Low Vision,6,15,119,90,209
Maharashtra,Aurangabad,Low Vision,15,35,355,183,538
Maharashtra,Aurangabad,Low Vision,35,60,314,118,432
Maharashtra,Aurangabad,Low Vision,60,80,109,54,163
Maharashtra,Aurangabad,Low Vision,80,100,8,8,16
Uttar Pradesh,Auraiya,Low Vision,0,6,1,2,3
Uttar Pradesh,Auraiya,Low Vision,6,15,10,13,23
Uttar Pradesh,Auraiya,Low Vision,15,35,73,39,112
Uttar Pradesh,Auraiya,Low Vision,35,60,99,32,131
Uttar Pradesh,Auraiya,Low Vision,60,80,35,11,46
Uttar Pradesh,Auraiya,Low Vision,80,100,5,1,6
Madhya Pradesh,Ashoknagar,Low Vision,15,35,17,8,25
Madhya Pradesh,Ashoknagar,Low Vision,35,60,17,10,27
Madhya Pradesh,Ashoknagar,Low Vision,60,80,8,2,10
Madhya Pradesh,Ashoknagar,Low Vision,80,100,1,0,1
Bihar,Arwal,Low Vision,0,6,0,2,2
Bihar,Arwal,Low Vision,6,15,18,5,23
Bihar,Arwal,Low Vision,15,35,93,35,128
Bihar,Arwal,Low Vision,35,60,71,52,123
Bihar,Arwal,Low Vision,60,80,10,12,22
Bihar,Arwal,Low Vision,80,100,3,0,3
Gujarat,Arvalli,Low Vision,6,15,48,41,89
Gujarat,Arvalli,Low Vision,15,35,91,59,150
Gujarat,Arvalli,Low Vision,35,60,41,11,52
Gujarat,Arvalli,Low Vision,60,80,16,3,19
Tamil Nadu,Ariyalur,Low Vision,6,15,23,8,31
Tamil Nadu,Ariyalur,Low Vision,15,35,47,24,71
Tamil Nadu,Ariyalur,Low Vision,35,60,52,29,81
Tamil Nadu,Ariyalur,Low Vision,60,80,27,8,35
Tamil Nadu,Ariyalur,Low Vision,80,100,2,0,2
Bihar,Araria,Low Vision,0,6,0,3,3
Bihar,Araria,Low Vision,6,15,30,30,60
Bihar,Araria,Low Vision,15,35,101,71,172
Bihar,Araria,Low Vision,35,60,76,50,126
Bihar,Araria,Low Vision,60,80,40,27,67
Bihar,Araria,Low Vision,80,100,3,2,5
Madhya Pradesh,Anuppur,Low Vision,0,6,1,0,1
Madhya Pradesh,Anuppur,Low Vision,6,15,6,4,10
Madhya Pradesh,Anuppur,Low Vision,15,35,36,31,67
Madhya Pradesh,Anuppur,Low Vision,35,60,49,22,71
Madhya Pradesh,Anuppur,Low Vision,60,80,15,8,23
Madhya Pradesh,Anuppur,Low Vision,80,100,2,0,2
Odisha,Anugul,Low Vision,0,6,1,8,9
Odisha,Anugul,Low Vision,6,15,100,47,147
Odisha,Anugul,Low Vision,15,35,291,143,434
Odisha,Anugul,Low Vision,35,60,317,152,469
Odisha,Anugul,Low Vision,60,80,97,36,133
Odisha,Anugul,Low Vision,80,100,2,3,5
Arunachal Pradesh,Anjaw,Low Vision,15,35,1,0,1
Arunachal Pradesh,Anjaw,Low Vision,35,60,1,1,2
Jammu And Kashmir,Anantnag,Low Vision,0,6,21,12,33
Jammu And Kashmir,Anantnag,Low Vision,6,15,101,98,199
Jammu And Kashmir,Anantnag,Low Vision,15,35,318,225,543
Jammu And Kashmir,Anantnag,Low Vision,35,60,287,197,484
Jammu And Kashmir,Anantnag,Low Vision,60,80,90,46,136
Jammu And Kashmir,Anantnag,Low Vision,80,100,4,5,9
Andhra Pradesh,Anantapur,Low Vision,0,6,4,6,10
Andhra Pradesh,Anantapur,Low Vision,6,15,50,34,84
Andhra Pradesh,Anantapur,Low Vision,15,35,182,101,283
Andhra Pradesh,Anantapur,Low Vision,35,60,465,217,682
Andhra Pradesh,Anantapur,Low Vision,60,80,126,76,202
Andhra Pradesh,Anantapur,Low Vision,80,100,7,4,11
Gujarat,Anand,Low Vision,0,6,6,2,8
Gujarat,Anand,Low Vision,6,15,37,34,71
Gujarat,Anand,Low Vision,15,35,121,61,182
Gujarat,Anand,Low Vision,35,60,48,11,59
Gujarat,Anand,Low Vision,60,80,15,2,17
Gujarat,Anand,Low Vision,80,100,0,1,1
Uttar Pradesh,Amroha,Low Vision,0,6,1,1,2
Uttar Pradesh,Amroha,Low Vision,6,15,6,1,7
Uttar Pradesh,Amroha,Low Vision,15,35,47,19,66
Uttar Pradesh,Amroha,Low Vision,35,60,43,9,52
Uttar Pradesh,Amroha,Low Vision,60,80,10,2,12
Uttar Pradesh,Amroha,Low Vision,80,100,1,0,1
Punjab,Amritsar,Low Vision,0,6,3,3,6
Punjab,Amritsar,Low Vision,6,15,44,50,94
Punjab,Amritsar,Low Vision,15,35,268,118,386
Punjab,Amritsar,Low Vision,35,60,315,127,442
Punjab,Amritsar,Low Vision,60,80,111,28,139
Punjab,Amritsar,Low Vision,80,100,7,8,15
Gujarat,Amreli,Low Vision,0,6,1,0,1
Gujarat,Amreli,Low Vision,6,15,40,26,66
Gujarat,Amreli,Low Vision,15,35,78,74,152
Gujarat,Amreli,Low Vision,35,60,19,3,22
Gujarat,Amreli,Low Vision,60,80,12,6,18
Gujarat,Amreli,Low Vision,80,100,1,1,2
Maharashtra,Amravati,Low Vision,0,6,21,13,34
Maharashtra,Amravati,Low Vision,6,15,183,158,341
Maharashtra,Amravati,Low Vision,15,35,521,275,796
Maharashtra,Amravati,Low Vision,35,60,601,309,910
Maharashtra,Amravati,Low Vision,60,80,235,86,321
Maharashtra,Amravati,Low Vision,80,100,19,6,25
Uttar Pradesh,Amethi,Low Vision,6,15,14,5,19
Uttar Pradesh,Amethi,Low Vision,15,35,139,72,211
Uttar Pradesh,Amethi,Low Vision,35,60,149,68,217
Uttar Pradesh,Amethi,Low Vision,60,80,36,11,47
Uttar Pradesh,Amethi,Low Vision,80,100,2,0,2
Uttar Pradesh,Ambedkar Nagar,Low Vision,6,15,16,13,29
Uttar Pradesh,Ambedkar Nagar,Low Vision,15,35,215,112,327
Uttar Pradesh,Ambedkar Nagar,Low Vision,35,60,202,93,295
Uttar Pradesh,Ambedkar Nagar,Low Vision,60,80,21,10,31
Uttar Pradesh,Ambedkar Nagar,Low Vision,80,100,1,1,2
Haryana,Ambala,Low Vision,0,6,0,1,1
Haryana,Ambala,Low Vision,6,15,8,7,15
Haryana,Ambala,Low Vision,15,35,16,16,32
Haryana,Ambala,Low Vision,35,60,21,6,27
Haryana,Ambala,Low Vision,60,80,4,1,5
Rajasthan,Alwar,Low Vision,0,6,2,0,2
Rajasthan,Alwar,Low Vision,6,15,9,5,14
Rajasthan,Alwar,Low Vision,15,35,61,29,90
Rajasthan,Alwar,Low Vision,35,60,55,35,90
Rajasthan,Alwar,Low Vision,60,80,32,13,45
Rajasthan,Alwar,Low Vision,80,100,2,4,6
Uttarakhand,Almora,Low Vision,6,15,7,4,11
Uttarakhand,Almora,Low Vision,15,35,50,22,72
Uttarakhand,Almora,Low Vision,35,60,74,35,109
Uttarakhand,Almora,Low Vision,60,80,10,3,13
Madhya Pradesh,Alirajpur,Low Vision,6,15,14,16,30
Madhya Pradesh,Alirajpur,Low Vision,15,35,74,48,122
Madhya Pradesh,Alirajpur,Low Vision,35,60,75,38,113
Madhya Pradesh,Alirajpur,Low Vision,60,80,18,6,24
Uttar Pradesh,Aligarh,Low Vision,0,6,1,3,4
Uttar Pradesh,Aligarh,Low Vision,6,15,20,11,31
Uttar Pradesh,Aligarh,Low Vision,15,35,106,32,138
Uttar Pradesh,Aligarh,Low Vision,35,60,68,35,103
Uttar Pradesh,Aligarh,Low Vision,60,80,18,16,34
Uttar Pradesh,Aligarh,Low Vision,80,100,2,1,3
Kerala,Alappuzha,Low Vision,0,6,1,1,2
Kerala,Alappuzha,Low Vision,6,15,13,6,19
Kerala,Alappuzha,Low Vision,15,35,80,59,139
Kerala,Alappuzha,Low Vision,35,60,132,88,220
Kerala,Alappuzha,Low Vision,60,80,64,36,100
Kerala,Alappuzha,Low Vision,80,100,1,1,2
Maharashtra,Akola,Low Vision,0,6,18,21,39
Maharashtra,Akola,Low Vision,6,15,171,138,309
Maharashtra,Akola,Low Vision,15,35,652,365,1017
Maharashtra,Akola,Low Vision,35,60,847,419,1266
Maharashtra,Akola,Low Vision,60,80,417,193,610
Maharashtra,Akola,Low Vision,80,100,11,3,14
Rajasthan,Ajmer,Low Vision,6,15,11,5,16
Rajasthan,Ajmer,Low Vision,15,35,34,24,58
Rajasthan,Ajmer,Low Vision,35,60,28,17,45
Rajasthan,Ajmer,Low Vision,60,80,5,5,10
Mizoram,Aizawl,Low Vision,6,15,2,2,4
Mizoram,Aizawl,Low Vision,15,35,18,25,43
Mizoram,Aizawl,Low Vision,35,60,7,6,13
Mizoram,Aizawl,Low Vision,60,80,1,2,3
Maharashtra,Ahmednagar,Low Vision,0,6,10,6,16
Maharashtra,Ahmednagar,Low Vision,6,15,249,129,378
Maharashtra,Ahmednagar,Low Vision,15,35,797,333,1130
Maharashtra,Ahmednagar,Low Vision,35,60,846,364,1210
Maharashtra,Ahmednagar,Low Vision,60,80,357,108,465
Maharashtra,Ahmednagar,Low Vision,80,100,30,3,33
Gujarat,Ahmadabad,Low Vision,0,6,3,2,5
Gujarat,Ahmadabad,Low Vision,6,15,71,56,127
Gujarat,Ahmadabad,Low Vision,15,35,181,99,280
Gujarat,Ahmadabad,Low Vision,35,60,86,33,119
Gujarat,Ahmadabad,Low Vision,60,80,33,7,40
Gujarat,Ahmadabad,Low Vision,80,100,5,0,5
Uttar Pradesh,Agra,Low Vision,0,6,5,6,11
Uttar Pradesh,Agra,Low Vision,6,15,35,20,55
Uttar Pradesh,Agra,Low Vision,15,35,249,85,334
Uttar Pradesh,Agra,Low Vision,35,60,185,56,241
Uttar Pradesh,Agra,Low Vision,60,80,61,11,72
Uttar Pradesh,Agra,Low Vision,80,100,2,1,3
Madhya Pradesh,Agar Malwa,Low Vision,0,6,0,1,1
Madhya Pradesh,Agar Malwa,Low Vision,6,15,14,5,19
Madhya Pradesh,Agar Malwa,Low Vision,15,35,70,22,92
Madhya Pradesh,Agar Malwa,Low Vision,35,60,69,16,85
Madhya Pradesh,Agar Malwa,Low Vision,60,80,15,3,18
Madhya Pradesh,Agar Malwa,Low Vision,80,100,3,0,3
Telangana,Adilabad,Low Vision,6,15,23,28,51
Telangana,Adilabad,Low Vision,15,35,122,116,238
Telangana,Adilabad,Low Vision,35,60,178,114,292
Telangana,Adilabad,Low Vision,60,80,109,62,171
Telangana,Adilabad,Low Vision,80,100,21,18,39
Nagaland,Zunheboto,Mental Illness,6,15,0,1,1
Maharashtra,Yavatmal,Mental Illness,6,15,11,2,13
Maharashtra,Yavatmal,Mental Illness,15,35,93,70,163
Maharashtra,Yavatmal,Mental Illness,35,60,179,80,259
Maharashtra,Yavatmal,Mental Illness,60,80,17,7,24
Maharashtra,Yavatmal,Mental Illness,80,100,0,1,1
Puducherry,Yanam,Mental Illness,6,15,2,7,9
Puducherry,Yanam,Mental Illness,15,35,60,29,89
Puducherry,Yanam,Mental Illness,35,60,25,25,50
Puducherry,Yanam,Mental Illness,60,80,2,5,7
Haryana,Yamunanagar,Mental Illness,0,6,2,0,2
Haryana,Yamunanagar,Mental Illness,6,15,4,3,7
Haryana,Yamunanagar,Mental Illness,15,35,19,12,31
Haryana,Yamunanagar,Mental Illness,35,60,7,2,9
Haryana,Yamunanagar,Mental Illness,60,80,1,0,1
Karnataka,Yadgir,Mental Illness,0,6,32,20,52
Karnataka,Yadgir,Mental Illness,6,15,93,69,162
Karnataka,Yadgir,Mental Illness,15,35,128,135,263
Karnataka,Yadgir,Mental Illness,35,60,69,64,133
Karnataka,Yadgir,Mental Illness,60,80,0,1,1
Telangana,Yadadri Bhuvanagiri,Mental Illness,6,15,0,1,1
Telangana,Yadadri Bhuvanagiri,Mental Illness,15,35,105,79,184
Telangana,Yadadri Bhuvanagiri,Mental Illness,35,60,570,368,938
Telangana,Yadadri Bhuvanagiri,Mental Illness,60,80,139,63,202
Telangana,Yadadri Bhuvanagiri,Mental Illness,80,100,3,3,6
Andhra Pradesh,Y.S.R.,Mental Illness,0,6,1,0,1
Andhra Pradesh,Y.S.R.,Mental Illness,6,15,2,2,4
Andhra Pradesh,Y.S.R.,Mental Illness,15,35,81,35,116
Andhra Pradesh,Y.S.R.,Mental Illness,35,60,396,148,544
Andhra Pradesh,Y.S.R.,Mental Illness,60,80,58,38,96
Andhra Pradesh,Y.S.R.,Mental Illness,80,100,2,3,5
Nagaland,Wokha,Mental Illness,15,35,5,2,7
Nagaland,Wokha,Mental Illness,35,60,4,2,6
Tripura,West Tripura,Mental Illness,6,15,1,0,1
Tripura,West Tripura,Mental Illness,15,35,32,15,47
Tripura,West Tripura,Mental Illness,35,60,85,44,129
Tripura,West Tripura,Mental Illness,60,80,9,5,14
Tripura,West Tripura,Mental Illness,80,100,1,3,4
Jharkhand,West Singhbhum,Mental Illness,0,6,0,1,1
Jharkhand,West Singhbhum,Mental Illness,6,15,16,10,26
Jharkhand,West Singhbhum,Mental Illness,15,35,20,18,38
Jharkhand,West Singhbhum,Mental Illness,35,60,12,5,17
Arunachal Pradesh,West Siang,Mental Illness,15,35,2,1,3
Meghalaya,West Khasi Hills,Mental Illness,6,15,2,1,3
Meghalaya,West Khasi Hills,Mental Illness,15,35,7,6,13
Meghalaya,West Khasi Hills,Mental Illness,35,60,6,10,16
Assam,West Karbi Anglong,Mental Illness,15,35,7,1,8
Meghalaya,West Jaintia Hills,Mental Illness,15,35,19,24,43
Meghalaya,West Jaintia Hills,Mental Illness,35,60,14,21,35
Meghalaya,West Jaintia Hills,Mental Illness,60,80,0,1,1
Andhra Pradesh,West Godavari,Mental Illness,0,6,1,0,1
Andhra Pradesh,West Godavari,Mental Illness,6,15,14,9,23
Andhra Pradesh,West Godavari,Mental Illness,15,35,204,116,320
Andhra Pradesh,West Godavari,Mental Illness,35,60,910,192,1102
Andhra Pradesh,West Godavari,Mental Illness,60,80,138,33,171
Andhra Pradesh,West Godavari,Mental Illness,80,100,3,1,4
Meghalaya,West Garo Hills,Mental Illness,6,15,5,10,15
Meghalaya,West Garo Hills,Mental Illness,15,35,47,49,96
Meghalaya,West Garo Hills,Mental Illness,35,60,10,14,24
Meghalaya,West Garo Hills,Mental Illness,60,80,1,1,2
Delhi,West,Mental Illness,6,15,9,3,12
Delhi,West,Mental Illness,15,35,44,23,67
Delhi,West,Mental Illness,35,60,58,21,79
Delhi,West,Mental Illness,60,80,4,5,9
Kerala,Wayanad,Mental Illness,0,6,0,1,1
Kerala,Wayanad,Mental Illness,6,15,9,4,13
Kerala,Wayanad,Mental Illness,15,35,56,57,113
Kerala,Wayanad,Mental Illness,35,60,148,124,272
Kerala,Wayanad,Mental Illness,60,80,30,47,77
Maharashtra,Washim,Mental Illness,6,15,3,0,3
Maharashtra,Washim,Mental Illness,15,35,96,36,132
Maharashtra,Washim,Mental Illness,35,60,249,71,320
Maharashtra,Washim,Mental Illness,60,80,24,21,45
Maharashtra,Washim,Mental Illness,80,100,1,0,1
Maharashtra,Wardha,Mental Illness,6,15,3,3,6
Maharashtra,Wardha,Mental Illness,15,35,40,35,75
Maharashtra,Wardha,Mental Illness,35,60,104,46,150
Maharashtra,Wardha,Mental Illness,60,80,16,4,20
Telangana,Warangal,Mental Illness,6,15,1,1,2
Telangana,Warangal,Mental Illness,15,35,12,10,22
Telangana,Warangal,Mental Illness,35,60,78,64,142
Telangana,Warangal,Mental Illness,60,80,13,15,28
Telangana,Wanaparthy,Mental Illness,15,35,268,262,530
Telangana,Wanaparthy,Mental Illness,35,60,442,258,700
Telangana,Wanaparthy,Mental Illness,60,80,72,36,108
Telangana,Wanaparthy,Mental Illness,80,100,4,3,7
Andhra Pradesh,Vizianagaram,Mental Illness,6,15,6,3,9
Andhra Pradesh,Vizianagaram,Mental Illness,15,35,129,64,193
Andhra Pradesh,Vizianagaram,Mental Illness,35,60,333,80,413
Andhra Pradesh,Vizianagaram,Mental Illness,60,80,46,16,62
Andhra Pradesh,Vizianagaram,Mental Illness,80,100,1,1,2
Andhra Pradesh,Visakhapatanam,Mental Illness,0,6,2,0,2
Andhra Pradesh,Visakhapatanam,Mental Illness,6,15,19,17,36
Andhra Pradesh,Visakhapatanam,Mental Illness,15,35,109,35,144
Andhra Pradesh,Visakhapatanam,Mental Illness,35,60,335,74,409
Andhra Pradesh,Visakhapatanam,Mental Illness,60,80,38,9,47
Andhra Pradesh,Visakhapatanam,Mental Illness,80,100,1,0,1
Tamil Nadu,Virudhunagar,Mental Illness,0,6,3,2,5
Tamil Nadu,Virudhunagar,Mental Illness,6,15,111,81,192
Tamil Nadu,Virudhunagar,Mental Illness,15,35,369,257,626
Tamil Nadu,Virudhunagar,Mental Illness,35,60,200,169,369
Tamil Nadu,Virudhunagar,Mental Illness,60,80,6,10,16
Tamil Nadu,Virudhunagar,Mental Illness,80,100,1,0,1
Tamil Nadu,Villupuram,Mental Illness,0,6,1,0,1
Tamil Nadu,Villupuram,Mental Illness,6,15,42,22,64
Tamil Nadu,Villupuram,Mental Illness,15,35,124,92,216
Tamil Nadu,Villupuram,Mental Illness,35,60,118,94,212
Tamil Nadu,Villupuram,Mental Illness,60,80,19,14,33
Tamil Nadu,Villupuram,Mental Illness,80,100,0,1,1
Telangana,Vikarabad,Mental Illness,15,35,46,52,98
Telangana,Vikarabad,Mental Illness,35,60,45,37,82
Telangana,Vikarabad,Mental Illness,60,80,10,6,16
Karnataka,Vijayapura,Mental Illness,0,6,22,11,33
Karnataka,Vijayapura,Mental Illness,6,15,126,95,221
Karnataka,Vijayapura,Mental Illness,15,35,310,220,530
Karnataka,Vijayapura,Mental Illness,35,60,197,143,340
Karnataka,Vijayapura,Mental Illness,60,80,11,13,24
Madhya Pradesh,Vidisha,Mental Illness,0,6,3,0,3
Madhya Pradesh,Vidisha,Mental Illness,6,15,131,87,218
Madhya Pradesh,Vidisha,Mental Illness,15,35,358,211,569
Madhya Pradesh,Vidisha,Mental Illness,35,60,253,116,369
Madhya Pradesh,Vidisha,Mental Illness,60,80,22,15,37
Madhya Pradesh,Vidisha,Mental Illness,80,100,3,1,4
Tamil Nadu,Vellore,Mental Illness,0,6,0,2,2
Tamil Nadu,Vellore,Mental Illness,6,15,123,88,211
Tamil Nadu,Vellore,Mental Illness,15,35,400,262,662
Tamil Nadu,Vellore,Mental Illness,35,60,213,159,372
Tamil Nadu,Vellore,Mental Illness,60,80,26,14,40
Tamil Nadu,Vellore,Mental Illness,80,100,1,1,2
Uttar Pradesh,Varanasi,Mental Illness,0,6,14,6,20
Uttar Pradesh,Varanasi,Mental Illness,6,15,49,21,70
Uttar Pradesh,Varanasi,Mental Illness,15,35,114,68,182
Uttar Pradesh,Varanasi,Mental Illness,35,60,44,18,62
Uttar Pradesh,Varanasi,Mental Illness,60,80,5,1,6
Gujarat,Valsad,Mental Illness,6,15,211,170,381
Gujarat,Valsad,Mental Illness,15,35,302,225,527
Gujarat,Valsad,Mental Illness,35,60,69,35,104
Gujarat,Valsad,Mental Illness,60,80,5,2,7
Bihar,Vaishali,Mental Illness,0,6,2,3,5
Bihar,Vaishali,Mental Illness,6,15,82,51,133
Bihar,Vaishali,Mental Illness,15,35,190,95,285
Bihar,Vaishali,Mental Illness,35,60,69,24,93
Bihar,Vaishali,Mental Illness,60,80,8,4,12
Gujarat,Vadodara,Mental Illness,0,6,2,1,3
Gujarat,Vadodara,Mental Illness,6,15,16,7,23
Gujarat,Vadodara,Mental Illness,15,35,93,52,145
Gujarat,Vadodara,Mental Illness,35,60,171,96,267
Gujarat,Vadodara,Mental Illness,60,80,31,23,54
Gujarat,Vadodara,Mental Illness,80,100,0,4,4
Karnataka,Uttara Kannada,Mental Illness,0,6,1,3,4
Karnataka,Uttara Kannada,Mental Illness,6,15,24,19,43
Karnataka,Uttara Kannada,Mental Illness,15,35,112,72,184
Karnataka,Uttara Kannada,Mental Illness,35,60,319,309,628
Karnataka,Uttara Kannada,Mental Illness,60,80,57,50,107
Karnataka,Uttara Kannada,Mental Illness,80,100,0,1,1
Uttarakhand,Uttar Kashi,Mental Illness,0,6,1,3,4
Uttarakhand,Uttar Kashi,Mental Illness,6,15,9,2,11
Uttarakhand,Uttar Kashi,Mental Illness,15,35,26,7,33
Uttarakhand,Uttar Kashi,Mental Illness,35,60,13,8,21
Uttarakhand,Uttar Kashi,Mental Illness,60,80,1,0,1
Arunachal Pradesh,Upper Siang,Mental Illness,6,15,1,1,2
Arunachal Pradesh,Upper Siang,Mental Illness,15,35,2,0,2
Arunachal Pradesh,Upper Siang,Mental Illness,35,60,1,0,1
Uttar Pradesh,Unnao,Mental Illness,0,6,4,3,7
Uttar Pradesh,Unnao,Mental Illness,6,15,72,51,123
Uttar Pradesh,Unnao,Mental Illness,15,35,198,124,322
Uttar Pradesh,Unnao,Mental Illness,35,60,77,37,114
Uttar Pradesh,Unnao,Mental Illness,60,80,3,1,4
Tripura,Unakoti,Mental Illness,6,15,0,2,2
Tripura,Unakoti,Mental Illness,15,35,30,17,47
Tripura,Unakoti,Mental Illness,35,60,39,33,72
Tripura,Unakoti,Mental Illness,60,80,3,7,10
Himachal Pradesh,Una,Mental Illness,0,6,1,3,4
Himachal Pradesh,Una,Mental Illness,6,15,47,33,80
Himachal Pradesh,Una,Mental Illness,15,35,223,131,354
Himachal Pradesh,Una,Mental Illness,35,60,139,84,223
Himachal Pradesh,Una,Mental Illness,60,80,17,3,20
Himachal Pradesh,Una,Mental Illness,80,100,1,0,1
Madhya Pradesh,Umaria,Mental Illness,6,15,9,8,17
Madhya Pradesh,Umaria,Mental Illness,15,35,46,42,88
Madhya Pradesh,Umaria,Mental Illness,35,60,20,12,32
Madhya Pradesh,Umaria,Mental Illness,60,80,6,1,7
Manipur,Ukhrul,Mental Illness,6,15,0,3,3
Manipur,Ukhrul,Mental Illness,15,35,1,1,2
Manipur,Ukhrul,Mental Illness,35,60,2,1,3
Manipur,Ukhrul,Mental Illness,60,80,1,0,1
Madhya Pradesh,Ujjain,Mental Illness,6,15,43,22,65
Madhya Pradesh,Ujjain,Mental Illness,15,35,138,79,217
Madhya Pradesh,Ujjain,Mental Illness,35,60,83,57,140
Madhya Pradesh,Ujjain,Mental Illness,60,80,6,3,9
Karnataka,Udupi,Mental Illness,0,6,1,3,4
Karnataka,Udupi,Mental Illness,6,15,46,23,69
Karnataka,Udupi,Mental Illness,15,35,183,130,313
Karnataka,Udupi,Mental Illness,35,60,349,305,654
Karnataka,Udupi,Mental Illness,60,80,48,43,91
Karnataka,Udupi,Mental Illness,80,100,1,0,1
Jammu And Kashmir,Udhampur,Mental Illness,6,15,1,2,3
Jammu And Kashmir,Udhampur,Mental Illness,15,35,36,21,57
Jammu And Kashmir,Udhampur,Mental Illness,35,60,70,18,88
Jammu And Kashmir,Udhampur,Mental Illness,60,80,3,0,3
Uttarakhand,Udam Singh Nagar,Mental Illness,0,6,19,11,30
Uttarakhand,Udam Singh Nagar,Mental Illness,6,15,69,49,118
Uttarakhand,Udam Singh Nagar,Mental Illness,15,35,104,62,166
Uttarakhand,Udam Singh Nagar,Mental Illness,35,60,24,10,34
Uttarakhand,Udam Singh Nagar,Mental Illness,60,80,2,0,2
Assam,Udalguri,Mental Illness,0,6,13,4,17
Assam,Udalguri,Mental Illness,6,15,43,23,66
Assam,Udalguri,Mental Illness,15,35,74,50,124
Assam,Udalguri,Mental Illness,35,60,43,44,87
Assam,Udalguri,Mental Illness,60,80,5,4,9
Rajasthan,Udaipur,Mental Illness,0,6,4,1,5
Rajasthan,Udaipur,Mental Illness,6,15,60,38,98
Rajasthan,Udaipur,Mental Illness,15,35,177,138,315
Rajasthan,Udaipur,Mental Illness,35,60,98,55,153
Rajasthan,Udaipur,Mental Illness,60,80,13,5,18
Rajasthan,Udaipur,Mental Illness,80,100,1,1,2
Tamil Nadu,Tuticorin,Mental Illness,0,6,2,1,3
Tamil Nadu,Tuticorin,Mental Illness,6,15,15,13,28
Tamil Nadu,Tuticorin,Mental Illness,15,35,98,65,163
Tamil Nadu,Tuticorin,Mental Illness,35,60,185,181,366
Tamil Nadu,Tuticorin,Mental Illness,60,80,47,21,68
Tamil Nadu,Tuticorin,Mental Illness,80,100,3,1,4
Karnataka,Tumakuru,Mental Illness,0,6,34,14,48
Karnataka,Tumakuru,Mental Illness,6,15,258,155,413
Karnataka,Tumakuru,Mental Illness,15,35,722,560,1282
Karnataka,Tumakuru,Mental Illness,35,60,698,595,1293
Karnataka,Tumakuru,Mental Illness,60,80,51,50,101
Nagaland,Tuensang,Mental Illness,60,80,0,1,1
Rajasthan,Tonk,Mental Illness,0,6,2,3,5
Rajasthan,Tonk,Mental Illness,6,15,65,47,112
Rajasthan,Tonk,Mental Illness,15,35,124,79,203
Rajasthan,Tonk,Mental Illness,35,60,63,34,97
Rajasthan,Tonk,Mental Illness,60,80,7,1,8
Tamil Nadu,Tiruvannamalai,Mental Illness,0,6,3,0,3
Tamil Nadu,Tiruvannamalai,Mental Illness,6,15,19,17,36
Tamil Nadu,Tiruvannamalai,Mental Illness,15,35,150,117,267
Tamil Nadu,Tiruvannamalai,Mental Illness,35,60,322,250,572
Tamil Nadu,Tiruvannamalai,Mental Illness,60,80,27,31,58
Tamil Nadu,Tiruppur,Mental Illness,6,15,8,3,11
Tamil Nadu,Tiruppur,Mental Illness,15,35,26,25,51
Tamil Nadu,Tiruppur,Mental Illness,35,60,53,31,84
Tamil Nadu,Tiruppur,Mental Illness,60,80,8,5,13
Tamil Nadu,Tirupathur,Mental Illness,0,6,2,1,3
Tamil Nadu,Tirupathur,Mental Illness,6,15,25,13,38
Tamil Nadu,Tirupathur,Mental Illness,15,35,131,92,223
Tamil Nadu,Tirupathur,Mental Illness,35,60,140,115,255
Tamil Nadu,Tirupathur,Mental Illness,60,80,20,17,37
Tamil Nadu,Tirupathur,Mental Illness,80,100,0,1,1
Tamil Nadu,Tirunelveli,Mental Illness,6,15,3,0,3
Tamil Nadu,Tirunelveli,Mental Illness,15,35,46,17,63
Tamil Nadu,Tirunelveli,Mental Illness,35,60,102,123,225
Tamil Nadu,Tirunelveli,Mental Illness,60,80,17,15,32
Tamil Nadu,Tirunelveli,Mental Illness,80,100,1,0,1
Tamil Nadu,Tiruchirappalli,Mental Illness,0,6,1,0,1
Tamil Nadu,Tiruchirappalli,Mental Illness,6,15,30,14,44
Tamil Nadu,Tiruchirappalli,Mental Illness,15,35,134,86,220
Tamil Nadu,Tiruchirappalli,Mental Illness,35,60,279,224,503
Tamil Nadu,Tiruchirappalli,Mental Illness,60,80,29,32,61
Assam,Tinsukia,Mental Illness,0,6,2,0,2
Assam,Tinsukia,Mental Illness,6,15,3,7,10
Assam,Tinsukia,Mental Illness,15,35,9,9,18
Assam,Tinsukia,Mental Illness,35,60,10,3,13
Assam,Tinsukia,Mental Illness,60,80,2,0,2
Madhya Pradesh,Tikamgarh,Mental Illness,0,6,5,0,5
Madhya Pradesh,Tikamgarh,Mental Illness,6,15,43,31,74
Madhya Pradesh,Tikamgarh,Mental Illness,15,35,163,78,241
Madhya Pradesh,Tikamgarh,Mental Illness,35,60,96,40,136
Madhya Pradesh,Tikamgarh,Mental Illness,60,80,11,5,16
Madhya Pradesh,Tikamgarh,Mental Illness,80,100,3,0,3
Kerala,Thrissur,Mental Illness,0,6,0,1,1
Kerala,Thrissur,Mental Illness,6,15,24,20,44
Kerala,Thrissur,Mental Illness,15,35,221,142,363
Kerala,Thrissur,Mental Illness,35,60,656,407,1063
Kerala,Thrissur,Mental Illness,60,80,158,116,274
Kerala,Thrissur,Mental Illness,80,100,0,3,3
Manipur,Thoubal,Mental Illness,15,35,4,12,16
Manipur,Thoubal,Mental Illness,35,60,18,22,40
Manipur,Thoubal,Mental Illness,60,80,2,4,6
Tamil Nadu,Thiruvarur,Mental Illness,0,6,0,1,1
Tamil Nadu,Thiruvarur,Mental Illness,6,15,1,0,1
Tamil Nadu,Thiruvarur,Mental Illness,15,35,17,11,28
Tamil Nadu,Thiruvarur,Mental Illness,35,60,76,57,133
Tamil Nadu,Thiruvarur,Mental Illness,60,80,6,7,13
Tamil Nadu,Thiruvarur,Mental Illness,80,100,1,0,1
Kerala,Thiruvananthapuram,Mental Illness,6,15,7,5,12
Kerala,Thiruvananthapuram,Mental Illness,15,35,212,107,319
Kerala,Thiruvananthapuram,Mental Illness,35,60,844,735,1579
Kerala,Thiruvananthapuram,Mental Illness,60,80,245,215,460
Kerala,Thiruvananthapuram,Mental Illness,80,100,6,8,14
Tamil Nadu,Thiruvallur,Mental Illness,0,6,1,0,1
Tamil Nadu,Thiruvallur,Mental Illness,6,15,41,28,69
Tamil Nadu,Thiruvallur,Mental Illness,15,35,154,106,260
Tamil Nadu,Thiruvallur,Mental Illness,35,60,237,238,475
Tamil Nadu,Thiruvallur,Mental Illness,60,80,60,129,189
Tamil Nadu,Thiruvallur,Mental Illness,80,100,5,12,17
Tamil Nadu,Theni,Mental Illness,6,15,1,0,1
Tamil Nadu,Theni,Mental Illness,15,35,53,13,66
Tamil Nadu,Theni,Mental Illness,35,60,109,49,158
Tamil Nadu,Theni,Mental Illness,60,80,8,6,14
Tamil Nadu,Theni,Mental Illness,80,100,1,0,1
Tamil Nadu,The Nilgiris,Mental Illness,0,6,1,0,1
Tamil Nadu,The Nilgiris,Mental Illness,6,15,10,3,13
Tamil Nadu,The Nilgiris,Mental Illness,15,35,31,30,61
Tamil Nadu,The Nilgiris,Mental Illness,35,60,13,15,28
Tamil Nadu,The Nilgiris,Mental Illness,60,80,0,1,1
Tamil Nadu,Thanjavur,Mental Illness,6,15,12,9,21
Tamil Nadu,Thanjavur,Mental Illness,15,35,40,26,66
Tamil Nadu,Thanjavur,Mental Illness,35,60,122,64,186
Tamil Nadu,Thanjavur,Mental Illness,60,80,19,6,25
Tamil Nadu,Thanjavur,Mental Illness,80,100,3,0,3
Maharashtra,Thane,Mental Illness,0,6,8,4,12
Maharashtra,Thane,Mental Illness,6,15,35,25,60
Maharashtra,Thane,Mental Illness,15,35,222,100,322
Maharashtra,Thane,Mental Illness,35,60,374,200,574
Maharashtra,Thane,Mental Illness,60,80,53,40,93
Maharashtra,Thane,Mental Illness,80,100,2,5,7
Tamil Nadu,Tenkasi,Mental Illness,6,15,5,2,7
Tamil Nadu,Tenkasi,Mental Illness,15,35,30,28,58
Tamil Nadu,Tenkasi,Mental Illness,35,60,64,50,114
Tamil Nadu,Tenkasi,Mental Illness,60,80,4,8,12
Manipur,Tengnoupal,Mental Illness,60,80,2,1,3
Uttarakhand,Tehri Garhwal,Mental Illness,6,15,4,2,6
Uttarakhand,Tehri Garhwal,Mental Illness,15,35,14,11,25
Uttarakhand,Tehri Garhwal,Mental Illness,35,60,6,4,10
Uttarakhand,Tehri Garhwal,Mental Illness,60,80,1,2,3
Punjab,Tarn Taran,Mental Illness,0,6,13,6,19
Punjab,Tarn Taran,Mental Illness,6,15,160,84,244
Punjab,Tarn Taran,Mental Illness,15,35,338,175,513
Punjab,Tarn Taran,Mental Illness,35,60,105,59,164
Punjab,Tarn Taran,Mental Illness,60,80,8,0,8
Punjab,Tarn Taran,Mental Illness,80,100,0,1,1
Gujarat,Tapi,Mental Illness,6,15,40,28,68
Gujarat,Tapi,Mental Illness,15,35,117,87,204
Gujarat,Tapi,Mental Illness,35,60,25,17,42
Gujarat,Tapi,Mental Illness,60,80,2,2,4
Manipur,Tamenglong,Mental Illness,0,6,1,1,2
Manipur,Tamenglong,Mental Illness,6,15,2,6,8
Manipur,Tamenglong,Mental Illness,15,35,15,11,26
Manipur,Tamenglong,Mental Illness,35,60,11,9,20
Manipur,Tamenglong,Mental Illness,60,80,1,1,2
Telangana,Suryapet,Mental Illness,6,15,2,1,3
Telangana,Suryapet,Mental Illness,15,35,158,136,294
Telangana,Suryapet,Mental Illness,35,60,787,657,1444
Telangana,Suryapet,Mental Illness,60,80,169,130,299
Telangana,Suryapet,Mental Illness,80,100,15,7,22
Chhattisgarh,Surguja,Mental Illness,0,6,2,1,3
Chhattisgarh,Surguja,Mental Illness,6,15,57,30,87
Chhattisgarh,Surguja,Mental Illness,15,35,86,73,159
Chhattisgarh,Surguja,Mental Illness,35,60,18,17,35
Chhattisgarh,Surguja,Mental Illness,60,80,1,0,1
Gujarat,Surendranagar,Mental Illness,6,15,8,5,13
Gujarat,Surendranagar,Mental Illness,15,35,52,21,73
Gujarat,Surendranagar,Mental Illness,35,60,50,15,65
Gujarat,Surendranagar,Mental Illness,60,80,9,1,10
Gujarat,Surat,Mental Illness,0,6,0,1,1
Gujarat,Surat,Mental Illness,6,15,61,37,98
Gujarat,Surat,Mental Illness,15,35,271,143,414
Gujarat,Surat,Mental Illness,35,60,99,53,152
Gujarat,Surat,Mental Illness,60,80,15,15,30
Gujarat,Surat,Mental Illness,80,100,2,0,2
Chhattisgarh,Surajpur,Mental Illness,0,6,3,4,7
Chhattisgarh,Surajpur,Mental Illness,6,15,86,44,130
Chhattisgarh,Surajpur,Mental Illness,15,35,87,78,165
Chhattisgarh,Surajpur,Mental Illness,35,60,20,11,31
Chhattisgarh,Surajpur,Mental Illness,60,80,1,0,1
Chhattisgarh,Surajpur,Mental Illness,80,100,1,0,1
Bihar,Supaul,Mental Illness,0,6,6,2,8
Bihar,Supaul,Mental Illness,6,15,99,47,146
Bihar,Supaul,Mental Illness,15,35,146,71,217
Bihar,Supaul,Mental Illness,35,60,46,17,63
Bihar,Supaul,Mental Illness,60,80,3,2,5
Odisha,Sundargarh,Mental Illness,0,6,40,13,53
Odisha,Sundargarh,Mental Illness,6,15,469,328,797
Odisha,Sundargarh,Mental Illness,15,35,775,552,1327
Odisha,Sundargarh,Mental Illness,35,60,541,386,927
Odisha,Sundargarh,Mental Illness,60,80,75,41,116
Odisha,Sundargarh,Mental Illness,80,100,4,1,5
Uttar Pradesh,Sultanpur,Mental Illness,0,6,2,0,2
Uttar Pradesh,Sultanpur,Mental Illness,6,15,11,4,15
Uttar Pradesh,Sultanpur,Mental Illness,15,35,74,33,107
Uttar Pradesh,Sultanpur,Mental Illness,35,60,45,14,59
Uttar Pradesh,Sultanpur,Mental Illness,60,80,0,1,1
Chhattisgarh,Sukma,Mental Illness,6,15,4,7,11
Chhattisgarh,Sukma,Mental Illness,15,35,10,14,24
Chhattisgarh,Sukma,Mental Illness,35,60,3,5,8
Chhattisgarh,Sukma,Mental Illness,60,80,1,2,3
Jammu And Kashmir,Srinagar,Mental Illness,0,6,3,3,6
Jammu And Kashmir,Srinagar,Mental Illness,6,15,31,19,50
Jammu And Kashmir,Srinagar,Mental Illness,15,35,106,71,177
Jammu And Kashmir,Srinagar,Mental Illness,35,60,155,94,249
Jammu And Kashmir,Srinagar,Mental Illness,60,80,8,3,11
Jammu And Kashmir,Srinagar,Mental Illness,80,100,0,1,1
Andhra Pradesh,Srikakulam,Mental Illness,0,6,1,0,1
Andhra Pradesh,Srikakulam,Mental Illness,6,15,2,3,5
Andhra Pradesh,Srikakulam,Mental Illness,15,35,31,17,48
Andhra Pradesh,Srikakulam,Mental Illness,35,60,90,17,107
Andhra Pradesh,Srikakulam,Mental Illness,60,80,5,0,5
Punjab,Sri Muktsar Sahib,Mental Illness,0,6,13,5,18
Punjab,Sri Muktsar Sahib,Mental Illness,6,15,123,77,200
Punjab,Sri Muktsar Sahib,Mental Illness,15,35,225,143,368
Punjab,Sri Muktsar Sahib,Mental Illness,35,60,107,34,141
Punjab,Sri Muktsar Sahib,Mental Illness,60,80,4,2,6
Punjab,Sri Muktsar Sahib,Mental Illness,80,100,1,0,1
Andhra Pradesh,Spsr Nellore,Mental Illness,6,15,10,8,18
Andhra Pradesh,Spsr Nellore,Mental Illness,15,35,77,49,126
Andhra Pradesh,Spsr Nellore,Mental Illness,35,60,230,76,306
Andhra Pradesh,Spsr Nellore,Mental Illness,60,80,33,9,42
Andhra Pradesh,Spsr Nellore,Mental Illness,80,100,1,0,1
Meghalaya,South West Khasi Hills,Mental Illness,0,6,1,0,1
Meghalaya,South West Khasi Hills,Mental Illness,6,15,5,5,10
Meghalaya,South West Khasi Hills,Mental Illness,15,35,9,5,14
Meghalaya,South West Khasi Hills,Mental Illness,35,60,13,7,20
Meghalaya,South West Khasi Hills,Mental Illness,60,80,3,0,3
Meghalaya,South West Garo Hills,Mental Illness,6,15,6,1,7
Meghalaya,South West Garo Hills,Mental Illness,15,35,18,31,49
Meghalaya,South West Garo Hills,Mental Illness,35,60,6,5,11
Delhi,South West,Mental Illness,6,15,6,1,7
Delhi,South West,Mental Illness,15,35,82,29,111
Delhi,South West,Mental Illness,35,60,55,24,79
Delhi,South West,Mental Illness,60,80,4,3,7
Tripura,South Tripura,Mental Illness,6,15,12,7,19
Tripura,South Tripura,Mental Illness,15,35,29,13,42
Tripura,South Tripura,Mental Illness,35,60,26,7,33
Tripura,South Tripura,Mental Illness,60,80,4,0,4
Assam,South Salmara Mancachar,Mental Illness,6,15,1,0,1
Assam,South Salmara Mancachar,Mental Illness,15,35,3,2,5
Assam,South Salmara Mancachar,Mental Illness,35,60,1,0,1
Goa,South Goa,Mental Illness,6,15,3,9,12
Goa,South Goa,Mental Illness,15,35,24,24,48
Goa,South Goa,Mental Illness,35,60,77,58,135
Goa,South Goa,Mental Illness,60,80,17,18,35
Goa,South Goa,Mental Illness,80,100,1,1,2
Meghalaya,South Garo Hills,Mental Illness,6,15,5,1,6
Meghalaya,South Garo Hills,Mental Illness,15,35,12,7,19
Meghalaya,South Garo Hills,Mental Illness,35,60,2,3,5
Delhi,South East,Mental Illness,6,15,6,3,9
Delhi,South East,Mental Illness,15,35,27,10,37
Delhi,South East,Mental Illness,35,60,10,3,13
Delhi,South East,Mental Illness,60,80,1,1,2
Andaman And Nicobar Islands,South Andamans,Mental Illness,0,6,3,6,9
Andaman And Nicobar Islands,South Andamans,Mental Illness,6,15,88,44,132
Andaman And Nicobar Islands,South Andamans,Mental Illness,15,35,196,144,340
Andaman And Nicobar Islands,South Andamans,Mental Illness,35,60,67,67,134
Andaman And Nicobar Islands,South Andamans,Mental Illness,60,80,2,3,5
Delhi,South,Mental Illness,6,15,4,3,7
Delhi,South,Mental Illness,15,35,39,15,54
Delhi,South,Mental Illness,35,60,25,15,40
Delhi,South,Mental Illness,60,80,0,1,1
Assam,Sonitpur,Mental Illness,6,15,2,0,2
Assam,Sonitpur,Mental Illness,15,35,27,17,44
Assam,Sonitpur,Mental Illness,35,60,51,36,87
Assam,Sonitpur,Mental Illness,60,80,5,1,6
Haryana,Sonipat,Mental Illness,0,6,3,0,3
Haryana,Sonipat,Mental Illness,6,15,23,8,31
Haryana,Sonipat,Mental Illness,15,35,75,32,107
Haryana,Sonipat,Mental Illness,35,60,51,14,65
Haryana,Sonipat,Mental Illness,60,80,2,0,2
Odisha,Sonepur,Mental Illness,0,6,2,0,2
Odisha,Sonepur,Mental Illness,6,15,11,7,18
Odisha,Sonepur,Mental Illness,15,35,84,49,133
Odisha,Sonepur,Mental Illness,35,60,150,84,234
Odisha,Sonepur,Mental Illness,60,80,15,9,24
Uttar Pradesh,Sonbhadra,Mental Illness,6,15,12,3,15
Uttar Pradesh,Sonbhadra,Mental Illness,15,35,55,23,78
Uttar Pradesh,Sonbhadra,Mental Illness,35,60,25,8,33
Uttar Pradesh,Sonbhadra,Mental Illness,60,80,1,0,1
Maharashtra,Solapur,Mental Illness,6,15,2,3,5
Maharashtra,Solapur,Mental Illness,15,35,54,19,73
Maharashtra,Solapur,Mental Illness,35,60,43,22,65
Maharashtra,Solapur,Mental Illness,60,80,4,4,8
Maharashtra,Solapur,Mental Illness,80,100,1,0,1
Himachal Pradesh,Solan,Mental Illness,0,6,3,1,4
Himachal Pradesh,Solan,Mental Illness,6,15,34,16,50
Himachal Pradesh,Solan,Mental Illness,15,35,88,41,129
Himachal Pradesh,Solan,Mental Illness,35,60,84,52,136
Himachal Pradesh,Solan,Mental Illness,60,80,14,8,22
Himachal Pradesh,Solan,Mental Illness,80,100,2,0,2
Bihar,Siwan,Mental Illness,0,6,15,13,28
Bihar,Siwan,Mental Illness,6,15,141,84,225
Bihar,Siwan,Mental Illness,15,35,148,84,232
Bihar,Siwan,Mental Illness,35,60,41,15,56
Bihar,Siwan,Mental Illness,60,80,5,3,8
Bihar,Siwan,Mental Illness,80,100,1,0,1
Assam,Sivasagar,Mental Illness,0,6,2,0,2
Assam,Sivasagar,Mental Illness,6,15,7,4,11
Assam,Sivasagar,Mental Illness,15,35,34,31,65
Assam,Sivasagar,Mental Illness,35,60,18,14,32
Assam,Sivasagar,Mental Illness,60,80,3,2,5
Tamil Nadu,Sivaganga,Mental Illness,0,6,1,1,2
Tamil Nadu,Sivaganga,Mental Illness,6,15,31,16,47
Tamil Nadu,Sivaganga,Mental Illness,15,35,73,73,146
Tamil Nadu,Sivaganga,Mental Illness,35,60,129,102,231
Tamil Nadu,Sivaganga,Mental Illness,60,80,9,8,17
Tamil Nadu,Sivaganga,Mental Illness,80,100,1,0,1
Uttar Pradesh,Sitapur,Mental Illness,0,6,29,7,36
Uttar Pradesh,Sitapur,Mental Illness,6,15,302,139,441
Uttar Pradesh,Sitapur,Mental Illness,15,35,250,115,365
Uttar Pradesh,Sitapur,Mental Illness,35,60,46,26,72
Uttar Pradesh,Sitapur,Mental Illness,60,80,2,2,4
Bihar,Sitamarhi,Mental Illness,0,6,3,1,4
Bihar,Sitamarhi,Mental Illness,6,15,35,19,54
Bihar,Sitamarhi,Mental Illness,15,35,85,34,119
Bihar,Sitamarhi,Mental Illness,35,60,22,13,35
Bihar,Sitamarhi,Mental Illness,60,80,1,3,4
Haryana,Sirsa,Mental Illness,0,6,4,0,4
Haryana,Sirsa,Mental Illness,6,15,84,47,131
Haryana,Sirsa,Mental Illness,15,35,224,112,336
Haryana,Sirsa,Mental Illness,35,60,164,64,228
Haryana,Sirsa,Mental Illness,60,80,30,19,49
Haryana,Sirsa,Mental Illness,80,100,1,1,2
Rajasthan,Sirohi,Mental Illness,0,6,3,0,3
Rajasthan,Sirohi,Mental Illness,6,15,23,14,37
Rajasthan,Sirohi,Mental Illness,15,35,151,72,223
Rajasthan,Sirohi,Mental Illness,35,60,99,45,144
Rajasthan,Sirohi,Mental Illness,60,80,10,10,20
Rajasthan,Sirohi,Mental Illness,80,100,0,3,3
Himachal Pradesh,Sirmaur,Mental Illness,0,6,13,6,19
Himachal Pradesh,Sirmaur,Mental Illness,6,15,92,61,153
Himachal Pradesh,Sirmaur,Mental Illness,15,35,204,100,304
Himachal Pradesh,Sirmaur,Mental Illness,35,60,87,49,136
Himachal Pradesh,Sirmaur,Mental Illness,60,80,8,1,9
Madhya Pradesh,Singrauli,Mental Illness,0,6,2,0,2
Madhya Pradesh,Singrauli,Mental Illness,6,15,107,85,192
Madhya Pradesh,Singrauli,Mental Illness,15,35,265,168,433
Madhya Pradesh,Singrauli,Mental Illness,35,60,72,43,115
Madhya Pradesh,Singrauli,Mental Illness,60,80,3,4,7
Maharashtra,Sindhudurg,Mental Illness,0,6,1,0,1
Maharashtra,Sindhudurg,Mental Illness,6,15,21,18,39
Maharashtra,Sindhudurg,Mental Illness,15,35,137,81,218
Maharashtra,Sindhudurg,Mental Illness,35,60,83,34,117
Maharashtra,Sindhudurg,Mental Illness,60,80,11,4,15
Jharkhand,Simdega,Mental Illness,6,15,1,0,1
Jharkhand,Simdega,Mental Illness,15,35,14,11,25
Jharkhand,Simdega,Mental Illness,35,60,0,3,3
Jharkhand,Simdega,Mental Illness,60,80,1,0,1
Jharkhand,Simdega,Mental Illness,80,100,1,0,1
Rajasthan,Sikar,Mental Illness,6,15,26,15,41
Rajasthan,Sikar,Mental Illness,15,35,258,94,352
Rajasthan,Sikar,Mental Illness,35,60,128,27,155
Rajasthan,Sikar,Mental Illness,60,80,7,5,12
Madhya Pradesh,Sidhi,Mental Illness,0,6,15,3,18
Madhya Pradesh,Sidhi,Mental Illness,6,15,109,65,174
Madhya Pradesh,Sidhi,Mental Illness,15,35,246,120,366
Madhya Pradesh,Sidhi,Mental Illness,35,60,128,45,173
Madhya Pradesh,Sidhi,Mental Illness,60,80,8,5,13
Telangana,Siddipet,Mental Illness,6,15,4,0,4
Telangana,Siddipet,Mental Illness,15,35,201,119,320
Telangana,Siddipet,Mental Illness,35,60,319,179,498
Telangana,Siddipet,Mental Illness,60,80,42,36,78
Telangana,Siddipet,Mental Illness,80,100,1,0,1
Uttar Pradesh,Siddharth Nagar,Mental Illness,0,6,5,2,7
Uttar Pradesh,Siddharth Nagar,Mental Illness,6,15,43,21,64
Uttar Pradesh,Siddharth Nagar,Mental Illness,15,35,142,76,218
Uttar Pradesh,Siddharth Nagar,Mental Illness,35,60,37,15,52
Uttar Pradesh,Siddharth Nagar,Mental Illness,60,80,4,2,6
Uttar Pradesh,Shravasti,Mental Illness,0,6,1,1,2
Uttar Pradesh,Shravasti,Mental Illness,6,15,11,7,18
Uttar Pradesh,Shravasti,Mental Illness,15,35,19,14,33
Uttar Pradesh,Shravasti,Mental Illness,35,60,9,1,10
Uttar Pradesh,Shravasti,Mental Illness,60,80,1,0,1
Uttar Pradesh,Shravasti,Mental Illness,80,100,0,1,1
Jammu And Kashmir,Shopian,Mental Illness,0,6,14,12,26
Jammu And Kashmir,Shopian,Mental Illness,6,15,62,47,109
Jammu And Kashmir,Shopian,Mental Illness,15,35,140,118,258
Jammu And Kashmir,Shopian,Mental Illness,35,60,73,75,148
Jammu And Kashmir,Shopian,Mental Illness,60,80,4,4,8
Madhya Pradesh,Shivpuri,Mental Illness,0,6,1,4,5
Madhya Pradesh,Shivpuri,Mental Illness,6,15,43,25,68
Madhya Pradesh,Shivpuri,Mental Illness,15,35,111,37,148
Madhya Pradesh,Shivpuri,Mental Illness,35,60,26,9,35
Madhya Pradesh,Shivpuri,Mental Illness,60,80,3,3,6
Karnataka,Shivamogga,Mental Illness,0,6,5,6,11
Karnataka,Shivamogga,Mental Illness,6,15,117,101,218
Karnataka,Shivamogga,Mental Illness,15,35,351,220,571
Karnataka,Shivamogga,Mental Illness,35,60,162,147,309
Karnataka,Shivamogga,Mental Illness,60,80,19,10,29
Karnataka,Shivamogga,Mental Illness,80,100,1,0,1
Himachal Pradesh,Shimla,Mental Illness,0,6,0,1,1
Himachal Pradesh,Shimla,Mental Illness,6,15,18,14,32
Himachal Pradesh,Shimla,Mental Illness,15,35,75,54,129
Himachal Pradesh,Shimla,Mental Illness,35,60,68,24,92
Himachal Pradesh,Shimla,Mental Illness,60,80,9,7,16
Himachal Pradesh,Shimla,Mental Illness,80,100,2,1,3
Madhya Pradesh,Sheopur,Mental Illness,0,6,0,1,1
Madhya Pradesh,Sheopur,Mental Illness,6,15,28,36,64
Madhya Pradesh,Sheopur,Mental Illness,15,35,142,70,212
Madhya Pradesh,Sheopur,Mental Illness,35,60,60,22,82
Madhya Pradesh,Sheopur,Mental Illness,60,80,4,0,4
Bihar,Sheohar,Mental Illness,0,6,5,6,11
Bihar,Sheohar,Mental Illness,6,15,49,24,73
Bihar,Sheohar,Mental Illness,15,35,45,12,57
Bihar,Sheohar,Mental Illness,35,60,8,5,13
Bihar,Sheohar,Mental Illness,60,80,2,0,2
Bihar,Sheikhpura,Mental Illness,0,6,1,0,1
Bihar,Sheikhpura,Mental Illness,6,15,16,9,25
Bihar,Sheikhpura,Mental Illness,15,35,40,23,63
Bihar,Sheikhpura,Mental Illness,35,60,18,3,21
Bihar,Sheikhpura,Mental Illness,60,80,1,0,1
Uttar Pradesh,Shamli,Mental Illness,0,6,1,2,3
Uttar Pradesh,Shamli,Mental Illness,6,15,40,21,61
Uttar Pradesh,Shamli,Mental Illness,15,35,92,41,133
Uttar Pradesh,Shamli,Mental Illness,35,60,18,9,27
Uttar Pradesh,Shamli,Mental Illness,60,80,1,0,1
Madhya Pradesh,Shajapur,Mental Illness,6,15,8,7,15
Madhya Pradesh,Shajapur,Mental Illness,15,35,29,23,52
Madhya Pradesh,Shajapur,Mental Illness,35,60,24,17,41
Madhya Pradesh,Shajapur,Mental Illness,60,80,1,4,5
Uttar Pradesh,Shahjahanpur,Mental Illness,0,6,12,6,18
Uttar Pradesh,Shahjahanpur,Mental Illness,6,15,183,97,280
Uttar Pradesh,Shahjahanpur,Mental Illness,15,35,412,194,606
Uttar Pradesh,Shahjahanpur,Mental Illness,35,60,109,57,166
Uttar Pradesh,Shahjahanpur,Mental Illness,60,80,8,7,15
Punjab,Shahid Bhagat Singh Nagar,Mental Illness,6,15,32,18,50
Punjab,Shahid Bhagat Singh Nagar,Mental Illness,15,35,197,105,302
Punjab,Shahid Bhagat Singh Nagar,Mental Illness,35,60,121,64,185
Punjab,Shahid Bhagat Singh Nagar,Mental Illness,60,80,12,4,16
Punjab,Shahid Bhagat Singh Nagar,Mental Illness,80,100,3,0,3
Madhya Pradesh,Shahdol,Mental Illness,0,6,5,5,10
Madhya Pradesh,Shahdol,Mental Illness,6,15,81,42,123
Madhya Pradesh,Shahdol,Mental Illness,15,35,163,122,285
Madhya Pradesh,Shahdol,Mental Illness,35,60,117,52,169
Madhya Pradesh,Shahdol,Mental Illness,60,80,23,6,29
Madhya Pradesh,Shahdol,Mental Illness,80,100,3,0,3
Delhi,Shahdara,Mental Illness,15,35,3,4,7
Delhi,Shahdara,Mental Illness,35,60,12,7,19
Delhi,Shahdara,Mental Illness,60,80,1,0,1
Mizoram,Serchhip,Mental Illness,6,15,1,0,1
Mizoram,Serchhip,Mental Illness,15,35,7,2,9
Mizoram,Serchhip,Mental Illness,35,60,2,0,2
Mizoram,Serchhip,Mental Illness,60,80,1,1,2
Tripura,Sepahijala,Mental Illness,15,35,6,7,13
Tripura,Sepahijala,Mental Illness,35,60,24,6,30
Tripura,Sepahijala,Mental Illness,60,80,0,1,1
Madhya Pradesh,Seoni,Mental Illness,0,6,2,2,4
Madhya Pradesh,Seoni,Mental Illness,6,15,100,100,200
Madhya Pradesh,Seoni,Mental Illness,15,35,295,215,510
Madhya Pradesh,Seoni,Mental Illness,35,60,134,84,218
Madhya Pradesh,Seoni,Mental Illness,60,80,17,7,24
Manipur,Senapati,Mental Illness,6,15,5,0,5
Manipur,Senapati,Mental Illness,15,35,3,2,5
Manipur,Senapati,Mental Illness,35,60,5,4,9
Manipur,Senapati,Mental Illness,60,80,1,1,2
Madhya Pradesh,Sehore,Mental Illness,0,6,6,4,10
Madhya Pradesh,Sehore,Mental Illness,6,15,69,45,114
Madhya Pradesh,Sehore,Mental Illness,15,35,226,127,353
Madhya Pradesh,Sehore,Mental Illness,35,60,195,80,275
Madhya Pradesh,Sehore,Mental Illness,60,80,31,20,51
Madhya Pradesh,Sehore,Mental Illness,80,100,1,0,1
Rajasthan,Sawai Madhopur,Mental Illness,0,6,3,1,4
Rajasthan,Sawai Madhopur,Mental Illness,6,15,50,24,74
Rajasthan,Sawai Madhopur,Mental Illness,15,35,63,33,96
Rajasthan,Sawai Madhopur,Mental Illness,35,60,18,5,23
Rajasthan,Sawai Madhopur,Mental Illness,60,80,3,0,3
Madhya Pradesh,Satna,Mental Illness,0,6,2,2,4
Madhya Pradesh,Satna,Mental Illness,6,15,187,133,320
Madhya Pradesh,Satna,Mental Illness,15,35,626,343,969
Madhya Pradesh,Satna,Mental Illness,35,60,353,108,461
Madhya Pradesh,Satna,Mental Illness,60,80,32,13,45
Madhya Pradesh,Satna,Mental Illness,80,100,2,1,3
Maharashtra,Satara,Mental Illness,6,15,8,9,17
Maharashtra,Satara,Mental Illness,15,35,97,53,150
Maharashtra,Satara,Mental Illness,35,60,127,70,197
Maharashtra,Satara,Mental Illness,60,80,18,9,27
Maharashtra,Satara,Mental Illness,80,100,0,1,1
Bihar,Saran,Mental Illness,0,6,5,0,5
Bihar,Saran,Mental Illness,6,15,74,42,116
Bihar,Saran,Mental Illness,15,35,189,107,296
Bihar,Saran,Mental Illness,35,60,89,52,141
Bihar,Saran,Mental Illness,60,80,26,17,43
Bihar,Saran,Mental Illness,80,100,5,0,5
Jharkhand,Saraikela Kharsawan,Mental Illness,0,6,0,1,1
Jharkhand,Saraikela Kharsawan,Mental Illness,6,15,27,11,38
Jharkhand,Saraikela Kharsawan,Mental Illness,15,35,32,31,63
Jharkhand,Saraikela Kharsawan,Mental Illness,35,60,11,13,24
Jharkhand,Saraikela Kharsawan,Mental Illness,60,80,1,1,2
Uttar Pradesh,Sant Kabeer Nagar,Mental Illness,6,15,8,6,14
Uttar Pradesh,Sant Kabeer Nagar,Mental Illness,15,35,68,20,88
Uttar Pradesh,Sant Kabeer Nagar,Mental Illness,35,60,17,8,25
Uttar Pradesh,Sant Kabeer Nagar,Mental Illness,60,80,1,0,1
Uttar Pradesh,Sant Kabeer Nagar,Mental Illness,80,100,0,1,1
Punjab,Sangrur,Mental Illness,0,6,10,5,15
Punjab,Sangrur,Mental Illness,6,15,193,132,325
Punjab,Sangrur,Mental Illness,15,35,472,271,743
Punjab,Sangrur,Mental Illness,35,60,242,102,344
Punjab,Sangrur,Mental Illness,60,80,21,4,25
Maharashtra,Sangli,Mental Illness,6,15,12,0,12
Maharashtra,Sangli,Mental Illness,15,35,56,29,85
Maharashtra,Sangli,Mental Illness,35,60,58,30,88
Maharashtra,Sangli,Mental Illness,60,80,5,1,6
Telangana,Sangareddy,Mental Illness,15,35,60,37,97
Telangana,Sangareddy,Mental Illness,35,60,142,64,206
Telangana,Sangareddy,Mental Illness,60,80,25,16,41
Telangana,Sangareddy,Mental Illness,80,100,0,2,2
Uttar Pradesh,Sambhal,Mental Illness,0,6,0,1,1
Uttar Pradesh,Sambhal,Mental Illness,6,15,15,6,21
Uttar Pradesh,Sambhal,Mental Illness,15,35,58,14,72
Uttar Pradesh,Sambhal,Mental Illness,35,60,11,4,15
Uttar Pradesh,Sambhal,Mental Illness,60,80,2,0,2
Odisha,Sambalpur,Mental Illness,0,6,5,1,6
Odisha,Sambalpur,Mental Illness,6,15,50,38,88
Odisha,Sambalpur,Mental Illness,15,35,152,123,275
Odisha,Sambalpur,Mental Illness,35,60,128,79,207
Odisha,Sambalpur,Mental Illness,60,80,9,5,14
Odisha,Sambalpur,Mental Illness,80,100,1,1,2
Jammu And Kashmir,Samba,Mental Illness,0,6,0,1,1
Jammu And Kashmir,Samba,Mental Illness,6,15,9,4,13
Jammu And Kashmir,Samba,Mental Illness,15,35,50,31,81
Jammu And Kashmir,Samba,Mental Illness,35,60,37,22,59
Jammu And Kashmir,Samba,Mental Illness,60,80,2,3,5
Jammu And Kashmir,Samba,Mental Illness,80,100,1,0,1
Bihar,Samastipur,Mental Illness,0,6,12,3,15
Bihar,Samastipur,Mental Illness,6,15,81,50,131
Bihar,Samastipur,Mental Illness,15,35,331,153,484
Bihar,Samastipur,Mental Illness,35,60,184,50,234
Bihar,Samastipur,Mental Illness,60,80,14,8,22
Bihar,Samastipur,Mental Illness,80,100,1,0,1
Tamil Nadu,Salem,Mental Illness,0,6,0,1,1
Tamil Nadu,Salem,Mental Illness,6,15,27,12,39
Tamil Nadu,Salem,Mental Illness,15,35,111,73,184
Tamil Nadu,Salem,Mental Illness,35,60,99,63,162
Tamil Nadu,Salem,Mental Illness,60,80,5,14,19
Mizoram,Saiha,Mental Illness,15,35,2,2,4
Mizoram,Saiha,Mental Illness,35,60,6,2,8
Jharkhand,Sahebganj,Mental Illness,0,6,4,2,6
Jharkhand,Sahebganj,Mental Illness,6,15,47,41,88
Jharkhand,Sahebganj,Mental Illness,15,35,59,58,117
Jharkhand,Sahebganj,Mental Illness,35,60,30,20,50
Bihar,Saharsa,Mental Illness,0,6,0,1,1
Bihar,Saharsa,Mental Illness,6,15,26,10,36
Bihar,Saharsa,Mental Illness,15,35,49,21,70
Bihar,Saharsa,Mental Illness,35,60,20,1,21
Bihar,Saharsa,Mental Illness,60,80,3,1,4
Uttar Pradesh,Saharanpur,Mental Illness,0,6,6,2,8
Uttar Pradesh,Saharanpur,Mental Illness,6,15,62,43,105
Uttar Pradesh,Saharanpur,Mental Illness,15,35,227,105,332
Uttar Pradesh,Saharanpur,Mental Illness,35,60,74,28,102
Uttar Pradesh,Saharanpur,Mental Illness,60,80,6,2,8
Madhya Pradesh,Sagar,Mental Illness,0,6,1,1,2
Madhya Pradesh,Sagar,Mental Illness,6,15,139,107,246
Madhya Pradesh,Sagar,Mental Illness,15,35,473,280,753
Madhya Pradesh,Sagar,Mental Illness,35,60,207,125,332
Madhya Pradesh,Sagar,Mental Illness,60,80,35,18,53
Madhya Pradesh,Sagar,Mental Illness,80,100,2,1,3
Gujarat,Sabar Kantha,Mental Illness,6,15,25,17,42
Gujarat,Sabar Kantha,Mental Illness,15,35,106,52,158
Gujarat,Sabar Kantha,Mental Illness,35,60,81,36,117
Gujarat,Sabar Kantha,Mental Illness,60,80,10,4,14
Punjab,S.A.S Nagar,Mental Illness,0,6,6,3,9
Punjab,S.A.S Nagar,Mental Illness,6,15,81,39,120
Punjab,S.A.S Nagar,Mental Illness,15,35,242,135,377
Punjab,S.A.S Nagar,Mental Illness,35,60,160,63,223
Punjab,S.A.S Nagar,Mental Illness,60,80,23,1,24
Punjab,S.A.S Nagar,Mental Illness,80,100,1,3,4
Punjab,Rupnagar,Mental Illness,6,15,38,32,70
Punjab,Rupnagar,Mental Illness,15,35,152,63,215
Punjab,Rupnagar,Mental Illness,35,60,109,45,154
Punjab,Rupnagar,Mental Illness,60,80,15,1,16
Punjab,Rupnagar,Mental Illness,80,100,2,0,2
Uttarakhand,Rudra Prayag,Mental Illness,0,6,0,2,2
Uttarakhand,Rudra Prayag,Mental Illness,6,15,1,2,3
Uttarakhand,Rudra Prayag,Mental Illness,15,35,17,12,29
Uttarakhand,Rudra Prayag,Mental Illness,35,60,14,4,18
Uttarakhand,Rudra Prayag,Mental Illness,60,80,1,0,1
Bihar,Rohtas,Mental Illness,0,6,11,2,13
Bihar,Rohtas,Mental Illness,6,15,127,72,199
Bihar,Rohtas,Mental Illness,15,35,157,77,234
Bihar,Rohtas,Mental Illness,35,60,28,19,47
Bihar,Rohtas,Mental Illness,60,80,5,4,9
Bihar,Rohtas,Mental Illness,80,100,0,1,1
Haryana,Rohtak,Mental Illness,0,6,1,0,1
Haryana,Rohtak,Mental Illness,6,15,23,11,34
Haryana,Rohtak,Mental Illness,15,35,316,121,437
Haryana,Rohtak,Mental Illness,35,60,322,130,452
Haryana,Rohtak,Mental Illness,60,80,25,31,56
Haryana,Rohtak,Mental Illness,80,100,0,2,2
Meghalaya,Ri Bhoi,Mental Illness,6,15,0,1,1
Meghalaya,Ri Bhoi,Mental Illness,15,35,11,11,22
Meghalaya,Ri Bhoi,Mental Illness,35,60,21,25,46
Meghalaya,Ri Bhoi,Mental Illness,60,80,2,5,7
Meghalaya,Ri Bhoi,Mental Illness,80,100,0,1,1
Haryana,Rewari,Mental Illness,0,6,5,6,11
Haryana,Rewari,Mental Illness,6,15,43,16,59
Haryana,Rewari,Mental Illness,15,35,87,46,133
Haryana,Rewari,Mental Illness,35,60,52,14,66
Haryana,Rewari,Mental Illness,60,80,3,3,6
Madhya Pradesh,Rewa,Mental Illness,0,6,1,0,1
Madhya Pradesh,Rewa,Mental Illness,6,15,82,45,127
Madhya Pradesh,Rewa,Mental Illness,15,35,345,169,514
Madhya Pradesh,Rewa,Mental Illness,35,60,319,78,397
Madhya Pradesh,Rewa,Mental Illness,60,80,35,14,49
Madhya Pradesh,Rewa,Mental Illness,80,100,3,1,4
Jammu And Kashmir,Reasi,Mental Illness,0,6,0,1,1
Jammu And Kashmir,Reasi,Mental Illness,6,15,10,5,15
Jammu And Kashmir,Reasi,Mental Illness,15,35,23,10,33
Jammu And Kashmir,Reasi,Mental Illness,35,60,18,7,25
Jammu And Kashmir,Reasi,Mental Illness,60,80,0,1,1
Odisha,Rayagada,Mental Illness,0,6,10,6,16
Odisha,Rayagada,Mental Illness,6,15,199,142,341
Odisha,Rayagada,Mental Illness,15,35,444,350,794
Odisha,Rayagada,Mental Illness,35,60,185,153,338
Odisha,Rayagada,Mental Illness,60,80,13,18,31
Odisha,Rayagada,Mental Illness,80,100,1,1,2
Maharashtra,Ratnagiri,Mental Illness,6,15,39,34,73
Maharashtra,Ratnagiri,Mental Illness,15,35,349,178,527
Maharashtra,Ratnagiri,Mental Illness,35,60,245,178,423
Maharashtra,Ratnagiri,Mental Illness,60,80,17,15,32
Maharashtra,Ratnagiri,Mental Illness,80,100,0,3,3
Madhya Pradesh,Ratlam,Mental Illness,6,15,43,21,64
Madhya Pradesh,Ratlam,Mental Illness,15,35,107,57,164
Madhya Pradesh,Ratlam,Mental Illness,35,60,84,33,117
Madhya Pradesh,Ratlam,Mental Illness,60,80,5,5,10
Tamil Nadu,Ranipet,Mental Illness,0,6,3,3,6
Tamil Nadu,Ranipet,Mental Illness,6,15,40,24,64
Tamil Nadu,Ranipet,Mental Illness,15,35,158,109,267
Tamil Nadu,Ranipet,Mental Illness,35,60,124,89,213
Tamil Nadu,Ranipet,Mental Illness,60,80,15,7,22
Telangana,Ranga Reddy,Mental Illness,6,15,0,1,1
Telangana,Ranga Reddy,Mental Illness,15,35,135,89,224
Telangana,Ranga Reddy,Mental Illness,35,60,120,104,224
Telangana,Ranga Reddy,Mental Illness,60,80,32,25,57
Telangana,Ranga Reddy,Mental Illness,80,100,1,1,2
Jharkhand,Ranchi,Mental Illness,6,15,4,10,14
Jharkhand,Ranchi,Mental Illness,15,35,14,9,23
Jharkhand,Ranchi,Mental Illness,35,60,13,5,18
Uttar Pradesh,Rampur,Mental Illness,0,6,8,3,11
Uttar Pradesh,Rampur,Mental Illness,6,15,85,69,154
Uttar Pradesh,Rampur,Mental Illness,15,35,151,75,226
Uttar Pradesh,Rampur,Mental Illness,35,60,46,8,54
Uttar Pradesh,Rampur,Mental Illness,60,80,2,0,2
Uttar Pradesh,Rampur,Mental Illness,80,100,1,0,1
Jharkhand,Ramgarh,Mental Illness,0,6,9,5,14
Jharkhand,Ramgarh,Mental Illness,6,15,55,45,100
Jharkhand,Ramgarh,Mental Illness,15,35,193,128,321
Jharkhand,Ramgarh,Mental Illness,35,60,101,66,167
Jharkhand,Ramgarh,Mental Illness,60,80,20,3,23
Jharkhand,Ramgarh,Mental Illness,80,100,1,0,1
Jammu And Kashmir,Ramban,Mental Illness,0,6,0,1,1
Jammu And Kashmir,Ramban,Mental Illness,6,15,7,9,16
Jammu And Kashmir,Ramban,Mental Illness,15,35,54,25,79
Jammu And Kashmir,Ramban,Mental Illness,35,60,22,15,37
Jammu And Kashmir,Ramban,Mental Illness,60,80,1,1,2
Tamil Nadu,Ramanathapuram,Mental Illness,6,15,1,1,2
Tamil Nadu,Ramanathapuram,Mental Illness,15,35,33,31,64
Tamil Nadu,Ramanathapuram,Mental Illness,35,60,160,102,262
Tamil Nadu,Ramanathapuram,Mental Illness,60,80,26,10,36
Tamil Nadu,Ramanathapuram,Mental Illness,80,100,1,3,4
Karnataka,Ramanagara,Mental Illness,0,6,2,2,4
Karnataka,Ramanagara,Mental Illness,6,15,17,4,21
Karnataka,Ramanagara,Mental Illness,15,35,46,28,74
Karnataka,Ramanagara,Mental Illness,35,60,79,51,130
Karnataka,Ramanagara,Mental Illness,60,80,9,4,13
Rajasthan,Rajsamand,Mental Illness,0,6,4,5,9
Rajasthan,Rajsamand,Mental Illness,6,15,86,45,131
Rajasthan,Rajsamand,Mental Illness,15,35,207,131,338
Rajasthan,Rajsamand,Mental Illness,35,60,103,54,157
Rajasthan,Rajsamand,Mental Illness,60,80,4,6,10
Rajasthan,Rajsamand,Mental Illness,80,100,0,1,1
Jammu And Kashmir,Rajouri,Mental Illness,0,6,4,7,11
Jammu And Kashmir,Rajouri,Mental Illness,6,15,72,35,107
Jammu And Kashmir,Rajouri,Mental Illness,15,35,226,163,389
Jammu And Kashmir,Rajouri,Mental Illness,35,60,158,94,252
Jammu And Kashmir,Rajouri,Mental Illness,60,80,10,6,16
Jammu And Kashmir,Rajouri,Mental Illness,80,100,0,1,1
Chhattisgarh,Rajnandgaon,Mental Illness,0,6,0,1,1
Chhattisgarh,Rajnandgaon,Mental Illness,6,15,80,60,140
Chhattisgarh,Rajnandgaon,Mental Illness,15,35,290,243,533
Chhattisgarh,Rajnandgaon,Mental Illness,35,60,106,95,201
Chhattisgarh,Rajnandgaon,Mental Illness,60,80,14,7,21
Gujarat,Rajkot,Mental Illness,6,15,4,3,7
Gujarat,Rajkot,Mental Illness,15,35,71,20,91
Gujarat,Rajkot,Mental Illness,35,60,185,80,265
Gujarat,Rajkot,Mental Illness,60,80,45,19,64
Gujarat,Rajkot,Mental Illness,80,100,1,0,1
Madhya Pradesh,Rajgarh,Mental Illness,0,6,1,3,4
Madhya Pradesh,Rajgarh,Mental Illness,6,15,127,79,206
Madhya Pradesh,Rajgarh,Mental Illness,15,35,306,167,473
Madhya Pradesh,Rajgarh,Mental Illness,35,60,184,79,263
Madhya Pradesh,Rajgarh,Mental Illness,60,80,24,17,41
Madhya Pradesh,Rajgarh,Mental Illness,80,100,1,1,2
Telangana,Rajanna Sircilla,Mental Illness,6,15,1,0,1
Telangana,Rajanna Sircilla,Mental Illness,15,35,63,52,115
Telangana,Rajanna Sircilla,Mental Illness,35,60,149,92,241
Telangana,Rajanna Sircilla,Mental Illness,60,80,37,34,71
Telangana,Rajanna Sircilla,Mental Illness,80,100,1,0,1
Madhya Pradesh,Raisen,Mental Illness,0,6,15,7,22
Madhya Pradesh,Raisen,Mental Illness,6,15,119,75,194
Madhya Pradesh,Raisen,Mental Illness,15,35,230,131,361
Madhya Pradesh,Raisen,Mental Illness,35,60,106,43,149
Madhya Pradesh,Raisen,Mental Illness,60,80,15,8,23
Madhya Pradesh,Raisen,Mental Illness,80,100,1,1,2
Chhattisgarh,Raipur,Mental Illness,0,6,0,1,1
Chhattisgarh,Raipur,Mental Illness,6,15,13,10,23
Chhattisgarh,Raipur,Mental Illness,15,35,53,28,81
Chhattisgarh,Raipur,Mental Illness,35,60,24,8,32
Chhattisgarh,Raipur,Mental Illness,60,80,1,2,3
Chhattisgarh,Raigarh,Mental Illness,0,6,0,1,1
Chhattisgarh,Raigarh,Mental Illness,6,15,11,8,19
Chhattisgarh,Raigarh,Mental Illness,15,35,33,32,65
Chhattisgarh,Raigarh,Mental Illness,35,60,27,30,57
Chhattisgarh,Raigarh,Mental Illness,60,80,4,4,8
Chhattisgarh,Raigarh,Mental Illness,80,100,0,1,1
Maharashtra,Raigad,Mental Illness,0,6,1,0,1
Maharashtra,Raigad,Mental Illness,6,15,38,14,52
Maharashtra,Raigad,Mental Illness,15,35,151,85,236
Maharashtra,Raigad,Mental Illness,35,60,177,98,275
Maharashtra,Raigad,Mental Illness,60,80,39,20,59
Maharashtra,Raigad,Mental Illness,80,100,1,1,2
Karnataka,Raichur,Mental Illness,0,6,5,2,7
Karnataka,Raichur,Mental Illness,6,15,20,12,32
Karnataka,Raichur,Mental Illness,15,35,116,108,224
Karnataka,Raichur,Mental Illness,35,60,90,57,147
Karnataka,Raichur,Mental Illness,60,80,6,8,14
Uttar Pradesh,Rae Bareli,Mental Illness,0,6,1,0,1
Uttar Pradesh,Rae Bareli,Mental Illness,6,15,22,6,28
Uttar Pradesh,Rae Bareli,Mental Illness,15,35,100,74,174
Uttar Pradesh,Rae Bareli,Mental Illness,35,60,35,14,49
Uttar Pradesh,Rae Bareli,Mental Illness,60,80,3,1,4
Bihar,Purnia,Mental Illness,0,6,9,4,13
Bihar,Purnia,Mental Illness,6,15,86,68,154
Bihar,Purnia,Mental Illness,15,35,139,97,236
Bihar,Purnia,Mental Illness,35,60,48,27,75
Bihar,Purnia,Mental Illness,60,80,6,1,7
Odisha,Puri,Mental Illness,0,6,50,28,78
Odisha,Puri,Mental Illness,6,15,362,216,578
Odisha,Puri,Mental Illness,15,35,989,658,1647
Odisha,Puri,Mental Illness,35,60,1118,629,1747
Odisha,Puri,Mental Illness,60,80,124,92,216
Odisha,Puri,Mental Illness,80,100,2,4,6
Bihar,Purbi Champaran,Mental Illness,0,6,15,10,25
Bihar,Purbi Champaran,Mental Illness,6,15,123,78,201
Bihar,Purbi Champaran,Mental Illness,15,35,161,66,227
Bihar,Purbi Champaran,Mental Illness,35,60,56,42,98
Bihar,Purbi Champaran,Mental Illness,60,80,11,0,11
Maharashtra,Pune,Mental Illness,0,6,1,3,4
Maharashtra,Pune,Mental Illness,6,15,19,7,26
Maharashtra,Pune,Mental Illness,15,35,342,140,482
Maharashtra,Pune,Mental Illness,35,60,554,275,829
Maharashtra,Pune,Mental Illness,60,80,75,59,134
Maharashtra,Pune,Mental Illness,80,100,4,6,10
Jammu And Kashmir,Pulwama,Mental Illness,0,6,6,5,11
Jammu And Kashmir,Pulwama,Mental Illness,6,15,39,34,73
Jammu And Kashmir,Pulwama,Mental Illness,15,35,147,149,296
Jammu And Kashmir,Pulwama,Mental Illness,35,60,228,190,418
Jammu And Kashmir,Pulwama,Mental Illness,60,80,28,11,39
Jammu And Kashmir,Pulwama,Mental Illness,80,100,0,2,2
Tamil Nadu,Pudukkottai,Mental Illness,6,15,8,4,12
Tamil Nadu,Pudukkottai,Mental Illness,15,35,32,25,57
Tamil Nadu,Pudukkottai,Mental Illness,35,60,115,84,199
Tamil Nadu,Pudukkottai,Mental Illness,60,80,19,18,37
Tamil Nadu,Pudukkottai,Mental Illness,80,100,0,1,1
Uttar Pradesh,Prayagraj,Mental Illness,0,6,19,12,31
Uttar Pradesh,Prayagraj,Mental Illness,6,15,195,92,287
Uttar Pradesh,Prayagraj,Mental Illness,15,35,425,175,600
Uttar Pradesh,Prayagraj,Mental Illness,35,60,157,57,214
Uttar Pradesh,Prayagraj,Mental Illness,60,80,19,7,26
Rajasthan,Pratapgarh,Mental Illness,0,6,2,0,2
Rajasthan,Pratapgarh,Mental Illness,6,15,59,34,93
Rajasthan,Pratapgarh,Mental Illness,15,35,169,104,273
Rajasthan,Pratapgarh,Mental Illness,35,60,120,35,155
Rajasthan,Pratapgarh,Mental Illness,60,80,21,12,33
Rajasthan,Pratapgarh,Mental Illness,80,100,1,1,2
Uttar Pradesh,Pratapgarh,Mental Illness,6,15,9,8,17
Uttar Pradesh,Pratapgarh,Mental Illness,15,35,101,57,158
Uttar Pradesh,Pratapgarh,Mental Illness,35,60,54,35,89
Uttar Pradesh,Pratapgarh,Mental Illness,60,80,3,2,5
Andhra Pradesh,Prakasam,Mental Illness,0,6,1,0,1
Andhra Pradesh,Prakasam,Mental Illness,6,15,12,12,24
Andhra Pradesh,Prakasam,Mental Illness,15,35,128,66,194
Andhra Pradesh,Prakasam,Mental Illness,35,60,412,98,510
Andhra Pradesh,Prakasam,Mental Illness,60,80,46,10,56
Andhra Pradesh,Prakasam,Mental Illness,80,100,2,1,3
Gujarat,Porbandar,Mental Illness,6,15,5,5,10
Gujarat,Porbandar,Mental Illness,15,35,80,36,116
Gujarat,Porbandar,Mental Illness,35,60,113,44,157
Gujarat,Porbandar,Mental Illness,60,80,28,10,38
Jammu And Kashmir,Poonch,Mental Illness,0,6,26,13,39
Jammu And Kashmir,Poonch,Mental Illness,6,15,103,72,175
Jammu And Kashmir,Poonch,Mental Illness,15,35,211,176,387
Jammu And Kashmir,Poonch,Mental Illness,35,60,148,94,242
Jammu And Kashmir,Poonch,Mental Illness,60,80,3,6,9
Puducherry,Pondicherry,Mental Illness,6,15,7,3,10
Puducherry,Pondicherry,Mental Illness,15,35,38,30,68
Puducherry,Pondicherry,Mental Illness,35,60,82,59,141
Puducherry,Pondicherry,Mental Illness,60,80,3,3,6
Puducherry,Pondicherry,Mental Illness,80,100,1,1,2
Uttarakhand,Pithoragarh,Mental Illness,0,6,1,0,1
Uttarakhand,Pithoragarh,Mental Illness,6,15,13,5,18
Uttarakhand,Pithoragarh,Mental Illness,15,35,22,13,35
Uttarakhand,Pithoragarh,Mental Illness,35,60,32,8,40
Uttarakhand,Pithoragarh,Mental Illness,60,80,4,1,5
Uttarakhand,Pithoragarh,Mental Illness,80,100,1,0,1
Uttar Pradesh,Pilibhit,Mental Illness,0,6,5,0,5
Uttar Pradesh,Pilibhit,Mental Illness,6,15,99,52,151
Uttar Pradesh,Pilibhit,Mental Illness,15,35,258,149,407
Uttar Pradesh,Pilibhit,Mental Illness,35,60,52,30,82
Uttar Pradesh,Pilibhit,Mental Illness,60,80,5,0,5
Nagaland,Phek,Mental Illness,15,35,2,1,3
Nagaland,Phek,Mental Illness,60,80,1,0,1
Tamil Nadu,Perambalur,Mental Illness,0,6,3,1,4
Tamil Nadu,Perambalur,Mental Illness,6,15,0,1,1
Tamil Nadu,Perambalur,Mental Illness,15,35,35,16,51
Tamil Nadu,Perambalur,Mental Illness,35,60,125,58,183
Tamil Nadu,Perambalur,Mental Illness,60,80,14,9,23
Tamil Nadu,Perambalur,Mental Illness,80,100,0,2,2
Telangana,Peddapalli,Mental Illness,0,6,1,2,3
Telangana,Peddapalli,Mental Illness,6,15,3,1,4
Telangana,Peddapalli,Mental Illness,15,35,122,102,224
Telangana,Peddapalli,Mental Illness,35,60,290,230,520
Telangana,Peddapalli,Mental Illness,60,80,90,64,154
Telangana,Peddapalli,Mental Illness,80,100,4,1,5
Uttarakhand,Pauri Garhwal,Mental Illness,0,6,3,2,5
Uttarakhand,Pauri Garhwal,Mental Illness,6,15,28,11,39
Uttarakhand,Pauri Garhwal,Mental Illness,15,35,80,47,127
Uttarakhand,Pauri Garhwal,Mental Illness,35,60,92,26,118
Uttarakhand,Pauri Garhwal,Mental Illness,60,80,7,1,8
Uttarakhand,Pauri Garhwal,Mental Illness,80,100,1,0,1
Bihar,Patna,Mental Illness,0,6,11,3,14
Bihar,Patna,Mental Illness,6,15,119,78,197
Bihar,Patna,Mental Illness,15,35,244,132,376
Bihar,Patna,Mental Illness,35,60,85,44,129
Bihar,Patna,Mental Illness,60,80,12,3,15
Bihar,Patna,Mental Illness,80,100,2,0,2
Punjab,Patiala,Mental Illness,0,6,9,5,14
Punjab,Patiala,Mental Illness,6,15,117,77,194
Punjab,Patiala,Mental Illness,15,35,522,251,773
Punjab,Patiala,Mental Illness,35,60,297,139,436
Punjab,Patiala,Mental Illness,60,80,29,8,37
Punjab,Patiala,Mental Illness,80,100,1,2,3
Punjab,Pathankot,Mental Illness,0,6,5,0,5
Punjab,Pathankot,Mental Illness,6,15,233,117,350
Punjab,Pathankot,Mental Illness,15,35,473,260,733
Punjab,Pathankot,Mental Illness,35,60,312,140,452
Punjab,Pathankot,Mental Illness,60,80,31,9,40
Punjab,Pathankot,Mental Illness,80,100,3,1,4
Kerala,Pathanamthitta,Mental Illness,0,6,0,1,1
Kerala,Pathanamthitta,Mental Illness,6,15,10,3,13
Kerala,Pathanamthitta,Mental Illness,15,35,86,73,159
Kerala,Pathanamthitta,Mental Illness,35,60,249,180,429
Kerala,Pathanamthitta,Mental Illness,60,80,77,50,127
Kerala,Pathanamthitta,Mental Illness,80,100,4,6,10
Gujarat,Patan,Mental Illness,0,6,1,0,1
Gujarat,Patan,Mental Illness,6,15,0,1,1
Gujarat,Patan,Mental Illness,15,35,16,10,26
Gujarat,Patan,Mental Illness,35,60,46,21,67
Gujarat,Patan,Mental Illness,60,80,7,4,11
Bihar,Pashchim Champaran,Mental Illness,0,6,3,5,8
Bihar,Pashchim Champaran,Mental Illness,6,15,52,22,74
Bihar,Pashchim Champaran,Mental Illness,15,35,107,52,159
Bihar,Pashchim Champaran,Mental Illness,35,60,38,21,59
Bihar,Pashchim Champaran,Mental Illness,60,80,6,0,6
West Bengal,Paschim Bardhaman,Mental Illness,15,35,2,0,2
Maharashtra,Parbhani,Mental Illness,0,6,1,1,2
Maharashtra,Parbhani,Mental Illness,6,15,6,3,9
Maharashtra,Parbhani,Mental Illness,15,35,32,18,50
Maharashtra,Parbhani,Mental Illness,35,60,62,21,83
Maharashtra,Parbhani,Mental Illness,60,80,7,6,13
Arunachal Pradesh,Papum Pare,Mental Illness,0,6,1,0,1
Arunachal Pradesh,Papum Pare,Mental Illness,6,15,4,5,9
Arunachal Pradesh,Papum Pare,Mental Illness,15,35,13,6,19
Arunachal Pradesh,Papum Pare,Mental Illness,35,60,1,0,1
Arunachal Pradesh,Papum Pare,Mental Illness,60,80,0,1,1
Madhya Pradesh,Panna,Mental Illness,0,6,16,11,27
Madhya Pradesh,Panna,Mental Illness,6,15,137,102,239
Madhya Pradesh,Panna,Mental Illness,15,35,249,137,386
Madhya Pradesh,Panna,Mental Illness,35,60,129,62,191
Madhya Pradesh,Panna,Mental Illness,60,80,4,7,11
Madhya Pradesh,Panna,Mental Illness,80,100,0,1,1
Haryana,Panipat,Mental Illness,0,6,4,5,9
Haryana,Panipat,Mental Illness,6,15,23,19,42
Haryana,Panipat,Mental Illness,15,35,80,40,120
Haryana,Panipat,Mental Illness,35,60,29,8,37
Haryana,Panipat,Mental Illness,60,80,2,1,3
Haryana,Panchkula,Mental Illness,0,6,1,1,2
Haryana,Panchkula,Mental Illness,6,15,60,30,90
Haryana,Panchkula,Mental Illness,15,35,189,93,282
Haryana,Panchkula,Mental Illness,35,60,105,43,148
Haryana,Panchkula,Mental Illness,60,80,11,6,17
Haryana,Panchkula,Mental Illness,80,100,1,1,2
Gujarat,Panch Mahals,Mental Illness,0,6,1,0,1
Gujarat,Panch Mahals,Mental Illness,6,15,2,1,3
Gujarat,Panch Mahals,Mental Illness,15,35,34,15,49
Gujarat,Panch Mahals,Mental Illness,35,60,48,18,66
Gujarat,Panch Mahals,Mental Illness,60,80,2,3,5
Haryana,Palwal,Mental Illness,6,15,3,3,6
Haryana,Palwal,Mental Illness,15,35,14,14,28
Haryana,Palwal,Mental Illness,35,60,36,11,47
Haryana,Palwal,Mental Illness,60,80,1,1,2
Rajasthan,Pali,Mental Illness,0,6,16,12,28
Rajasthan,Pali,Mental Illness,6,15,157,122,279
Rajasthan,Pali,Mental Illness,15,35,399,240,639
Rajasthan,Pali,Mental Illness,35,60,272,139,411
Rajasthan,Pali,Mental Illness,60,80,22,7,29
Rajasthan,Pali,Mental Illness,80,100,2,0,2
Maharashtra,Palghar,Mental Illness,0,6,3,0,3
Maharashtra,Palghar,Mental Illness,6,15,38,20,58
Maharashtra,Palghar,Mental Illness,15,35,95,59,154
Maharashtra,Palghar,Mental Illness,35,60,27,25,52
Maharashtra,Palghar,Mental Illness,60,80,2,4,6
Jharkhand,Palamu,Mental Illness,0,6,6,3,9
Jharkhand,Palamu,Mental Illness,6,15,97,67,164
Jharkhand,Palamu,Mental Illness,15,35,202,124,326
Jharkhand,Palamu,Mental Illness,35,60,47,17,64
Jharkhand,Palamu,Mental Illness,60,80,3,1,4
Kerala,Palakkad,Mental Illness,0,6,5,0,5
Kerala,Palakkad,Mental Illness,6,15,31,19,50
Kerala,Palakkad,Mental Illness,15,35,152,87,239
Kerala,Palakkad,Mental Illness,35,60,412,261,673
Kerala,Palakkad,Mental Illness,60,80,59,57,116
Kerala,Palakkad,Mental Illness,80,100,0,1,1
Jharkhand,Pakur,Mental Illness,0,6,0,1,1
Jharkhand,Pakur,Mental Illness,6,15,21,19,40
Jharkhand,Pakur,Mental Illness,15,35,33,38,71
Jharkhand,Pakur,Mental Illness,35,60,12,5,17
Jharkhand,Pakur,Mental Illness,60,80,1,1,2
Maharashtra,Osmanabad,Mental Illness,6,15,4,8,12
Maharashtra,Osmanabad,Mental Illness,15,35,94,26,120
Maharashtra,Osmanabad,Mental Illness,35,60,107,41,148
Maharashtra,Osmanabad,Mental Illness,60,80,12,4,16
Maharashtra,Osmanabad,Mental Illness,80,100,1,0,1
Haryana,Nuh,Mental Illness,0,6,8,2,10
Haryana,Nuh,Mental Illness,6,15,81,43,124
Haryana,Nuh,Mental Illness,15,35,181,114,295
Haryana,Nuh,Mental Illness,35,60,56,27,83
Haryana,Nuh,Mental Illness,60,80,4,5,9
Odisha,Nuapada,Mental Illness,0,6,9,5,14
Odisha,Nuapada,Mental Illness,6,15,157,130,287
Odisha,Nuapada,Mental Illness,15,35,252,200,452
Odisha,Nuapada,Mental Illness,35,60,94,58,152
Odisha,Nuapada,Mental Illness,60,80,4,4,8
Delhi,North West,Mental Illness,6,15,4,2,6
Delhi,North West,Mental Illness,15,35,90,43,133
Delhi,North West,Mental Illness,35,60,78,49,127
Delhi,North West,Mental Illness,60,80,7,6,13
Tripura,North Tripura,Mental Illness,15,35,13,4,17
Tripura,North Tripura,Mental Illness,35,60,26,19,45
Tripura,North Tripura,Mental Illness,60,80,3,2,5
Goa,North Goa,Mental Illness,15,35,19,12,31
Goa,North Goa,Mental Illness,35,60,77,48,125
Goa,North Goa,Mental Illness,60,80,14,10,24
Meghalaya,North Garo Hills,Mental Illness,6,15,2,1,3
Meghalaya,North Garo Hills,Mental Illness,15,35,7,9,16
Meghalaya,North Garo Hills,Mental Illness,35,60,1,1,2
Meghalaya,North Garo Hills,Mental Illness,60,80,1,0,1
Delhi,North East,Mental Illness,0,6,1,0,1
Delhi,North East,Mental Illness,6,15,2,1,3
Delhi,North East,Mental Illness,15,35,22,7,29
Delhi,North East,Mental Illness,35,60,46,15,61
Delhi,North East,Mental Illness,60,80,7,1,8
Andaman And Nicobar Islands,North And Middle Andaman,Mental Illness,0,6,1,0,1
Andaman And Nicobar Islands,North And Middle Andaman,Mental Illness,6,15,19,16,35
Andaman And Nicobar Islands,North And Middle Andaman,Mental Illness,15,35,73,51,124
Andaman And Nicobar Islands,North And Middle Andaman,Mental Illness,35,60,31,18,49
Andaman And Nicobar Islands,North And Middle Andaman,Mental Illness,60,80,0,1,1
Delhi,North,Mental Illness,6,15,1,2,3
Delhi,North,Mental Illness,15,35,16,3,19
Delhi,North,Mental Illness,35,60,18,9,27
Delhi,North,Mental Illness,60,80,0,1,1
Manipur,Noney,Mental Illness,6,15,4,0,4
Manipur,Noney,Mental Illness,15,35,3,3,6
Manipur,Noney,Mental Illness,35,60,1,0,1
Telangana,Nizamabad,Mental Illness,0,6,1,0,1
Telangana,Nizamabad,Mental Illness,6,15,2,1,3
Telangana,Nizamabad,Mental Illness,15,35,46,43,89
Telangana,Nizamabad,Mental Illness,35,60,301,235,536
Telangana,Nizamabad,Mental Illness,60,80,105,57,162
Telangana,Nizamabad,Mental Illness,80,100,6,4,10
Madhya Pradesh,Niwari,Mental Illness,0,6,0,1,1
Madhya Pradesh,Niwari,Mental Illness,6,15,8,5,13
Madhya Pradesh,Niwari,Mental Illness,15,35,59,28,87
Madhya Pradesh,Niwari,Mental Illness,35,60,47,20,67
Madhya Pradesh,Niwari,Mental Illness,60,80,7,5,12
Madhya Pradesh,Niwari,Mental Illness,80,100,1,0,1
Telangana,Nirmal,Mental Illness,15,35,2,2,4
Telangana,Nirmal,Mental Illness,35,60,14,6,20
Telangana,Nirmal,Mental Illness,60,80,3,2,5
Andaman And Nicobar Islands,Nicobars,Mental Illness,6,15,4,6,10
Andaman And Nicobar Islands,Nicobars,Mental Illness,15,35,13,15,28
Andaman And Nicobar Islands,Nicobars,Mental Illness,35,60,7,4,11
Delhi,New Delhi,Mental Illness,15,35,14,1,15
Delhi,New Delhi,Mental Illness,35,60,4,3,7
Delhi,New Delhi,Mental Illness,60,80,1,0,1
Delhi,New Delhi,Mental Illness,80,100,0,1,1
Madhya Pradesh,Neemuch,Mental Illness,6,15,102,75,177
Madhya Pradesh,Neemuch,Mental Illness,15,35,442,265,707
Madhya Pradesh,Neemuch,Mental Illness,35,60,204,98,302
Madhya Pradesh,Neemuch,Mental Illness,60,80,18,17,35
Madhya Pradesh,Neemuch,Mental Illness,80,100,3,2,5
Odisha,Nayagarh,Mental Illness,0,6,53,20,73
Odisha,Nayagarh,Mental Illness,6,15,397,221,618
Odisha,Nayagarh,Mental Illness,15,35,957,549,1506
Odisha,Nayagarh,Mental Illness,35,60,879,453,1332
Odisha,Nayagarh,Mental Illness,60,80,109,68,177
Odisha,Nayagarh,Mental Illness,80,100,2,4,6
Bihar,Nawada,Mental Illness,0,6,4,2,6
Bihar,Nawada,Mental Illness,6,15,95,56,151
Bihar,Nawada,Mental Illness,15,35,134,78,212
Bihar,Nawada,Mental Illness,35,60,35,14,49
Bihar,Nawada,Mental Illness,60,80,6,3,9
Gujarat,Navsari,Mental Illness,6,15,14,6,20
Gujarat,Navsari,Mental Illness,15,35,45,24,69
Gujarat,Navsari,Mental Illness,35,60,18,27,45
Gujarat,Navsari,Mental Illness,60,80,1,4,5
Maharashtra,Nashik,Mental Illness,6,15,14,10,24
Maharashtra,Nashik,Mental Illness,15,35,100,47,147
Maharashtra,Nashik,Mental Illness,35,60,177,93,270
Maharashtra,Nashik,Mental Illness,60,80,10,6,16
Madhya Pradesh,Narsinghpur,Mental Illness,0,6,1,2,3
Madhya Pradesh,Narsinghpur,Mental Illness,6,15,71,63,134
Madhya Pradesh,Narsinghpur,Mental Illness,15,35,362,202,564
Madhya Pradesh,Narsinghpur,Mental Illness,35,60,280,119,399
Madhya Pradesh,Narsinghpur,Mental Illness,60,80,34,25,59
Madhya Pradesh,Narsinghpur,Mental Illness,80,100,0,1,1
Madhya Pradesh,Narmadapuram,Mental Illness,6,15,65,27,92
Madhya Pradesh,Narmadapuram,Mental Illness,15,35,200,133,333
Madhya Pradesh,Narmadapuram,Mental Illness,35,60,118,56,174
Madhya Pradesh,Narmadapuram,Mental Illness,60,80,10,5,15
Madhya Pradesh,Narmadapuram,Mental Illness,80,100,2,1,3
Gujarat,Narmada,Mental Illness,6,15,5,7,12
Gujarat,Narmada,Mental Illness,15,35,28,15,43
Gujarat,Narmada,Mental Illness,35,60,17,5,22
Gujarat,Narmada,Mental Illness,60,80,6,0,6
Chhattisgarh,Narayanpur,Mental Illness,6,15,9,4,13
Chhattisgarh,Narayanpur,Mental Illness,15,35,15,17,32
Chhattisgarh,Narayanpur,Mental Illness,35,60,1,2,3
Maharashtra,Nandurbar,Mental Illness,6,15,23,11,34
Maharashtra,Nandurbar,Mental Illness,15,35,48,13,61
Maharashtra,Nandurbar,Mental Illness,35,60,15,10,25
Maharashtra,Nandurbar,Mental Illness,60,80,1,0,1
Maharashtra,Nanded,Mental Illness,6,15,26,8,34
Maharashtra,Nanded,Mental Illness,15,35,166,49,215
Maharashtra,Nanded,Mental Illness,35,60,94,35,129
Maharashtra,Nanded,Mental Illness,60,80,7,3,10
Arunachal Pradesh,Namsai,Mental Illness,6,15,3,2,5
Arunachal Pradesh,Namsai,Mental Illness,15,35,9,5,14
Arunachal Pradesh,Namsai,Mental Illness,35,60,0,2,2
Sikkim,Namchi,Mental Illness,6,15,2,0,2
Sikkim,Namchi,Mental Illness,15,35,11,3,14
Sikkim,Namchi,Mental Illness,35,60,20,8,28
Sikkim,Namchi,Mental Illness,60,80,5,1,6
Tamil Nadu,Namakkal,Mental Illness,0,6,0,1,1
Tamil Nadu,Namakkal,Mental Illness,6,15,30,9,39
Tamil Nadu,Namakkal,Mental Illness,15,35,96,67,163
Tamil Nadu,Namakkal,Mental Illness,35,60,160,111,271
Tamil Nadu,Namakkal,Mental Illness,60,80,23,25,48
Tamil Nadu,Namakkal,Mental Illness,80,100,1,0,1
Telangana,Nalgonda,Mental Illness,6,15,2,3,5
Telangana,Nalgonda,Mental Illness,15,35,269,210,479
Telangana,Nalgonda,Mental Illness,35,60,1013,798,1811
Telangana,Nalgonda,Mental Illness,60,80,231,168,399
Telangana,Nalgonda,Mental Illness,80,100,11,7,18
Assam,Nalbari,Mental Illness,0,6,3,2,5
Assam,Nalbari,Mental Illness,6,15,41,24,65
Assam,Nalbari,Mental Illness,15,35,122,92,214
Assam,Nalbari,Mental Illness,35,60,96,43,139
Assam,Nalbari,Mental Illness,60,80,6,0,6
Bihar,Nalanda,Mental Illness,0,6,9,4,13
Bihar,Nalanda,Mental Illness,6,15,85,64,149
Bihar,Nalanda,Mental Illness,15,35,105,65,170
Bihar,Nalanda,Mental Illness,35,60,32,7,39
Bihar,Nalanda,Mental Illness,60,80,3,1,4
Uttarakhand,Nainital,Mental Illness,0,6,1,0,1
Uttarakhand,Nainital,Mental Illness,6,15,10,12,22
Uttarakhand,Nainital,Mental Illness,15,35,35,24,59
Uttarakhand,Nainital,Mental Illness,35,60,37,18,55
Uttarakhand,Nainital,Mental Illness,60,80,1,3,4
Maharashtra,Nagpur,Mental Illness,6,15,0,2,2
Maharashtra,Nagpur,Mental Illness,15,35,48,19,67
Maharashtra,Nagpur,Mental Illness,35,60,180,104,284
Maharashtra,Nagpur,Mental Illness,60,80,20,15,35
Rajasthan,Nagaur,Mental Illness,0,6,5,6,11
Rajasthan,Nagaur,Mental Illness,6,15,99,57,156
Rajasthan,Nagaur,Mental Illness,15,35,255,111,366
Rajasthan,Nagaur,Mental Illness,35,60,206,88,294
Rajasthan,Nagaur,Mental Illness,60,80,14,5,19
Rajasthan,Nagaur,Mental Illness,80,100,1,1,2
Telangana,Nagarkurnool,Mental Illness,6,15,1,0,1
Telangana,Nagarkurnool,Mental Illness,15,35,255,236,491
Telangana,Nagarkurnool,Mental Illness,35,60,336,223,559
Telangana,Nagarkurnool,Mental Illness,60,80,60,41,101
Telangana,Nagarkurnool,Mental Illness,80,100,4,1,5
Tamil Nadu,Nagapattinam,Mental Illness,6,15,5,1,6
Tamil Nadu,Nagapattinam,Mental Illness,15,35,39,29,68
Tamil Nadu,Nagapattinam,Mental Illness,35,60,122,91,213
Tamil Nadu,Nagapattinam,Mental Illness,60,80,34,23,57
Assam,Nagaon,Mental Illness,0,6,6,6,12
Assam,Nagaon,Mental Illness,6,15,69,49,118
Assam,Nagaon,Mental Illness,15,35,147,129,276
Assam,Nagaon,Mental Illness,35,60,74,63,137
Assam,Nagaon,Mental Illness,60,80,15,4,19
Assam,Nagaon,Mental Illness,80,100,1,0,1
Odisha,Nabarangpur,Mental Illness,0,6,17,19,36
Odisha,Nabarangpur,Mental Illness,6,15,123,94,217
Odisha,Nabarangpur,Mental Illness,15,35,148,127,275
Odisha,Nabarangpur,Mental Illness,35,60,51,37,88
Odisha,Nabarangpur,Mental Illness,60,80,5,4,9
Karnataka,Mysuru,Mental Illness,0,6,7,4,11
Karnataka,Mysuru,Mental Illness,6,15,97,50,147
Karnataka,Mysuru,Mental Illness,15,35,236,220,456
Karnataka,Mysuru,Mental Illness,35,60,239,202,441
Karnataka,Mysuru,Mental Illness,60,80,23,21,44
Bihar,Muzaffarpur,Mental Illness,0,6,5,5,10
Bihar,Muzaffarpur,Mental Illness,6,15,154,87,241
Bihar,Muzaffarpur,Mental Illness,15,35,183,81,264
Bihar,Muzaffarpur,Mental Illness,35,60,33,19,52
Bihar,Muzaffarpur,Mental Illness,60,80,3,2,5
Uttar Pradesh,Muzaffarnagar,Mental Illness,0,6,13,5,18
Uttar Pradesh,Muzaffarnagar,Mental Illness,6,15,94,50,144
Uttar Pradesh,Muzaffarnagar,Mental Illness,15,35,202,82,284
Uttar Pradesh,Muzaffarnagar,Mental Illness,35,60,79,27,106
Uttar Pradesh,Muzaffarnagar,Mental Illness,60,80,18,7,25
Bihar,Munger,Mental Illness,0,6,3,0,3
Bihar,Munger,Mental Illness,6,15,39,30,69
Bihar,Munger,Mental Illness,15,35,85,20,105
Bihar,Munger,Mental Illness,35,60,28,11,39
Bihar,Munger,Mental Illness,60,80,2,1,3
Bihar,Munger,Mental Illness,80,100,1,1,2
Chhattisgarh,Mungeli,Mental Illness,0,6,1,0,1
Chhattisgarh,Mungeli,Mental Illness,6,15,10,11,21
Chhattisgarh,Mungeli,Mental Illness,15,35,73,45,118
Chhattisgarh,Mungeli,Mental Illness,35,60,27,17,44
Chhattisgarh,Mungeli,Mental Illness,60,80,2,1,3
Maharashtra,Mumbai Suburban,Mental Illness,6,15,5,0,5
Maharashtra,Mumbai Suburban,Mental Illness,15,35,22,12,34
Maharashtra,Mumbai Suburban,Mental Illness,35,60,65,18,83
Maharashtra,Mumbai Suburban,Mental Illness,60,80,9,5,14
Maharashtra,Mumbai Suburban,Mental Illness,80,100,1,1,2
Maharashtra,Mumbai,Mental Illness,6,15,0,1,1
Maharashtra,Mumbai,Mental Illness,15,35,31,5,36
Maharashtra,Mumbai,Mental Illness,35,60,56,29,85
Maharashtra,Mumbai,Mental Illness,60,80,14,5,19
Maharashtra,Mumbai,Mental Illness,80,100,2,0,2
Madhya Pradesh,Morena,Mental Illness,0,6,6,0,6
Madhya Pradesh,Morena,Mental Illness,6,15,88,45,133
Madhya Pradesh,Morena,Mental Illness,15,35,213,91,304
Madhya Pradesh,Morena,Mental Illness,35,60,61,17,78
Madhya Pradesh,Morena,Mental Illness,60,80,5,3,8
Gujarat,Morbi,Mental Illness,6,15,25,6,31
Gujarat,Morbi,Mental Illness,15,35,103,52,155
Gujarat,Morbi,Mental Illness,35,60,39,20,59
Gujarat,Morbi,Mental Illness,60,80,4,1,5
Uttar Pradesh,Moradabad,Mental Illness,0,6,16,12,28
Uttar Pradesh,Moradabad,Mental Illness,6,15,152,107,259
Uttar Pradesh,Moradabad,Mental Illness,15,35,255,113,368
Uttar Pradesh,Moradabad,Mental Illness,35,60,58,23,81
Uttar Pradesh,Moradabad,Mental Illness,60,80,5,1,6
Uttar Pradesh,Moradabad,Mental Illness,80,100,1,0,1
Nagaland,Mon,Mental Illness,6,15,0,2,2
Nagaland,Mon,Mental Illness,15,35,6,7,13
Nagaland,Mon,Mental Illness,35,60,2,0,2
Nagaland,Mon,Mental Illness,60,80,2,1,3
Nagaland,Mokokchung,Mental Illness,6,15,6,3,9
Nagaland,Mokokchung,Mental Illness,15,35,6,5,11
Nagaland,Mokokchung,Mental Illness,35,60,27,14,41
Nagaland,Mokokchung,Mental Illness,60,80,2,3,5
Punjab,Moga,Mental Illness,0,6,21,10,31
Punjab,Moga,Mental Illness,6,15,259,161,420
Punjab,Moga,Mental Illness,15,35,372,202,574
Punjab,Moga,Mental Illness,35,60,190,96,286
Punjab,Moga,Mental Illness,60,80,16,4,20
Uttar Pradesh,Mirzapur,Mental Illness,0,6,2,2,4
Uttar Pradesh,Mirzapur,Mental Illness,6,15,19,5,24
Uttar Pradesh,Mirzapur,Mental Illness,15,35,80,34,114
Uttar Pradesh,Mirzapur,Mental Illness,35,60,34,13,47
Uttar Pradesh,Mirzapur,Mental Illness,60,80,2,1,3
Uttar Pradesh,Meerut,Mental Illness,0,6,5,2,7
Uttar Pradesh,Meerut,Mental Illness,6,15,116,56,172
Uttar Pradesh,Meerut,Mental Illness,15,35,260,90,350
Uttar Pradesh,Meerut,Mental Illness,35,60,92,31,123
Uttar Pradesh,Meerut,Mental Illness,60,80,8,3,11
Uttar Pradesh,Meerut,Mental Illness,80,100,0,1,1
West Bengal,Medinipur East,Mental Illness,6,15,1,0,1
Telangana,Medchal Malkajgiri,Mental Illness,15,35,3,3,6
Telangana,Medchal Malkajgiri,Mental Illness,35,60,21,8,29
Telangana,Medchal Malkajgiri,Mental Illness,60,80,9,4,13
Telangana,Medak,Mental Illness,6,15,2,0,2
Telangana,Medak,Mental Illness,15,35,83,78,161
Telangana,Medak,Mental Illness,35,60,158,93,251
Telangana,Medak,Mental Illness,60,80,23,17,40
Telangana,Medak,Mental Illness,80,100,2,1,3
Odisha,Mayurbhanj,Mental Illness,0,6,4,1,5
Odisha,Mayurbhanj,Mental Illness,6,15,64,47,111
Odisha,Mayurbhanj,Mental Illness,15,35,119,125,244
Odisha,Mayurbhanj,Mental Illness,35,60,197,139,336
Odisha,Mayurbhanj,Mental Illness,60,80,20,19,39
Odisha,Mayurbhanj,Mental Illness,80,100,0,3,3
Tamil Nadu,Mayiladuthurai,Mental Illness,6,15,5,1,6
Tamil Nadu,Mayiladuthurai,Mental Illness,15,35,20,13,33
Tamil Nadu,Mayiladuthurai,Mental Illness,35,60,38,24,62
Tamil Nadu,Mayiladuthurai,Mental Illness,60,80,3,3,6
Uttar Pradesh,Mau,Mental Illness,0,6,1,2,3
Uttar Pradesh,Mau,Mental Illness,6,15,37,27,64
Uttar Pradesh,Mau,Mental Illness,15,35,156,84,240
Uttar Pradesh,Mau,Mental Illness,35,60,55,21,76
Uttar Pradesh,Mau,Mental Illness,60,80,1,1,2
Uttar Pradesh,Mathura,Mental Illness,0,6,15,12,27
Uttar Pradesh,Mathura,Mental Illness,6,15,89,27,116
Uttar Pradesh,Mathura,Mental Illness,15,35,87,30,117
Uttar Pradesh,Mathura,Mental Illness,35,60,23,8,31
Uttar Pradesh,Mathura,Mental Illness,60,80,1,0,1
Assam,Marigaon,Mental Illness,0,6,0,2,2
Assam,Marigaon,Mental Illness,6,15,47,38,85
Assam,Marigaon,Mental Illness,15,35,116,79,195
Assam,Marigaon,Mental Illness,35,60,49,32,81
Assam,Marigaon,Mental Illness,60,80,2,1,3
Punjab,Mansa,Mental Illness,0,6,3,0,3
Punjab,Mansa,Mental Illness,6,15,129,89,218
Punjab,Mansa,Mental Illness,15,35,273,138,411
Punjab,Mansa,Mental Illness,35,60,116,53,169
Punjab,Mansa,Mental Illness,60,80,5,5,10
Sikkim,Mangan,Mental Illness,6,15,4,0,4
Sikkim,Mangan,Mental Illness,15,35,2,6,8
Sikkim,Mangan,Mental Illness,35,60,2,1,3
Sikkim,Mangan,Mental Illness,60,80,1,0,1
Karnataka,Mandya,Mental Illness,0,6,7,4,11
Karnataka,Mandya,Mental Illness,6,15,50,36,86
Karnataka,Mandya,Mental Illness,15,35,138,101,239
Karnataka,Mandya,Mental Illness,35,60,221,158,379
Karnataka,Mandya,Mental Illness,60,80,27,13,40
Madhya Pradesh,Mandsaur,Mental Illness,0,6,1,1,2
Madhya Pradesh,Mandsaur,Mental Illness,6,15,65,64,129
Madhya Pradesh,Mandsaur,Mental Illness,15,35,406,296,702
Madhya Pradesh,Mandsaur,Mental Illness,35,60,201,103,304
Madhya Pradesh,Mandsaur,Mental Illness,60,80,37,16,53
Madhya Pradesh,Mandsaur,Mental Illness,80,100,2,2,4
Madhya Pradesh,Mandla,Mental Illness,0,6,1,0,1
Madhya Pradesh,Mandla,Mental Illness,6,15,115,75,190
Madhya Pradesh,Mandla,Mental Illness,15,35,223,147,370
Madhya Pradesh,Mandla,Mental Illness,35,60,112,85,197
Madhya Pradesh,Mandla,Mental Illness,60,80,14,7,21
Madhya Pradesh,Mandla,Mental Illness,80,100,1,1,2
Himachal Pradesh,Mandi,Mental Illness,0,6,0,1,1
Himachal Pradesh,Mandi,Mental Illness,6,15,91,69,160
Himachal Pradesh,Mandi,Mental Illness,15,35,372,203,575
Himachal Pradesh,Mandi,Mental Illness,35,60,237,88,325
Himachal Pradesh,Mandi,Mental Illness,60,80,27,4,31
Telangana,Mancherial,Mental Illness,15,35,4,3,7
Telangana,Mancherial,Mental Illness,35,60,36,16,52
Telangana,Mancherial,Mental Illness,60,80,9,6,15
Mizoram,Mamit,Mental Illness,6,15,1,0,1
Mizoram,Mamit,Mental Illness,15,35,9,0,9
Mizoram,Mamit,Mental Illness,35,60,4,1,5
Mizoram,Mamit,Mental Illness,60,80,1,0,1
Odisha,Malkangiri,Mental Illness,0,6,28,22,50
Odisha,Malkangiri,Mental Illness,6,15,225,160,385
Odisha,Malkangiri,Mental Illness,15,35,329,248,577
Odisha,Malkangiri,Mental Illness,35,60,126,104,230
Odisha,Malkangiri,Mental Illness,60,80,8,17,25
Odisha,Malkangiri,Mental Illness,80,100,0,1,1
Punjab,Malerkotla,Mental Illness,0,6,2,0,2
Punjab,Malerkotla,Mental Illness,6,15,6,3,9
Punjab,Malerkotla,Mental Illness,15,35,29,13,42
Punjab,Malerkotla,Mental Illness,35,60,16,11,27
Kerala,Malappuram,Mental Illness,0,6,5,4,9
Kerala,Malappuram,Mental Illness,6,15,64,41,105
Kerala,Malappuram,Mental Illness,15,35,550,369,919
Kerala,Malappuram,Mental Illness,35,60,1393,1048,2441
Kerala,Malappuram,Mental Illness,60,80,319,281,600
Kerala,Malappuram,Mental Illness,80,100,3,12,15
Assam,Majuli,Mental Illness,0,6,0,1,1
Assam,Majuli,Mental Illness,6,15,1,1,2
Assam,Majuli,Mental Illness,15,35,3,4,7
Assam,Majuli,Mental Illness,35,60,3,3,6
Uttar Pradesh,Mainpuri,Mental Illness,6,15,15,14,29
Uttar Pradesh,Mainpuri,Mental Illness,15,35,94,30,124
Uttar Pradesh,Mainpuri,Mental Illness,35,60,39,7,46
Uttar Pradesh,Mainpuri,Mental Illness,60,80,3,2,5
Uttar Pradesh,Mahoba,Mental Illness,0,6,0,1,1
Uttar Pradesh,Mahoba,Mental Illness,6,15,14,8,22
Uttar Pradesh,Mahoba,Mental Illness,15,35,31,22,53
Uttar Pradesh,Mahoba,Mental Illness,35,60,16,3,19
Uttar Pradesh,Mahoba,Mental Illness,60,80,2,0,2
Gujarat,Mahisagar,Mental Illness,0,6,1,0,1
Gujarat,Mahisagar,Mental Illness,6,15,22,12,34
Gujarat,Mahisagar,Mental Illness,15,35,94,51,145
Gujarat,Mahisagar,Mental Illness,35,60,17,9,26
Gujarat,Mahisagar,Mental Illness,60,80,1,1,2
Gujarat,Mahesana,Mental Illness,6,15,2,2,4
Gujarat,Mahesana,Mental Illness,15,35,21,10,31
Gujarat,Mahesana,Mental Illness,35,60,67,32,99
Gujarat,Mahesana,Mental Illness,60,80,9,2,11
Haryana,Mahendragarh,Mental Illness,0,6,5,0,5
Haryana,Mahendragarh,Mental Illness,6,15,66,33,99
Haryana,Mahendragarh,Mental Illness,15,35,330,91,421
Haryana,Mahendragarh,Mental Illness,35,60,194,59,253
Haryana,Mahendragarh,Mental Illness,60,80,13,11,24
Haryana,Mahendragarh,Mental Illness,80,100,2,0,2
Puducherry,Mahe,Mental Illness,6,15,5,1,6
Puducherry,Mahe,Mental Illness,15,35,15,14,29
Puducherry,Mahe,Mental Illness,35,60,11,9,20
Puducherry,Mahe,Mental Illness,60,80,7,1,8
Chhattisgarh,Mahasamund,Mental Illness,6,15,43,29,72
Chhattisgarh,Mahasamund,Mental Illness,15,35,150,115,265
Chhattisgarh,Mahasamund,Mental Illness,35,60,29,35,64
Chhattisgarh,Mahasamund,Mental Illness,60,80,0,1,1
Uttar Pradesh,Maharajganj,Mental Illness,0,6,2,0,2
Uttar Pradesh,Maharajganj,Mental Illness,6,15,30,16,46
Uttar Pradesh,Maharajganj,Mental Illness,15,35,153,73,226
Uttar Pradesh,Maharajganj,Mental Illness,35,60,43,15,58
Uttar Pradesh,Maharajganj,Mental Illness,60,80,5,0,5
Telangana,Mahabubnagar,Mental Illness,15,35,481,440,921
Telangana,Mahabubnagar,Mental Illness,35,60,495,385,880
Telangana,Mahabubnagar,Mental Illness,60,80,114,79,193
Telangana,Mahabubnagar,Mental Illness,80,100,9,5,14
Telangana,Mahabubabad,Mental Illness,6,15,1,0,1
Telangana,Mahabubabad,Mental Illness,15,35,5,7,12
Telangana,Mahabubabad,Mental Illness,35,60,44,28,72
Telangana,Mahabubabad,Mental Illness,60,80,10,7,17
Telangana,Mahabubabad,Mental Illness,80,100,1,0,1
Tamil Nadu,Madurai,Mental Illness,0,6,2,0,2
Tamil Nadu,Madurai,Mental Illness,6,15,42,19,61
Tamil Nadu,Madurai,Mental Illness,15,35,188,130,318
Tamil Nadu,Madurai,Mental Illness,35,60,216,137,353
Tamil Nadu,Madurai,Mental Illness,60,80,35,27,62
Tamil Nadu,Madurai,Mental Illness,80,100,2,1,3
Bihar,Madhubani,Mental Illness,0,6,4,1,5
Bihar,Madhubani,Mental Illness,6,15,27,18,45
Bihar,Madhubani,Mental Illness,15,35,76,35,111
Bihar,Madhubani,Mental Illness,35,60,27,9,36
Bihar,Madhubani,Mental Illness,60,80,2,0,2
Bihar,Madhubani,Mental Illness,80,100,1,0,1
Bihar,Madhepura,Mental Illness,6,15,34,10,44
Bihar,Madhepura,Mental Illness,15,35,81,41,122
Bihar,Madhepura,Mental Illness,35,60,23,13,36
Bihar,Madhepura,Mental Illness,60,80,8,3,11
Bihar,Madhepura,Mental Illness,80,100,1,0,1
Mizoram,Lunglei,Mental Illness,15,35,5,3,8
Mizoram,Lunglei,Mental Illness,35,60,11,3,14
Mizoram,Lunglei,Mental Illness,60,80,2,1,3
Punjab,Ludhiana,Mental Illness,0,6,10,8,18
Punjab,Ludhiana,Mental Illness,6,15,194,107,301
Punjab,Ludhiana,Mental Illness,15,35,610,325,935
Punjab,Ludhiana,Mental Illness,35,60,313,184,497
Punjab,Ludhiana,Mental Illness,60,80,31,24,55
Punjab,Ludhiana,Mental Illness,80,100,0,1,1
Uttar Pradesh,Lucknow,Mental Illness,0,6,4,6,10
Uttar Pradesh,Lucknow,Mental Illness,6,15,88,70,158
Uttar Pradesh,Lucknow,Mental Illness,15,35,316,184,500
Uttar Pradesh,Lucknow,Mental Illness,35,60,132,64,196
Uttar Pradesh,Lucknow,Mental Illness,60,80,12,4,16
Uttar Pradesh,Lucknow,Mental Illness,80,100,1,2,3
Arunachal Pradesh,Lower Dibang Valley,Mental Illness,0,6,0,3,3
Arunachal Pradesh,Lower Dibang Valley,Mental Illness,6,15,9,8,17
Arunachal Pradesh,Lower Dibang Valley,Mental Illness,15,35,15,10,25
Arunachal Pradesh,Lower Dibang Valley,Mental Illness,35,60,4,3,7
Arunachal Pradesh,Lohit,Mental Illness,15,35,1,0,1
Jharkhand,Lohardaga,Mental Illness,0,6,2,1,3
Jharkhand,Lohardaga,Mental Illness,6,15,42,41,83
Jharkhand,Lohardaga,Mental Illness,15,35,106,69,175
Jharkhand,Lohardaga,Mental Illness,35,60,31,12,43
Jharkhand,Lohardaga,Mental Illness,60,80,3,2,5
Jharkhand,Lohardaga,Mental Illness,80,100,2,1,3
Ladakh,Leh Ladakh,Mental Illness,15,35,14,7,21
Ladakh,Leh Ladakh,Mental Illness,35,60,15,13,28
Ladakh,Leh Ladakh,Mental Illness,60,80,2,2,4
Mizoram,Lawngtlai,Mental Illness,6,15,1,0,1
Mizoram,Lawngtlai,Mental Illness,15,35,2,0,2
Mizoram,Lawngtlai,Mental Illness,35,60,5,1,6
Maharashtra,Latur,Mental Illness,6,15,17,14,31
Maharashtra,Latur,Mental Illness,15,35,131,61,192
Maharashtra,Latur,Mental Illness,35,60,64,26,90
Maharashtra,Latur,Mental Illness,60,80,11,3,14
Jharkhand,Latehar,Mental Illness,0,6,2,0,2
Jharkhand,Latehar,Mental Illness,6,15,13,4,17
Jharkhand,Latehar,Mental Illness,15,35,23,19,42
Jharkhand,Latehar,Mental Illness,35,60,8,7,15
Uttar Pradesh,Lalitpur,Mental Illness,0,6,0,2,2
Uttar Pradesh,Lalitpur,Mental Illness,6,15,23,18,41
Uttar Pradesh,Lalitpur,Mental Illness,15,35,37,19,56
Uttar Pradesh,Lalitpur,Mental Illness,35,60,25,4,29
Uttar Pradesh,Lalitpur,Mental Illness,60,80,3,1,4
Lakshadweep,Lakshadweep District,Mental Illness,15,35,3,5,8
Lakshadweep,Lakshadweep District,Mental Illness,35,60,11,6,17
Lakshadweep,Lakshadweep District,Mental Illness,60,80,1,5,6
Lakshadweep,Lakshadweep District,Mental Illness,80,100,1,0,1
Bihar,Lakhisarai,Mental Illness,0,6,1,0,1
Bihar,Lakhisarai,Mental Illness,6,15,19,6,25
Bihar,Lakhisarai,Mental Illness,15,35,32,12,44
Bihar,Lakhisarai,Mental Illness,35,60,7,2,9
Bihar,Lakhisarai,Mental Illness,60,80,1,0,1
Assam,Lakhimpur,Mental Illness,0,6,3,4,7
Assam,Lakhimpur,Mental Illness,6,15,91,70,161
Assam,Lakhimpur,Mental Illness,15,35,135,102,237
Assam,Lakhimpur,Mental Illness,35,60,62,56,118
Assam,Lakhimpur,Mental Illness,60,80,6,3,9
Himachal Pradesh,Lahul And Spiti,Mental Illness,6,15,1,0,1
Himachal Pradesh,Lahul And Spiti,Mental Illness,15,35,1,1,2
Himachal Pradesh,Lahul And Spiti,Mental Illness,35,60,0,1,1
Uttar Pradesh,Kushi Nagar,Mental Illness,0,6,6,4,10
Uttar Pradesh,Kushi Nagar,Mental Illness,6,15,68,34,102
Uttar Pradesh,Kushi Nagar,Mental Illness,15,35,219,110,329
Uttar Pradesh,Kushi Nagar,Mental Illness,35,60,85,30,115
Uttar Pradesh,Kushi Nagar,Mental Illness,60,80,4,3,7
Uttar Pradesh,Kushi Nagar,Mental Illness,80,100,0,1,1
Haryana,Kurukshetra,Mental Illness,0,6,3,0,3
Haryana,Kurukshetra,Mental Illness,6,15,14,8,22
Haryana,Kurukshetra,Mental Illness,15,35,113,43,156
Haryana,Kurukshetra,Mental Illness,35,60,106,34,140
Haryana,Kurukshetra,Mental Illness,60,80,12,2,14
Andhra Pradesh,Kurnool,Mental Illness,6,15,20,15,35
Andhra Pradesh,Kurnool,Mental Illness,15,35,197,93,290
Andhra Pradesh,Kurnool,Mental Illness,35,60,402,142,544
Andhra Pradesh,Kurnool,Mental Illness,60,80,30,10,40
Andhra Pradesh,Kurnool,Mental Illness,80,100,1,0,1
Jammu And Kashmir,Kupwara,Mental Illness,0,6,17,11,28
Jammu And Kashmir,Kupwara,Mental Illness,6,15,87,61,148
Jammu And Kashmir,Kupwara,Mental Illness,15,35,286,172,458
Jammu And Kashmir,Kupwara,Mental Illness,35,60,163,137,300
Jammu And Kashmir,Kupwara,Mental Illness,60,80,7,9,16
Jammu And Kashmir,Kupwara,Mental Illness,80,100,1,2,3
Telangana,Kumuram Bheem Asifabad,Mental Illness,15,35,0,1,1
Telangana,Kumuram Bheem Asifabad,Mental Illness,35,60,4,3,7
Telangana,Kumuram Bheem Asifabad,Mental Illness,60,80,2,2,4
Himachal Pradesh,Kullu,Mental Illness,0,6,2,0,2
Himachal Pradesh,Kullu,Mental Illness,6,15,12,8,20
Himachal Pradesh,Kullu,Mental Illness,15,35,27,20,47
Himachal Pradesh,Kullu,Mental Illness,35,60,22,12,34
Himachal Pradesh,Kullu,Mental Illness,60,80,2,1,3
Jammu And Kashmir,Kulgam,Mental Illness,0,6,0,1,1
Jammu And Kashmir,Kulgam,Mental Illness,6,15,3,0,3
Jammu And Kashmir,Kulgam,Mental Illness,15,35,36,20,56
Jammu And Kashmir,Kulgam,Mental Illness,35,60,49,33,82
Jammu And Kashmir,Kulgam,Mental Illness,60,80,6,5,11
Jammu And Kashmir,Kulgam,Mental Illness,80,100,1,0,1
Tamil Nadu,Krishnagiri,Mental Illness,6,15,26,30,56
Tamil Nadu,Krishnagiri,Mental Illness,15,35,151,108,259
Tamil Nadu,Krishnagiri,Mental Illness,35,60,121,58,179
Tamil Nadu,Krishnagiri,Mental Illness,60,80,11,14,25
Tamil Nadu,Krishnagiri,Mental Illness,80,100,2,1,3
Andhra Pradesh,Krishna,Mental Illness,0,6,1,0,1
Andhra Pradesh,Krishna,Mental Illness,6,15,12,3,15
Andhra Pradesh,Krishna,Mental Illness,15,35,89,52,141
Andhra Pradesh,Krishna,Mental Illness,35,60,494,104,598
Andhra Pradesh,Krishna,Mental Illness,60,80,75,11,86
Andhra Pradesh,Krishna,Mental Illness,80,100,1,0,1
Kerala,Kozhikode,Mental Illness,0,6,2,1,3
Kerala,Kozhikode,Mental Illness,6,15,12,9,21
Kerala,Kozhikode,Mental Illness,15,35,194,133,327
Kerala,Kozhikode,Mental Illness,35,60,874,625,1499
Kerala,Kozhikode,Mental Illness,60,80,284,187,471
Kerala,Kozhikode,Mental Illness,80,100,3,13,16
Kerala,Kottayam,Mental Illness,6,15,2,4,6
Kerala,Kottayam,Mental Illness,15,35,83,52,135
Kerala,Kottayam,Mental Illness,35,60,308,308,616
Kerala,Kottayam,Mental Illness,60,80,106,96,202
Kerala,Kottayam,Mental Illness,80,100,6,10,16
Rajasthan,Kota,Mental Illness,0,6,12,14,26
Rajasthan,Kota,Mental Illness,6,15,146,89,235
Rajasthan,Kota,Mental Illness,15,35,322,194,516
Rajasthan,Kota,Mental Illness,35,60,152,65,217
Rajasthan,Kota,Mental Illness,60,80,5,6,11
Rajasthan,Kota,Mental Illness,80,100,1,0,1
Chhattisgarh,Korea,Mental Illness,0,6,1,3,4
Chhattisgarh,Korea,Mental Illness,6,15,45,33,78
Chhattisgarh,Korea,Mental Illness,15,35,166,129,295
Chhattisgarh,Korea,Mental Illness,35,60,62,51,113
Chhattisgarh,Korea,Mental Illness,60,80,5,3,8
Chhattisgarh,Korba,Mental Illness,0,6,8,4,12
Chhattisgarh,Korba,Mental Illness,6,15,116,67,183
Chhattisgarh,Korba,Mental Illness,15,35,178,153,331
Chhattisgarh,Korba,Mental Illness,35,60,31,36,67
Chhattisgarh,Korba,Mental Illness,60,80,5,4,9
Odisha,Koraput,Mental Illness,0,6,66,43,109
Odisha,Koraput,Mental Illness,6,15,303,218,521
Odisha,Koraput,Mental Illness,15,35,588,558,1146
Odisha,Koraput,Mental Illness,35,60,273,310,583
Odisha,Koraput,Mental Illness,60,80,35,45,80
Odisha,Koraput,Mental Illness,80,100,0,2,2
Karnataka,Koppal,Mental Illness,0,6,8,5,13
Karnataka,Koppal,Mental Illness,6,15,201,152,353
Karnataka,Koppal,Mental Illness,15,35,456,362,818
Karnataka,Koppal,Mental Illness,35,60,228,193,421
Karnataka,Koppal,Mental Illness,60,80,11,22,33
Karnataka,Koppal,Mental Illness,80,100,1,1,2
Chhattisgarh,Kondagaon,Mental Illness,0,6,1,1,2
Chhattisgarh,Kondagaon,Mental Illness,6,15,80,55,135
Chhattisgarh,Kondagaon,Mental Illness,15,35,88,78,166
Chhattisgarh,Kondagaon,Mental Illness,35,60,18,16,34
Chhattisgarh,Kondagaon,Mental Illness,60,80,0,2,2
Kerala,Kollam,Mental Illness,0,6,2,0,2
Kerala,Kollam,Mental Illness,6,15,28,26,54
Kerala,Kollam,Mental Illness,15,35,229,166,395
Kerala,Kollam,Mental Illness,35,60,469,412,881
Kerala,Kollam,Mental Illness,60,80,142,130,272
Kerala,Kollam,Mental Illness,80,100,2,5,7
Maharashtra,Kolhapur,Mental Illness,6,15,6,1,7
Maharashtra,Kolhapur,Mental Illness,15,35,27,11,38
Maharashtra,Kolhapur,Mental Illness,35,60,55,30,85
Maharashtra,Kolhapur,Mental Illness,60,80,2,2,4
Mizoram,Kolasib,Mental Illness,6,15,2,2,4
Mizoram,Kolasib,Mental Illness,15,35,5,9,14
Mizoram,Kolasib,Mental Illness,35,60,6,7,13
Mizoram,Kolasib,Mental Illness,60,80,1,3,4
Karnataka,Kolar,Mental Illness,0,6,6,5,11
Karnataka,Kolar,Mental Illness,6,15,73,50,123
Karnataka,Kolar,Mental Illness,15,35,219,194,413
Karnataka,Kolar,Mental Illness,35,60,258,205,463
Karnataka,Kolar,Mental Illness,60,80,35,23,58
Karnataka,Kolar,Mental Illness,80,100,1,0,1
Assam,Kokrajhar,Mental Illness,0,6,4,6,10
Assam,Kokrajhar,Mental Illness,6,15,38,40,78
Assam,Kokrajhar,Mental Illness,15,35,112,79,191
Assam,Kokrajhar,Mental Illness,35,60,60,35,95
Assam,Kokrajhar,Mental Illness,60,80,3,2,5
Nagaland,Kohima,Mental Illness,6,15,4,1,5
Nagaland,Kohima,Mental Illness,15,35,5,5,10
Nagaland,Kohima,Mental Illness,35,60,10,3,13
Jharkhand,Koderma,Mental Illness,6,15,6,8,14
Jharkhand,Koderma,Mental Illness,15,35,27,13,40
Jharkhand,Koderma,Mental Illness,35,60,6,2,8
Jharkhand,Koderma,Mental Illness,60,80,2,0,2
Karnataka,Kodagu,Mental Illness,6,15,2,0,2
Karnataka,Kodagu,Mental Illness,15,35,14,7,21
Karnataka,Kodagu,Mental Illness,35,60,38,42,80
Karnataka,Kodagu,Mental Illness,60,80,12,5,17
Jammu And Kashmir,Kishtwar,Mental Illness,0,6,3,2,5
Jammu And Kashmir,Kishtwar,Mental Illness,6,15,24,15,39
Jammu And Kashmir,Kishtwar,Mental Illness,15,35,44,41,85
Jammu And Kashmir,Kishtwar,Mental Illness,35,60,48,19,67
Jammu And Kashmir,Kishtwar,Mental Illness,60,80,1,1,2
Bihar,Kishanganj,Mental Illness,0,6,1,0,1
Bihar,Kishanganj,Mental Illness,6,15,38,23,61
Bihar,Kishanganj,Mental Illness,15,35,98,58,156
Bihar,Kishanganj,Mental Illness,35,60,18,13,31
Bihar,Kishanganj,Mental Illness,60,80,5,3,8
Himachal Pradesh,Kinnaur,Mental Illness,6,15,5,5,10
Himachal Pradesh,Kinnaur,Mental Illness,15,35,8,5,13
Himachal Pradesh,Kinnaur,Mental Illness,35,60,2,6,8
Himachal Pradesh,Kinnaur,Mental Illness,60,80,0,1,1
Jharkhand,Khunti,Mental Illness,6,15,11,7,18
Jharkhand,Khunti,Mental Illness,15,35,27,20,47
Jharkhand,Khunti,Mental Illness,35,60,11,0,11
Tripura,Khowai,Mental Illness,15,35,6,2,8
Tripura,Khowai,Mental Illness,35,60,16,5,21
Tripura,Khowai,Mental Illness,60,80,2,1,3
Odisha,Khordha,Mental Illness,0,6,11,12,23
Odisha,Khordha,Mental Illness,6,15,242,148,390
Odisha,Khordha,Mental Illness,15,35,421,309,730
Odisha,Khordha,Mental Illness,35,60,583,273,856
Odisha,Khordha,Mental Illness,60,80,87,40,127
Odisha,Khordha,Mental Illness,80,100,4,1,5
Uttar Pradesh,Kheri,Mental Illness,0,6,3,2,5
Uttar Pradesh,Kheri,Mental Illness,6,15,30,12,42
Uttar Pradesh,Kheri,Mental Illness,15,35,107,43,150
Uttar Pradesh,Kheri,Mental Illness,35,60,24,13,37
Uttar Pradesh,Kheri,Mental Illness,60,80,3,0,3
Uttar Pradesh,Kheri,Mental Illness,80,100,1,0,1
Gujarat,Kheda,Mental Illness,6,15,0,1,1
Gujarat,Kheda,Mental Illness,15,35,8,4,12
Gujarat,Kheda,Mental Illness,35,60,12,9,21
Mizoram,Khawzawl,Mental Illness,6,15,1,0,1
Mizoram,Khawzawl,Mental Illness,35,60,4,1,5
Mizoram,Khawzawl,Mental Illness,60,80,2,2,4
Madhya Pradesh,Khargone,Mental Illness,0,6,4,8,12
Madhya Pradesh,Khargone,Mental Illness,6,15,93,63,156
Madhya Pradesh,Khargone,Mental Illness,15,35,236,162,398
Madhya Pradesh,Khargone,Mental Illness,35,60,152,84,236
Madhya Pradesh,Khargone,Mental Illness,60,80,24,15,39
Madhya Pradesh,Khargone,Mental Illness,80,100,2,0,2
Telangana,Khammam,Mental Illness,6,15,2,3,5
Telangana,Khammam,Mental Illness,15,35,18,22,40
Telangana,Khammam,Mental Illness,35,60,107,71,178
Telangana,Khammam,Mental Illness,60,80,45,26,71
Telangana,Khammam,Mental Illness,80,100,3,1,4
Bihar,Khagaria,Mental Illness,6,15,11,5,16
Bihar,Khagaria,Mental Illness,15,35,25,10,35
Bihar,Khagaria,Mental Illness,35,60,3,2,5
Bihar,Khagaria,Mental Illness,60,80,1,0,1
Odisha,Kendujhar,Mental Illness,0,6,1,0,1
Odisha,Kendujhar,Mental Illness,6,15,2,1,3
Odisha,Kendujhar,Mental Illness,15,35,98,75,173
Odisha,Kendujhar,Mental Illness,35,60,202,128,330
Odisha,Kendujhar,Mental Illness,60,80,11,12,23
Odisha,Kendujhar,Mental Illness,80,100,2,1,3
Odisha,Kendrapara,Mental Illness,0,6,39,9,48
Odisha,Kendrapara,Mental Illness,6,15,354,197,551
Odisha,Kendrapara,Mental Illness,15,35,810,488,1298
Odisha,Kendrapara,Mental Illness,35,60,915,518,1433
Odisha,Kendrapara,Mental Illness,60,80,108,63,171
Odisha,Kendrapara,Mental Illness,80,100,4,0,4
Uttar Pradesh,Kaushambi,Mental Illness,0,6,3,0,3
Uttar Pradesh,Kaushambi,Mental Illness,6,15,17,8,25
Uttar Pradesh,Kaushambi,Mental Illness,15,35,40,17,57
Uttar Pradesh,Kaushambi,Mental Illness,35,60,17,2,19
Uttar Pradesh,Kaushambi,Mental Illness,60,80,2,0,2
Madhya Pradesh,Katni,Mental Illness,0,6,1,0,1
Madhya Pradesh,Katni,Mental Illness,6,15,60,40,100
Madhya Pradesh,Katni,Mental Illness,15,35,234,168,402
Madhya Pradesh,Katni,Mental Illness,35,60,112,64,176
Madhya Pradesh,Katni,Mental Illness,60,80,19,11,30
Bihar,Katihar,Mental Illness,6,15,51,42,93
Bihar,Katihar,Mental Illness,15,35,141,93,234
Bihar,Katihar,Mental Illness,35,60,60,48,108
Bihar,Katihar,Mental Illness,60,80,12,6,18
Jammu And Kashmir,Kathua,Mental Illness,0,6,7,6,13
Jammu And Kashmir,Kathua,Mental Illness,6,15,52,22,74
Jammu And Kashmir,Kathua,Mental Illness,15,35,201,105,306
Jammu And Kashmir,Kathua,Mental Illness,35,60,114,64,178
Jammu And Kashmir,Kathua,Mental Illness,60,80,9,2,11
Uttar Pradesh,Kasganj,Mental Illness,0,6,3,0,3
Uttar Pradesh,Kasganj,Mental Illness,6,15,13,6,19
Uttar Pradesh,Kasganj,Mental Illness,15,35,34,19,53
Uttar Pradesh,Kasganj,Mental Illness,35,60,15,4,19
Uttar Pradesh,Kasganj,Mental Illness,60,80,1,0,1
Kerala,Kasaragod,Mental Illness,0,6,5,2,7
Kerala,Kasaragod,Mental Illness,6,15,21,16,37
Kerala,Kasaragod,Mental Illness,15,35,95,79,174
Kerala,Kasaragod,Mental Illness,35,60,333,191,524
Kerala,Kasaragod,Mental Illness,60,80,62,45,107
Kerala,Kasaragod,Mental Illness,80,100,1,1,2
Tamil Nadu,Karur,Mental Illness,6,15,12,7,19
Tamil Nadu,Karur,Mental Illness,15,35,54,30,84
Tamil Nadu,Karur,Mental Illness,35,60,75,86,161
Tamil Nadu,Karur,Mental Illness,60,80,19,9,28
Haryana,Karnal,Mental Illness,0,6,4,4,8
Haryana,Karnal,Mental Illness,6,15,76,50,126
Haryana,Karnal,Mental Illness,15,35,275,126,401
Haryana,Karnal,Mental Illness,35,60,151,56,207
Haryana,Karnal,Mental Illness,60,80,6,4,10
Haryana,Karnal,Mental Illness,80,100,2,0,2
Telangana,Karimnagar,Mental Illness,6,15,7,6,13
Telangana,Karimnagar,Mental Illness,15,35,152,97,249
Telangana,Karimnagar,Mental Illness,35,60,362,263,625
Telangana,Karimnagar,Mental Illness,60,80,95,66,161
Telangana,Karimnagar,Mental Illness,80,100,2,2,4
Assam,Karimganj,Mental Illness,0,6,2,2,4
Assam,Karimganj,Mental Illness,6,15,15,19,34
Assam,Karimganj,Mental Illness,15,35,54,42,96
Assam,Karimganj,Mental Illness,35,60,32,23,55
Assam,Karimganj,Mental Illness,60,80,0,1,1
Ladakh,Kargil,Mental Illness,0,6,5,2,7
Ladakh,Kargil,Mental Illness,6,15,9,7,16
Ladakh,Kargil,Mental Illness,15,35,19,10,29
Ladakh,Kargil,Mental Illness,35,60,18,7,25
Ladakh,Kargil,Mental Illness,60,80,4,0,4
Ladakh,Kargil,Mental Illness,80,100,1,0,1
Assam,Karbi Anglong,Mental Illness,6,15,10,10,20
Assam,Karbi Anglong,Mental Illness,15,35,50,23,73
Assam,Karbi Anglong,Mental Illness,35,60,22,17,39
Assam,Karbi Anglong,Mental Illness,60,80,1,1,2
Assam,Karbi Anglong,Mental Illness,80,100,1,1,2
Rajasthan,Karauli,Mental Illness,6,15,1,0,1
Rajasthan,Karauli,Mental Illness,15,35,6,4,10
Rajasthan,Karauli,Mental Illness,35,60,2,0,2
Puducherry,Karaikal,Mental Illness,0,6,0,1,1
Puducherry,Karaikal,Mental Illness,6,15,32,18,50
Puducherry,Karaikal,Mental Illness,15,35,110,65,175
Puducherry,Karaikal,Mental Illness,35,60,63,37,100
Puducherry,Karaikal,Mental Illness,60,80,10,3,13
Punjab,Kapurthala,Mental Illness,0,6,5,1,6
Punjab,Kapurthala,Mental Illness,6,15,121,81,202
Punjab,Kapurthala,Mental Illness,15,35,313,185,498
Punjab,Kapurthala,Mental Illness,35,60,152,87,239
Punjab,Kapurthala,Mental Illness,60,80,15,8,23
Punjab,Kapurthala,Mental Illness,80,100,4,1,5
Uttar Pradesh,Kanpur Nagar,Mental Illness,0,6,29,9,38
Uttar Pradesh,Kanpur Nagar,Mental Illness,6,15,115,63,178
Uttar Pradesh,Kanpur Nagar,Mental Illness,15,35,386,186,572
Uttar Pradesh,Kanpur Nagar,Mental Illness,35,60,225,76,301
Uttar Pradesh,Kanpur Nagar,Mental Illness,60,80,21,13,34
Uttar Pradesh,Kanpur Nagar,Mental Illness,80,100,3,2,5
Uttar Pradesh,Kanpur Dehat,Mental Illness,0,6,1,3,4
Uttar Pradesh,Kanpur Dehat,Mental Illness,6,15,37,12,49
Uttar Pradesh,Kanpur Dehat,Mental Illness,15,35,74,44,118
Uttar Pradesh,Kanpur Dehat,Mental Illness,35,60,32,10,42
Uttar Pradesh,Kanpur Dehat,Mental Illness,60,80,7,0,7
Uttar Pradesh,Kanpur Dehat,Mental Illness,80,100,1,0,1
Kerala,Kannur,Mental Illness,0,6,1,1,2
Kerala,Kannur,Mental Illness,6,15,3,3,6
Kerala,Kannur,Mental Illness,15,35,110,40,150
Kerala,Kannur,Mental Illness,35,60,436,245,681
Kerala,Kannur,Mental Illness,60,80,141,73,214
Kerala,Kannur,Mental Illness,80,100,8,6,14
Tamil Nadu,Kanniyakumari,Mental Illness,0,6,1,0,1
Tamil Nadu,Kanniyakumari,Mental Illness,6,15,7,5,12
Tamil Nadu,Kanniyakumari,Mental Illness,15,35,92,77,169
Tamil Nadu,Kanniyakumari,Mental Illness,35,60,310,398,708
Tamil Nadu,Kanniyakumari,Mental Illness,60,80,45,47,92
Tamil Nadu,Kanniyakumari,Mental Illness,80,100,3,1,4
Uttar Pradesh,Kannauj,Mental Illness,0,6,1,0,1
Uttar Pradesh,Kannauj,Mental Illness,6,15,9,7,16
Uttar Pradesh,Kannauj,Mental Illness,15,35,53,24,77
Uttar Pradesh,Kannauj,Mental Illness,35,60,12,4,16
Uttar Pradesh,Kannauj,Mental Illness,60,80,1,1,2
Chhattisgarh,Kanker,Mental Illness,0,6,1,0,1
Chhattisgarh,Kanker,Mental Illness,6,15,30,26,56
Chhattisgarh,Kanker,Mental Illness,15,35,57,60,117
Chhattisgarh,Kanker,Mental Illness,35,60,23,29,52
Chhattisgarh,Kanker,Mental Illness,60,80,2,0,2
Himachal Pradesh,Kangra,Mental Illness,0,6,23,3,26
Himachal Pradesh,Kangra,Mental Illness,6,15,163,89,252
Himachal Pradesh,Kangra,Mental Illness,15,35,515,265,780
Himachal Pradesh,Kangra,Mental Illness,35,60,426,192,618
Himachal Pradesh,Kangra,Mental Illness,60,80,34,13,47
Manipur,Kangpokpi,Mental Illness,6,15,0,2,2
Manipur,Kangpokpi,Mental Illness,15,35,3,4,7
Manipur,Kangpokpi,Mental Illness,35,60,2,0,2
Manipur,Kangpokpi,Mental Illness,60,80,1,1,2
Odisha,Kandhamal,Mental Illness,0,6,11,7,18
Odisha,Kandhamal,Mental Illness,6,15,158,137,295
Odisha,Kandhamal,Mental Illness,15,35,282,230,512
Odisha,Kandhamal,Mental Illness,35,60,156,138,294
Odisha,Kandhamal,Mental Illness,60,80,16,24,40
Tamil Nadu,Kanchipuram,Mental Illness,6,15,36,24,60
Tamil Nadu,Kanchipuram,Mental Illness,15,35,113,79,192
Tamil Nadu,Kanchipuram,Mental Illness,35,60,70,40,110
Tamil Nadu,Kanchipuram,Mental Illness,60,80,10,3,13
Assam,Kamrup Metro,Mental Illness,6,15,39,14,53
Assam,Kamrup Metro,Mental Illness,15,35,77,69,146
Assam,Kamrup Metro,Mental Illness,35,60,40,24,64
Assam,Kamrup Metro,Mental Illness,60,80,2,2,4
Assam,Kamrup,Mental Illness,0,6,5,1,6
Assam,Kamrup,Mental Illness,6,15,49,27,76
Assam,Kamrup,Mental Illness,15,35,106,74,180
Assam,Kamrup,Mental Illness,35,60,91,42,133
Assam,Kamrup,Mental Illness,60,80,11,5,16
Assam,Kamrup,Mental Illness,80,100,0,1,1
Telangana,Kamareddy,Mental Illness,15,35,51,38,89
Telangana,Kamareddy,Mental Illness,35,60,180,135,315
Telangana,Kamareddy,Mental Illness,60,80,71,33,104
Telangana,Kamareddy,Mental Illness,80,100,2,2,4
Tamil Nadu,Kallakurichi,Mental Illness,0,6,1,2,3
Tamil Nadu,Kallakurichi,Mental Illness,6,15,50,29,79
Tamil Nadu,Kallakurichi,Mental Illness,15,35,118,60,178
Tamil Nadu,Kallakurichi,Mental Illness,35,60,45,29,74
Tamil Nadu,Kallakurichi,Mental Illness,60,80,4,4,8
Odisha,Kalahandi,Mental Illness,0,6,1,1,2
Odisha,Kalahandi,Mental Illness,6,15,86,70,156
Odisha,Kalahandi,Mental Illness,15,35,297,234,531
Odisha,Kalahandi,Mental Illness,35,60,230,168,398
Odisha,Kalahandi,Mental Illness,60,80,24,20,44
Odisha,Kalahandi,Mental Illness,80,100,1,0,1
Karnataka,Kalaburagi,Mental Illness,0,6,8,3,11
Karnataka,Kalaburagi,Mental Illness,6,15,74,43,117
Karnataka,Kalaburagi,Mental Illness,15,35,125,73,198
Karnataka,Kalaburagi,Mental Illness,35,60,88,45,133
Karnataka,Kalaburagi,Mental Illness,60,80,4,4,8
Manipur,Kakching,Mental Illness,6,15,4,3,7
Manipur,Kakching,Mental Illness,15,35,17,9,26
Manipur,Kakching,Mental Illness,35,60,15,11,26
Manipur,Kakching,Mental Illness,60,80,3,4,7
Manipur,Kakching,Mental Illness,80,100,0,1,1
Haryana,Kaithal,Mental Illness,0,6,15,4,19
Haryana,Kaithal,Mental Illness,6,15,121,79,200
Haryana,Kaithal,Mental Illness,15,35,115,59,174
Haryana,Kaithal,Mental Illness,35,60,61,14,75
Haryana,Kaithal,Mental Illness,60,80,4,2,6
Bihar,Kaimur (Bhabua),Mental Illness,0,6,2,0,2
Bihar,Kaimur (Bhabua),Mental Illness,6,15,50,11,61
Bihar,Kaimur (Bhabua),Mental Illness,15,35,81,34,115
Bihar,Kaimur (Bhabua),Mental Illness,35,60,26,11,37
Bihar,Kaimur (Bhabua),Mental Illness,60,80,1,2,3
Gujarat,Kachchh,Mental Illness,0,6,1,0,1
Gujarat,Kachchh,Mental Illness,6,15,58,36,94
Gujarat,Kachchh,Mental Illness,15,35,154,84,238
Gujarat,Kachchh,Mental Illness,35,60,124,61,185
Gujarat,Kachchh,Mental Illness,60,80,26,12,38
Gujarat,Kachchh,Mental Illness,80,100,0,1,1
Chhattisgarh,Kabirdham,Mental Illness,0,6,5,4,9
Chhattisgarh,Kabirdham,Mental Illness,6,15,79,51,130
Chhattisgarh,Kabirdham,Mental Illness,15,35,71,56,127
Chhattisgarh,Kabirdham,Mental Illness,35,60,7,4,11
Chhattisgarh,Kabirdham,Mental Illness,60,80,1,0,1
Gujarat,Junagadh,Mental Illness,6,15,7,5,12
Gujarat,Junagadh,Mental Illness,15,35,54,24,78
Gujarat,Junagadh,Mental Illness,35,60,87,35,122
Gujarat,Junagadh,Mental Illness,60,80,10,5,15
Gujarat,Junagadh,Mental Illness,80,100,1,0,1
Assam,Jorhat,Mental Illness,0,6,0,1,1
Assam,Jorhat,Mental Illness,6,15,2,1,3
Assam,Jorhat,Mental Illness,15,35,16,20,36
Assam,Jorhat,Mental Illness,35,60,44,24,68
Assam,Jorhat,Mental Illness,60,80,6,0,6
Telangana,Jogulamba Gadwal,Mental Illness,6,15,0,1,1
Telangana,Jogulamba Gadwal,Mental Illness,15,35,234,262,496
Telangana,Jogulamba Gadwal,Mental Illness,35,60,251,216,467
Telangana,Jogulamba Gadwal,Mental Illness,60,80,47,42,89
Telangana,Jogulamba Gadwal,Mental Illness,80,100,3,2,5
Rajasthan,Jodhpur,Mental Illness,0,6,1,2,3
Rajasthan,Jodhpur,Mental Illness,6,15,30,14,44
Rajasthan,Jodhpur,Mental Illness,15,35,190,89,279
Rajasthan,Jodhpur,Mental Illness,35,60,105,36,141
Rajasthan,Jodhpur,Mental Illness,60,80,6,7,13
Rajasthan,Jodhpur,Mental Illness,80,100,0,1,1
Manipur,Jiribam,Mental Illness,6,15,3,2,5
Manipur,Jiribam,Mental Illness,15,35,2,5,7
Manipur,Jiribam,Mental Illness,35,60,1,0,1
Manipur,Jiribam,Mental Illness,60,80,1,0,1
Haryana,Jind,Mental Illness,0,6,3,0,3
Haryana,Jind,Mental Illness,6,15,13,14,27
Haryana,Jind,Mental Illness,15,35,50,22,72
Haryana,Jind,Mental Illness,35,60,56,23,79
Haryana,Jind,Mental Illness,60,80,2,1,3
Rajasthan,Jhunjhunu,Mental Illness,0,6,9,9,18
Rajasthan,Jhunjhunu,Mental Illness,6,15,125,68,193
Rajasthan,Jhunjhunu,Mental Illness,15,35,238,108,346
Rajasthan,Jhunjhunu,Mental Illness,35,60,133,53,186
Rajasthan,Jhunjhunu,Mental Illness,60,80,7,2,9
Rajasthan,Jhunjhunu,Mental Illness,80,100,1,1,2
Odisha,Jharsuguda,Mental Illness,0,6,3,3,6
Odisha,Jharsuguda,Mental Illness,6,15,139,82,221
Odisha,Jharsuguda,Mental Illness,15,35,207,161,368
Odisha,Jharsuguda,Mental Illness,35,60,196,150,346
Odisha,Jharsuguda,Mental Illness,60,80,24,25,49
Odisha,Jharsuguda,Mental Illness,80,100,0,2,2
Uttar Pradesh,Jhansi,Mental Illness,6,15,32,21,53
Uttar Pradesh,Jhansi,Mental Illness,15,35,77,36,113
Uttar Pradesh,Jhansi,Mental Illness,35,60,23,11,34
Uttar Pradesh,Jhansi,Mental Illness,60,80,3,0,3
Rajasthan,Jhalawar,Mental Illness,0,6,5,2,7
Rajasthan,Jhalawar,Mental Illness,6,15,22,35,57
Rajasthan,Jhalawar,Mental Illness,15,35,247,349,596
Rajasthan,Jhalawar,Mental Illness,35,60,294,269,563
Rajasthan,Jhalawar,Mental Illness,60,80,15,11,26
Haryana,Jhajjar,Mental Illness,0,6,2,0,2
Haryana,Jhajjar,Mental Illness,6,15,19,4,23
Haryana,Jhajjar,Mental Illness,15,35,53,30,83
Haryana,Jhajjar,Mental Illness,35,60,42,19,61
Haryana,Jhajjar,Mental Illness,60,80,1,0,1
Madhya Pradesh,Jhabua,Mental Illness,6,15,34,28,62
Madhya Pradesh,Jhabua,Mental Illness,15,35,145,103,248
Madhya Pradesh,Jhabua,Mental Illness,35,60,84,50,134
Madhya Pradesh,Jhabua,Mental Illness,60,80,11,13,24
Madhya Pradesh,Jhabua,Mental Illness,80,100,1,2,3
Bihar,Jehanabad,Mental Illness,0,6,4,2,6
Bihar,Jehanabad,Mental Illness,6,15,32,25,57
Bihar,Jehanabad,Mental Illness,15,35,62,31,93
Bihar,Jehanabad,Mental Illness,35,60,17,12,29
Bihar,Jehanabad,Mental Illness,60,80,3,0,3
Telangana,Jayashankar Bhupalapally,Mental Illness,6,15,1,0,1
Telangana,Jayashankar Bhupalapally,Mental Illness,15,35,41,31,72
Telangana,Jayashankar Bhupalapally,Mental Illness,35,60,96,63,159
Telangana,Jayashankar Bhupalapally,Mental Illness,60,80,20,14,34
Telangana,Jayashankar Bhupalapally,Mental Illness,80,100,1,0,1
Uttar Pradesh,Jaunpur,Mental Illness,0,6,18,11,29
Uttar Pradesh,Jaunpur,Mental Illness,6,15,191,109,300
Uttar Pradesh,Jaunpur,Mental Illness,15,35,356,176,532
Uttar Pradesh,Jaunpur,Mental Illness,35,60,104,37,141
Uttar Pradesh,Jaunpur,Mental Illness,60,80,3,3,6
Chhattisgarh,Jashpur,Mental Illness,6,15,3,2,5
Chhattisgarh,Jashpur,Mental Illness,15,35,8,5,13
Chhattisgarh,Jashpur,Mental Illness,35,60,3,6,9
Chhattisgarh,Jashpur,Mental Illness,60,80,0,2,2
Chhattisgarh,Janjgir-Champa,Mental Illness,0,6,1,1,2
Chhattisgarh,Janjgir-Champa,Mental Illness,6,15,63,51,114
Chhattisgarh,Janjgir-Champa,Mental Illness,15,35,106,77,183
Chhattisgarh,Janjgir-Champa,Mental Illness,35,60,26,26,52
Chhattisgarh,Janjgir-Champa,Mental Illness,60,80,0,1,1
Telangana,Jangoan,Mental Illness,15,35,6,3,9
Telangana,Jangoan,Mental Illness,35,60,30,32,62
Telangana,Jangoan,Mental Illness,60,80,12,5,17
Bihar,Jamui,Mental Illness,0,6,1,1,2
Bihar,Jamui,Mental Illness,6,15,22,17,39
Bihar,Jamui,Mental Illness,15,35,66,35,101
Bihar,Jamui,Mental Illness,35,60,12,11,23
Bihar,Jamui,Mental Illness,60,80,4,0,4
Jharkhand,Jamtara,Mental Illness,0,6,1,0,1
Jharkhand,Jamtara,Mental Illness,6,15,12,5,17
Jharkhand,Jamtara,Mental Illness,15,35,32,20,52
Jharkhand,Jamtara,Mental Illness,35,60,16,9,25
Jharkhand,Jamtara,Mental Illness,60,80,0,2,2
Gujarat,Jamnagar,Mental Illness,0,6,1,0,1
Gujarat,Jamnagar,Mental Illness,6,15,143,84,227
Gujarat,Jamnagar,Mental Illness,15,35,499,246,745
Gujarat,Jamnagar,Mental Illness,35,60,226,118,344
Gujarat,Jamnagar,Mental Illness,60,80,19,3,22
Gujarat,Jamnagar,Mental Illness,80,100,2,1,3
Jammu And Kashmir,Jammu,Mental Illness,0,6,13,6,19
Jammu And Kashmir,Jammu,Mental Illness,6,15,92,43,135
Jammu And Kashmir,Jammu,Mental Illness,15,35,361,222,583
Jammu And Kashmir,Jammu,Mental Illness,35,60,419,224,643
Jammu And Kashmir,Jammu,Mental Illness,60,80,37,13,50
Jammu And Kashmir,Jammu,Mental Illness,80,100,2,2,4
Rajasthan,Jalore,Mental Illness,0,6,2,3,5
Rajasthan,Jalore,Mental Illness,6,15,57,27,84
Rajasthan,Jalore,Mental Illness,15,35,236,98,334
Rajasthan,Jalore,Mental Illness,35,60,265,112,377
Rajasthan,Jalore,Mental Illness,60,80,43,22,65
Maharashtra,Jalna,Mental Illness,6,15,5,4,9
Maharashtra,Jalna,Mental Illness,15,35,99,34,133
Maharashtra,Jalna,Mental Illness,35,60,158,44,202
Maharashtra,Jalna,Mental Illness,60,80,15,6,21
Maharashtra,Jalna,Mental Illness,80,100,1,0,1
Maharashtra,Jalgaon,Mental Illness,6,15,1,0,1
Maharashtra,Jalgaon,Mental Illness,15,35,33,12,45
Maharashtra,Jalgaon,Mental Illness,35,60,143,47,190
Maharashtra,Jalgaon,Mental Illness,60,80,9,6,15
Uttar Pradesh,Jalaun,Mental Illness,0,6,6,4,10
Uttar Pradesh,Jalaun,Mental Illness,6,15,49,44,93
Uttar Pradesh,Jalaun,Mental Illness,15,35,149,70,219
Uttar Pradesh,Jalaun,Mental Illness,35,60,45,24,69
Uttar Pradesh,Jalaun,Mental Illness,60,80,2,1,3
Punjab,Jalandhar,Mental Illness,0,6,21,6,27
Punjab,Jalandhar,Mental Illness,6,15,415,271,686
Punjab,Jalandhar,Mental Illness,15,35,1110,588,1698
Punjab,Jalandhar,Mental Illness,35,60,385,201,586
Punjab,Jalandhar,Mental Illness,60,80,47,11,58
Punjab,Jalandhar,Mental Illness,80,100,1,2,3
Odisha,Jajapur,Mental Illness,0,6,35,17,52
Odisha,Jajapur,Mental Illness,6,15,366,226,592
Odisha,Jajapur,Mental Illness,15,35,891,587,1478
Odisha,Jajapur,Mental Illness,35,60,1096,690,1786
Odisha,Jajapur,Mental Illness,60,80,114,77,191
Odisha,Jajapur,Mental Illness,80,100,4,1,5
Rajasthan,Jaisalmer,Mental Illness,0,6,6,1,7
Rajasthan,Jaisalmer,Mental Illness,6,15,58,37,95
Rajasthan,Jaisalmer,Mental Illness,15,35,139,56,195
Rajasthan,Jaisalmer,Mental Illness,35,60,63,16,79
Rajasthan,Jaisalmer,Mental Illness,60,80,5,4,9
Rajasthan,Jaisalmer,Mental Illness,80,100,1,0,1
Rajasthan,Jaipur,Mental Illness,0,6,13,6,19
Rajasthan,Jaipur,Mental Illness,6,15,137,86,223
Rajasthan,Jaipur,Mental Illness,15,35,373,153,526
Rajasthan,Jaipur,Mental Illness,35,60,132,44,176
Rajasthan,Jaipur,Mental Illness,60,80,8,6,14
Telangana,Jagitial,Mental Illness,6,15,3,0,3
Telangana,Jagitial,Mental Illness,15,35,142,146,288
Telangana,Jagitial,Mental Illness,35,60,326,266,592
Telangana,Jagitial,Mental Illness,60,80,91,56,147
Telangana,Jagitial,Mental Illness,80,100,6,2,8
Odisha,Jagatsinghapur,Mental Illness,0,6,5,5,10
Odisha,Jagatsinghapur,Mental Illness,6,15,147,109,256
Odisha,Jagatsinghapur,Mental Illness,15,35,394,265,659
Odisha,Jagatsinghapur,Mental Illness,35,60,583,333,916
Odisha,Jagatsinghapur,Mental Illness,60,80,88,38,126
Odisha,Jagatsinghapur,Mental Illness,80,100,1,0,1
Madhya Pradesh,Jabalpur,Mental Illness,6,15,24,22,46
Madhya Pradesh,Jabalpur,Mental Illness,15,35,82,44,126
Madhya Pradesh,Jabalpur,Mental Illness,35,60,73,25,98
Madhya Pradesh,Jabalpur,Mental Illness,60,80,6,5,11
Madhya Pradesh,Jabalpur,Mental Illness,80,100,0,1,1
Madhya Pradesh,Indore,Mental Illness,0,6,2,0,2
Madhya Pradesh,Indore,Mental Illness,6,15,71,38,109
Madhya Pradesh,Indore,Mental Illness,15,35,210,150,360
Madhya Pradesh,Indore,Mental Illness,35,60,76,59,135
Madhya Pradesh,Indore,Mental Illness,60,80,6,5,11
Manipur,Imphal West,Mental Illness,0,6,0,1,1
Manipur,Imphal West,Mental Illness,6,15,5,0,5
Manipur,Imphal West,Mental Illness,15,35,18,13,31
Manipur,Imphal West,Mental Illness,35,60,42,32,74
Manipur,Imphal West,Mental Illness,60,80,7,6,13
Manipur,Imphal West,Mental Illness,80,100,2,7,9
Manipur,Imphal East,Mental Illness,0,6,1,1,2
Manipur,Imphal East,Mental Illness,6,15,7,6,13
Manipur,Imphal East,Mental Illness,15,35,18,17,35
Manipur,Imphal East,Mental Illness,35,60,43,45,88
Manipur,Imphal East,Mental Illness,60,80,7,11,18
Manipur,Imphal East,Mental Illness,80,100,1,3,4
Kerala,Idukki,Mental Illness,6,15,5,1,6
Kerala,Idukki,Mental Illness,15,35,49,34,83
Kerala,Idukki,Mental Illness,35,60,177,168,345
Kerala,Idukki,Mental Illness,60,80,72,37,109
Kerala,Idukki,Mental Illness,80,100,3,4,7
Telangana,Hyderabad,Mental Illness,15,35,12,6,18
Telangana,Hyderabad,Mental Illness,35,60,75,30,105
Telangana,Hyderabad,Mental Illness,60,80,13,5,18
West Bengal,Howrah,Mental Illness,15,35,1,2,3
Punjab,Hoshiarpur,Mental Illness,0,6,0,2,2
Punjab,Hoshiarpur,Mental Illness,6,15,149,96,245
Punjab,Hoshiarpur,Mental Illness,15,35,533,284,817
Punjab,Hoshiarpur,Mental Illness,35,60,452,176,628
Punjab,Hoshiarpur,Mental Illness,60,80,56,14,70
Punjab,Hoshiarpur,Mental Illness,80,100,2,0,2
Assam,Hojai,Mental Illness,0,6,13,14,27
Assam,Hojai,Mental Illness,6,15,35,42,77
Assam,Hojai,Mental Illness,15,35,77,56,133
Assam,Hojai,Mental Illness,35,60,30,18,48
Assam,Hojai,Mental Illness,60,80,1,3,4
Mizoram,Hnahthial,Mental Illness,6,15,1,0,1
Mizoram,Hnahthial,Mental Illness,15,35,0,2,2
Mizoram,Hnahthial,Mental Illness,60,80,1,0,1
Haryana,Hisar,Mental Illness,0,6,10,6,16
Haryana,Hisar,Mental Illness,6,15,49,23,72
Haryana,Hisar,Mental Illness,15,35,193,76,269
Haryana,Hisar,Mental Illness,35,60,123,49,172
Haryana,Hisar,Mental Illness,60,80,7,7,14
Maharashtra,Hingoli,Mental Illness,6,15,10,3,13
Maharashtra,Hingoli,Mental Illness,15,35,69,25,94
Maharashtra,Hingoli,Mental Illness,35,60,102,36,138
Maharashtra,Hingoli,Mental Illness,60,80,12,10,22
Maharashtra,Hingoli,Mental Illness,80,100,1,1,2
Jharkhand,Hazaribagh,Mental Illness,0,6,8,4,12
Jharkhand,Hazaribagh,Mental Illness,6,15,84,50,134
Jharkhand,Hazaribagh,Mental Illness,15,35,118,87,205
Jharkhand,Hazaribagh,Mental Illness,35,60,77,34,111
Jharkhand,Hazaribagh,Mental Illness,60,80,6,1,7
Karnataka,Haveri,Mental Illness,0,6,14,10,24
Karnataka,Haveri,Mental Illness,6,15,104,64,168
Karnataka,Haveri,Mental Illness,15,35,247,160,407
Karnataka,Haveri,Mental Illness,35,60,172,140,312
Karnataka,Haveri,Mental Illness,60,80,14,8,22
Uttar Pradesh,Hathras,Mental Illness,0,6,4,1,5
Uttar Pradesh,Hathras,Mental Illness,6,15,45,27,72
Uttar Pradesh,Hathras,Mental Illness,15,35,97,32,129
Uttar Pradesh,Hathras,Mental Illness,35,60,28,8,36
Uttar Pradesh,Hathras,Mental Illness,60,80,1,1,2
Karnataka,Hassan,Mental Illness,0,6,12,12,24
Karnataka,Hassan,Mental Illness,6,15,151,120,271
Karnataka,Hassan,Mental Illness,15,35,427,301,728
Karnataka,Hassan,Mental Illness,35,60,289,238,527
Karnataka,Hassan,Mental Illness,60,80,22,18,40
Uttarakhand,Haridwar,Mental Illness,0,6,4,0,4
Uttarakhand,Haridwar,Mental Illness,6,15,16,7,23
Uttarakhand,Haridwar,Mental Illness,15,35,75,39,114
Uttarakhand,Haridwar,Mental Illness,35,60,30,5,35
Uttarakhand,Haridwar,Mental Illness,60,80,0,1,1
Uttar Pradesh,Hardoi,Mental Illness,0,6,1,2,3
Uttar Pradesh,Hardoi,Mental Illness,6,15,36,26,62
Uttar Pradesh,Hardoi,Mental Illness,15,35,160,70,230
Uttar Pradesh,Hardoi,Mental Illness,35,60,62,20,82
Uttar Pradesh,Hardoi,Mental Illness,60,80,4,1,5
Madhya Pradesh,Harda,Mental Illness,6,15,14,8,22
Madhya Pradesh,Harda,Mental Illness,15,35,39,25,64
Madhya Pradesh,Harda,Mental Illness,35,60,15,4,19
Madhya Pradesh,Harda,Mental Illness,60,80,2,1,3
Uttar Pradesh,Hapur,Mental Illness,0,6,6,2,8
Uttar Pradesh,Hapur,Mental Illness,6,15,43,23,66
Uttar Pradesh,Hapur,Mental Illness,15,35,69,16,85
Uttar Pradesh,Hapur,Mental Illness,35,60,17,8,25
Rajasthan,Hanumangarh,Mental Illness,6,15,16,20,36
Rajasthan,Hanumangarh,Mental Illness,15,35,78,37,115
Rajasthan,Hanumangarh,Mental Illness,35,60,26,10,36
Rajasthan,Hanumangarh,Mental Illness,60,80,4,1,5
Telangana,Hanumakonda,Mental Illness,6,15,0,1,1
Telangana,Hanumakonda,Mental Illness,15,35,33,28,61
Telangana,Hanumakonda,Mental Illness,35,60,115,82,197
Telangana,Hanumakonda,Mental Illness,60,80,39,15,54
Telangana,Hanumakonda,Mental Illness,80,100,4,2,6
Himachal Pradesh,Hamirpur,Mental Illness,0,6,1,0,1
Himachal Pradesh,Hamirpur,Mental Illness,6,15,58,25,83
Himachal Pradesh,Hamirpur,Mental Illness,15,35,207,132,339
Himachal Pradesh,Hamirpur,Mental Illness,35,60,266,117,383
Himachal Pradesh,Hamirpur,Mental Illness,60,80,31,19,50
Himachal Pradesh,Hamirpur,Mental Illness,80,100,3,0,3
Uttar Pradesh,Hamirpur,Mental Illness,6,15,1,3,4
Uttar Pradesh,Hamirpur,Mental Illness,15,35,25,16,41
Uttar Pradesh,Hamirpur,Mental Illness,35,60,7,3,10
Uttar Pradesh,Hamirpur,Mental Illness,60,80,2,1,3
Assam,Hailakandi,Mental Illness,0,6,1,1,2
Assam,Hailakandi,Mental Illness,6,15,16,10,26
Assam,Hailakandi,Mental Illness,15,35,40,34,74
Assam,Hailakandi,Mental Illness,35,60,31,13,44
Assam,Hailakandi,Mental Illness,60,80,5,3,8
Sikkim,Gyalshing,Mental Illness,6,15,2,2,4
Sikkim,Gyalshing,Mental Illness,15,35,8,3,11
Sikkim,Gyalshing,Mental Illness,35,60,6,3,9
Sikkim,Gyalshing,Mental Illness,60,80,0,2,2
Madhya Pradesh,Gwalior,Mental Illness,0,6,2,1,3
Madhya Pradesh,Gwalior,Mental Illness,6,15,84,34,118
Madhya Pradesh,Gwalior,Mental Illness,15,35,176,71,247
Madhya Pradesh,Gwalior,Mental Illness,35,60,46,27,73
Madhya Pradesh,Gwalior,Mental Illness,60,80,3,1,4
Haryana,Gurugram,Mental Illness,0,6,1,0,1
Haryana,Gurugram,Mental Illness,6,15,24,10,34
Haryana,Gurugram,Mental Illness,15,35,70,26,96
Haryana,Gurugram,Mental Illness,35,60,76,29,105
Haryana,Gurugram,Mental Illness,60,80,5,1,6
Punjab,Gurdaspur,Mental Illness,0,6,15,5,20
Punjab,Gurdaspur,Mental Illness,6,15,337,176,513
Punjab,Gurdaspur,Mental Illness,15,35,988,442,1430
Punjab,Gurdaspur,Mental Illness,35,60,589,264,853
Punjab,Gurdaspur,Mental Illness,60,80,62,27,89
Punjab,Gurdaspur,Mental Illness,80,100,2,1,3
Andhra Pradesh,Guntur,Mental Illness,0,6,3,4,7
Andhra Pradesh,Guntur,Mental Illness,6,15,13,10,23
Andhra Pradesh,Guntur,Mental Illness,15,35,175,105,280
Andhra Pradesh,Guntur,Mental Illness,35,60,578,115,693
Andhra Pradesh,Guntur,Mental Illness,60,80,97,5,102
Andhra Pradesh,Guntur,Mental Illness,80,100,7,0,7
Madhya Pradesh,Guna,Mental Illness,6,15,18,11,29
Madhya Pradesh,Guna,Mental Illness,15,35,67,38,105
Madhya Pradesh,Guna,Mental Illness,35,60,50,18,68
Madhya Pradesh,Guna,Mental Illness,60,80,3,2,5
Jharkhand,Gumla,Mental Illness,0,6,4,0,4
Jharkhand,Gumla,Mental Illness,6,15,38,34,72
Jharkhand,Gumla,Mental Illness,15,35,126,100,226
Jharkhand,Gumla,Mental Illness,35,60,34,37,71
Jharkhand,Gumla,Mental Illness,60,80,6,3,9
Uttar Pradesh,Gorakhpur,Mental Illness,0,6,18,11,29
Uttar Pradesh,Gorakhpur,Mental Illness,6,15,171,87,258
Uttar Pradesh,Gorakhpur,Mental Illness,15,35,364,181,545
Uttar Pradesh,Gorakhpur,Mental Illness,35,60,135,48,183
Uttar Pradesh,Gorakhpur,Mental Illness,60,80,13,6,19
Bihar,Gopalganj,Mental Illness,0,6,12,7,19
Bihar,Gopalganj,Mental Illness,6,15,125,80,205
Bihar,Gopalganj,Mental Illness,15,35,109,58,167
Bihar,Gopalganj,Mental Illness,35,60,14,10,24
Bihar,Gopalganj,Mental Illness,60,80,0,1,1
Maharashtra,Gondia,Mental Illness,0,6,19,10,29
Maharashtra,Gondia,Mental Illness,6,15,22,14,36
Maharashtra,Gondia,Mental Illness,15,35,14,9,23
Maharashtra,Gondia,Mental Illness,35,60,51,26,77
Maharashtra,Gondia,Mental Illness,60,80,4,4,8
Uttar Pradesh,Gonda,Mental Illness,0,6,2,2,4
Uttar Pradesh,Gonda,Mental Illness,6,15,24,17,41
Uttar Pradesh,Gonda,Mental Illness,15,35,66,30,96
Uttar Pradesh,Gonda,Mental Illness,35,60,23,7,30
Uttar Pradesh,Gonda,Mental Illness,60,80,3,0,3
Uttar Pradesh,Gonda,Mental Illness,80,100,1,0,1
Tripura,Gomati,Mental Illness,0,6,1,2,3
Tripura,Gomati,Mental Illness,6,15,22,7,29
Tripura,Gomati,Mental Illness,15,35,26,18,44
Tripura,Gomati,Mental Illness,35,60,21,12,33
Tripura,Gomati,Mental Illness,60,80,2,2,4
Assam,Golaghat,Mental Illness,0,6,2,0,2
Assam,Golaghat,Mental Illness,6,15,15,12,27
Assam,Golaghat,Mental Illness,15,35,52,36,88
Assam,Golaghat,Mental Illness,35,60,40,36,76
Assam,Golaghat,Mental Illness,60,80,3,2,5
Jharkhand,Godda,Mental Illness,0,6,0,1,1
Jharkhand,Godda,Mental Illness,6,15,8,12,20
Jharkhand,Godda,Mental Illness,15,35,35,35,70
Jharkhand,Godda,Mental Illness,35,60,30,23,53
Jharkhand,Godda,Mental Illness,60,80,9,4,13
Assam,Goalpara,Mental Illness,0,6,6,4,10
Assam,Goalpara,Mental Illness,6,15,83,55,138
Assam,Goalpara,Mental Illness,15,35,358,242,600
Assam,Goalpara,Mental Illness,35,60,241,155,396
Assam,Goalpara,Mental Illness,60,80,15,15,30
Assam,Goalpara,Mental Illness,80,100,1,0,1
Jharkhand,Giridih,Mental Illness,0,6,1,2,3
Jharkhand,Giridih,Mental Illness,6,15,52,24,76
Jharkhand,Giridih,Mental Illness,15,35,80,63,143
Jharkhand,Giridih,Mental Illness,35,60,38,10,48
Jharkhand,Giridih,Mental Illness,60,80,1,1,2
Jharkhand,Giridih,Mental Illness,80,100,2,0,2
Gujarat,Gir Somnath,Mental Illness,6,15,1,0,1
Gujarat,Gir Somnath,Mental Illness,15,35,12,1,13
Gujarat,Gir Somnath,Mental Illness,35,60,13,8,21
Gujarat,Gir Somnath,Mental Illness,60,80,7,1,8
Uttar Pradesh,Ghazipur,Mental Illness,0,6,1,1,2
Uttar Pradesh,Ghazipur,Mental Illness,6,15,19,12,31
Uttar Pradesh,Ghazipur,Mental Illness,15,35,128,72,200
Uttar Pradesh,Ghazipur,Mental Illness,35,60,42,14,56
Uttar Pradesh,Ghazipur,Mental Illness,60,80,5,0,5
Uttar Pradesh,Ghaziabad,Mental Illness,0,6,2,0,2
Uttar Pradesh,Ghaziabad,Mental Illness,6,15,65,30,95
Uttar Pradesh,Ghaziabad,Mental Illness,15,35,213,78,291
Uttar Pradesh,Ghaziabad,Mental Illness,35,60,88,25,113
Uttar Pradesh,Ghaziabad,Mental Illness,60,80,5,1,6
Uttar Pradesh,Ghaziabad,Mental Illness,80,100,0,1,1
Bihar,Gaya,Mental Illness,0,6,0,2,2
Bihar,Gaya,Mental Illness,6,15,73,38,111
Bihar,Gaya,Mental Illness,15,35,138,103,241
Bihar,Gaya,Mental Illness,35,60,62,25,87
Bihar,Gaya,Mental Illness,60,80,7,3,10
Uttar Pradesh,Gautam Buddha Nagar,Mental Illness,0,6,9,5,14
Uttar Pradesh,Gautam Buddha Nagar,Mental Illness,6,15,33,19,52
Uttar Pradesh,Gautam Buddha Nagar,Mental Illness,15,35,55,19,74
Uttar Pradesh,Gautam Buddha Nagar,Mental Illness,35,60,24,5,29
Uttar Pradesh,Gautam Buddha Nagar,Mental Illness,60,80,6,1,7
Chhattisgarh,Gaurella Pendra Marwahi,Mental Illness,15,35,3,0,3
Chhattisgarh,Gaurella Pendra Marwahi,Mental Illness,35,60,0,1,1
Chhattisgarh,Gariyaband,Mental Illness,0,6,7,6,13
Chhattisgarh,Gariyaband,Mental Illness,6,15,101,54,155
Chhattisgarh,Gariyaband,Mental Illness,15,35,180,182,362
Chhattisgarh,Gariyaband,Mental Illness,35,60,55,49,104
Chhattisgarh,Gariyaband,Mental Illness,60,80,7,3,10
Chhattisgarh,Gariyaband,Mental Illness,80,100,1,1,2
Jharkhand,Garhwa,Mental Illness,0,6,5,6,11
Jharkhand,Garhwa,Mental Illness,6,15,84,80,164
Jharkhand,Garhwa,Mental Illness,15,35,138,88,226
Jharkhand,Garhwa,Mental Illness,35,60,50,21,71
Jharkhand,Garhwa,Mental Illness,60,80,2,1,3
Odisha,Ganjam,Mental Illness,0,6,10,8,18
Odisha,Ganjam,Mental Illness,6,15,33,15,48
Odisha,Ganjam,Mental Illness,15,35,274,187,461
Odisha,Ganjam,Mental Illness,35,60,583,286,869
Odisha,Ganjam,Mental Illness,60,80,93,67,160
Odisha,Ganjam,Mental Illness,80,100,3,0,3
Sikkim,Gangtok,Mental Illness,6,15,5,2,7
Sikkim,Gangtok,Mental Illness,15,35,16,8,24
Sikkim,Gangtok,Mental Illness,35,60,25,20,45
Sikkim,Gangtok,Mental Illness,60,80,5,3,8
Rajasthan,Ganganagar,Mental Illness,0,6,12,2,14
Rajasthan,Ganganagar,Mental Illness,6,15,157,108,265
Rajasthan,Ganganagar,Mental Illness,15,35,447,267,714
Rajasthan,Ganganagar,Mental Illness,35,60,253,124,377
Rajasthan,Ganganagar,Mental Illness,60,80,12,9,21
Rajasthan,Ganganagar,Mental Illness,80,100,1,0,1
Gujarat,Gandhinagar,Mental Illness,6,15,5,2,7
Gujarat,Gandhinagar,Mental Illness,15,35,17,9,26
Gujarat,Gandhinagar,Mental Illness,35,60,44,22,66
Gujarat,Gandhinagar,Mental Illness,60,80,1,4,5
Jammu And Kashmir,Ganderbal,Mental Illness,0,6,4,6,10
Jammu And Kashmir,Ganderbal,Mental Illness,6,15,34,26,60
Jammu And Kashmir,Ganderbal,Mental Illness,15,35,143,148,291
Jammu And Kashmir,Ganderbal,Mental Illness,35,60,114,150,264
Jammu And Kashmir,Ganderbal,Mental Illness,60,80,8,5,13
Odisha,Gajapati,Mental Illness,0,6,21,23,44
Odisha,Gajapati,Mental Illness,6,15,248,211,459
Odisha,Gajapati,Mental Illness,15,35,512,476,988
Odisha,Gajapati,Mental Illness,35,60,305,236,541
Odisha,Gajapati,Mental Illness,60,80,54,40,94
Odisha,Gajapati,Mental Illness,80,100,1,0,1
Maharashtra,Gadchiroli,Mental Illness,6,15,14,7,21
Maharashtra,Gadchiroli,Mental Illness,15,35,54,48,102
Maharashtra,Gadchiroli,Mental Illness,35,60,57,57,114
Maharashtra,Gadchiroli,Mental Illness,60,80,10,6,16
Karnataka,Gadag,Mental Illness,0,6,8,9,17
Karnataka,Gadag,Mental Illness,6,15,56,33,89
Karnataka,Gadag,Mental Illness,15,35,107,78,185
Karnataka,Gadag,Mental Illness,35,60,64,44,108
Karnataka,Gadag,Mental Illness,60,80,4,4,8
Uttar Pradesh,Firozabad,Mental Illness,6,15,19,9,28
Uttar Pradesh,Firozabad,Mental Illness,15,35,77,34,111
Uttar Pradesh,Firozabad,Mental Illness,35,60,98,36,134
Uttar Pradesh,Firozabad,Mental Illness,60,80,3,1,4
Punjab,Ferozepur,Mental Illness,0,6,3,1,4
Punjab,Ferozepur,Mental Illness,6,15,58,31,89
Punjab,Ferozepur,Mental Illness,15,35,94,42,136
Punjab,Ferozepur,Mental Illness,35,60,30,22,52
Punjab,Ferozepur,Mental Illness,60,80,4,0,4
Punjab,Fazilka,Mental Illness,0,6,2,0,2
Punjab,Fazilka,Mental Illness,6,15,19,15,34
Punjab,Fazilka,Mental Illness,15,35,55,31,86
Punjab,Fazilka,Mental Illness,35,60,27,18,45
Punjab,Fazilka,Mental Illness,60,80,3,3,6
Uttar Pradesh,Fatehpur,Mental Illness,0,6,1,0,1
Uttar Pradesh,Fatehpur,Mental Illness,6,15,23,22,45
Uttar Pradesh,Fatehpur,Mental Illness,15,35,107,61,168
Uttar Pradesh,Fatehpur,Mental Illness,35,60,30,18,48
Uttar Pradesh,Fatehpur,Mental Illness,60,80,4,1,5
Punjab,Fatehgarh Sahib,Mental Illness,0,6,2,1,3
Punjab,Fatehgarh Sahib,Mental Illness,6,15,71,38,109
Punjab,Fatehgarh Sahib,Mental Illness,15,35,324,179,503
Punjab,Fatehgarh Sahib,Mental Illness,35,60,190,86,276
Punjab,Fatehgarh Sahib,Mental Illness,60,80,15,5,20
Punjab,Fatehgarh Sahib,Mental Illness,80,100,1,0,1
Haryana,Fatehabad,Mental Illness,0,6,12,6,18
Haryana,Fatehabad,Mental Illness,6,15,91,46,137
Haryana,Fatehabad,Mental Illness,15,35,266,148,414
Haryana,Fatehabad,Mental Illness,35,60,144,57,201
Haryana,Fatehabad,Mental Illness,60,80,16,4,20
Uttar Pradesh,Farrukhabad,Mental Illness,0,6,1,0,1
Uttar Pradesh,Farrukhabad,Mental Illness,6,15,49,29,78
Uttar Pradesh,Farrukhabad,Mental Illness,15,35,93,47,140
Uttar Pradesh,Farrukhabad,Mental Illness,35,60,46,15,61
Uttar Pradesh,Farrukhabad,Mental Illness,60,80,7,3,10
Punjab,Faridkot,Mental Illness,6,15,6,2,8
Punjab,Faridkot,Mental Illness,15,35,22,14,36
Punjab,Faridkot,Mental Illness,35,60,47,16,63
Punjab,Faridkot,Mental Illness,60,80,2,0,2
Haryana,Faridabad,Mental Illness,0,6,1,2,3
Haryana,Faridabad,Mental Illness,6,15,55,36,91
Haryana,Faridabad,Mental Illness,15,35,137,69,206
Haryana,Faridabad,Mental Illness,35,60,54,27,81
Haryana,Faridabad,Mental Illness,60,80,1,3,4
Haryana,Faridabad,Mental Illness,80,100,0,1,1
Uttar Pradesh,Etawah,Mental Illness,0,6,2,0,2
Uttar Pradesh,Etawah,Mental Illness,6,15,31,21,52
Uttar Pradesh,Etawah,Mental Illness,15,35,67,24,91
Uttar Pradesh,Etawah,Mental Illness,35,60,32,10,42
Uttar Pradesh,Etawah,Mental Illness,60,80,4,0,4
Uttar Pradesh,Etah,Mental Illness,0,6,1,0,1
Uttar Pradesh,Etah,Mental Illness,6,15,16,6,22
Uttar Pradesh,Etah,Mental Illness,15,35,42,15,57
Uttar Pradesh,Etah,Mental Illness,35,60,15,5,20
Uttar Pradesh,Etah,Mental Illness,60,80,1,2,3
Tamil Nadu,Erode,Mental Illness,6,15,8,4,12
Tamil Nadu,Erode,Mental Illness,15,35,61,42,103
Tamil Nadu,Erode,Mental Illness,35,60,142,111,253
Tamil Nadu,Erode,Mental Illness,60,80,25,20,45
Tamil Nadu,Erode,Mental Illness,80,100,0,2,2
Kerala,Ernakulam,Mental Illness,0,6,2,2,4
Kerala,Ernakulam,Mental Illness,6,15,11,5,16
Kerala,Ernakulam,Mental Illness,15,35,87,56,143
Kerala,Ernakulam,Mental Illness,35,60,345,266,611
Kerala,Ernakulam,Mental Illness,60,80,102,97,199
Kerala,Ernakulam,Mental Illness,80,100,1,3,4
Meghalaya,Eastern West Khasi Hills,Mental Illness,15,35,3,2,5
Meghalaya,Eastern West Khasi Hills,Mental Illness,35,60,5,4,9
Meghalaya,Eastern West Khasi Hills,Mental Illness,60,80,1,2,3
Jharkhand,East Singhbum,Mental Illness,0,6,9,4,13
Jharkhand,East Singhbum,Mental Illness,6,15,117,57,174
Jharkhand,East Singhbum,Mental Illness,15,35,356,244,600
Jharkhand,East Singhbum,Mental Illness,35,60,163,151,314
Jharkhand,East Singhbum,Mental Illness,60,80,20,11,31
Jharkhand,East Singhbum,Mental Illness,80,100,2,1,3
Arunachal Pradesh,East Siang,Mental Illness,6,15,1,1,2
Arunachal Pradesh,East Siang,Mental Illness,15,35,0,1,1
Madhya Pradesh,East Nimar,Mental Illness,0,6,3,1,4
Madhya Pradesh,East Nimar,Mental Illness,6,15,167,102,269
Madhya Pradesh,East Nimar,Mental Illness,15,35,502,273,775
Madhya Pradesh,East Nimar,Mental Illness,35,60,178,113,291
Madhya Pradesh,East Nimar,Mental Illness,60,80,18,10,28
Meghalaya,East Khasi Hills,Mental Illness,15,35,43,25,68
Meghalaya,East Khasi Hills,Mental Illness,35,60,59,76,135
Meghalaya,East Khasi Hills,Mental Illness,60,80,10,13,23
Meghalaya,East Khasi Hills,Mental Illness,80,100,0,2,2
Arunachal Pradesh,East Kameng,Mental Illness,6,15,0,2,2
Arunachal Pradesh,East Kameng,Mental Illness,15,35,1,1,2
Meghalaya,East Jaintia Hills,Mental Illness,15,35,6,2,8
Meghalaya,East Jaintia Hills,Mental Illness,35,60,5,7,12
Meghalaya,East Jaintia Hills,Mental Illness,60,80,0,1,1
Meghalaya,East Jaintia Hills,Mental Illness,80,100,0,1,1
Andhra Pradesh,East Godavari,Mental Illness,0,6,7,5,12
Andhra Pradesh,East Godavari,Mental Illness,6,15,35,24,59
Andhra Pradesh,East Godavari,Mental Illness,15,35,289,153,442
Andhra Pradesh,East Godavari,Mental Illness,35,60,1008,160,1168
Andhra Pradesh,East Godavari,Mental Illness,60,80,122,11,133
Andhra Pradesh,East Godavari,Mental Illness,80,100,2,0,2
Meghalaya,East Garo Hills,Mental Illness,0,6,0,1,1
Meghalaya,East Garo Hills,Mental Illness,6,15,9,3,12
Meghalaya,East Garo Hills,Mental Illness,15,35,30,29,59
Meghalaya,East Garo Hills,Mental Illness,35,60,10,4,14
Delhi,East,Mental Illness,6,15,2,0,2
Delhi,East,Mental Illness,15,35,26,11,37
Delhi,East,Mental Illness,35,60,42,12,54
Delhi,East,Mental Illness,60,80,4,0,4
Chhattisgarh,Durg,Mental Illness,0,6,13,3,16
Chhattisgarh,Durg,Mental Illness,6,15,297,234,531
Chhattisgarh,Durg,Mental Illness,15,35,726,452,1178
Chhattisgarh,Durg,Mental Illness,35,60,235,170,405
Chhattisgarh,Durg,Mental Illness,60,80,12,9,21
Rajasthan,Dungarpur,Mental Illness,0,6,1,0,1
Rajasthan,Dungarpur,Mental Illness,6,15,35,15,50
Rajasthan,Dungarpur,Mental Illness,15,35,99,55,154
Rajasthan,Dungarpur,Mental Illness,35,60,51,27,78
Rajasthan,Dungarpur,Mental Illness,60,80,6,4,10
Jharkhand,Dumka,Mental Illness,0,6,1,1,2
Jharkhand,Dumka,Mental Illness,6,15,40,21,61
Jharkhand,Dumka,Mental Illness,15,35,60,32,92
Jharkhand,Dumka,Mental Illness,35,60,40,20,60
Jharkhand,Dumka,Mental Illness,60,80,1,0,1
Gujarat,Dohad,Mental Illness,6,15,33,17,50
Gujarat,Dohad,Mental Illness,15,35,145,89,234
Gujarat,Dohad,Mental Illness,35,60,37,6,43
Gujarat,Dohad,Mental Illness,60,80,1,2,3
Jammu And Kashmir,Doda,Mental Illness,0,6,7,4,11
Jammu And Kashmir,Doda,Mental Illness,6,15,58,48,106
Jammu And Kashmir,Doda,Mental Illness,15,35,195,131,326
Jammu And Kashmir,Doda,Mental Illness,35,60,137,77,214
Jammu And Kashmir,Doda,Mental Illness,60,80,9,12,21
Dadra Nagar Haveli And Daman And Diu,Diu,Mental Illness,15,35,2,2,4
Dadra Nagar Haveli And Daman And Diu,Diu,Mental Illness,35,60,1,0,1
Dadra Nagar Haveli And Daman And Diu,Diu,Mental Illness,60,80,1,0,1
Madhya Pradesh,Dindori,Mental Illness,6,15,27,18,45
Madhya Pradesh,Dindori,Mental Illness,15,35,78,71,149
Madhya Pradesh,Dindori,Mental Illness,35,60,41,20,61
Madhya Pradesh,Dindori,Mental Illness,60,80,5,6,11
Madhya Pradesh,Dindori,Mental Illness,80,100,1,0,1
Tamil Nadu,Dindigul,Mental Illness,6,15,89,62,151
Tamil Nadu,Dindigul,Mental Illness,15,35,383,246,629
Tamil Nadu,Dindigul,Mental Illness,35,60,194,161,355
Tamil Nadu,Dindigul,Mental Illness,60,80,18,16,34
Tamil Nadu,Dindigul,Mental Illness,80,100,0,1,1
Nagaland,Dimapur,Mental Illness,6,15,1,0,1
Nagaland,Dimapur,Mental Illness,15,35,1,0,1
Nagaland,Dimapur,Mental Illness,35,60,1,1,2
Assam,Dima Hasao,Mental Illness,0,6,0,1,1
Assam,Dima Hasao,Mental Illness,6,15,3,2,5
Assam,Dima Hasao,Mental Illness,15,35,4,0,4
Assam,Dima Hasao,Mental Illness,35,60,1,1,2
Assam,Dibrugarh,Mental Illness,0,6,0,2,2
Assam,Dibrugarh,Mental Illness,6,15,10,5,15
Assam,Dibrugarh,Mental Illness,15,35,25,20,45
Assam,Dibrugarh,Mental Illness,35,60,26,22,48
Assam,Dibrugarh,Mental Illness,60,80,3,1,4
Maharashtra,Dhule,Mental Illness,6,15,15,4,19
Maharashtra,Dhule,Mental Illness,15,35,128,45,173
Maharashtra,Dhule,Mental Illness,35,60,147,66,213
Maharashtra,Dhule,Mental Illness,60,80,29,10,39
Assam,Dhubri,Mental Illness,0,6,0,1,1
Assam,Dhubri,Mental Illness,6,15,27,19,46
Assam,Dhubri,Mental Illness,15,35,71,45,116
Assam,Dhubri,Mental Illness,35,60,7,5,12
Assam,Dhubri,Mental Illness,60,80,2,1,3
Rajasthan,Dholpur,Mental Illness,6,15,6,0,6
Rajasthan,Dholpur,Mental Illness,15,35,24,5,29
Rajasthan,Dholpur,Mental Illness,35,60,17,6,23
Odisha,Dhenkanal,Mental Illness,0,6,21,15,36
Odisha,Dhenkanal,Mental Illness,6,15,417,240,657
Odisha,Dhenkanal,Mental Illness,15,35,770,509,1279
Odisha,Dhenkanal,Mental Illness,35,60,555,297,852
Odisha,Dhenkanal,Mental Illness,60,80,55,42,97
Odisha,Dhenkanal,Mental Illness,80,100,3,0,3
Assam,Dhemaji,Mental Illness,0,6,2,0,2
Assam,Dhemaji,Mental Illness,6,15,4,7,11
Assam,Dhemaji,Mental Illness,15,35,15,16,31
Assam,Dhemaji,Mental Illness,35,60,9,9,18
Assam,Dhemaji,Mental Illness,60,80,3,0,3
Karnataka,Dharwad,Mental Illness,0,6,17,14,31
Karnataka,Dharwad,Mental Illness,6,15,115,85,200
Karnataka,Dharwad,Mental Illness,15,35,211,132,343
Karnataka,Dharwad,Mental Illness,35,60,135,83,218
Karnataka,Dharwad,Mental Illness,60,80,11,5,16
Tamil Nadu,Dharmapuri,Mental Illness,0,6,1,1,2
Tamil Nadu,Dharmapuri,Mental Illness,6,15,12,13,25
Tamil Nadu,Dharmapuri,Mental Illness,15,35,65,28,93
Tamil Nadu,Dharmapuri,Mental Illness,35,60,107,32,139
Tamil Nadu,Dharmapuri,Mental Illness,60,80,14,13,27
Tamil Nadu,Dharmapuri,Mental Illness,80,100,0,1,1
Madhya Pradesh,Dhar,Mental Illness,6,15,60,45,105
Madhya Pradesh,Dhar,Mental Illness,15,35,373,244,617
Madhya Pradesh,Dhar,Mental Illness,35,60,221,140,361
Madhya Pradesh,Dhar,Mental Illness,60,80,24,16,40
Madhya Pradesh,Dhar,Mental Illness,80,100,1,0,1
Jharkhand,Dhanbad,Mental Illness,0,6,0,1,1
Jharkhand,Dhanbad,Mental Illness,6,15,14,4,18
Jharkhand,Dhanbad,Mental Illness,15,35,49,30,79
Jharkhand,Dhanbad,Mental Illness,35,60,13,14,27
Jharkhand,Dhanbad,Mental Illness,60,80,4,1,5
Chhattisgarh,Dhamtari,Mental Illness,0,6,8,6,14
Chhattisgarh,Dhamtari,Mental Illness,6,15,139,91,230
Chhattisgarh,Dhamtari,Mental Illness,15,35,265,218,483
Chhattisgarh,Dhamtari,Mental Illness,35,60,76,58,134
Chhattisgarh,Dhamtari,Mental Illness,60,80,3,3,6
Chhattisgarh,Dhamtari,Mental Illness,80,100,1,0,1
Tripura,Dhalai,Mental Illness,15,35,12,6,18
Tripura,Dhalai,Mental Illness,35,60,50,20,70
Tripura,Dhalai,Mental Illness,60,80,2,4,6
Tripura,Dhalai,Mental Illness,80,100,1,1,2
Madhya Pradesh,Dewas,Mental Illness,0,6,1,1,2
Madhya Pradesh,Dewas,Mental Illness,6,15,27,31,58
Madhya Pradesh,Dewas,Mental Illness,15,35,204,111,315
Madhya Pradesh,Dewas,Mental Illness,35,60,144,70,214
Madhya Pradesh,Dewas,Mental Illness,60,80,19,9,28
Madhya Pradesh,Dewas,Mental Illness,80,100,0,1,1
Gujarat,Devbhumi Dwarka,Mental Illness,0,6,0,1,1
Gujarat,Devbhumi Dwarka,Mental Illness,6,15,25,18,43
Gujarat,Devbhumi Dwarka,Mental Illness,15,35,54,25,79
Gujarat,Devbhumi Dwarka,Mental Illness,35,60,29,11,40
Gujarat,Devbhumi Dwarka,Mental Illness,60,80,6,3,9
Uttar Pradesh,Deoria,Mental Illness,0,6,14,6,20
Uttar Pradesh,Deoria,Mental Illness,6,15,187,111,298
Uttar Pradesh,Deoria,Mental Illness,15,35,431,192,623
Uttar Pradesh,Deoria,Mental Illness,35,60,110,32,142
Uttar Pradesh,Deoria,Mental Illness,60,80,9,3,12
Uttar Pradesh,Deoria,Mental Illness,80,100,1,0,1
Jharkhand,Deoghar,Mental Illness,0,6,3,1,4
Jharkhand,Deoghar,Mental Illness,6,15,14,3,17
Jharkhand,Deoghar,Mental Illness,15,35,33,14,47
Jharkhand,Deoghar,Mental Illness,35,60,22,1,23
Jharkhand,Deoghar,Mental Illness,60,80,2,2,4
Jharkhand,Deoghar,Mental Illness,80,100,1,0,1
Odisha,Deogarh,Mental Illness,0,6,9,7,16
Odisha,Deogarh,Mental Illness,6,15,39,37,76
Odisha,Deogarh,Mental Illness,15,35,46,53,99
Odisha,Deogarh,Mental Illness,35,60,45,24,69
Odisha,Deogarh,Mental Illness,60,80,1,3,4
Odisha,Deogarh,Mental Illness,80,100,0,1,1
Uttarakhand,Dehradun,Mental Illness,0,6,2,6,8
Uttarakhand,Dehradun,Mental Illness,6,15,17,15,32
Uttarakhand,Dehradun,Mental Illness,15,35,73,35,108
Uttarakhand,Dehradun,Mental Illness,35,60,49,31,80
Uttarakhand,Dehradun,Mental Illness,60,80,3,7,10
Uttarakhand,Dehradun,Mental Illness,80,100,0,3,3
Karnataka,Davangere,Mental Illness,0,6,12,12,24
Karnataka,Davangere,Mental Illness,6,15,31,17,48
Karnataka,Davangere,Mental Illness,15,35,99,79,178
Karnataka,Davangere,Mental Illness,35,60,171,118,289
Karnataka,Davangere,Mental Illness,60,80,16,14,30
Rajasthan,Dausa,Mental Illness,0,6,2,2,4
Rajasthan,Dausa,Mental Illness,6,15,91,60,151
Rajasthan,Dausa,Mental Illness,15,35,216,105,321
Rajasthan,Dausa,Mental Illness,35,60,67,30,97
Rajasthan,Dausa,Mental Illness,60,80,1,3,4
Madhya Pradesh,Datia,Mental Illness,0,6,1,0,1
Madhya Pradesh,Datia,Mental Illness,6,15,34,18,52
Madhya Pradesh,Datia,Mental Illness,15,35,121,68,189
Madhya Pradesh,Datia,Mental Illness,35,60,46,19,65
Madhya Pradesh,Datia,Mental Illness,60,80,9,4,13
Assam,Darrang,Mental Illness,0,6,11,3,14
Assam,Darrang,Mental Illness,6,15,121,78,199
Assam,Darrang,Mental Illness,15,35,249,169,418
Assam,Darrang,Mental Illness,35,60,205,100,305
Assam,Darrang,Mental Illness,60,80,15,12,27
Assam,Darrang,Mental Illness,80,100,1,0,1
Bihar,Darbhanga,Mental Illness,0,6,1,0,1
Bihar,Darbhanga,Mental Illness,6,15,42,22,64
Bihar,Darbhanga,Mental Illness,15,35,126,80,206
Bihar,Darbhanga,Mental Illness,35,60,53,19,72
Bihar,Darbhanga,Mental Illness,60,80,4,0,4
Chhattisgarh,Dantewada,Mental Illness,0,6,2,1,3
Chhattisgarh,Dantewada,Mental Illness,6,15,19,21,40
Chhattisgarh,Dantewada,Mental Illness,15,35,28,36,64
Chhattisgarh,Dantewada,Mental Illness,35,60,0,10,10
Chhattisgarh,Dantewada,Mental Illness,60,80,1,3,4
Chhattisgarh,Dantewada,Mental Illness,80,100,1,0,1
Gujarat,Dang,Mental Illness,6,15,4,3,7
Gujarat,Dang,Mental Illness,15,35,13,8,21
Gujarat,Dang,Mental Illness,35,60,0,3,3
Gujarat,Dang,Mental Illness,60,80,1,0,1
Madhya Pradesh,Damoh,Mental Illness,0,6,1,0,1
Madhya Pradesh,Damoh,Mental Illness,6,15,52,37,89
Madhya Pradesh,Damoh,Mental Illness,15,35,493,286,779
Madhya Pradesh,Damoh,Mental Illness,35,60,304,166,470
Madhya Pradesh,Damoh,Mental Illness,60,80,48,31,79
Madhya Pradesh,Damoh,Mental Illness,80,100,2,3,5
Dadra Nagar Haveli And Daman And Diu,Daman,Mental Illness,6,15,3,2,5
Dadra Nagar Haveli And Daman And Diu,Daman,Mental Illness,15,35,11,1,12
Dadra Nagar Haveli And Daman And Diu,Daman,Mental Illness,35,60,4,3,7
Karnataka,Dakshina Kannada,Mental Illness,0,6,0,1,1
Karnataka,Dakshina Kannada,Mental Illness,6,15,15,10,25
Karnataka,Dakshina Kannada,Mental Illness,15,35,104,70,174
Karnataka,Dakshina Kannada,Mental Illness,35,60,198,170,368
Karnataka,Dakshina Kannada,Mental Illness,60,80,39,30,69
Karnataka,Dakshina Kannada,Mental Illness,80,100,0,2,2
Dadra Nagar Haveli And Daman And Diu,Dadra And Nagar Haveli,Mental Illness,6,15,3,0,3
Dadra Nagar Haveli And Daman And Diu,Dadra And Nagar Haveli,Mental Illness,35,60,0,1,1
Odisha,Cuttack,Mental Illness,0,6,46,19,65
Odisha,Cuttack,Mental Illness,6,15,435,268,703
Odisha,Cuttack,Mental Illness,15,35,578,406,984
Odisha,Cuttack,Mental Illness,35,60,815,452,1267
Odisha,Cuttack,Mental Illness,60,80,101,61,162
Odisha,Cuttack,Mental Illness,80,100,2,1,3
Tamil Nadu,Cuddalore,Mental Illness,0,6,3,1,4
Tamil Nadu,Cuddalore,Mental Illness,6,15,21,6,27
Tamil Nadu,Cuddalore,Mental Illness,15,35,96,69,165
Tamil Nadu,Cuddalore,Mental Illness,35,60,169,107,276
Tamil Nadu,Cuddalore,Mental Illness,60,80,7,9,16
Tamil Nadu,Cuddalore,Mental Illness,80,100,2,0,2
West Bengal,Coochbehar,Mental Illness,6,15,4,3,7
West Bengal,Coochbehar,Mental Illness,15,35,2,1,3
Tamil Nadu,Coimbatore,Mental Illness,6,15,32,15,47
Tamil Nadu,Coimbatore,Mental Illness,15,35,98,81,179
Tamil Nadu,Coimbatore,Mental Illness,35,60,87,97,184
Tamil Nadu,Coimbatore,Mental Illness,60,80,15,14,29
Tamil Nadu,Coimbatore,Mental Illness,80,100,0,3,3
Rajasthan,Churu,Mental Illness,0,6,4,2,6
Rajasthan,Churu,Mental Illness,6,15,81,56,137
Rajasthan,Churu,Mental Illness,15,35,257,130,387
Rajasthan,Churu,Mental Illness,35,60,119,30,149
Rajasthan,Churu,Mental Illness,60,80,9,6,15
Rajasthan,Churu,Mental Illness,80,100,1,0,1
Manipur,Churachandpur,Mental Illness,0,6,5,0,5
Manipur,Churachandpur,Mental Illness,6,15,5,3,8
Manipur,Churachandpur,Mental Illness,15,35,18,15,33
Manipur,Churachandpur,Mental Illness,35,60,17,19,36
Manipur,Churachandpur,Mental Illness,60,80,1,5,6
Rajasthan,Chittorgarh,Mental Illness,0,6,3,1,4
Rajasthan,Chittorgarh,Mental Illness,6,15,74,60,134
Rajasthan,Chittorgarh,Mental Illness,15,35,384,226,610
Rajasthan,Chittorgarh,Mental Illness,35,60,250,130,380
Rajasthan,Chittorgarh,Mental Illness,60,80,34,22,56
Rajasthan,Chittorgarh,Mental Illness,80,100,0,5,5
Andhra Pradesh,Chittoor,Mental Illness,0,6,2,0,2
Andhra Pradesh,Chittoor,Mental Illness,6,15,39,26,65
Andhra Pradesh,Chittoor,Mental Illness,15,35,474,345,819
Andhra Pradesh,Chittoor,Mental Illness,35,60,1180,443,1623
Andhra Pradesh,Chittoor,Mental Illness,60,80,189,66,255
Andhra Pradesh,Chittoor,Mental Illness,80,100,10,1,11
Uttar Pradesh,Chitrakoot,Mental Illness,0,6,9,6,15
Uttar Pradesh,Chitrakoot,Mental Illness,6,15,92,57,149
Uttar Pradesh,Chitrakoot,Mental Illness,15,35,75,23,98
Uttar Pradesh,Chitrakoot,Mental Illness,35,60,20,7,27
Uttar Pradesh,Chitrakoot,Mental Illness,60,80,1,0,1
Uttar Pradesh,Chitrakoot,Mental Illness,80,100,1,1,2
Karnataka,Chitradurga,Mental Illness,0,6,2,0,2
Karnataka,Chitradurga,Mental Illness,6,15,86,60,146
Karnataka,Chitradurga,Mental Illness,15,35,346,212,558
Karnataka,Chitradurga,Mental Illness,35,60,200,154,354
Karnataka,Chitradurga,Mental Illness,60,80,18,9,27
Assam,Chirang,Mental Illness,0,6,1,0,1
Assam,Chirang,Mental Illness,6,15,14,11,25
Assam,Chirang,Mental Illness,15,35,33,30,63
Assam,Chirang,Mental Illness,35,60,20,17,37
Assam,Chirang,Mental Illness,60,80,1,5,6
Karnataka,Chikkamagaluru,Mental Illness,0,6,2,3,5
Karnataka,Chikkamagaluru,Mental Illness,6,15,34,27,61
Karnataka,Chikkamagaluru,Mental Illness,15,35,108,97,205
Karnataka,Chikkamagaluru,Mental Illness,35,60,129,100,229
Karnataka,Chikkamagaluru,Mental Illness,60,80,8,9,17
Karnataka,Chikkaballapura,Mental Illness,0,6,4,0,4
Karnataka,Chikkaballapura,Mental Illness,6,15,35,15,50
Karnataka,Chikkaballapura,Mental Illness,15,35,98,87,185
Karnataka,Chikkaballapura,Mental Illness,35,60,110,123,233
Karnataka,Chikkaballapura,Mental Illness,60,80,15,19,34
Gujarat,Chhotaudepur,Mental Illness,6,15,41,28,69
Gujarat,Chhotaudepur,Mental Illness,15,35,58,49,107
Gujarat,Chhotaudepur,Mental Illness,35,60,13,7,20
Gujarat,Chhotaudepur,Mental Illness,60,80,2,0,2
Madhya Pradesh,Chhindwara,Mental Illness,0,6,2,0,2
Madhya Pradesh,Chhindwara,Mental Illness,6,15,187,127,314
Madhya Pradesh,Chhindwara,Mental Illness,15,35,724,459,1183
Madhya Pradesh,Chhindwara,Mental Illness,35,60,339,251,590
Madhya Pradesh,Chhindwara,Mental Illness,60,80,33,18,51
Madhya Pradesh,Chhindwara,Mental Illness,80,100,1,2,3
Madhya Pradesh,Chhatarpur,Mental Illness,0,6,13,1,14
Madhya Pradesh,Chhatarpur,Mental Illness,6,15,91,53,144
Madhya Pradesh,Chhatarpur,Mental Illness,15,35,400,236,636
Madhya Pradesh,Chhatarpur,Mental Illness,35,60,159,73,232
Madhya Pradesh,Chhatarpur,Mental Illness,60,80,11,6,17
Tamil Nadu,Chennai,Mental Illness,0,6,1,0,1
Tamil Nadu,Chennai,Mental Illness,6,15,105,57,162
Tamil Nadu,Chennai,Mental Illness,15,35,395,204,599
Tamil Nadu,Chennai,Mental Illness,35,60,284,222,506
Tamil Nadu,Chennai,Mental Illness,60,80,56,59,115
Tamil Nadu,Chennai,Mental Illness,80,100,1,2,3
Tamil Nadu,Chengalpattu,Mental Illness,6,15,5,6,11
Tamil Nadu,Chengalpattu,Mental Illness,15,35,34,37,71
Tamil Nadu,Chengalpattu,Mental Illness,35,60,114,100,214
Tamil Nadu,Chengalpattu,Mental Illness,60,80,21,31,52
Tamil Nadu,Chengalpattu,Mental Illness,80,100,1,1,2
Jharkhand,Chatra,Mental Illness,0,6,1,0,1
Jharkhand,Chatra,Mental Illness,6,15,22,11,33
Jharkhand,Chatra,Mental Illness,15,35,22,14,36
Jharkhand,Chatra,Mental Illness,35,60,11,2,13
Jharkhand,Chatra,Mental Illness,60,80,0,1,1
Haryana,Charki Dadri,Mental Illness,0,6,4,1,5
Haryana,Charki Dadri,Mental Illness,6,15,25,18,43
Haryana,Charki Dadri,Mental Illness,15,35,40,13,53
Haryana,Charki Dadri,Mental Illness,35,60,31,17,48
Haryana,Charki Dadri,Mental Illness,60,80,2,2,4
Assam,Charaideo,Mental Illness,0,6,2,1,3
Assam,Charaideo,Mental Illness,6,15,9,11,20
Assam,Charaideo,Mental Illness,15,35,21,19,40
Assam,Charaideo,Mental Illness,35,60,18,9,27
Assam,Charaideo,Mental Illness,60,80,2,0,2
Assam,Charaideo,Mental Illness,80,100,1,0,1
Arunachal Pradesh,Changlang,Mental Illness,15,35,0,1,1
Maharashtra,Chandrapur,Mental Illness,15,35,16,11,27
Maharashtra,Chandrapur,Mental Illness,35,60,35,17,52
Maharashtra,Chandrapur,Mental Illness,60,80,1,1,2
Chandigarh,Chandigarh,Mental Illness,0,6,2,1,3
Chandigarh,Chandigarh,Mental Illness,6,15,29,11,40
Chandigarh,Chandigarh,Mental Illness,15,35,123,73,196
Chandigarh,Chandigarh,Mental Illness,35,60,160,70,230
Chandigarh,Chandigarh,Mental Illness,60,80,17,14,31
Manipur,Chandel,Mental Illness,0,6,1,1,2
Manipur,Chandel,Mental Illness,6,15,9,5,14
Manipur,Chandel,Mental Illness,15,35,17,9,26
Manipur,Chandel,Mental Illness,35,60,6,6,12
Manipur,Chandel,Mental Illness,60,80,1,0,1
Uttar Pradesh,Chandauli,Mental Illness,6,15,1,3,4
Uttar Pradesh,Chandauli,Mental Illness,15,35,57,30,87
Uttar Pradesh,Chandauli,Mental Illness,35,60,19,12,31
Uttar Pradesh,Chandauli,Mental Illness,60,80,1,1,2
Uttar Pradesh,Chandauli,Mental Illness,80,100,0,1,1
Mizoram,Champhai,Mental Illness,6,15,3,2,5
Mizoram,Champhai,Mental Illness,15,35,9,1,10
Mizoram,Champhai,Mental Illness,35,60,9,2,11
Mizoram,Champhai,Mental Illness,60,80,2,1,3
Uttarakhand,Champawat,Mental Illness,0,6,0,1,1
Uttarakhand,Champawat,Mental Illness,6,15,8,4,12
Uttarakhand,Champawat,Mental Illness,15,35,24,18,42
Uttarakhand,Champawat,Mental Illness,35,60,22,11,33
Uttarakhand,Champawat,Mental Illness,60,80,2,1,3
Uttarakhand,Chamoli,Mental Illness,6,15,11,12,23
Uttarakhand,Chamoli,Mental Illness,15,35,76,45,121
Uttarakhand,Chamoli,Mental Illness,35,60,43,20,63
Uttarakhand,Chamoli,Mental Illness,60,80,4,0,4
Himachal Pradesh,Chamba,Mental Illness,0,6,5,1,6
Himachal Pradesh,Chamba,Mental Illness,6,15,39,26,65
Himachal Pradesh,Chamba,Mental Illness,15,35,123,62,185
Himachal Pradesh,Chamba,Mental Illness,35,60,45,18,63
Himachal Pradesh,Chamba,Mental Illness,60,80,5,1,6
Karnataka,Chamarajanagara,Mental Illness,0,6,1,0,1
Karnataka,Chamarajanagara,Mental Illness,6,15,20,12,32
Karnataka,Chamarajanagara,Mental Illness,15,35,97,76,173
Karnataka,Chamarajanagara,Mental Illness,35,60,109,59,168
Karnataka,Chamarajanagara,Mental Illness,60,80,8,3,11
Delhi,Central,Mental Illness,6,15,4,1,5
Delhi,Central,Mental Illness,15,35,36,13,49
Delhi,Central,Mental Illness,35,60,39,13,52
Delhi,Central,Mental Illness,60,80,1,2,3
Assam,Cachar,Mental Illness,0,6,2,2,4
Assam,Cachar,Mental Illness,6,15,79,46,125
Assam,Cachar,Mental Illness,15,35,181,152,333
Assam,Cachar,Mental Illness,35,60,65,50,115
Assam,Cachar,Mental Illness,60,80,1,4,5
Bihar,Buxar,Mental Illness,0,6,2,1,3
Bihar,Buxar,Mental Illness,6,15,69,29,98
Bihar,Buxar,Mental Illness,15,35,86,51,137
Bihar,Buxar,Mental Illness,35,60,53,14,67
Bihar,Buxar,Mental Illness,60,80,7,3,10
Madhya Pradesh,Burhanpur,Mental Illness,0,6,2,3,5
Madhya Pradesh,Burhanpur,Mental Illness,6,15,54,51,105
Madhya Pradesh,Burhanpur,Mental Illness,15,35,218,119,337
Madhya Pradesh,Burhanpur,Mental Illness,35,60,104,69,173
Madhya Pradesh,Burhanpur,Mental Illness,60,80,11,6,17
Rajasthan,Bundi,Mental Illness,0,6,2,1,3
Rajasthan,Bundi,Mental Illness,6,15,35,26,61
Rajasthan,Bundi,Mental Illness,15,35,165,94,259
Rajasthan,Bundi,Mental Illness,35,60,128,55,183
Rajasthan,Bundi,Mental Illness,60,80,12,20,32
Maharashtra,Buldhana,Mental Illness,0,6,1,0,1
Maharashtra,Buldhana,Mental Illness,6,15,11,6,17
Maharashtra,Buldhana,Mental Illness,15,35,167,87,254
Maharashtra,Buldhana,Mental Illness,35,60,384,202,586
Maharashtra,Buldhana,Mental Illness,60,80,47,34,81
Maharashtra,Buldhana,Mental Illness,80,100,1,2,3
Uttar Pradesh,Bulandshahr,Mental Illness,0,6,11,10,21
Uttar Pradesh,Bulandshahr,Mental Illness,6,15,158,79,237
Uttar Pradesh,Bulandshahr,Mental Illness,15,35,305,122,427
Uttar Pradesh,Bulandshahr,Mental Illness,35,60,98,32,130
Uttar Pradesh,Bulandshahr,Mental Illness,60,80,10,2,12
Jammu And Kashmir,Budgam,Mental Illness,0,6,26,20,46
Jammu And Kashmir,Budgam,Mental Illness,6,15,164,92,256
Jammu And Kashmir,Budgam,Mental Illness,15,35,267,241,508
Jammu And Kashmir,Budgam,Mental Illness,35,60,220,170,390
Jammu And Kashmir,Budgam,Mental Illness,60,80,12,17,29
Uttar Pradesh,Budaun,Mental Illness,0,6,2,7,9
Uttar Pradesh,Budaun,Mental Illness,6,15,82,42,124
Uttar Pradesh,Budaun,Mental Illness,15,35,237,81,318
Uttar Pradesh,Budaun,Mental Illness,35,60,51,16,67
Uttar Pradesh,Budaun,Mental Illness,60,80,3,1,4
Odisha,Boudh,Mental Illness,0,6,7,4,11
Odisha,Boudh,Mental Illness,6,15,76,64,140
Odisha,Boudh,Mental Illness,15,35,133,81,214
Odisha,Boudh,Mental Illness,35,60,82,34,116
Odisha,Boudh,Mental Illness,60,80,2,1,3
Gujarat,Botad,Mental Illness,6,15,10,4,14
Gujarat,Botad,Mental Illness,15,35,44,25,69
Gujarat,Botad,Mental Illness,35,60,9,3,12
Gujarat,Botad,Mental Illness,60,80,4,2,6
Assam,Bongaigaon,Mental Illness,6,15,31,15,46
Assam,Bongaigaon,Mental Illness,15,35,65,34,99
Assam,Bongaigaon,Mental Illness,35,60,55,21,76
Assam,Bongaigaon,Mental Illness,60,80,4,2,6
Jharkhand,Bokaro,Mental Illness,0,6,1,3,4
Jharkhand,Bokaro,Mental Illness,6,15,44,41,85
Jharkhand,Bokaro,Mental Illness,15,35,228,129,357
Jharkhand,Bokaro,Mental Illness,35,60,107,52,159
Jharkhand,Bokaro,Mental Illness,60,80,5,4,9
Jharkhand,Bokaro,Mental Illness,80,100,1,0,1
Assam,Biswanath,Mental Illness,0,6,1,1,2
Assam,Biswanath,Mental Illness,6,15,11,11,22
Assam,Biswanath,Mental Illness,15,35,32,24,56
Assam,Biswanath,Mental Illness,35,60,13,8,21
Assam,Biswanath,Mental Illness,60,80,1,0,1
Manipur,Bishnupur,Mental Illness,6,15,7,0,7
Manipur,Bishnupur,Mental Illness,15,35,19,16,35
Manipur,Bishnupur,Mental Illness,35,60,48,42,90
Manipur,Bishnupur,Mental Illness,60,80,13,23,36
Manipur,Bishnupur,Mental Illness,80,100,3,5,8
West Bengal,Birbhum,Mental Illness,60,80,0,1,1
Chhattisgarh,Bilaspur,Mental Illness,0,6,0,2,2
Chhattisgarh,Bilaspur,Mental Illness,6,15,22,23,45
Chhattisgarh,Bilaspur,Mental Illness,15,35,88,71,159
Chhattisgarh,Bilaspur,Mental Illness,35,60,12,13,25
Chhattisgarh,Bilaspur,Mental Illness,60,80,2,2,4
Chhattisgarh,Bilaspur,Mental Illness,80,100,0,1,1
Himachal Pradesh,Bilaspur,Mental Illness,0,6,3,2,5
Himachal Pradesh,Bilaspur,Mental Illness,6,15,34,26,60
Himachal Pradesh,Bilaspur,Mental Illness,15,35,143,70,213
Himachal Pradesh,Bilaspur,Mental Illness,35,60,144,45,189
Himachal Pradesh,Bilaspur,Mental Illness,60,80,9,3,12
Himachal Pradesh,Bilaspur,Mental Illness,80,100,1,0,1
Rajasthan,Bikaner,Mental Illness,0,6,1,0,1
Rajasthan,Bikaner,Mental Illness,6,15,29,23,52
Rajasthan,Bikaner,Mental Illness,15,35,189,88,277
Rajasthan,Bikaner,Mental Illness,35,60,128,43,171
Rajasthan,Bikaner,Mental Illness,60,80,12,8,20
Uttar Pradesh,Bijnor,Mental Illness,0,6,36,19,55
Uttar Pradesh,Bijnor,Mental Illness,6,15,268,151,419
Uttar Pradesh,Bijnor,Mental Illness,15,35,483,230,713
Uttar Pradesh,Bijnor,Mental Illness,35,60,85,39,124
Uttar Pradesh,Bijnor,Mental Illness,60,80,6,0,6
Chhattisgarh,Bijapur,Mental Illness,6,15,9,7,16
Chhattisgarh,Bijapur,Mental Illness,15,35,17,16,33
Chhattisgarh,Bijapur,Mental Illness,35,60,3,4,7
Karnataka,Bidar,Mental Illness,0,6,29,22,51
Karnataka,Bidar,Mental Illness,6,15,219,130,349
Karnataka,Bidar,Mental Illness,15,35,356,306,662
Karnataka,Bidar,Mental Illness,35,60,175,118,293
Karnataka,Bidar,Mental Illness,60,80,11,6,17
Madhya Pradesh,Bhopal,Mental Illness,0,6,3,4,7
Madhya Pradesh,Bhopal,Mental Illness,6,15,196,127,323
Madhya Pradesh,Bhopal,Mental Illness,15,35,640,346,986
Madhya Pradesh,Bhopal,Mental Illness,35,60,305,183,488
Madhya Pradesh,Bhopal,Mental Illness,60,80,30,20,50
Madhya Pradesh,Bhopal,Mental Illness,80,100,2,3,5
Bihar,Bhojpur,Mental Illness,0,6,4,0,4
Bihar,Bhojpur,Mental Illness,6,15,62,35,97
Bihar,Bhojpur,Mental Illness,15,35,131,62,193
Bihar,Bhojpur,Mental Illness,35,60,35,18,53
Bihar,Bhojpur,Mental Illness,60,80,3,0,3
Haryana,Bhiwani,Mental Illness,0,6,4,2,6
Haryana,Bhiwani,Mental Illness,6,15,26,27,53
Haryana,Bhiwani,Mental Illness,15,35,176,84,260
Haryana,Bhiwani,Mental Illness,35,60,169,49,218
Haryana,Bhiwani,Mental Illness,60,80,9,1,10
Haryana,Bhiwani,Mental Illness,80,100,1,0,1
Madhya Pradesh,Bhind,Mental Illness,0,6,9,10,19
Madhya Pradesh,Bhind,Mental Illness,6,15,131,47,178
Madhya Pradesh,Bhind,Mental Illness,15,35,267,78,345
Madhya Pradesh,Bhind,Mental Illness,35,60,143,56,199
Madhya Pradesh,Bhind,Mental Illness,60,80,15,10,25
Madhya Pradesh,Bhind,Mental Illness,80,100,1,0,1
Rajasthan,Bhilwara,Mental Illness,0,6,7,2,9
Rajasthan,Bhilwara,Mental Illness,6,15,90,65,155
Rajasthan,Bhilwara,Mental Illness,15,35,429,263,692
Rajasthan,Bhilwara,Mental Illness,35,60,264,141,405
Rajasthan,Bhilwara,Mental Illness,60,80,44,25,69
Rajasthan,Bhilwara,Mental Illness,80,100,2,3,5
Gujarat,Bhavnagar,Mental Illness,0,6,5,0,5
Gujarat,Bhavnagar,Mental Illness,6,15,34,23,57
Gujarat,Bhavnagar,Mental Illness,15,35,38,13,51
Gujarat,Bhavnagar,Mental Illness,35,60,51,10,61
Gujarat,Bhavnagar,Mental Illness,60,80,5,3,8
Gujarat,Bharuch,Mental Illness,6,15,121,69,190
Gujarat,Bharuch,Mental Illness,15,35,311,149,460
Gujarat,Bharuch,Mental Illness,35,60,63,28,91
Gujarat,Bharuch,Mental Illness,60,80,4,3,7
Rajasthan,Bharatpur,Mental Illness,0,6,0,1,1
Rajasthan,Bharatpur,Mental Illness,6,15,9,12,21
Rajasthan,Bharatpur,Mental Illness,15,35,54,18,72
Rajasthan,Bharatpur,Mental Illness,35,60,30,9,39
Rajasthan,Bharatpur,Mental Illness,60,80,2,1,3
Rajasthan,Bharatpur,Mental Illness,80,100,0,1,1
Maharashtra,Bhandara,Mental Illness,0,6,0,1,1
Maharashtra,Bhandara,Mental Illness,6,15,8,6,14
Maharashtra,Bhandara,Mental Illness,15,35,69,44,113
Maharashtra,Bhandara,Mental Illness,35,60,112,60,172
Maharashtra,Bhandara,Mental Illness,60,80,13,10,23
Bihar,Bhagalpur,Mental Illness,0,6,11,4,15
Bihar,Bhagalpur,Mental Illness,6,15,143,98,241
Bihar,Bhagalpur,Mental Illness,15,35,78,49,127
Bihar,Bhagalpur,Mental Illness,35,60,21,8,29
Bihar,Bhagalpur,Mental Illness,60,80,5,0,5
Odisha,Bhadrak,Mental Illness,0,6,20,8,28
Odisha,Bhadrak,Mental Illness,6,15,321,188,509
Odisha,Bhadrak,Mental Illness,15,35,737,430,1167
Odisha,Bhadrak,Mental Illness,35,60,503,335,838
Odisha,Bhadrak,Mental Illness,60,80,65,21,86
Odisha,Bhadrak,Mental Illness,80,100,1,0,1
Telangana,Bhadradri Kothagudem,Mental Illness,15,35,14,10,24
Telangana,Bhadradri Kothagudem,Mental Illness,35,60,41,23,64
Telangana,Bhadradri Kothagudem,Mental Illness,60,80,7,6,13
Telangana,Bhadradri Kothagudem,Mental Illness,80,100,0,1,1
Uttar Pradesh,Bhadohi,Mental Illness,6,15,3,1,4
Uttar Pradesh,Bhadohi,Mental Illness,15,35,29,12,41
Uttar Pradesh,Bhadohi,Mental Illness,35,60,7,4,11
Madhya Pradesh,Betul,Mental Illness,0,6,0,1,1
Madhya Pradesh,Betul,Mental Illness,6,15,54,36,90
Madhya Pradesh,Betul,Mental Illness,15,35,137,103,240
Madhya Pradesh,Betul,Mental Illness,35,60,126,84,210
Madhya Pradesh,Betul,Mental Illness,60,80,13,11,24
Madhya Pradesh,Betul,Mental Illness,80,100,1,0,1
Karnataka,Bengaluru Urban,Mental Illness,0,6,9,5,14
Karnataka,Bengaluru Urban,Mental Illness,6,15,55,37,92
Karnataka,Bengaluru Urban,Mental Illness,15,35,244,130,374
Karnataka,Bengaluru Urban,Mental Illness,35,60,417,259,676
Karnataka,Bengaluru Urban,Mental Illness,60,80,43,39,82
Karnataka,Bengaluru Urban,Mental Illness,80,100,1,1,2
Karnataka,Bengaluru Rural,Mental Illness,0,6,5,3,8
Karnataka,Bengaluru Rural,Mental Illness,6,15,107,84,191
Karnataka,Bengaluru Rural,Mental Illness,15,35,412,300,712
Karnataka,Bengaluru Rural,Mental Illness,35,60,315,253,568
Karnataka,Bengaluru Rural,Mental Illness,60,80,51,23,74
Karnataka,Bengaluru Rural,Mental Illness,80,100,3,1,4
Chhattisgarh,Bemetara,Mental Illness,6,15,45,31,76
Chhattisgarh,Bemetara,Mental Illness,15,35,64,73,137
Chhattisgarh,Bemetara,Mental Illness,35,60,13,15,28
Chhattisgarh,Bemetara,Mental Illness,60,80,1,0,1
Karnataka,Belagavi,Mental Illness,0,6,80,62,142
Karnataka,Belagavi,Mental Illness,6,15,617,384,1001
Karnataka,Belagavi,Mental Illness,15,35,1007,765,1772
Karnataka,Belagavi,Mental Illness,35,60,862,649,1511
Karnataka,Belagavi,Mental Illness,60,80,73,56,129
Karnataka,Belagavi,Mental Illness,80,100,2,0,2
Bihar,Begusarai,Mental Illness,0,6,10,7,17
Bihar,Begusarai,Mental Illness,6,15,130,106,236
Bihar,Begusarai,Mental Illness,15,35,158,74,232
Bihar,Begusarai,Mental Illness,35,60,52,16,68
Bihar,Begusarai,Mental Illness,60,80,2,0,2
Maharashtra,Beed,Mental Illness,0,6,1,0,1
Maharashtra,Beed,Mental Illness,6,15,18,12,30
Maharashtra,Beed,Mental Illness,15,35,186,74,260
Maharashtra,Beed,Mental Illness,35,60,141,46,187
Maharashtra,Beed,Mental Illness,60,80,12,4,16
Maharashtra,Beed,Mental Illness,80,100,1,0,1
Punjab,Bathinda,Mental Illness,0,6,2,0,2
Punjab,Bathinda,Mental Illness,6,15,54,33,87
Punjab,Bathinda,Mental Illness,15,35,362,189,551
Punjab,Bathinda,Mental Illness,35,60,175,71,246
Punjab,Bathinda,Mental Illness,60,80,13,0,13
Punjab,Bathinda,Mental Illness,80,100,2,0,2
Uttar Pradesh,Basti,Mental Illness,6,15,24,14,38
Uttar Pradesh,Basti,Mental Illness,15,35,84,46,130
Uttar Pradesh,Basti,Mental Illness,35,60,20,7,27
Chhattisgarh,Bastar,Mental Illness,0,6,3,2,5
Chhattisgarh,Bastar,Mental Illness,6,15,103,69,172
Chhattisgarh,Bastar,Mental Illness,15,35,110,120,230
Chhattisgarh,Bastar,Mental Illness,35,60,21,52,73
Chhattisgarh,Bastar,Mental Illness,60,80,1,9,10
Chhattisgarh,Bastar,Mental Illness,80,100,0,1,1
Madhya Pradesh,Barwani,Mental Illness,6,15,65,39,104
Madhya Pradesh,Barwani,Mental Illness,15,35,228,208,436
Madhya Pradesh,Barwani,Mental Illness,35,60,244,209,453
Madhya Pradesh,Barwani,Mental Illness,60,80,77,65,142
Madhya Pradesh,Barwani,Mental Illness,80,100,8,7,15
Assam,Barpeta,Mental Illness,0,6,6,0,6
Assam,Barpeta,Mental Illness,6,15,62,56,118
Assam,Barpeta,Mental Illness,15,35,154,118,272
Assam,Barpeta,Mental Illness,35,60,74,44,118
Assam,Barpeta,Mental Illness,60,80,4,3,7
Assam,Barpeta,Mental Illness,80,100,0,1,1
Punjab,Barnala,Mental Illness,0,6,3,0,3
Punjab,Barnala,Mental Illness,6,15,74,45,119
Punjab,Barnala,Mental Illness,15,35,197,92,289
Punjab,Barnala,Mental Illness,35,60,80,37,117
Punjab,Barnala,Mental Illness,60,80,6,0,6
Rajasthan,Barmer,Mental Illness,0,6,1,1,2
Rajasthan,Barmer,Mental Illness,6,15,41,16,57
Rajasthan,Barmer,Mental Illness,15,35,192,86,278
Rajasthan,Barmer,Mental Illness,35,60,253,96,349
Rajasthan,Barmer,Mental Illness,60,80,20,11,31
Rajasthan,Barmer,Mental Illness,80,100,1,0,1
Odisha,Bargarh,Mental Illness,6,15,58,48,106
Odisha,Bargarh,Mental Illness,15,35,126,110,236
Odisha,Bargarh,Mental Illness,35,60,110,73,183
Odisha,Bargarh,Mental Illness,60,80,11,5,16
Uttar Pradesh,Bareilly,Mental Illness,0,6,7,4,11
Uttar Pradesh,Bareilly,Mental Illness,6,15,126,81,207
Uttar Pradesh,Bareilly,Mental Illness,15,35,365,168,533
Uttar Pradesh,Bareilly,Mental Illness,35,60,95,38,133
Uttar Pradesh,Bareilly,Mental Illness,60,80,6,10,16
Rajasthan,Baran,Mental Illness,0,6,7,2,9
Rajasthan,Baran,Mental Illness,6,15,43,31,74
Rajasthan,Baran,Mental Illness,15,35,136,76,212
Rajasthan,Baran,Mental Illness,35,60,95,60,155
Rajasthan,Baran,Mental Illness,60,80,6,3,9
Jammu And Kashmir,Baramulla,Mental Illness,0,6,30,17,47
Jammu And Kashmir,Baramulla,Mental Illness,6,15,194,139,333
Jammu And Kashmir,Baramulla,Mental Illness,15,35,561,421,982
Jammu And Kashmir,Baramulla,Mental Illness,35,60,308,193,501
Jammu And Kashmir,Baramulla,Mental Illness,60,80,15,7,22
Jammu And Kashmir,Baramulla,Mental Illness,80,100,0,1,1
Uttar Pradesh,Barabanki,Mental Illness,0,6,19,9,28
Uttar Pradesh,Barabanki,Mental Illness,6,15,213,147,360
Uttar Pradesh,Barabanki,Mental Illness,15,35,288,160,448
Uttar Pradesh,Barabanki,Mental Illness,35,60,91,37,128
Uttar Pradesh,Barabanki,Mental Illness,60,80,6,1,7
Uttar Pradesh,Barabanki,Mental Illness,80,100,0,3,3
Rajasthan,Banswara,Mental Illness,0,6,2,1,3
Rajasthan,Banswara,Mental Illness,6,15,17,13,30
Rajasthan,Banswara,Mental Illness,15,35,27,24,51
Rajasthan,Banswara,Mental Illness,35,60,25,13,38
Rajasthan,Banswara,Mental Illness,60,80,0,1,1
West Bengal,Bankura,Mental Illness,15,35,2,0,2
Bihar,Banka,Mental Illness,0,6,5,3,8
Bihar,Banka,Mental Illness,6,15,68,45,113
Bihar,Banka,Mental Illness,15,35,86,47,133
Bihar,Banka,Mental Illness,35,60,16,10,26
Bihar,Banka,Mental Illness,60,80,3,0,3
Jammu And Kashmir,Bandipora,Mental Illness,0,6,19,14,33
Jammu And Kashmir,Bandipora,Mental Illness,6,15,43,31,74
Jammu And Kashmir,Bandipora,Mental Illness,15,35,183,163,346
Jammu And Kashmir,Bandipora,Mental Illness,35,60,133,99,232
Jammu And Kashmir,Bandipora,Mental Illness,60,80,12,10,22
Jammu And Kashmir,Bandipora,Mental Illness,80,100,3,0,3
Uttar Pradesh,Banda,Mental Illness,0,6,4,3,7
Uttar Pradesh,Banda,Mental Illness,6,15,36,17,53
Uttar Pradesh,Banda,Mental Illness,15,35,152,75,227
Uttar Pradesh,Banda,Mental Illness,35,60,41,21,62
Uttar Pradesh,Banda,Mental Illness,60,80,3,1,4
Gujarat,Banas Kantha,Mental Illness,6,15,25,2,27
Gujarat,Banas Kantha,Mental Illness,15,35,112,26,138
Gujarat,Banas Kantha,Mental Illness,35,60,74,22,96
Gujarat,Banas Kantha,Mental Illness,60,80,4,3,7
Gujarat,Banas Kantha,Mental Illness,80,100,2,0,2
Chhattisgarh,Balrampur,Mental Illness,6,15,12,11,23
Chhattisgarh,Balrampur,Mental Illness,15,35,27,23,50
Chhattisgarh,Balrampur,Mental Illness,35,60,5,7,12
Chhattisgarh,Balrampur,Mental Illness,60,80,1,0,1
Uttar Pradesh,Balrampur,Mental Illness,0,6,2,2,4
Uttar Pradesh,Balrampur,Mental Illness,6,15,31,18,49
Uttar Pradesh,Balrampur,Mental Illness,15,35,38,27,65
Uttar Pradesh,Balrampur,Mental Illness,35,60,13,9,22
Uttar Pradesh,Balrampur,Mental Illness,60,80,1,0,1
Chhattisgarh,Baloda Bazar,Mental Illness,0,6,2,1,3
Chhattisgarh,Baloda Bazar,Mental Illness,6,15,61,36,97
Chhattisgarh,Baloda Bazar,Mental Illness,15,35,111,91,202
Chhattisgarh,Baloda Bazar,Mental Illness,35,60,28,23,51
Chhattisgarh,Balod,Mental Illness,6,15,110,91,201
Chhattisgarh,Balod,Mental Illness,15,35,168,142,310
Chhattisgarh,Balod,Mental Illness,35,60,23,34,57
Chhattisgarh,Balod,Mental Illness,60,80,1,0,1
Chhattisgarh,Balod,Mental Illness,80,100,1,0,1
Uttar Pradesh,Ballia,Mental Illness,0,6,2,1,3
Uttar Pradesh,Ballia,Mental Illness,6,15,29,13,42
Uttar Pradesh,Ballia,Mental Illness,15,35,103,46,149
Uttar Pradesh,Ballia,Mental Illness,35,60,43,8,51
Uttar Pradesh,Ballia,Mental Illness,60,80,1,2,3
Karnataka,Ballari,Mental Illness,0,6,62,41,103
Karnataka,Ballari,Mental Illness,6,15,526,374,900
Karnataka,Ballari,Mental Illness,15,35,939,705,1644
Karnataka,Ballari,Mental Illness,35,60,368,343,711
Karnataka,Ballari,Mental Illness,60,80,19,14,33
Odisha,Baleshwar,Mental Illness,0,6,91,70,161
Odisha,Baleshwar,Mental Illness,6,15,1100,729,1829
Odisha,Baleshwar,Mental Illness,15,35,2135,1406,3541
Odisha,Baleshwar,Mental Illness,35,60,1797,1178,2975
Odisha,Baleshwar,Mental Illness,60,80,278,219,497
Odisha,Baleshwar,Mental Illness,80,100,9,4,13
Odisha,Balangir,Mental Illness,0,6,55,31,86
Odisha,Balangir,Mental Illness,6,15,440,315,755
Odisha,Balangir,Mental Illness,15,35,706,504,1210
Odisha,Balangir,Mental Illness,35,60,359,258,617
Odisha,Balangir,Mental Illness,60,80,31,38,69
Odisha,Balangir,Mental Illness,80,100,3,2,5
Madhya Pradesh,Balaghat,Mental Illness,0,6,4,3,7
Madhya Pradesh,Balaghat,Mental Illness,6,15,223,154,377
Madhya Pradesh,Balaghat,Mental Illness,15,35,370,252,622
Madhya Pradesh,Balaghat,Mental Illness,35,60,102,80,182
Madhya Pradesh,Balaghat,Mental Illness,60,80,4,4,8
Assam,Baksa,Mental Illness,0,6,6,8,14
Assam,Baksa,Mental Illness,6,15,46,43,89
Assam,Baksa,Mental Illness,15,35,116,108,224
Assam,Baksa,Mental Illness,35,60,58,45,103
Assam,Baksa,Mental Illness,60,80,6,3,9
Assam,Bajali,Mental Illness,15,35,2,0,2
Assam,Bajali,Mental Illness,35,60,1,1,2
Assam,Bajali,Mental Illness,60,80,1,0,1
Uttar Pradesh,Bahraich,Mental Illness,0,6,8,3,11
Uttar Pradesh,Bahraich,Mental Illness,6,15,131,101,232
Uttar Pradesh,Bahraich,Mental Illness,15,35,141,74,215
Uttar Pradesh,Bahraich,Mental Illness,35,60,42,14,56
Uttar Pradesh,Bahraich,Mental Illness,60,80,2,1,3
Uttar Pradesh,Baghpat,Mental Illness,0,6,2,0,2
Uttar Pradesh,Baghpat,Mental Illness,6,15,20,10,30
Uttar Pradesh,Baghpat,Mental Illness,15,35,47,21,68
Uttar Pradesh,Baghpat,Mental Illness,35,60,20,2,22
Uttar Pradesh,Baghpat,Mental Illness,60,80,1,1,2
Uttarakhand,Bageshwar,Mental Illness,0,6,1,0,1
Uttarakhand,Bageshwar,Mental Illness,6,15,10,12,22
Uttarakhand,Bageshwar,Mental Illness,15,35,39,36,75
Uttarakhand,Bageshwar,Mental Illness,35,60,71,25,96
Uttarakhand,Bageshwar,Mental Illness,60,80,4,1,5
Karnataka,Bagalkote,Mental Illness,0,6,5,1,6
Karnataka,Bagalkote,Mental Illness,6,15,77,45,122
Karnataka,Bagalkote,Mental Illness,15,35,144,119,263
Karnataka,Bagalkote,Mental Illness,35,60,50,46,96
Karnataka,Bagalkote,Mental Illness,60,80,2,2,4
Uttar Pradesh,Azamgarh,Mental Illness,0,6,1,2,3
Uttar Pradesh,Azamgarh,Mental Illness,6,15,24,13,37
Uttar Pradesh,Azamgarh,Mental Illness,15,35,133,73,206
Uttar Pradesh,Azamgarh,Mental Illness,35,60,41,15,56
Uttar Pradesh,Azamgarh,Mental Illness,60,80,4,1,5
Uttar Pradesh,Ayodhya,Mental Illness,0,6,11,7,18
Uttar Pradesh,Ayodhya,Mental Illness,6,15,187,126,313
Uttar Pradesh,Ayodhya,Mental Illness,15,35,164,101,265
Uttar Pradesh,Ayodhya,Mental Illness,35,60,37,17,54
Uttar Pradesh,Ayodhya,Mental Illness,60,80,3,0,3
Bihar,Aurangabad,Mental Illness,6,15,14,8,22
Bihar,Aurangabad,Mental Illness,15,35,33,20,53
Bihar,Aurangabad,Mental Illness,35,60,16,3,19
Bihar,Aurangabad,Mental Illness,60,80,1,2,3
Maharashtra,Aurangabad,Mental Illness,15,35,31,11,42
Maharashtra,Aurangabad,Mental Illness,35,60,65,32,97
Maharashtra,Aurangabad,Mental Illness,60,80,3,2,5
Uttar Pradesh,Auraiya,Mental Illness,0,6,2,0,2
Uttar Pradesh,Auraiya,Mental Illness,6,15,27,12,39
Uttar Pradesh,Auraiya,Mental Illness,15,35,55,31,86
Uttar Pradesh,Auraiya,Mental Illness,35,60,21,9,30
Uttar Pradesh,Auraiya,Mental Illness,60,80,2,1,3
Madhya Pradesh,Ashoknagar,Mental Illness,6,15,4,2,6
Madhya Pradesh,Ashoknagar,Mental Illness,15,35,23,11,34
Madhya Pradesh,Ashoknagar,Mental Illness,35,60,6,1,7
Madhya Pradesh,Ashoknagar,Mental Illness,60,80,0,1,1
Bihar,Arwal,Mental Illness,0,6,0,2,2
Bihar,Arwal,Mental Illness,6,15,25,17,42
Bihar,Arwal,Mental Illness,15,35,43,19,62
Bihar,Arwal,Mental Illness,35,60,8,7,15
Bihar,Arwal,Mental Illness,60,80,2,0,2
Gujarat,Arvalli,Mental Illness,6,15,11,10,21
Gujarat,Arvalli,Mental Illness,15,35,68,28,96
Gujarat,Arvalli,Mental Illness,35,60,31,18,49
Gujarat,Arvalli,Mental Illness,60,80,0,3,3
Tamil Nadu,Ariyalur,Mental Illness,6,15,2,2,4
Tamil Nadu,Ariyalur,Mental Illness,15,35,44,12,56
Tamil Nadu,Ariyalur,Mental Illness,35,60,89,48,137
Tamil Nadu,Ariyalur,Mental Illness,60,80,14,11,25
Tamil Nadu,Ariyalur,Mental Illness,80,100,0,1,1
Bihar,Araria,Mental Illness,0,6,0,1,1
Bihar,Araria,Mental Illness,6,15,13,9,22
Bihar,Araria,Mental Illness,15,35,26,15,41
Bihar,Araria,Mental Illness,35,60,2,2,4
Madhya Pradesh,Anuppur,Mental Illness,0,6,1,1,2
Madhya Pradesh,Anuppur,Mental Illness,6,15,25,25,50
Madhya Pradesh,Anuppur,Mental Illness,15,35,88,71,159
Madhya Pradesh,Anuppur,Mental Illness,35,60,48,32,80
Madhya Pradesh,Anuppur,Mental Illness,60,80,1,2,3
Odisha,Anugul,Mental Illness,0,6,26,14,40
Odisha,Anugul,Mental Illness,6,15,304,182,486
Odisha,Anugul,Mental Illness,15,35,546,451,997
Odisha,Anugul,Mental Illness,35,60,395,214,609
Odisha,Anugul,Mental Illness,60,80,42,24,66
Odisha,Anugul,Mental Illness,80,100,1,0,1
Jammu And Kashmir,Anantnag,Mental Illness,0,6,14,6,20
Jammu And Kashmir,Anantnag,Mental Illness,6,15,72,66,138
Jammu And Kashmir,Anantnag,Mental Illness,15,35,333,261,594
Jammu And Kashmir,Anantnag,Mental Illness,35,60,263,218,481
Jammu And Kashmir,Anantnag,Mental Illness,60,80,21,17,38
Jammu And Kashmir,Anantnag,Mental Illness,80,100,2,1,3
Andhra Pradesh,Anantapur,Mental Illness,0,6,0,3,3
Andhra Pradesh,Anantapur,Mental Illness,6,15,13,7,20
Andhra Pradesh,Anantapur,Mental Illness,15,35,174,122,296
Andhra Pradesh,Anantapur,Mental Illness,35,60,567,206,773
Andhra Pradesh,Anantapur,Mental Illness,60,80,47,25,72
Andhra Pradesh,Anantapur,Mental Illness,80,100,1,1,2
Gujarat,Anand,Mental Illness,0,6,1,0,1
Gujarat,Anand,Mental Illness,6,15,9,8,17
Gujarat,Anand,Mental Illness,15,35,56,25,81
Gujarat,Anand,Mental Illness,35,60,60,39,99
Gujarat,Anand,Mental Illness,60,80,6,6,12
Uttar Pradesh,Amroha,Mental Illness,0,6,5,4,9
Uttar Pradesh,Amroha,Mental Illness,6,15,46,22,68
Uttar Pradesh,Amroha,Mental Illness,15,35,131,55,186
Uttar Pradesh,Amroha,Mental Illness,35,60,25,8,33
Uttar Pradesh,Amroha,Mental Illness,60,80,0,1,1
Punjab,Amritsar,Mental Illness,0,6,6,2,8
Punjab,Amritsar,Mental Illness,6,15,46,24,70
Punjab,Amritsar,Mental Illness,15,35,119,77,196
Punjab,Amritsar,Mental Illness,35,60,113,55,168
Punjab,Amritsar,Mental Illness,60,80,20,11,31
Punjab,Amritsar,Mental Illness,80,100,1,0,1
Gujarat,Amreli,Mental Illness,0,6,1,2,3
Gujarat,Amreli,Mental Illness,6,15,153,88,241
Gujarat,Amreli,Mental Illness,15,35,692,352,1044
Gujarat,Amreli,Mental Illness,35,60,183,81,264
Gujarat,Amreli,Mental Illness,60,80,16,4,20
Maharashtra,Amravati,Mental Illness,0,6,2,1,3
Maharashtra,Amravati,Mental Illness,6,15,15,19,34
Maharashtra,Amravati,Mental Illness,15,35,122,93,215
Maharashtra,Amravati,Mental Illness,35,60,248,124,372
Maharashtra,Amravati,Mental Illness,60,80,23,24,47
Uttar Pradesh,Amethi,Mental Illness,0,6,0,2,2
Uttar Pradesh,Amethi,Mental Illness,6,15,22,19,41
Uttar Pradesh,Amethi,Mental Illness,15,35,128,57,185
Uttar Pradesh,Amethi,Mental Illness,35,60,37,18,55
Uttar Pradesh,Amethi,Mental Illness,60,80,1,0,1
Uttar Pradesh,Ambedkar Nagar,Mental Illness,6,15,19,15,34
Uttar Pradesh,Ambedkar Nagar,Mental Illness,15,35,78,42,120
Uttar Pradesh,Ambedkar Nagar,Mental Illness,35,60,25,7,32
Uttar Pradesh,Ambedkar Nagar,Mental Illness,60,80,2,0,2
Haryana,Ambala,Mental Illness,0,6,2,1,3
Haryana,Ambala,Mental Illness,6,15,44,23,67
Haryana,Ambala,Mental Illness,15,35,149,88,237
Haryana,Ambala,Mental Illness,35,60,119,66,185
Haryana,Ambala,Mental Illness,60,80,10,8,18
Rajasthan,Alwar,Mental Illness,0,6,14,14,28
Rajasthan,Alwar,Mental Illness,6,15,390,221,611
Rajasthan,Alwar,Mental Illness,15,35,738,333,1071
Rajasthan,Alwar,Mental Illness,35,60,278,111,389
Rajasthan,Alwar,Mental Illness,60,80,24,11,35
Rajasthan,Alwar,Mental Illness,80,100,0,1,1
Uttarakhand,Almora,Mental Illness,0,6,2,2,4
Uttarakhand,Almora,Mental Illness,6,15,30,22,52
Uttarakhand,Almora,Mental Illness,15,35,188,76,264
Uttarakhand,Almora,Mental Illness,35,60,198,69,267
Uttarakhand,Almora,Mental Illness,60,80,4,4,8
Madhya Pradesh,Alirajpur,Mental Illness,6,15,12,14,26
Madhya Pradesh,Alirajpur,Mental Illness,15,35,49,40,89
Madhya Pradesh,Alirajpur,Mental Illness,35,60,19,15,34
Madhya Pradesh,Alirajpur,Mental Illness,60,80,3,6,9
Uttar Pradesh,Aligarh,Mental Illness,0,6,6,2,8
Uttar Pradesh,Aligarh,Mental Illness,6,15,111,67,178
Uttar Pradesh,Aligarh,Mental Illness,15,35,258,104,362
Uttar Pradesh,Aligarh,Mental Illness,35,60,66,16,82
Uttar Pradesh,Aligarh,Mental Illness,60,80,1,0,1
Uttar Pradesh,Aligarh,Mental Illness,80,100,0,1,1
Kerala,Alappuzha,Mental Illness,6,15,12,10,22
Kerala,Alappuzha,Mental Illness,15,35,119,75,194
Kerala,Alappuzha,Mental Illness,35,60,370,454,824
Kerala,Alappuzha,Mental Illness,60,80,112,124,236
Kerala,Alappuzha,Mental Illness,80,100,2,7,9
Maharashtra,Akola,Mental Illness,6,15,0,1,1
Maharashtra,Akola,Mental Illness,15,35,29,22,51
Maharashtra,Akola,Mental Illness,35,60,72,41,113
Maharashtra,Akola,Mental Illness,60,80,6,3,9
Rajasthan,Ajmer,Mental Illness,0,6,3,1,4
Rajasthan,Ajmer,Mental Illness,6,15,132,69,201
Rajasthan,Ajmer,Mental Illness,15,35,268,136,404
Rajasthan,Ajmer,Mental Illness,35,60,125,48,173
Rajasthan,Ajmer,Mental Illness,60,80,3,2,5
Mizoram,Aizawl,Mental Illness,0,6,4,0,4
Mizoram,Aizawl,Mental Illness,6,15,15,11,26
Mizoram,Aizawl,Mental Illness,15,35,76,46,122
Mizoram,Aizawl,Mental Illness,35,60,69,66,135
Mizoram,Aizawl,Mental Illness,60,80,12,14,26
Mizoram,Aizawl,Mental Illness,80,100,0,2,2
Maharashtra,Ahmednagar,Mental Illness,6,15,12,11,23
Maharashtra,Ahmednagar,Mental Illness,15,35,103,56,159
Maharashtra,Ahmednagar,Mental Illness,35,60,188,75,263
Maharashtra,Ahmednagar,Mental Illness,60,80,23,19,42
Maharashtra,Ahmednagar,Mental Illness,80,100,1,0,1
Gujarat,Ahmadabad,Mental Illness,0,6,6,4,10
Gujarat,Ahmadabad,Mental Illness,6,15,58,22,80
Gujarat,Ahmadabad,Mental Illness,15,35,207,77,284
Gujarat,Ahmadabad,Mental Illness,35,60,259,114,373
Gujarat,Ahmadabad,Mental Illness,60,80,37,10,47
Gujarat,Ahmadabad,Mental Illness,80,100,1,1,2
Uttar Pradesh,Agra,Mental Illness,6,15,14,4,18
Uttar Pradesh,Agra,Mental Illness,15,35,70,28,98
Uttar Pradesh,Agra,Mental Illness,35,60,27,29,56
Uttar Pradesh,Agra,Mental Illness,60,80,4,4,8
Madhya Pradesh,Agar Malwa,Mental Illness,0,6,1,1,2
Madhya Pradesh,Agar Malwa,Mental Illness,6,15,17,14,31
Madhya Pradesh,Agar Malwa,Mental Illness,15,35,40,23,63
Madhya Pradesh,Agar Malwa,Mental Illness,35,60,15,6,21
Madhya Pradesh,Agar Malwa,Mental Illness,60,80,1,1,2
Telangana,Adilabad,Mental Illness,15,35,4,2,6
Telangana,Adilabad,Mental Illness,35,60,4,3,7
Telangana,Adilabad,Mental Illness,60,80,2,3,5
West Bengal,24 Paraganas South,Mental Illness,0,6,1,0,1
West Bengal,24 Paraganas North,Mental Illness,15,35,1,0,1
West Bengal,24 Paraganas North,Mental Illness,35,60,1,0,1
Nagaland,Zunheboto,Multiple Disability,60,80,0,1,1
Maharashtra,Yavatmal,Multiple Disability,0,6,14,9,23
Maharashtra,Yavatmal,Multiple Disability,6,15,135,97,232
Maharashtra,Yavatmal,Multiple Disability,15,35,132,66,198
Maharashtra,Yavatmal,Multiple Disability,35,60,61,18,79
Maharashtra,Yavatmal,Multiple Disability,60,80,11,1,12
Maharashtra,Yavatmal,Multiple Disability,80,100,1,1,2
Puducherry,Yanam,Multiple Disability,0,6,1,0,1
Puducherry,Yanam,Multiple Disability,6,15,1,0,1
Puducherry,Yanam,Multiple Disability,15,35,1,4,5
Puducherry,Yanam,Multiple Disability,35,60,7,2,9
Puducherry,Yanam,Multiple Disability,60,80,4,1,5
Haryana,Yamunanagar,Multiple Disability,0,6,6,3,9
Haryana,Yamunanagar,Multiple Disability,6,15,66,22,88
Haryana,Yamunanagar,Multiple Disability,15,35,71,31,102
Haryana,Yamunanagar,Multiple Disability,35,60,33,9,42
Haryana,Yamunanagar,Multiple Disability,60,80,8,2,10
Karnataka,Yadgir,Multiple Disability,0,6,7,2,9
Karnataka,Yadgir,Multiple Disability,6,15,45,27,72
Karnataka,Yadgir,Multiple Disability,15,35,82,58,140
Karnataka,Yadgir,Multiple Disability,35,60,47,20,67
Karnataka,Yadgir,Multiple Disability,60,80,5,2,7
Karnataka,Yadgir,Multiple Disability,80,100,0,1,1
Andhra Pradesh,Y.S.R.,Multiple Disability,6,15,1,0,1
Nagaland,Wokha,Multiple Disability,6,15,3,1,4
Nagaland,Wokha,Multiple Disability,15,35,7,3,10
Nagaland,Wokha,Multiple Disability,35,60,3,7,10
Nagaland,Wokha,Multiple Disability,60,80,3,0,3
Nagaland,Wokha,Multiple Disability,80,100,1,0,1
Tripura,West Tripura,Multiple Disability,0,6,8,5,13
Tripura,West Tripura,Multiple Disability,6,15,79,68,147
Tripura,West Tripura,Multiple Disability,15,35,167,104,271
Tripura,West Tripura,Multiple Disability,35,60,116,33,149
Tripura,West Tripura,Multiple Disability,60,80,27,13,40
Tripura,West Tripura,Multiple Disability,80,100,5,2,7
Jharkhand,West Singhbhum,Multiple Disability,0,6,1,1,2
Jharkhand,West Singhbhum,Multiple Disability,6,15,15,9,24
Jharkhand,West Singhbhum,Multiple Disability,15,35,12,15,27
Jharkhand,West Singhbhum,Multiple Disability,35,60,24,14,38
Jharkhand,West Singhbhum,Multiple Disability,60,80,5,1,6
Jharkhand,West Singhbhum,Multiple Disability,80,100,1,0,1
Arunachal Pradesh,West Siang,Multiple Disability,6,15,0,3,3
Arunachal Pradesh,West Siang,Multiple Disability,15,35,2,2,4
Arunachal Pradesh,West Siang,Multiple Disability,35,60,3,1,4
Arunachal Pradesh,West Siang,Multiple Disability,60,80,1,1,2
Meghalaya,West Khasi Hills,Multiple Disability,6,15,1,1,2
Meghalaya,West Khasi Hills,Multiple Disability,15,35,2,5,7
Meghalaya,West Khasi Hills,Multiple Disability,35,60,2,2,4
Meghalaya,West Khasi Hills,Multiple Disability,60,80,1,0,1
Assam,West Karbi Anglong,Multiple Disability,6,15,1,1,2
Assam,West Karbi Anglong,Multiple Disability,15,35,1,2,3
Assam,West Karbi Anglong,Multiple Disability,35,60,3,0,3
Assam,West Karbi Anglong,Multiple Disability,60,80,1,0,1
Assam,West Karbi Anglong,Multiple Disability,80,100,0,1,1
Arunachal Pradesh,West Kameng,Multiple Disability,15,35,3,2,5
Meghalaya,West Jaintia Hills,Multiple Disability,0,6,4,6,10
Meghalaya,West Jaintia Hills,Multiple Disability,6,15,26,27,53
Meghalaya,West Jaintia Hills,Multiple Disability,15,35,49,49,98
Meghalaya,West Jaintia Hills,Multiple Disability,35,60,26,20,46
Meghalaya,West Jaintia Hills,Multiple Disability,60,80,1,4,5
Andhra Pradesh,West Godavari,Multiple Disability,0,6,0,1,1
Andhra Pradesh,West Godavari,Multiple Disability,15,35,3,0,3
Andhra Pradesh,West Godavari,Multiple Disability,35,60,3,0,3
Meghalaya,West Garo Hills,Multiple Disability,6,15,1,0,1
Meghalaya,West Garo Hills,Multiple Disability,15,35,1,3,4
Meghalaya,West Garo Hills,Multiple Disability,35,60,2,0,2
Delhi,West,Multiple Disability,0,6,51,27,78
Delhi,West,Multiple Disability,6,15,183,99,282
Delhi,West,Multiple Disability,15,35,176,84,260
Delhi,West,Multiple Disability,35,60,42,18,60
Delhi,West,Multiple Disability,60,80,10,2,12
Delhi,West,Multiple Disability,80,100,2,1,3
Kerala,Wayanad,Multiple Disability,0,6,2,2,4
Kerala,Wayanad,Multiple Disability,6,15,25,27,52
Kerala,Wayanad,Multiple Disability,15,35,49,45,94
Kerala,Wayanad,Multiple Disability,35,60,39,28,67
Kerala,Wayanad,Multiple Disability,60,80,10,1,11
Kerala,Wayanad,Multiple Disability,80,100,2,0,2
Maharashtra,Washim,Multiple Disability,0,6,3,1,4
Maharashtra,Washim,Multiple Disability,6,15,22,9,31
Maharashtra,Washim,Multiple Disability,15,35,91,46,137
Maharashtra,Washim,Multiple Disability,35,60,44,27,71
Maharashtra,Washim,Multiple Disability,60,80,17,6,23
Maharashtra,Washim,Multiple Disability,80,100,2,0,2
Maharashtra,Wardha,Multiple Disability,0,6,17,11,28
Maharashtra,Wardha,Multiple Disability,6,15,109,63,172
Maharashtra,Wardha,Multiple Disability,15,35,48,33,81
Maharashtra,Wardha,Multiple Disability,35,60,27,3,30
Maharashtra,Wardha,Multiple Disability,60,80,17,2,19
Telangana,Wanaparthy,Multiple Disability,15,35,1,0,1
Andhra Pradesh,Vizianagaram,Multiple Disability,15,35,9,4,13
Andhra Pradesh,Vizianagaram,Multiple Disability,35,60,9,2,11
Andhra Pradesh,Vizianagaram,Multiple Disability,60,80,2,2,4
Andhra Pradesh,Visakhapatanam,Multiple Disability,0,6,3,3,6
Andhra Pradesh,Visakhapatanam,Multiple Disability,6,15,5,4,9
Andhra Pradesh,Visakhapatanam,Multiple Disability,15,35,22,10,32
Andhra Pradesh,Visakhapatanam,Multiple Disability,35,60,17,10,27
Andhra Pradesh,Visakhapatanam,Multiple Disability,60,80,5,3,8
Tamil Nadu,Virudhunagar,Multiple Disability,0,6,7,9,16
Tamil Nadu,Virudhunagar,Multiple Disability,6,15,67,50,117
Tamil Nadu,Virudhunagar,Multiple Disability,15,35,190,100,290
Tamil Nadu,Virudhunagar,Multiple Disability,35,60,38,20,58
Tamil Nadu,Virudhunagar,Multiple Disability,60,80,6,2,8
Tamil Nadu,Virudhunagar,Multiple Disability,80,100,1,0,1
Tamil Nadu,Villupuram,Multiple Disability,0,6,11,12,23
Tamil Nadu,Villupuram,Multiple Disability,6,15,80,75,155
Tamil Nadu,Villupuram,Multiple Disability,15,35,72,52,124
Tamil Nadu,Villupuram,Multiple Disability,35,60,30,12,42
Tamil Nadu,Villupuram,Multiple Disability,60,80,8,2,10
Tamil Nadu,Villupuram,Multiple Disability,80,100,1,0,1
Karnataka,Vijayapura,Multiple Disability,0,6,0,1,1
Karnataka,Vijayapura,Multiple Disability,6,15,30,22,52
Karnataka,Vijayapura,Multiple Disability,15,35,64,32,96
Karnataka,Vijayapura,Multiple Disability,35,60,69,23,92
Karnataka,Vijayapura,Multiple Disability,60,80,11,1,12
Madhya Pradesh,Vidisha,Multiple Disability,0,6,0,2,2
Madhya Pradesh,Vidisha,Multiple Disability,6,15,24,6,30
Madhya Pradesh,Vidisha,Multiple Disability,15,35,98,32,130
Madhya Pradesh,Vidisha,Multiple Disability,35,60,72,31,103
Madhya Pradesh,Vidisha,Multiple Disability,60,80,20,2,22
Madhya Pradesh,Vidisha,Multiple Disability,80,100,2,1,3
Tamil Nadu,Vellore,Multiple Disability,0,6,1,0,1
Tamil Nadu,Vellore,Multiple Disability,6,15,121,93,214
Tamil Nadu,Vellore,Multiple Disability,15,35,253,171,424
Tamil Nadu,Vellore,Multiple Disability,35,60,118,72,190
Tamil Nadu,Vellore,Multiple Disability,60,80,36,10,46
Tamil Nadu,Vellore,Multiple Disability,80,100,2,0,2
Uttar Pradesh,Varanasi,Multiple Disability,0,6,6,5,11
Uttar Pradesh,Varanasi,Multiple Disability,6,15,39,22,61
Uttar Pradesh,Varanasi,Multiple Disability,15,35,56,29,85
Uttar Pradesh,Varanasi,Multiple Disability,35,60,36,14,50
Uttar Pradesh,Varanasi,Multiple Disability,60,80,10,1,11
Gujarat,Valsad,Multiple Disability,0,6,48,24,72
Gujarat,Valsad,Multiple Disability,6,15,342,223,565
Gujarat,Valsad,Multiple Disability,15,35,420,289,709
Gujarat,Valsad,Multiple Disability,35,60,141,86,227
Gujarat,Valsad,Multiple Disability,60,80,25,9,34
Gujarat,Valsad,Multiple Disability,80,100,4,0,4
Bihar,Vaishali,Multiple Disability,0,6,0,1,1
Bihar,Vaishali,Multiple Disability,6,15,33,12,45
Bihar,Vaishali,Multiple Disability,15,35,78,47,125
Bihar,Vaishali,Multiple Disability,35,60,49,18,67
Bihar,Vaishali,Multiple Disability,60,80,12,0,12
Gujarat,Vadodara,Multiple Disability,0,6,74,37,111
Gujarat,Vadodara,Multiple Disability,6,15,301,190,491
Gujarat,Vadodara,Multiple Disability,15,35,375,203,578
Gujarat,Vadodara,Multiple Disability,35,60,93,39,132
Gujarat,Vadodara,Multiple Disability,60,80,34,6,40
Gujarat,Vadodara,Multiple Disability,80,100,2,0,2
Karnataka,Uttara Kannada,Multiple Disability,0,6,17,8,25
Karnataka,Uttara Kannada,Multiple Disability,6,15,124,87,211
Karnataka,Uttara Kannada,Multiple Disability,15,35,234,134,368
Karnataka,Uttara Kannada,Multiple Disability,35,60,173,100,273
Karnataka,Uttara Kannada,Multiple Disability,60,80,32,7,39
Karnataka,Uttara Kannada,Multiple Disability,80,100,1,0,1
Uttarakhand,Uttar Kashi,Multiple Disability,0,6,2,0,2
Uttarakhand,Uttar Kashi,Multiple Disability,6,15,6,6,12
Uttarakhand,Uttar Kashi,Multiple Disability,15,35,36,26,62
Uttarakhand,Uttar Kashi,Multiple Disability,35,60,35,21,56
Uttarakhand,Uttar Kashi,Multiple Disability,60,80,6,3,9
Arunachal Pradesh,Upper Subansiri,Multiple Disability,6,15,1,0,1
Arunachal Pradesh,Upper Subansiri,Multiple Disability,15,35,3,2,5
Arunachal Pradesh,Upper Subansiri,Multiple Disability,35,60,1,2,3
Arunachal Pradesh,Upper Siang,Multiple Disability,6,15,2,1,3
Arunachal Pradesh,Upper Siang,Multiple Disability,15,35,1,2,3
Uttar Pradesh,Unnao,Multiple Disability,6,15,7,0,7
Uttar Pradesh,Unnao,Multiple Disability,15,35,47,18,65
Uttar Pradesh,Unnao,Multiple Disability,35,60,39,14,53
Uttar Pradesh,Unnao,Multiple Disability,60,80,5,1,6
Uttar Pradesh,Unnao,Multiple Disability,80,100,0,1,1
Tripura,Unakoti,Multiple Disability,0,6,1,4,5
Tripura,Unakoti,Multiple Disability,6,15,29,19,48
Tripura,Unakoti,Multiple Disability,15,35,76,47,123
Tripura,Unakoti,Multiple Disability,35,60,46,30,76
Tripura,Unakoti,Multiple Disability,60,80,21,15,36
Tripura,Unakoti,Multiple Disability,80,100,5,5,10
Himachal Pradesh,Una,Multiple Disability,0,6,0,2,2
Himachal Pradesh,Una,Multiple Disability,6,15,13,11,24
Himachal Pradesh,Una,Multiple Disability,15,35,71,38,109
Himachal Pradesh,Una,Multiple Disability,35,60,53,14,67
Himachal Pradesh,Una,Multiple Disability,60,80,19,5,24
Himachal Pradesh,Una,Multiple Disability,80,100,0,2,2
Madhya Pradesh,Umaria,Multiple Disability,6,15,11,2,13
Madhya Pradesh,Umaria,Multiple Disability,15,35,14,8,22
Madhya Pradesh,Umaria,Multiple Disability,35,60,14,4,18
Madhya Pradesh,Umaria,Multiple Disability,60,80,4,0,4
Manipur,Ukhrul,Multiple Disability,0,6,3,1,4
Manipur,Ukhrul,Multiple Disability,6,15,12,4,16
Manipur,Ukhrul,Multiple Disability,15,35,21,14,35
Manipur,Ukhrul,Multiple Disability,35,60,10,13,23
Manipur,Ukhrul,Multiple Disability,60,80,6,3,9
Manipur,Ukhrul,Multiple Disability,80,100,1,0,1
Madhya Pradesh,Ujjain,Multiple Disability,0,6,51,35,86
Madhya Pradesh,Ujjain,Multiple Disability,6,15,212,122,334
Madhya Pradesh,Ujjain,Multiple Disability,15,35,195,112,307
Madhya Pradesh,Ujjain,Multiple Disability,35,60,84,27,111
Madhya Pradesh,Ujjain,Multiple Disability,60,80,18,4,22
Madhya Pradesh,Ujjain,Multiple Disability,80,100,2,0,2
Karnataka,Udupi,Multiple Disability,0,6,1,2,3
Karnataka,Udupi,Multiple Disability,6,15,24,27,51
Karnataka,Udupi,Multiple Disability,15,35,80,64,144
Karnataka,Udupi,Multiple Disability,35,60,104,69,173
Karnataka,Udupi,Multiple Disability,60,80,25,16,41
Karnataka,Udupi,Multiple Disability,80,100,2,2,4
Jammu And Kashmir,Udhampur,Multiple Disability,6,15,2,1,3
Jammu And Kashmir,Udhampur,Multiple Disability,15,35,10,5,15
Jammu And Kashmir,Udhampur,Multiple Disability,35,60,15,10,25
Jammu And Kashmir,Udhampur,Multiple Disability,60,80,5,0,5
Jammu And Kashmir,Udhampur,Multiple Disability,80,100,1,0,1
Uttarakhand,Udam Singh Nagar,Multiple Disability,0,6,5,3,8
Uttarakhand,Udam Singh Nagar,Multiple Disability,6,15,60,43,103
Uttarakhand,Udam Singh Nagar,Multiple Disability,15,35,262,150,412
Uttarakhand,Udam Singh Nagar,Multiple Disability,35,60,250,103,353
Uttarakhand,Udam Singh Nagar,Multiple Disability,60,80,64,24,88
Assam,Udalguri,Multiple Disability,0,6,3,3,6
Assam,Udalguri,Multiple Disability,6,15,30,17,47
Assam,Udalguri,Multiple Disability,15,35,61,60,121
Assam,Udalguri,Multiple Disability,35,60,70,60,130
Assam,Udalguri,Multiple Disability,60,80,10,4,14
Assam,Udalguri,Multiple Disability,80,100,0,2,2
Rajasthan,Udaipur,Multiple Disability,6,15,22,18,40
Rajasthan,Udaipur,Multiple Disability,15,35,65,40,105
Rajasthan,Udaipur,Multiple Disability,35,60,53,16,69
Rajasthan,Udaipur,Multiple Disability,60,80,23,17,40
Rajasthan,Udaipur,Multiple Disability,80,100,3,2,5
Tamil Nadu,Tuticorin,Multiple Disability,6,15,73,45,118
Tamil Nadu,Tuticorin,Multiple Disability,15,35,167,78,245
Tamil Nadu,Tuticorin,Multiple Disability,35,60,38,8,46
Tamil Nadu,Tuticorin,Multiple Disability,60,80,3,4,7
Tamil Nadu,Tuticorin,Multiple Disability,80,100,1,0,1
Karnataka,Tumakuru,Multiple Disability,0,6,11,4,15
Karnataka,Tumakuru,Multiple Disability,6,15,73,37,110
Karnataka,Tumakuru,Multiple Disability,15,35,171,106,277
Karnataka,Tumakuru,Multiple Disability,35,60,188,102,290
Karnataka,Tumakuru,Multiple Disability,60,80,50,21,71
Karnataka,Tumakuru,Multiple Disability,80,100,1,0,1
Nagaland,Tuensang,Multiple Disability,6,15,1,1,2
Nagaland,Tuensang,Multiple Disability,15,35,1,0,1
Rajasthan,Tonk,Multiple Disability,0,6,2,1,3
Rajasthan,Tonk,Multiple Disability,6,15,25,12,37
Rajasthan,Tonk,Multiple Disability,15,35,42,25,67
Rajasthan,Tonk,Multiple Disability,35,60,32,11,43
Rajasthan,Tonk,Multiple Disability,60,80,8,1,9
Tamil Nadu,Tiruvannamalai,Multiple Disability,0,6,22,17,39
Tamil Nadu,Tiruvannamalai,Multiple Disability,6,15,150,91,241
Tamil Nadu,Tiruvannamalai,Multiple Disability,15,35,135,82,217
Tamil Nadu,Tiruvannamalai,Multiple Disability,35,60,47,17,64
Tamil Nadu,Tiruvannamalai,Multiple Disability,60,80,8,9,17
Tamil Nadu,Tiruvannamalai,Multiple Disability,80,100,1,0,1
Tamil Nadu,Tiruppur,Multiple Disability,0,6,10,7,17
Tamil Nadu,Tiruppur,Multiple Disability,6,15,105,79,184
Tamil Nadu,Tiruppur,Multiple Disability,15,35,85,71,156
Tamil Nadu,Tiruppur,Multiple Disability,35,60,14,9,23
Tamil Nadu,Tiruppur,Multiple Disability,60,80,1,1,2
Tamil Nadu,Tiruppur,Multiple Disability,80,100,1,0,1
Tamil Nadu,Tirupathur,Multiple Disability,0,6,4,1,5
Tamil Nadu,Tirupathur,Multiple Disability,6,15,6,8,14
Tamil Nadu,Tirupathur,Multiple Disability,15,35,11,5,16
Tamil Nadu,Tirupathur,Multiple Disability,35,60,9,4,13
Tamil Nadu,Tirupathur,Multiple Disability,60,80,4,4,8
Tamil Nadu,Tirunelveli,Multiple Disability,0,6,17,11,28
Tamil Nadu,Tirunelveli,Multiple Disability,6,15,126,75,201
Tamil Nadu,Tirunelveli,Multiple Disability,15,35,122,86,208
Tamil Nadu,Tirunelveli,Multiple Disability,35,60,25,15,40
Tamil Nadu,Tirunelveli,Multiple Disability,60,80,1,1,2
Tamil Nadu,Tiruchirappalli,Multiple Disability,0,6,63,52,115
Tamil Nadu,Tiruchirappalli,Multiple Disability,6,15,142,67,209
Tamil Nadu,Tiruchirappalli,Multiple Disability,15,35,204,139,343
Tamil Nadu,Tiruchirappalli,Multiple Disability,35,60,104,59,163
Tamil Nadu,Tiruchirappalli,Multiple Disability,60,80,59,21,80
Tamil Nadu,Tiruchirappalli,Multiple Disability,80,100,6,2,8
Arunachal Pradesh,Tirap,Multiple Disability,6,15,2,1,3
Arunachal Pradesh,Tirap,Multiple Disability,15,35,2,3,5
Assam,Tinsukia,Multiple Disability,0,6,1,0,1
Assam,Tinsukia,Multiple Disability,6,15,9,5,14
Assam,Tinsukia,Multiple Disability,15,35,12,10,22
Assam,Tinsukia,Multiple Disability,35,60,9,6,15
Assam,Tinsukia,Multiple Disability,60,80,1,0,1
Madhya Pradesh,Tikamgarh,Multiple Disability,0,6,3,0,3
Madhya Pradesh,Tikamgarh,Multiple Disability,6,15,13,4,17
Madhya Pradesh,Tikamgarh,Multiple Disability,15,35,52,19,71
Madhya Pradesh,Tikamgarh,Multiple Disability,35,60,63,21,84
Madhya Pradesh,Tikamgarh,Multiple Disability,60,80,23,9,32
Madhya Pradesh,Tikamgarh,Multiple Disability,80,100,0,1,1
Kerala,Thrissur,Multiple Disability,0,6,15,8,23
Kerala,Thrissur,Multiple Disability,6,15,44,18,62
Kerala,Thrissur,Multiple Disability,15,35,48,34,82
Kerala,Thrissur,Multiple Disability,35,60,47,22,69
Kerala,Thrissur,Multiple Disability,60,80,15,3,18
Kerala,Thrissur,Multiple Disability,80,100,0,1,1
Manipur,Thoubal,Multiple Disability,0,6,8,2,10
Manipur,Thoubal,Multiple Disability,6,15,23,25,48
Manipur,Thoubal,Multiple Disability,15,35,35,23,58
Manipur,Thoubal,Multiple Disability,35,60,15,15,30
Tamil Nadu,Thiruvarur,Multiple Disability,0,6,13,7,20
Tamil Nadu,Thiruvarur,Multiple Disability,6,15,50,43,93
Tamil Nadu,Thiruvarur,Multiple Disability,15,35,125,62,187
Tamil Nadu,Thiruvarur,Multiple Disability,35,60,32,18,50
Tamil Nadu,Thiruvarur,Multiple Disability,60,80,2,0,2
Tamil Nadu,Thiruvarur,Multiple Disability,80,100,2,0,2
Kerala,Thiruvananthapuram,Multiple Disability,0,6,16,12,28
Kerala,Thiruvananthapuram,Multiple Disability,6,15,65,39,104
Kerala,Thiruvananthapuram,Multiple Disability,15,35,119,73,192
Kerala,Thiruvananthapuram,Multiple Disability,35,60,106,49,155
Kerala,Thiruvananthapuram,Multiple Disability,60,80,28,11,39
Kerala,Thiruvananthapuram,Multiple Disability,80,100,1,1,2
Tamil Nadu,Thiruvallur,Multiple Disability,0,6,42,10,52
Tamil Nadu,Thiruvallur,Multiple Disability,6,15,192,111,303
Tamil Nadu,Thiruvallur,Multiple Disability,15,35,170,100,270
Tamil Nadu,Thiruvallur,Multiple Disability,35,60,64,33,97
Tamil Nadu,Thiruvallur,Multiple Disability,60,80,12,6,18
Tamil Nadu,Thiruvallur,Multiple Disability,80,100,3,0,3
Tamil Nadu,Theni,Multiple Disability,0,6,8,6,14
Tamil Nadu,Theni,Multiple Disability,6,15,57,38,95
Tamil Nadu,Theni,Multiple Disability,15,35,80,54,134
Tamil Nadu,Theni,Multiple Disability,35,60,24,11,35
Tamil Nadu,Theni,Multiple Disability,60,80,6,0,6
Tamil Nadu,The Nilgiris,Multiple Disability,0,6,1,0,1
Tamil Nadu,The Nilgiris,Multiple Disability,6,15,14,11,25
Tamil Nadu,The Nilgiris,Multiple Disability,15,35,28,22,50
Tamil Nadu,The Nilgiris,Multiple Disability,35,60,11,7,18
Tamil Nadu,The Nilgiris,Multiple Disability,60,80,2,2,4
Tamil Nadu,Thanjavur,Multiple Disability,0,6,86,61,147
Tamil Nadu,Thanjavur,Multiple Disability,6,15,349,204,553
Tamil Nadu,Thanjavur,Multiple Disability,15,35,465,256,721
Tamil Nadu,Thanjavur,Multiple Disability,35,60,100,75,175
Tamil Nadu,Thanjavur,Multiple Disability,60,80,8,2,10
Maharashtra,Thane,Multiple Disability,0,6,50,28,78
Maharashtra,Thane,Multiple Disability,6,15,242,151,393
Maharashtra,Thane,Multiple Disability,15,35,251,139,390
Maharashtra,Thane,Multiple Disability,35,60,146,45,191
Maharashtra,Thane,Multiple Disability,60,80,47,17,64
Maharashtra,Thane,Multiple Disability,80,100,5,3,8
Tamil Nadu,Tenkasi,Multiple Disability,0,6,2,2,4
Tamil Nadu,Tenkasi,Multiple Disability,6,15,17,5,22
Tamil Nadu,Tenkasi,Multiple Disability,15,35,9,8,17
Tamil Nadu,Tenkasi,Multiple Disability,35,60,6,6,12
Manipur,Tengnoupal,Multiple Disability,0,6,1,0,1
Manipur,Tengnoupal,Multiple Disability,6,15,1,0,1
Manipur,Tengnoupal,Multiple Disability,15,35,3,2,5
Manipur,Tengnoupal,Multiple Disability,35,60,4,0,4
Manipur,Tengnoupal,Multiple Disability,60,80,2,0,2
Uttarakhand,Tehri Garhwal,Multiple Disability,0,6,2,1,3
Uttarakhand,Tehri Garhwal,Multiple Disability,6,15,23,14,37
Uttarakhand,Tehri Garhwal,Multiple Disability,15,35,80,34,114
Uttarakhand,Tehri Garhwal,Multiple Disability,35,60,73,37,110
Uttarakhand,Tehri Garhwal,Multiple Disability,60,80,24,14,38
Arunachal Pradesh,Tawang,Multiple Disability,6,15,0,1,1
Arunachal Pradesh,Tawang,Multiple Disability,15,35,0,2,2
Punjab,Tarn Taran,Multiple Disability,0,6,3,2,5
Punjab,Tarn Taran,Multiple Disability,6,15,23,7,30
Punjab,Tarn Taran,Multiple Disability,15,35,61,23,84
Punjab,Tarn Taran,Multiple Disability,35,60,58,12,70
Punjab,Tarn Taran,Multiple Disability,60,80,15,2,17
Gujarat,Tapi,Multiple Disability,0,6,2,0,2
Gujarat,Tapi,Multiple Disability,6,15,26,17,43
Gujarat,Tapi,Multiple Disability,15,35,64,30,94
Gujarat,Tapi,Multiple Disability,35,60,19,17,36
Gujarat,Tapi,Multiple Disability,60,80,2,1,3
Gujarat,Tapi,Multiple Disability,80,100,1,0,1
Manipur,Tamenglong,Multiple Disability,0,6,1,0,1
Manipur,Tamenglong,Multiple Disability,6,15,5,1,6
Manipur,Tamenglong,Multiple Disability,15,35,6,5,11
Manipur,Tamenglong,Multiple Disability,35,60,2,7,9
Manipur,Tamenglong,Multiple Disability,60,80,1,2,3
Manipur,Tamenglong,Multiple Disability,80,100,1,0,1
Chhattisgarh,Surguja,Multiple Disability,0,6,0,2,2
Chhattisgarh,Surguja,Multiple Disability,6,15,5,4,9
Chhattisgarh,Surguja,Multiple Disability,15,35,16,22,38
Chhattisgarh,Surguja,Multiple Disability,35,60,12,1,13
Chhattisgarh,Surguja,Multiple Disability,60,80,4,2,6
Gujarat,Surendranagar,Multiple Disability,0,6,7,10,17
Gujarat,Surendranagar,Multiple Disability,6,15,59,31,90
Gujarat,Surendranagar,Multiple Disability,15,35,32,28,60
Gujarat,Surendranagar,Multiple Disability,35,60,16,4,20
Gujarat,Surendranagar,Multiple Disability,60,80,4,0,4
Gujarat,Surat,Multiple Disability,0,6,161,100,261
Gujarat,Surat,Multiple Disability,6,15,833,444,1277
Gujarat,Surat,Multiple Disability,15,35,660,375,1035
Gujarat,Surat,Multiple Disability,35,60,119,53,172
Gujarat,Surat,Multiple Disability,60,80,17,6,23
Chhattisgarh,Surajpur,Multiple Disability,0,6,3,2,5
Chhattisgarh,Surajpur,Multiple Disability,6,15,43,25,68
Chhattisgarh,Surajpur,Multiple Disability,15,35,90,55,145
Chhattisgarh,Surajpur,Multiple Disability,35,60,24,8,32
Chhattisgarh,Surajpur,Multiple Disability,60,80,0,2,2
Chhattisgarh,Surajpur,Multiple Disability,80,100,3,0,3
Bihar,Supaul,Multiple Disability,6,15,1,0,1
Bihar,Supaul,Multiple Disability,15,35,12,0,12
Bihar,Supaul,Multiple Disability,35,60,3,2,5
Bihar,Supaul,Multiple Disability,60,80,3,0,3
Odisha,Sundargarh,Multiple Disability,0,6,12,3,15
Odisha,Sundargarh,Multiple Disability,6,15,48,30,78
Odisha,Sundargarh,Multiple Disability,15,35,145,72,217
Odisha,Sundargarh,Multiple Disability,35,60,107,70,177
Odisha,Sundargarh,Multiple Disability,60,80,25,12,37
Odisha,Sundargarh,Multiple Disability,80,100,6,1,7
Uttar Pradesh,Sultanpur,Multiple Disability,0,6,4,1,5
Uttar Pradesh,Sultanpur,Multiple Disability,6,15,21,9,30
Uttar Pradesh,Sultanpur,Multiple Disability,15,35,108,60,168
Uttar Pradesh,Sultanpur,Multiple Disability,35,60,103,23,126
Uttar Pradesh,Sultanpur,Multiple Disability,60,80,16,2,18
Uttar Pradesh,Sultanpur,Multiple Disability,80,100,1,0,1
Chhattisgarh,Sukma,Multiple Disability,6,15,13,14,27
Chhattisgarh,Sukma,Multiple Disability,15,35,16,16,32
Chhattisgarh,Sukma,Multiple Disability,35,60,20,18,38
Chhattisgarh,Sukma,Multiple Disability,60,80,11,10,21
Chhattisgarh,Sukma,Multiple Disability,80,100,1,1,2
Jammu And Kashmir,Srinagar,Multiple Disability,6,15,8,5,13
Jammu And Kashmir,Srinagar,Multiple Disability,15,35,19,10,29
Jammu And Kashmir,Srinagar,Multiple Disability,35,60,7,3,10
Jammu And Kashmir,Srinagar,Multiple Disability,60,80,0,2,2
Jammu And Kashmir,Srinagar,Multiple Disability,80,100,2,0,2
Andhra Pradesh,Srikakulam,Multiple Disability,0,6,1,1,2
Andhra Pradesh,Srikakulam,Multiple Disability,6,15,9,7,16
Andhra Pradesh,Srikakulam,Multiple Disability,15,35,45,24,69
Andhra Pradesh,Srikakulam,Multiple Disability,35,60,65,30,95
Andhra Pradesh,Srikakulam,Multiple Disability,60,80,21,15,36
Andhra Pradesh,Srikakulam,Multiple Disability,80,100,2,0,2
Punjab,Sri Muktsar Sahib,Multiple Disability,6,15,17,17,34
Punjab,Sri Muktsar Sahib,Multiple Disability,15,35,54,42,96
Punjab,Sri Muktsar Sahib,Multiple Disability,35,60,39,14,53
Punjab,Sri Muktsar Sahib,Multiple Disability,60,80,4,0,4
Punjab,Sri Muktsar Sahib,Multiple Disability,80,100,1,0,1
Andhra Pradesh,Spsr Nellore,Multiple Disability,0,6,1,0,1
Andhra Pradesh,Spsr Nellore,Multiple Disability,6,15,11,10,21
Andhra Pradesh,Spsr Nellore,Multiple Disability,15,35,62,23,85
Andhra Pradesh,Spsr Nellore,Multiple Disability,35,60,90,22,112
Andhra Pradesh,Spsr Nellore,Multiple Disability,60,80,5,6,11
Meghalaya,South West Khasi Hills,Multiple Disability,6,15,2,0,2
Meghalaya,South West Khasi Hills,Multiple Disability,15,35,1,3,4
Meghalaya,South West Khasi Hills,Multiple Disability,35,60,0,2,2
Meghalaya,South West Garo Hills,Multiple Disability,6,15,0,1,1
Meghalaya,South West Garo Hills,Multiple Disability,15,35,1,0,1
Meghalaya,South West Garo Hills,Multiple Disability,35,60,0,2,2
Meghalaya,South West Garo Hills,Multiple Disability,60,80,1,0,1
Delhi,South West,Multiple Disability,0,6,23,10,33
Delhi,South West,Multiple Disability,6,15,72,37,109
Delhi,South West,Multiple Disability,15,35,46,21,67
Delhi,South West,Multiple Disability,35,60,21,3,24
Delhi,South West,Multiple Disability,60,80,4,0,4
Tripura,South Tripura,Multiple Disability,0,6,2,0,2
Tripura,South Tripura,Multiple Disability,6,15,25,20,45
Tripura,South Tripura,Multiple Disability,15,35,32,24,56
Tripura,South Tripura,Multiple Disability,35,60,28,9,37
Tripura,South Tripura,Multiple Disability,60,80,5,3,8
Assam,South Salmara Mancachar,Multiple Disability,35,60,2,0,2
Goa,South Goa,Multiple Disability,0,6,26,10,36
Goa,South Goa,Multiple Disability,6,15,55,17,72
Goa,South Goa,Multiple Disability,15,35,20,8,28
Goa,South Goa,Multiple Disability,35,60,20,14,34
Goa,South Goa,Multiple Disability,60,80,4,1,5
Meghalaya,South Garo Hills,Multiple Disability,6,15,0,1,1
Meghalaya,South Garo Hills,Multiple Disability,15,35,2,7,9
Meghalaya,South Garo Hills,Multiple Disability,35,60,2,0,2
Meghalaya,South Garo Hills,Multiple Disability,60,80,1,0,1
Delhi,South East,Multiple Disability,0,6,9,4,13
Delhi,South East,Multiple Disability,6,15,27,18,45
Delhi,South East,Multiple Disability,15,35,15,8,23
Delhi,South East,Multiple Disability,35,60,3,0,3
Andaman And Nicobar Islands,South Andamans,Multiple Disability,6,15,5,3,8
Andaman And Nicobar Islands,South Andamans,Multiple Disability,15,35,18,10,28
Andaman And Nicobar Islands,South Andamans,Multiple Disability,35,60,16,12,28
Andaman And Nicobar Islands,South Andamans,Multiple Disability,60,80,1,1,2
Delhi,South,Multiple Disability,0,6,19,7,26
Delhi,South,Multiple Disability,6,15,44,22,66
Delhi,South,Multiple Disability,15,35,33,13,46
Delhi,South,Multiple Disability,35,60,8,0,8
Assam,Sonitpur,Multiple Disability,0,6,1,0,1
Assam,Sonitpur,Multiple Disability,6,15,2,2,4
Assam,Sonitpur,Multiple Disability,15,35,3,2,5
Assam,Sonitpur,Multiple Disability,35,60,4,2,6
Assam,Sonitpur,Multiple Disability,60,80,1,0,1
Haryana,Sonipat,Multiple Disability,0,6,3,1,4
Haryana,Sonipat,Multiple Disability,6,15,83,36,119
Haryana,Sonipat,Multiple Disability,15,35,91,21,112
Haryana,Sonipat,Multiple Disability,35,60,53,9,62
Haryana,Sonipat,Multiple Disability,60,80,12,2,14
Odisha,Sonepur,Multiple Disability,0,6,1,2,3
Odisha,Sonepur,Multiple Disability,6,15,17,7,24
Odisha,Sonepur,Multiple Disability,15,35,25,20,45
Odisha,Sonepur,Multiple Disability,35,60,34,20,54
Odisha,Sonepur,Multiple Disability,60,80,14,4,18
Odisha,Sonepur,Multiple Disability,80,100,0,1,1
Uttar Pradesh,Sonbhadra,Multiple Disability,6,15,21,7,28
Uttar Pradesh,Sonbhadra,Multiple Disability,15,35,131,46,177
Uttar Pradesh,Sonbhadra,Multiple Disability,35,60,66,18,84
Uttar Pradesh,Sonbhadra,Multiple Disability,60,80,15,3,18
Uttar Pradesh,Sonbhadra,Multiple Disability,80,100,3,0,3
Maharashtra,Solapur,Multiple Disability,0,6,16,11,27
Maharashtra,Solapur,Multiple Disability,6,15,132,81,213
Maharashtra,Solapur,Multiple Disability,15,35,91,54,145
Maharashtra,Solapur,Multiple Disability,35,60,35,15,50
Maharashtra,Solapur,Multiple Disability,60,80,8,3,11
Himachal Pradesh,Solan,Multiple Disability,0,6,1,1,2
Himachal Pradesh,Solan,Multiple Disability,6,15,11,5,16
Himachal Pradesh,Solan,Multiple Disability,15,35,27,18,45
Himachal Pradesh,Solan,Multiple Disability,35,60,49,20,69
Himachal Pradesh,Solan,Multiple Disability,60,80,20,9,29
Himachal Pradesh,Solan,Multiple Disability,80,100,4,0,4
Bihar,Siwan,Multiple Disability,0,6,7,2,9
Bihar,Siwan,Multiple Disability,6,15,9,16,25
Bihar,Siwan,Multiple Disability,15,35,29,10,39
Bihar,Siwan,Multiple Disability,35,60,22,6,28
Bihar,Siwan,Multiple Disability,60,80,2,1,3
Bihar,Siwan,Multiple Disability,80,100,1,0,1
Assam,Sivasagar,Multiple Disability,6,15,1,2,3
Assam,Sivasagar,Multiple Disability,15,35,8,3,11
Assam,Sivasagar,Multiple Disability,35,60,3,3,6
Assam,Sivasagar,Multiple Disability,60,80,0,1,1
Tamil Nadu,Sivaganga,Multiple Disability,0,6,20,19,39
Tamil Nadu,Sivaganga,Multiple Disability,6,15,133,84,217
Tamil Nadu,Sivaganga,Multiple Disability,15,35,158,71,229
Tamil Nadu,Sivaganga,Multiple Disability,35,60,49,35,84
Tamil Nadu,Sivaganga,Multiple Disability,60,80,9,6,15
Uttar Pradesh,Sitapur,Multiple Disability,0,6,6,1,7
Uttar Pradesh,Sitapur,Multiple Disability,6,15,66,43,109
Uttar Pradesh,Sitapur,Multiple Disability,15,35,129,59,188
Uttar Pradesh,Sitapur,Multiple Disability,35,60,87,25,112
Uttar Pradesh,Sitapur,Multiple Disability,60,80,11,1,12
Uttar Pradesh,Sitapur,Multiple Disability,80,100,0,1,1
Bihar,Sitamarhi,Multiple Disability,6,15,2,2,4
Bihar,Sitamarhi,Multiple Disability,15,35,14,1,15
Bihar,Sitamarhi,Multiple Disability,35,60,13,2,15
Bihar,Sitamarhi,Multiple Disability,60,80,1,0,1
Haryana,Sirsa,Multiple Disability,0,6,2,0,2
Haryana,Sirsa,Multiple Disability,6,15,16,12,28
Haryana,Sirsa,Multiple Disability,15,35,52,28,80
Haryana,Sirsa,Multiple Disability,35,60,23,10,33
Haryana,Sirsa,Multiple Disability,60,80,4,2,6
Rajasthan,Sirohi,Multiple Disability,0,6,1,1,2
Rajasthan,Sirohi,Multiple Disability,6,15,12,15,27
Rajasthan,Sirohi,Multiple Disability,15,35,42,21,63
Rajasthan,Sirohi,Multiple Disability,35,60,27,6,33
Rajasthan,Sirohi,Multiple Disability,60,80,16,4,20
Rajasthan,Sirohi,Multiple Disability,80,100,1,0,1
Himachal Pradesh,Sirmaur,Multiple Disability,0,6,2,0,2
Himachal Pradesh,Sirmaur,Multiple Disability,6,15,10,6,16
Himachal Pradesh,Sirmaur,Multiple Disability,15,35,63,16,79
Himachal Pradesh,Sirmaur,Multiple Disability,35,60,58,16,74
Himachal Pradesh,Sirmaur,Multiple Disability,60,80,8,2,10
Madhya Pradesh,Singrauli,Multiple Disability,0,6,12,12,24
Madhya Pradesh,Singrauli,Multiple Disability,6,15,63,52,115
Madhya Pradesh,Singrauli,Multiple Disability,15,35,120,83,203
Madhya Pradesh,Singrauli,Multiple Disability,35,60,55,34,89
Madhya Pradesh,Singrauli,Multiple Disability,60,80,6,6,12
Maharashtra,Sindhudurg,Multiple Disability,6,15,12,11,23
Maharashtra,Sindhudurg,Multiple Disability,15,35,17,18,35
Maharashtra,Sindhudurg,Multiple Disability,35,60,27,5,32
Maharashtra,Sindhudurg,Multiple Disability,60,80,7,0,7
Jharkhand,Simdega,Multiple Disability,6,15,3,5,8
Jharkhand,Simdega,Multiple Disability,15,35,11,10,21
Jharkhand,Simdega,Multiple Disability,35,60,5,3,8
Jharkhand,Simdega,Multiple Disability,60,80,1,1,2
Rajasthan,Sikar,Multiple Disability,6,15,18,7,25
Rajasthan,Sikar,Multiple Disability,15,35,78,26,104
Rajasthan,Sikar,Multiple Disability,35,60,30,5,35
Rajasthan,Sikar,Multiple Disability,60,80,3,4,7
Rajasthan,Sikar,Multiple Disability,80,100,1,0,1
Madhya Pradesh,Sidhi,Multiple Disability,0,6,9,7,16
Madhya Pradesh,Sidhi,Multiple Disability,6,15,235,106,341
Madhya Pradesh,Sidhi,Multiple Disability,15,35,273,189,462
Madhya Pradesh,Sidhi,Multiple Disability,35,60,97,44,141
Madhya Pradesh,Sidhi,Multiple Disability,60,80,16,4,20
Madhya Pradesh,Sidhi,Multiple Disability,80,100,6,1,7
Uttar Pradesh,Siddharth Nagar,Multiple Disability,0,6,1,0,1
Uttar Pradesh,Siddharth Nagar,Multiple Disability,6,15,15,5,20
Uttar Pradesh,Siddharth Nagar,Multiple Disability,15,35,81,36,117
Uttar Pradesh,Siddharth Nagar,Multiple Disability,35,60,68,20,88
Uttar Pradesh,Siddharth Nagar,Multiple Disability,60,80,16,2,18
Arunachal Pradesh,Siang,Multiple Disability,6,15,1,0,1
Arunachal Pradesh,Siang,Multiple Disability,15,35,1,0,1
Arunachal Pradesh,Siang,Multiple Disability,35,60,1,0,1
Uttar Pradesh,Shravasti,Multiple Disability,6,15,1,2,3
Uttar Pradesh,Shravasti,Multiple Disability,15,35,9,5,14
Uttar Pradesh,Shravasti,Multiple Disability,35,60,5,2,7
Uttar Pradesh,Shravasti,Multiple Disability,60,80,1,0,1
Jammu And Kashmir,Shopian,Multiple Disability,0,6,0,2,2
Jammu And Kashmir,Shopian,Multiple Disability,6,15,2,1,3
Jammu And Kashmir,Shopian,Multiple Disability,15,35,11,3,14
Jammu And Kashmir,Shopian,Multiple Disability,35,60,6,3,9
Jammu And Kashmir,Shopian,Multiple Disability,60,80,4,0,4
Madhya Pradesh,Shivpuri,Multiple Disability,0,6,4,4,8
Madhya Pradesh,Shivpuri,Multiple Disability,6,15,27,26,53
Madhya Pradesh,Shivpuri,Multiple Disability,15,35,41,21,62
Madhya Pradesh,Shivpuri,Multiple Disability,35,60,25,14,39
Madhya Pradesh,Shivpuri,Multiple Disability,60,80,5,1,6
Madhya Pradesh,Shivpuri,Multiple Disability,80,100,1,0,1
Karnataka,Shivamogga,Multiple Disability,0,6,4,3,7
Karnataka,Shivamogga,Multiple Disability,6,15,58,40,98
Karnataka,Shivamogga,Multiple Disability,15,35,118,89,207
Karnataka,Shivamogga,Multiple Disability,35,60,125,80,205
Karnataka,Shivamogga,Multiple Disability,60,80,29,8,37
Karnataka,Shivamogga,Multiple Disability,80,100,0,1,1
Himachal Pradesh,Shimla,Multiple Disability,0,6,2,2,4
Himachal Pradesh,Shimla,Multiple Disability,6,15,12,6,18
Himachal Pradesh,Shimla,Multiple Disability,15,35,33,20,53
Himachal Pradesh,Shimla,Multiple Disability,35,60,36,16,52
Himachal Pradesh,Shimla,Multiple Disability,60,80,13,8,21
Himachal Pradesh,Shimla,Multiple Disability,80,100,2,0,2
Madhya Pradesh,Sheopur,Multiple Disability,6,15,12,3,15
Madhya Pradesh,Sheopur,Multiple Disability,15,35,14,7,21
Madhya Pradesh,Sheopur,Multiple Disability,35,60,4,3,7
Bihar,Sheohar,Multiple Disability,0,6,7,5,12
Bihar,Sheohar,Multiple Disability,6,15,20,26,46
Bihar,Sheohar,Multiple Disability,15,35,4,9,13
Bihar,Sheohar,Multiple Disability,35,60,0,2,2
Bihar,Sheohar,Multiple Disability,60,80,1,1,2
Bihar,Sheikhpura,Multiple Disability,6,15,1,1,2
Bihar,Sheikhpura,Multiple Disability,15,35,1,2,3
Bihar,Sheikhpura,Multiple Disability,35,60,2,0,2
Uttar Pradesh,Shamli,Multiple Disability,0,6,5,7,12
Uttar Pradesh,Shamli,Multiple Disability,6,15,32,24,56
Uttar Pradesh,Shamli,Multiple Disability,15,35,84,42,126
Uttar Pradesh,Shamli,Multiple Disability,35,60,64,15,79
Uttar Pradesh,Shamli,Multiple Disability,60,80,6,2,8
Uttar Pradesh,Shamli,Multiple Disability,80,100,1,0,1
Madhya Pradesh,Shajapur,Multiple Disability,0,6,5,3,8
Madhya Pradesh,Shajapur,Multiple Disability,6,15,14,6,20
Madhya Pradesh,Shajapur,Multiple Disability,15,35,23,10,33
Madhya Pradesh,Shajapur,Multiple Disability,35,60,14,5,19
Madhya Pradesh,Shajapur,Multiple Disability,60,80,4,1,5
Uttar Pradesh,Shahjahanpur,Multiple Disability,0,6,7,9,16
Uttar Pradesh,Shahjahanpur,Multiple Disability,6,15,118,80,198
Uttar Pradesh,Shahjahanpur,Multiple Disability,15,35,356,149,505
Uttar Pradesh,Shahjahanpur,Multiple Disability,35,60,253,99,352
Uttar Pradesh,Shahjahanpur,Multiple Disability,60,80,87,20,107
Uttar Pradesh,Shahjahanpur,Multiple Disability,80,100,5,1,6
Punjab,Shahid Bhagat Singh Nagar,Multiple Disability,0,6,1,0,1
Punjab,Shahid Bhagat Singh Nagar,Multiple Disability,6,15,7,11,18
Punjab,Shahid Bhagat Singh Nagar,Multiple Disability,15,35,71,61,132
Punjab,Shahid Bhagat Singh Nagar,Multiple Disability,35,60,97,44,141
Punjab,Shahid Bhagat Singh Nagar,Multiple Disability,60,80,23,4,27
Punjab,Shahid Bhagat Singh Nagar,Multiple Disability,80,100,2,0,2
Madhya Pradesh,Shahdol,Multiple Disability,0,6,1,2,3
Madhya Pradesh,Shahdol,Multiple Disability,6,15,33,18,51
Madhya Pradesh,Shahdol,Multiple Disability,15,35,55,38,93
Madhya Pradesh,Shahdol,Multiple Disability,35,60,63,32,95
Madhya Pradesh,Shahdol,Multiple Disability,60,80,9,2,11
Delhi,Shahdara,Multiple Disability,0,6,13,7,20
Delhi,Shahdara,Multiple Disability,6,15,31,12,43
Delhi,Shahdara,Multiple Disability,15,35,17,7,24
Delhi,Shahdara,Multiple Disability,35,60,4,2,6
Delhi,Shahdara,Multiple Disability,60,80,2,1,3
Mizoram,Serchhip,Multiple Disability,6,15,5,7,12
Mizoram,Serchhip,Multiple Disability,15,35,5,6,11
Mizoram,Serchhip,Multiple Disability,35,60,8,6,14
Mizoram,Serchhip,Multiple Disability,60,80,1,1,2
Mizoram,Serchhip,Multiple Disability,80,100,0,1,1
Tripura,Sepahijala,Multiple Disability,0,6,3,7,10
Tripura,Sepahijala,Multiple Disability,6,15,53,27,80
Tripura,Sepahijala,Multiple Disability,15,35,93,61,154
Tripura,Sepahijala,Multiple Disability,35,60,35,13,48
Tripura,Sepahijala,Multiple Disability,60,80,12,2,14
Madhya Pradesh,Seoni,Multiple Disability,0,6,2,0,2
Madhya Pradesh,Seoni,Multiple Disability,6,15,46,49,95
Madhya Pradesh,Seoni,Multiple Disability,15,35,77,42,119
Madhya Pradesh,Seoni,Multiple Disability,35,60,62,25,87
Madhya Pradesh,Seoni,Multiple Disability,60,80,10,3,13
Manipur,Senapati,Multiple Disability,0,6,1,0,1
Manipur,Senapati,Multiple Disability,6,15,6,7,13
Manipur,Senapati,Multiple Disability,15,35,5,7,12
Manipur,Senapati,Multiple Disability,35,60,4,2,6
Manipur,Senapati,Multiple Disability,60,80,1,1,2
Manipur,Senapati,Multiple Disability,80,100,0,1,1
Madhya Pradesh,Sehore,Multiple Disability,0,6,4,1,5
Madhya Pradesh,Sehore,Multiple Disability,6,15,71,38,109
Madhya Pradesh,Sehore,Multiple Disability,15,35,118,65,183
Madhya Pradesh,Sehore,Multiple Disability,35,60,49,20,69
Madhya Pradesh,Sehore,Multiple Disability,60,80,4,4,8
Madhya Pradesh,Sehore,Multiple Disability,80,100,2,0,2
Rajasthan,Sawai Madhopur,Multiple Disability,0,6,3,0,3
Rajasthan,Sawai Madhopur,Multiple Disability,6,15,8,7,15
Rajasthan,Sawai Madhopur,Multiple Disability,15,35,18,13,31
Rajasthan,Sawai Madhopur,Multiple Disability,35,60,10,4,14
Rajasthan,Sawai Madhopur,Multiple Disability,60,80,3,4,7
Madhya Pradesh,Satna,Multiple Disability,0,6,1,0,1
Madhya Pradesh,Satna,Multiple Disability,6,15,19,8,27
Madhya Pradesh,Satna,Multiple Disability,15,35,71,37,108
Madhya Pradesh,Satna,Multiple Disability,35,60,87,40,127
Madhya Pradesh,Satna,Multiple Disability,60,80,36,10,46
Madhya Pradesh,Satna,Multiple Disability,80,100,1,2,3
Maharashtra,Satara,Multiple Disability,0,6,10,7,17
Maharashtra,Satara,Multiple Disability,6,15,86,47,133
Maharashtra,Satara,Multiple Disability,15,35,123,50,173
Maharashtra,Satara,Multiple Disability,35,60,88,33,121
Maharashtra,Satara,Multiple Disability,60,80,20,6,26
Maharashtra,Satara,Multiple Disability,80,100,1,0,1
Bihar,Saran,Multiple Disability,0,6,1,1,2
Bihar,Saran,Multiple Disability,6,15,17,16,33
Bihar,Saran,Multiple Disability,15,35,35,10,45
Bihar,Saran,Multiple Disability,35,60,23,3,26
Bihar,Saran,Multiple Disability,60,80,8,0,8
Jharkhand,Saraikela Kharsawan,Multiple Disability,0,6,2,0,2
Jharkhand,Saraikela Kharsawan,Multiple Disability,6,15,4,4,8
Jharkhand,Saraikela Kharsawan,Multiple Disability,15,35,27,8,35
Jharkhand,Saraikela Kharsawan,Multiple Disability,35,60,12,10,22
Jharkhand,Saraikela Kharsawan,Multiple Disability,60,80,4,0,4
Uttar Pradesh,Sant Kabeer Nagar,Multiple Disability,0,6,1,0,1
Uttar Pradesh,Sant Kabeer Nagar,Multiple Disability,6,15,12,5,17
Uttar Pradesh,Sant Kabeer Nagar,Multiple Disability,15,35,49,20,69
Uttar Pradesh,Sant Kabeer Nagar,Multiple Disability,35,60,35,5,40
Uttar Pradesh,Sant Kabeer Nagar,Multiple Disability,60,80,12,1,13
Punjab,Sangrur,Multiple Disability,0,6,4,2,6
Punjab,Sangrur,Multiple Disability,6,15,60,15,75
Punjab,Sangrur,Multiple Disability,15,35,133,55,188
Punjab,Sangrur,Multiple Disability,35,60,115,40,155
Punjab,Sangrur,Multiple Disability,60,80,51,2,53
Punjab,Sangrur,Multiple Disability,80,100,2,0,2
Maharashtra,Sangli,Multiple Disability,0,6,20,14,34
Maharashtra,Sangli,Multiple Disability,6,15,168,115,283
Maharashtra,Sangli,Multiple Disability,15,35,221,104,325
Maharashtra,Sangli,Multiple Disability,35,60,122,52,174
Maharashtra,Sangli,Multiple Disability,60,80,43,2,45
Maharashtra,Sangli,Multiple Disability,80,100,2,0,2
Uttar Pradesh,Sambhal,Multiple Disability,0,6,1,2,3
Uttar Pradesh,Sambhal,Multiple Disability,6,15,18,12,30
Uttar Pradesh,Sambhal,Multiple Disability,15,35,66,26,92
Uttar Pradesh,Sambhal,Multiple Disability,35,60,38,12,50
Uttar Pradesh,Sambhal,Multiple Disability,60,80,7,1,8
Odisha,Sambalpur,Multiple Disability,0,6,3,1,4
Odisha,Sambalpur,Multiple Disability,6,15,9,8,17
Odisha,Sambalpur,Multiple Disability,15,35,42,36,78
Odisha,Sambalpur,Multiple Disability,35,60,34,19,53
Odisha,Sambalpur,Multiple Disability,60,80,19,4,23
Odisha,Sambalpur,Multiple Disability,80,100,1,1,2
Jammu And Kashmir,Samba,Multiple Disability,0,6,1,0,1
Jammu And Kashmir,Samba,Multiple Disability,6,15,2,1,3
Jammu And Kashmir,Samba,Multiple Disability,15,35,10,8,18
Jammu And Kashmir,Samba,Multiple Disability,35,60,10,1,11
Jammu And Kashmir,Samba,Multiple Disability,60,80,1,0,1
Bihar,Samastipur,Multiple Disability,0,6,2,2,4
Bihar,Samastipur,Multiple Disability,6,15,14,7,21
Bihar,Samastipur,Multiple Disability,15,35,59,26,85
Bihar,Samastipur,Multiple Disability,35,60,33,15,48
Tamil Nadu,Salem,Multiple Disability,0,6,47,23,70
Tamil Nadu,Salem,Multiple Disability,6,15,268,186,454
Tamil Nadu,Salem,Multiple Disability,15,35,141,71,212
Tamil Nadu,Salem,Multiple Disability,35,60,39,21,60
Tamil Nadu,Salem,Multiple Disability,60,80,9,1,10
Tamil Nadu,Salem,Multiple Disability,80,100,0,1,1
Mizoram,Saitual,Multiple Disability,6,15,0,1,1
Mizoram,Saitual,Multiple Disability,60,80,0,1,1
Mizoram,Saiha,Multiple Disability,6,15,0,1,1
Mizoram,Saiha,Multiple Disability,15,35,3,1,4
Mizoram,Saiha,Multiple Disability,35,60,2,0,2
Jharkhand,Sahebganj,Multiple Disability,6,15,0,1,1
Jharkhand,Sahebganj,Multiple Disability,15,35,4,1,5
Jharkhand,Sahebganj,Multiple Disability,35,60,1,0,1
Bihar,Saharsa,Multiple Disability,0,6,5,1,6
Bihar,Saharsa,Multiple Disability,6,15,37,14,51
Bihar,Saharsa,Multiple Disability,15,35,47,21,68
Bihar,Saharsa,Multiple Disability,35,60,32,17,49
Bihar,Saharsa,Multiple Disability,60,80,8,5,13
Uttar Pradesh,Saharanpur,Multiple Disability,0,6,29,17,46
Uttar Pradesh,Saharanpur,Multiple Disability,6,15,139,87,226
Uttar Pradesh,Saharanpur,Multiple Disability,15,35,330,142,472
Uttar Pradesh,Saharanpur,Multiple Disability,35,60,227,72,299
Uttar Pradesh,Saharanpur,Multiple Disability,60,80,44,6,50
Uttar Pradesh,Saharanpur,Multiple Disability,80,100,3,0,3
Madhya Pradesh,Sagar,Multiple Disability,0,6,5,0,5
Madhya Pradesh,Sagar,Multiple Disability,6,15,47,24,71
Madhya Pradesh,Sagar,Multiple Disability,15,35,125,56,181
Madhya Pradesh,Sagar,Multiple Disability,35,60,71,27,98
Madhya Pradesh,Sagar,Multiple Disability,60,80,19,5,24
Gujarat,Sabar Kantha,Multiple Disability,0,6,24,21,45
Gujarat,Sabar Kantha,Multiple Disability,6,15,142,85,227
Gujarat,Sabar Kantha,Multiple Disability,15,35,155,84,239
Gujarat,Sabar Kantha,Multiple Disability,35,60,48,19,67
Gujarat,Sabar Kantha,Multiple Disability,60,80,7,3,10
Punjab,S.A.S Nagar,Multiple Disability,0,6,5,3,8
Punjab,S.A.S Nagar,Multiple Disability,6,15,41,26,67
Punjab,S.A.S Nagar,Multiple Disability,15,35,105,39,144
Punjab,S.A.S Nagar,Multiple Disability,35,60,87,26,113
Punjab,S.A.S Nagar,Multiple Disability,60,80,20,6,26
Punjab,Rupnagar,Multiple Disability,0,6,2,1,3
Punjab,Rupnagar,Multiple Disability,6,15,13,14,27
Punjab,Rupnagar,Multiple Disability,15,35,77,41,118
Punjab,Rupnagar,Multiple Disability,35,60,85,35,120
Punjab,Rupnagar,Multiple Disability,60,80,19,3,22
Punjab,Rupnagar,Multiple Disability,80,100,2,0,2
Uttarakhand,Rudra Prayag,Multiple Disability,6,15,6,2,8
Uttarakhand,Rudra Prayag,Multiple Disability,15,35,15,11,26
Uttarakhand,Rudra Prayag,Multiple Disability,35,60,38,12,50
Uttarakhand,Rudra Prayag,Multiple Disability,60,80,12,8,20
Bihar,Rohtas,Multiple Disability,6,15,3,2,5
Bihar,Rohtas,Multiple Disability,15,35,21,4,25
Bihar,Rohtas,Multiple Disability,35,60,9,4,13
Bihar,Rohtas,Multiple Disability,60,80,6,0,6
Haryana,Rohtak,Multiple Disability,0,6,5,4,9
Haryana,Rohtak,Multiple Disability,6,15,36,18,54
Haryana,Rohtak,Multiple Disability,15,35,104,32,136
Haryana,Rohtak,Multiple Disability,35,60,98,27,125
Haryana,Rohtak,Multiple Disability,60,80,12,1,13
Haryana,Rohtak,Multiple Disability,80,100,1,0,1
Meghalaya,Ri Bhoi,Multiple Disability,0,6,2,1,3
Meghalaya,Ri Bhoi,Multiple Disability,6,15,9,5,14
Meghalaya,Ri Bhoi,Multiple Disability,15,35,10,9,19
Meghalaya,Ri Bhoi,Multiple Disability,35,60,9,0,9
Meghalaya,Ri Bhoi,Multiple Disability,60,80,2,1,3
Meghalaya,Ri Bhoi,Multiple Disability,80,100,3,0,3
Haryana,Rewari,Multiple Disability,0,6,1,1,2
Haryana,Rewari,Multiple Disability,6,15,34,13,47
Haryana,Rewari,Multiple Disability,15,35,54,18,72
Haryana,Rewari,Multiple Disability,35,60,28,8,36
Haryana,Rewari,Multiple Disability,60,80,3,1,4
Madhya Pradesh,Rewa,Multiple Disability,0,6,42,23,65
Madhya Pradesh,Rewa,Multiple Disability,6,15,110,56,166
Madhya Pradesh,Rewa,Multiple Disability,15,35,105,56,161
Madhya Pradesh,Rewa,Multiple Disability,35,60,45,11,56
Madhya Pradesh,Rewa,Multiple Disability,60,80,3,2,5
Madhya Pradesh,Rewa,Multiple Disability,80,100,0,1,1
Jammu And Kashmir,Reasi,Multiple Disability,0,6,1,0,1
Jammu And Kashmir,Reasi,Multiple Disability,15,35,1,3,4
Jammu And Kashmir,Reasi,Multiple Disability,35,60,7,2,9
Jammu And Kashmir,Reasi,Multiple Disability,60,80,1,0,1
Odisha,Rayagada,Multiple Disability,0,6,1,1,2
Odisha,Rayagada,Multiple Disability,6,15,5,12,17
Odisha,Rayagada,Multiple Disability,15,35,39,24,63
Odisha,Rayagada,Multiple Disability,35,60,36,17,53
Odisha,Rayagada,Multiple Disability,60,80,4,5,9
Odisha,Rayagada,Multiple Disability,80,100,0,2,2
Maharashtra,Ratnagiri,Multiple Disability,0,6,4,3,7
Maharashtra,Ratnagiri,Multiple Disability,6,15,13,14,27
Maharashtra,Ratnagiri,Multiple Disability,15,35,38,15,53
Maharashtra,Ratnagiri,Multiple Disability,35,60,22,12,34
Maharashtra,Ratnagiri,Multiple Disability,60,80,8,3,11
Maharashtra,Ratnagiri,Multiple Disability,80,100,1,0,1
Madhya Pradesh,Ratlam,Multiple Disability,0,6,12,11,23
Madhya Pradesh,Ratlam,Multiple Disability,6,15,91,58,149
Madhya Pradesh,Ratlam,Multiple Disability,15,35,79,64,143
Madhya Pradesh,Ratlam,Multiple Disability,35,60,54,15,69
Madhya Pradesh,Ratlam,Multiple Disability,60,80,16,3,19
Tamil Nadu,Ranipet,Multiple Disability,0,6,4,3,7
Tamil Nadu,Ranipet,Multiple Disability,6,15,10,5,15
Tamil Nadu,Ranipet,Multiple Disability,15,35,9,4,13
Tamil Nadu,Ranipet,Multiple Disability,35,60,10,3,13
Tamil Nadu,Ranipet,Multiple Disability,60,80,4,0,4
Jharkhand,Ranchi,Multiple Disability,0,6,2,0,2
Jharkhand,Ranchi,Multiple Disability,6,15,22,6,28
Jharkhand,Ranchi,Multiple Disability,15,35,26,8,34
Jharkhand,Ranchi,Multiple Disability,35,60,23,10,33
Jharkhand,Ranchi,Multiple Disability,60,80,6,2,8
Jharkhand,Ranchi,Multiple Disability,80,100,1,0,1
Uttar Pradesh,Rampur,Multiple Disability,6,15,7,5,12
Uttar Pradesh,Rampur,Multiple Disability,15,35,37,14,51
Uttar Pradesh,Rampur,Multiple Disability,35,60,33,8,41
Uttar Pradesh,Rampur,Multiple Disability,60,80,3,2,5
Jharkhand,Ramgarh,Multiple Disability,0,6,2,0,2
Jharkhand,Ramgarh,Multiple Disability,6,15,27,15,42
Jharkhand,Ramgarh,Multiple Disability,15,35,138,93,231
Jharkhand,Ramgarh,Multiple Disability,35,60,106,47,153
Jharkhand,Ramgarh,Multiple Disability,60,80,23,10,33
Jharkhand,Ramgarh,Multiple Disability,80,100,1,1,2
Jammu And Kashmir,Ramban,Multiple Disability,6,15,1,2,3
Jammu And Kashmir,Ramban,Multiple Disability,15,35,13,9,22
Jammu And Kashmir,Ramban,Multiple Disability,35,60,17,6,23
Jammu And Kashmir,Ramban,Multiple Disability,60,80,1,0,1
Tamil Nadu,Ramanathapuram,Multiple Disability,0,6,26,9,35
Tamil Nadu,Ramanathapuram,Multiple Disability,6,15,113,91,204
Tamil Nadu,Ramanathapuram,Multiple Disability,15,35,239,173,412
Tamil Nadu,Ramanathapuram,Multiple Disability,35,60,58,37,95
Tamil Nadu,Ramanathapuram,Multiple Disability,60,80,1,2,3
Tamil Nadu,Ramanathapuram,Multiple Disability,80,100,1,0,1
Karnataka,Ramanagara,Multiple Disability,0,6,6,5,11
Karnataka,Ramanagara,Multiple Disability,6,15,16,15,31
Karnataka,Ramanagara,Multiple Disability,15,35,37,33,70
Karnataka,Ramanagara,Multiple Disability,35,60,47,18,65
Karnataka,Ramanagara,Multiple Disability,60,80,16,1,17
Rajasthan,Rajsamand,Multiple Disability,0,6,3,1,4
Rajasthan,Rajsamand,Multiple Disability,6,15,33,10,43
Rajasthan,Rajsamand,Multiple Disability,15,35,63,34,97
Rajasthan,Rajsamand,Multiple Disability,35,60,38,18,56
Rajasthan,Rajsamand,Multiple Disability,60,80,15,9,24
Rajasthan,Rajsamand,Multiple Disability,80,100,1,5,6
Jammu And Kashmir,Rajouri,Multiple Disability,0,6,1,0,1
Jammu And Kashmir,Rajouri,Multiple Disability,6,15,4,8,12
Jammu And Kashmir,Rajouri,Multiple Disability,15,35,21,8,29
Jammu And Kashmir,Rajouri,Multiple Disability,35,60,31,4,35
Jammu And Kashmir,Rajouri,Multiple Disability,60,80,2,1,3
Chhattisgarh,Rajnandgaon,Multiple Disability,0,6,5,3,8
Chhattisgarh,Rajnandgaon,Multiple Disability,6,15,47,34,81
Chhattisgarh,Rajnandgaon,Multiple Disability,15,35,122,100,222
Chhattisgarh,Rajnandgaon,Multiple Disability,35,60,75,32,107
Chhattisgarh,Rajnandgaon,Multiple Disability,60,80,16,4,20
Chhattisgarh,Rajnandgaon,Multiple Disability,80,100,2,0,2
Gujarat,Rajkot,Multiple Disability,0,6,17,15,32
Gujarat,Rajkot,Multiple Disability,6,15,137,73,210
Gujarat,Rajkot,Multiple Disability,15,35,134,75,209
Gujarat,Rajkot,Multiple Disability,35,60,41,11,52
Gujarat,Rajkot,Multiple Disability,60,80,6,3,9
Gujarat,Rajkot,Multiple Disability,80,100,1,0,1
Madhya Pradesh,Rajgarh,Multiple Disability,0,6,1,2,3
Madhya Pradesh,Rajgarh,Multiple Disability,6,15,21,8,29
Madhya Pradesh,Rajgarh,Multiple Disability,15,35,56,24,80
Madhya Pradesh,Rajgarh,Multiple Disability,35,60,66,18,84
Madhya Pradesh,Rajgarh,Multiple Disability,60,80,25,5,30
Madhya Pradesh,Rajgarh,Multiple Disability,80,100,4,2,6
Madhya Pradesh,Raisen,Multiple Disability,0,6,1,0,1
Madhya Pradesh,Raisen,Multiple Disability,6,15,20,20,40
Madhya Pradesh,Raisen,Multiple Disability,15,35,126,62,188
Madhya Pradesh,Raisen,Multiple Disability,35,60,102,32,134
Madhya Pradesh,Raisen,Multiple Disability,60,80,25,8,33
Madhya Pradesh,Raisen,Multiple Disability,80,100,3,1,4
Chhattisgarh,Raipur,Multiple Disability,0,6,15,7,22
Chhattisgarh,Raipur,Multiple Disability,6,15,147,62,209
Chhattisgarh,Raipur,Multiple Disability,15,35,116,63,179
Chhattisgarh,Raipur,Multiple Disability,35,60,25,14,39
Chhattisgarh,Raipur,Multiple Disability,60,80,4,1,5
Chhattisgarh,Raigarh,Multiple Disability,6,15,5,3,8
Chhattisgarh,Raigarh,Multiple Disability,15,35,13,9,22
Chhattisgarh,Raigarh,Multiple Disability,35,60,7,2,9
Chhattisgarh,Raigarh,Multiple Disability,60,80,1,0,1
Maharashtra,Raigad,Multiple Disability,0,6,28,10,38
Maharashtra,Raigad,Multiple Disability,6,15,95,47,142
Maharashtra,Raigad,Multiple Disability,15,35,115,65,180
Maharashtra,Raigad,Multiple Disability,35,60,71,34,105
Maharashtra,Raigad,Multiple Disability,60,80,14,4,18
Maharashtra,Raigad,Multiple Disability,80,100,0,1,1
Karnataka,Raichur,Multiple Disability,0,6,43,46,89
Karnataka,Raichur,Multiple Disability,6,15,248,217,465
Karnataka,Raichur,Multiple Disability,15,35,502,315,817
Karnataka,Raichur,Multiple Disability,35,60,240,159,399
Karnataka,Raichur,Multiple Disability,60,80,63,22,85
Karnataka,Raichur,Multiple Disability,80,100,4,0,4
Uttar Pradesh,Rae Bareli,Multiple Disability,6,15,0,1,1
Uttar Pradesh,Rae Bareli,Multiple Disability,15,35,2,1,3
Uttar Pradesh,Rae Bareli,Multiple Disability,35,60,2,0,2
Uttar Pradesh,Rae Bareli,Multiple Disability,60,80,2,1,3
Bihar,Purnia,Multiple Disability,0,6,2,0,2
Bihar,Purnia,Multiple Disability,6,15,8,7,15
Bihar,Purnia,Multiple Disability,15,35,23,31,54
Bihar,Purnia,Multiple Disability,35,60,12,14,26
Bihar,Purnia,Multiple Disability,60,80,8,0,8
Odisha,Puri,Multiple Disability,0,6,0,4,4
Odisha,Puri,Multiple Disability,6,15,35,23,58
Odisha,Puri,Multiple Disability,15,35,70,46,116
Odisha,Puri,Multiple Disability,35,60,71,39,110
Odisha,Puri,Multiple Disability,60,80,17,4,21
Odisha,Puri,Multiple Disability,80,100,2,0,2
Bihar,Purbi Champaran,Multiple Disability,6,15,7,5,12
Bihar,Purbi Champaran,Multiple Disability,15,35,28,9,37
Bihar,Purbi Champaran,Multiple Disability,35,60,15,9,24
Bihar,Purbi Champaran,Multiple Disability,60,80,1,1,2
Maharashtra,Pune,Multiple Disability,0,6,117,57,174
Maharashtra,Pune,Multiple Disability,6,15,721,273,994
Maharashtra,Pune,Multiple Disability,15,35,487,225,712
Maharashtra,Pune,Multiple Disability,35,60,279,88,367
Maharashtra,Pune,Multiple Disability,60,80,107,25,132
Maharashtra,Pune,Multiple Disability,80,100,9,1,10
Jammu And Kashmir,Pulwama,Multiple Disability,0,6,0,2,2
Jammu And Kashmir,Pulwama,Multiple Disability,6,15,10,2,12
Jammu And Kashmir,Pulwama,Multiple Disability,15,35,26,10,36
Jammu And Kashmir,Pulwama,Multiple Disability,35,60,22,16,38
Jammu And Kashmir,Pulwama,Multiple Disability,60,80,6,2,8
Tamil Nadu,Pudukkottai,Multiple Disability,0,6,34,22,56
Tamil Nadu,Pudukkottai,Multiple Disability,6,15,223,130,353
Tamil Nadu,Pudukkottai,Multiple Disability,15,35,117,66,183
Tamil Nadu,Pudukkottai,Multiple Disability,35,60,29,10,39
Tamil Nadu,Pudukkottai,Multiple Disability,60,80,6,2,8
Uttar Pradesh,Prayagraj,Multiple Disability,0,6,1,0,1
Uttar Pradesh,Prayagraj,Multiple Disability,6,15,8,3,11
Uttar Pradesh,Prayagraj,Multiple Disability,15,35,50,11,61
Uttar Pradesh,Prayagraj,Multiple Disability,35,60,33,7,40
Uttar Pradesh,Prayagraj,Multiple Disability,60,80,6,3,9
Uttar Pradesh,Prayagraj,Multiple Disability,80,100,2,0,2
Rajasthan,Pratapgarh,Multiple Disability,0,6,0,1,1
Rajasthan,Pratapgarh,Multiple Disability,6,15,14,11,25
Rajasthan,Pratapgarh,Multiple Disability,15,35,46,31,77
Rajasthan,Pratapgarh,Multiple Disability,35,60,35,23,58
Rajasthan,Pratapgarh,Multiple Disability,60,80,26,18,44
Rajasthan,Pratapgarh,Multiple Disability,80,100,8,5,13
Uttar Pradesh,Pratapgarh,Multiple Disability,6,15,1,3,4
Uttar Pradesh,Pratapgarh,Multiple Disability,15,35,35,7,42
Uttar Pradesh,Pratapgarh,Multiple Disability,35,60,29,4,33
Uttar Pradesh,Pratapgarh,Multiple Disability,60,80,3,0,3
Andhra Pradesh,Prakasam,Multiple Disability,6,15,5,1,6
Andhra Pradesh,Prakasam,Multiple Disability,15,35,18,5,23
Andhra Pradesh,Prakasam,Multiple Disability,35,60,9,3,12
Andhra Pradesh,Prakasam,Multiple Disability,60,80,4,0,4
Gujarat,Porbandar,Multiple Disability,0,6,0,1,1
Gujarat,Porbandar,Multiple Disability,6,15,20,13,33
Gujarat,Porbandar,Multiple Disability,15,35,36,14,50
Gujarat,Porbandar,Multiple Disability,35,60,8,5,13
Gujarat,Porbandar,Multiple Disability,60,80,9,0,9
Jammu And Kashmir,Poonch,Multiple Disability,0,6,57,53,110
Jammu And Kashmir,Poonch,Multiple Disability,6,15,270,204,474
Jammu And Kashmir,Poonch,Multiple Disability,15,35,525,480,1005
Jammu And Kashmir,Poonch,Multiple Disability,35,60,530,406,936
Jammu And Kashmir,Poonch,Multiple Disability,60,80,62,36,98
Jammu And Kashmir,Poonch,Multiple Disability,80,100,3,2,5
Puducherry,Pondicherry,Multiple Disability,0,6,1,0,1
Puducherry,Pondicherry,Multiple Disability,6,15,2,1,3
Puducherry,Pondicherry,Multiple Disability,15,35,6,1,7
Puducherry,Pondicherry,Multiple Disability,35,60,2,4,6
Puducherry,Pondicherry,Multiple Disability,60,80,1,0,1
Puducherry,Pondicherry,Multiple Disability,80,100,1,0,1
Uttarakhand,Pithoragarh,Multiple Disability,0,6,4,2,6
Uttarakhand,Pithoragarh,Multiple Disability,6,15,34,24,58
Uttarakhand,Pithoragarh,Multiple Disability,15,35,109,56,165
Uttarakhand,Pithoragarh,Multiple Disability,35,60,112,62,174
Uttarakhand,Pithoragarh,Multiple Disability,60,80,35,8,43
Uttarakhand,Pithoragarh,Multiple Disability,80,100,3,0,3
Uttar Pradesh,Pilibhit,Multiple Disability,6,15,45,16,61
Uttar Pradesh,Pilibhit,Multiple Disability,15,35,237,110,347
Uttar Pradesh,Pilibhit,Multiple Disability,35,60,189,74,263
Uttar Pradesh,Pilibhit,Multiple Disability,60,80,49,11,60
Uttar Pradesh,Pilibhit,Multiple Disability,80,100,2,0,2
Nagaland,Phek,Multiple Disability,6,15,4,2,6
Nagaland,Phek,Multiple Disability,15,35,7,4,11
Nagaland,Phek,Multiple Disability,35,60,8,3,11
Nagaland,Phek,Multiple Disability,60,80,2,3,5
Nagaland,Peren,Multiple Disability,35,60,1,0,1
Tamil Nadu,Perambalur,Multiple Disability,0,6,13,14,27
Tamil Nadu,Perambalur,Multiple Disability,6,15,55,54,109
Tamil Nadu,Perambalur,Multiple Disability,15,35,98,33,131
Tamil Nadu,Perambalur,Multiple Disability,35,60,15,23,38
Tamil Nadu,Perambalur,Multiple Disability,60,80,6,1,7
Tamil Nadu,Perambalur,Multiple Disability,80,100,1,0,1
Uttarakhand,Pauri Garhwal,Multiple Disability,0,6,1,1,2
Uttarakhand,Pauri Garhwal,Multiple Disability,6,15,7,6,13
Uttarakhand,Pauri Garhwal,Multiple Disability,15,35,40,14,54
Uttarakhand,Pauri Garhwal,Multiple Disability,35,60,58,13,71
Uttarakhand,Pauri Garhwal,Multiple Disability,60,80,13,5,18
Uttarakhand,Pauri Garhwal,Multiple Disability,80,100,2,0,2
Bihar,Patna,Multiple Disability,0,6,9,5,14
Bihar,Patna,Multiple Disability,6,15,30,32,62
Bihar,Patna,Multiple Disability,15,35,78,31,109
Bihar,Patna,Multiple Disability,35,60,38,17,55
Bihar,Patna,Multiple Disability,60,80,9,3,12
Bihar,Patna,Multiple Disability,80,100,1,0,1
Punjab,Patiala,Multiple Disability,0,6,5,5,10
Punjab,Patiala,Multiple Disability,6,15,42,32,74
Punjab,Patiala,Multiple Disability,15,35,187,95,282
Punjab,Patiala,Multiple Disability,35,60,189,50,239
Punjab,Patiala,Multiple Disability,60,80,50,5,55
Punjab,Patiala,Multiple Disability,80,100,3,1,4
Punjab,Pathankot,Multiple Disability,0,6,0,1,1
Punjab,Pathankot,Multiple Disability,6,15,16,9,25
Punjab,Pathankot,Multiple Disability,15,35,72,34,106
Punjab,Pathankot,Multiple Disability,35,60,79,22,101
Punjab,Pathankot,Multiple Disability,60,80,16,3,19
Punjab,Pathankot,Multiple Disability,80,100,2,0,2
Kerala,Pathanamthitta,Multiple Disability,0,6,7,4,11
Kerala,Pathanamthitta,Multiple Disability,6,15,30,21,51
Kerala,Pathanamthitta,Multiple Disability,15,35,67,36,103
Kerala,Pathanamthitta,Multiple Disability,35,60,48,29,77
Kerala,Pathanamthitta,Multiple Disability,60,80,22,11,33
Kerala,Pathanamthitta,Multiple Disability,80,100,3,0,3
Gujarat,Patan,Multiple Disability,0,6,20,18,38
Gujarat,Patan,Multiple Disability,6,15,125,81,206
Gujarat,Patan,Multiple Disability,15,35,208,108,316
Gujarat,Patan,Multiple Disability,35,60,105,57,162
Gujarat,Patan,Multiple Disability,60,80,12,7,19
Gujarat,Patan,Multiple Disability,80,100,1,0,1
Bihar,Pashchim Champaran,Multiple Disability,0,6,3,3,6
Bihar,Pashchim Champaran,Multiple Disability,6,15,17,13,30
Bihar,Pashchim Champaran,Multiple Disability,15,35,85,34,119
Bihar,Pashchim Champaran,Multiple Disability,35,60,38,7,45
Bihar,Pashchim Champaran,Multiple Disability,60,80,5,4,9
West Bengal,Paschim Bardhaman,Multiple Disability,15,35,1,0,1
Maharashtra,Parbhani,Multiple Disability,6,15,9,6,15
Maharashtra,Parbhani,Multiple Disability,15,35,18,7,25
Maharashtra,Parbhani,Multiple Disability,35,60,15,3,18
Maharashtra,Parbhani,Multiple Disability,60,80,6,1,7
Arunachal Pradesh,Papum Pare,Multiple Disability,0,6,4,2,6
Arunachal Pradesh,Papum Pare,Multiple Disability,6,15,19,9,28
Arunachal Pradesh,Papum Pare,Multiple Disability,15,35,47,25,72
Arunachal Pradesh,Papum Pare,Multiple Disability,35,60,13,3,16
Arunachal Pradesh,Papum Pare,Multiple Disability,60,80,1,0,1
Madhya Pradesh,Panna,Multiple Disability,0,6,0,1,1
Madhya Pradesh,Panna,Multiple Disability,6,15,29,21,50
Madhya Pradesh,Panna,Multiple Disability,15,35,80,47,127
Madhya Pradesh,Panna,Multiple Disability,35,60,43,16,59
Madhya Pradesh,Panna,Multiple Disability,60,80,14,3,17
Madhya Pradesh,Panna,Multiple Disability,80,100,1,0,1
Haryana,Panipat,Multiple Disability,0,6,4,0,4
Haryana,Panipat,Multiple Disability,6,15,36,17,53
Haryana,Panipat,Multiple Disability,15,35,50,25,75
Haryana,Panipat,Multiple Disability,35,60,31,8,39
Haryana,Panipat,Multiple Disability,60,80,4,2,6
Haryana,Panchkula,Multiple Disability,0,6,1,0,1
Haryana,Panchkula,Multiple Disability,6,15,3,5,8
Haryana,Panchkula,Multiple Disability,15,35,14,10,24
Haryana,Panchkula,Multiple Disability,35,60,21,3,24
Haryana,Panchkula,Multiple Disability,60,80,3,2,5
Haryana,Panchkula,Multiple Disability,80,100,0,1,1
Gujarat,Panch Mahals,Multiple Disability,0,6,14,16,30
Gujarat,Panch Mahals,Multiple Disability,6,15,112,77,189
Gujarat,Panch Mahals,Multiple Disability,15,35,103,55,158
Gujarat,Panch Mahals,Multiple Disability,35,60,19,8,27
Gujarat,Panch Mahals,Multiple Disability,60,80,3,1,4
Haryana,Palwal,Multiple Disability,0,6,10,7,17
Haryana,Palwal,Multiple Disability,6,15,74,34,108
Haryana,Palwal,Multiple Disability,15,35,48,24,72
Haryana,Palwal,Multiple Disability,35,60,25,9,34
Haryana,Palwal,Multiple Disability,60,80,5,0,5
Rajasthan,Pali,Multiple Disability,0,6,5,1,6
Rajasthan,Pali,Multiple Disability,6,15,23,14,37
Rajasthan,Pali,Multiple Disability,15,35,44,22,66
Rajasthan,Pali,Multiple Disability,35,60,60,15,75
Rajasthan,Pali,Multiple Disability,60,80,28,13,41
Rajasthan,Pali,Multiple Disability,80,100,5,2,7
Maharashtra,Palghar,Multiple Disability,0,6,5,4,9
Maharashtra,Palghar,Multiple Disability,6,15,33,24,57
Maharashtra,Palghar,Multiple Disability,15,35,41,18,59
Maharashtra,Palghar,Multiple Disability,35,60,12,7,19
Maharashtra,Palghar,Multiple Disability,60,80,1,1,2
Jharkhand,Palamu,Multiple Disability,0,6,1,1,2
Jharkhand,Palamu,Multiple Disability,6,15,6,1,7
Jharkhand,Palamu,Multiple Disability,15,35,28,17,45
Jharkhand,Palamu,Multiple Disability,35,60,27,8,35
Jharkhand,Palamu,Multiple Disability,60,80,5,2,7
Kerala,Palakkad,Multiple Disability,0,6,11,7,18
Kerala,Palakkad,Multiple Disability,6,15,72,52,124
Kerala,Palakkad,Multiple Disability,15,35,134,120,254
Kerala,Palakkad,Multiple Disability,35,60,155,99,254
Kerala,Palakkad,Multiple Disability,60,80,42,23,65
Kerala,Palakkad,Multiple Disability,80,100,2,1,3
Jharkhand,Pakur,Multiple Disability,6,15,0,1,1
Jharkhand,Pakur,Multiple Disability,15,35,4,0,4
Arunachal Pradesh,Pakke Kessang,Multiple Disability,15,35,1,0,1
Maharashtra,Osmanabad,Multiple Disability,0,6,0,1,1
Maharashtra,Osmanabad,Multiple Disability,6,15,4,1,5
Maharashtra,Osmanabad,Multiple Disability,15,35,21,8,29
Maharashtra,Osmanabad,Multiple Disability,35,60,19,6,25
Maharashtra,Osmanabad,Multiple Disability,60,80,4,2,6
Haryana,Nuh,Multiple Disability,0,6,2,3,5
Haryana,Nuh,Multiple Disability,6,15,52,21,73
Haryana,Nuh,Multiple Disability,15,35,63,35,98
Haryana,Nuh,Multiple Disability,35,60,25,8,33
Haryana,Nuh,Multiple Disability,60,80,8,1,9
Haryana,Nuh,Multiple Disability,80,100,1,0,1
Odisha,Nuapada,Multiple Disability,0,6,1,2,3
Odisha,Nuapada,Multiple Disability,6,15,8,0,8
Odisha,Nuapada,Multiple Disability,15,35,9,6,15
Odisha,Nuapada,Multiple Disability,35,60,18,9,27
Odisha,Nuapada,Multiple Disability,60,80,7,2,9
Odisha,Nuapada,Multiple Disability,80,100,1,0,1
Delhi,North West,Multiple Disability,0,6,61,27,88
Delhi,North West,Multiple Disability,6,15,144,87,231
Delhi,North West,Multiple Disability,15,35,72,27,99
Delhi,North West,Multiple Disability,35,60,37,11,48
Delhi,North West,Multiple Disability,60,80,9,1,10
Tripura,North Tripura,Multiple Disability,0,6,3,6,9
Tripura,North Tripura,Multiple Disability,6,15,42,28,70
Tripura,North Tripura,Multiple Disability,15,35,85,49,134
Tripura,North Tripura,Multiple Disability,35,60,49,22,71
Tripura,North Tripura,Multiple Disability,60,80,10,3,13
Tripura,North Tripura,Multiple Disability,80,100,1,0,1
Goa,North Goa,Multiple Disability,0,6,9,10,19
Goa,North Goa,Multiple Disability,6,15,22,7,29
Goa,North Goa,Multiple Disability,15,35,11,1,12
Goa,North Goa,Multiple Disability,35,60,3,2,5
Goa,North Goa,Multiple Disability,60,80,1,0,1
Meghalaya,North Garo Hills,Multiple Disability,15,35,0,1,1
Meghalaya,North Garo Hills,Multiple Disability,35,60,0,1,1
Delhi,North East,Multiple Disability,0,6,68,32,100
Delhi,North East,Multiple Disability,6,15,214,133,347
Delhi,North East,Multiple Disability,15,35,71,36,107
Delhi,North East,Multiple Disability,35,60,30,5,35
Delhi,North East,Multiple Disability,60,80,5,0,5
Andaman And Nicobar Islands,North And Middle Andaman,Multiple Disability,0,6,3,2,5
Andaman And Nicobar Islands,North And Middle Andaman,Multiple Disability,6,15,13,8,21
Andaman And Nicobar Islands,North And Middle Andaman,Multiple Disability,15,35,22,16,38
Andaman And Nicobar Islands,North And Middle Andaman,Multiple Disability,35,60,18,7,25
Andaman And Nicobar Islands,North And Middle Andaman,Multiple Disability,80,100,0,1,1
Delhi,North,Multiple Disability,0,6,25,13,38
Delhi,North,Multiple Disability,6,15,48,40,88
Delhi,North,Multiple Disability,15,35,20,9,29
Delhi,North,Multiple Disability,35,60,12,1,13
Delhi,North,Multiple Disability,60,80,3,0,3
Manipur,Noney,Multiple Disability,6,15,3,2,5
Manipur,Noney,Multiple Disability,15,35,5,4,9
Manipur,Noney,Multiple Disability,35,60,6,0,6
Manipur,Noney,Multiple Disability,60,80,2,0,2
Manipur,Noney,Multiple Disability,80,100,0,1,1
Madhya Pradesh,Niwari,Multiple Disability,0,6,1,0,1
Madhya Pradesh,Niwari,Multiple Disability,6,15,5,2,7
Madhya Pradesh,Niwari,Multiple Disability,15,35,13,9,22
Madhya Pradesh,Niwari,Multiple Disability,35,60,25,9,34
Madhya Pradesh,Niwari,Multiple Disability,60,80,6,2,8
Madhya Pradesh,Niwari,Multiple Disability,80,100,0,1,1
Andaman And Nicobar Islands,Nicobars,Multiple Disability,6,15,1,2,3
Andaman And Nicobar Islands,Nicobars,Multiple Disability,15,35,3,1,4
Andaman And Nicobar Islands,Nicobars,Multiple Disability,35,60,1,1,2
Andaman And Nicobar Islands,Nicobars,Multiple Disability,80,100,0,1,1
Delhi,New Delhi,Multiple Disability,0,6,2,2,4
Delhi,New Delhi,Multiple Disability,6,15,14,8,22
Delhi,New Delhi,Multiple Disability,15,35,8,4,12
Delhi,New Delhi,Multiple Disability,35,60,2,2,4
Delhi,New Delhi,Multiple Disability,80,100,0,1,1
Madhya Pradesh,Neemuch,Multiple Disability,6,15,8,5,13
Madhya Pradesh,Neemuch,Multiple Disability,15,35,35,18,53
Madhya Pradesh,Neemuch,Multiple Disability,35,60,10,8,18
Madhya Pradesh,Neemuch,Multiple Disability,60,80,7,4,11
Odisha,Nayagarh,Multiple Disability,0,6,4,1,5
Odisha,Nayagarh,Multiple Disability,6,15,21,17,38
Odisha,Nayagarh,Multiple Disability,15,35,104,52,156
Odisha,Nayagarh,Multiple Disability,35,60,138,67,205
Odisha,Nayagarh,Multiple Disability,60,80,60,21,81
Odisha,Nayagarh,Multiple Disability,80,100,6,0,6
Bihar,Nawada,Multiple Disability,6,15,5,7,12
Bihar,Nawada,Multiple Disability,15,35,33,17,50
Bihar,Nawada,Multiple Disability,35,60,15,5,20
Bihar,Nawada,Multiple Disability,60,80,2,0,2
Gujarat,Navsari,Multiple Disability,0,6,19,15,34
Gujarat,Navsari,Multiple Disability,6,15,89,49,138
Gujarat,Navsari,Multiple Disability,15,35,92,65,157
Gujarat,Navsari,Multiple Disability,35,60,29,15,44
Gujarat,Navsari,Multiple Disability,60,80,9,4,13
Gujarat,Navsari,Multiple Disability,80,100,1,0,1
Maharashtra,Nashik,Multiple Disability,0,6,77,58,135
Maharashtra,Nashik,Multiple Disability,6,15,698,393,1091
Maharashtra,Nashik,Multiple Disability,15,35,659,317,976
Maharashtra,Nashik,Multiple Disability,35,60,258,100,358
Maharashtra,Nashik,Multiple Disability,60,80,51,11,62
Maharashtra,Nashik,Multiple Disability,80,100,2,0,2
Madhya Pradesh,Narsinghpur,Multiple Disability,0,6,1,0,1
Madhya Pradesh,Narsinghpur,Multiple Disability,6,15,63,40,103
Madhya Pradesh,Narsinghpur,Multiple Disability,15,35,143,82,225
Madhya Pradesh,Narsinghpur,Multiple Disability,35,60,119,47,166
Madhya Pradesh,Narsinghpur,Multiple Disability,60,80,19,10,29
Madhya Pradesh,Narmadapuram,Multiple Disability,6,15,28,10,38
Madhya Pradesh,Narmadapuram,Multiple Disability,15,35,77,28,105
Madhya Pradesh,Narmadapuram,Multiple Disability,35,60,48,17,65
Madhya Pradesh,Narmadapuram,Multiple Disability,60,80,7,4,11
Gujarat,Narmada,Multiple Disability,0,6,1,0,1
Gujarat,Narmada,Multiple Disability,6,15,13,4,17
Gujarat,Narmada,Multiple Disability,15,35,16,6,22
Gujarat,Narmada,Multiple Disability,35,60,11,1,12
Gujarat,Narmada,Multiple Disability,60,80,2,0,2
Chhattisgarh,Narayanpur,Multiple Disability,0,6,1,0,1
Chhattisgarh,Narayanpur,Multiple Disability,6,15,5,3,8
Chhattisgarh,Narayanpur,Multiple Disability,15,35,6,1,7
Chhattisgarh,Narayanpur,Multiple Disability,35,60,1,1,2
Chhattisgarh,Narayanpur,Multiple Disability,60,80,1,0,1
Maharashtra,Nandurbar,Multiple Disability,0,6,0,1,1
Maharashtra,Nandurbar,Multiple Disability,6,15,1,1,2
Maharashtra,Nandurbar,Multiple Disability,15,35,4,1,5
Maharashtra,Nandurbar,Multiple Disability,35,60,2,0,2
Maharashtra,Nanded,Multiple Disability,0,6,98,42,140
Maharashtra,Nanded,Multiple Disability,6,15,252,155,407
Maharashtra,Nanded,Multiple Disability,15,35,194,107,301
Maharashtra,Nanded,Multiple Disability,35,60,76,30,106
Maharashtra,Nanded,Multiple Disability,60,80,25,2,27
Maharashtra,Nanded,Multiple Disability,80,100,1,0,1
Arunachal Pradesh,Namsai,Multiple Disability,6,15,4,0,4
Arunachal Pradesh,Namsai,Multiple Disability,15,35,5,3,8
Arunachal Pradesh,Namsai,Multiple Disability,35,60,1,3,4
Arunachal Pradesh,Namsai,Multiple Disability,60,80,0,1,1
Sikkim,Namchi,Multiple Disability,0,6,2,1,3
Sikkim,Namchi,Multiple Disability,6,15,7,9,16
Sikkim,Namchi,Multiple Disability,15,35,18,21,39
Sikkim,Namchi,Multiple Disability,35,60,37,21,58
Sikkim,Namchi,Multiple Disability,60,80,11,2,13
Sikkim,Namchi,Multiple Disability,80,100,0,1,1
Tamil Nadu,Namakkal,Multiple Disability,0,6,16,6,22
Tamil Nadu,Namakkal,Multiple Disability,6,15,88,52,140
Tamil Nadu,Namakkal,Multiple Disability,15,35,109,61,170
Tamil Nadu,Namakkal,Multiple Disability,35,60,33,17,50
Tamil Nadu,Namakkal,Multiple Disability,60,80,6,1,7
Assam,Nalbari,Multiple Disability,0,6,1,2,3
Assam,Nalbari,Multiple Disability,6,15,39,24,63
Assam,Nalbari,Multiple Disability,15,35,60,42,102
Assam,Nalbari,Multiple Disability,35,60,48,17,65
Assam,Nalbari,Multiple Disability,60,80,9,6,15
Assam,Nalbari,Multiple Disability,80,100,0,1,1
Bihar,Nalanda,Multiple Disability,0,6,11,9,20
Bihar,Nalanda,Multiple Disability,6,15,22,23,45
Bihar,Nalanda,Multiple Disability,15,35,22,10,32
Bihar,Nalanda,Multiple Disability,35,60,21,6,27
Bihar,Nalanda,Multiple Disability,60,80,5,0,5
Uttarakhand,Nainital,Multiple Disability,6,15,10,13,23
Uttarakhand,Nainital,Multiple Disability,15,35,29,17,46
Uttarakhand,Nainital,Multiple Disability,35,60,45,16,61
Uttarakhand,Nainital,Multiple Disability,60,80,8,5,13
Maharashtra,Nagpur,Multiple Disability,0,6,7,2,9
Maharashtra,Nagpur,Multiple Disability,6,15,46,21,67
Maharashtra,Nagpur,Multiple Disability,15,35,74,54,128
Maharashtra,Nagpur,Multiple Disability,35,60,51,18,69
Maharashtra,Nagpur,Multiple Disability,60,80,8,1,9
Maharashtra,Nagpur,Multiple Disability,80,100,0,1,1
Rajasthan,Nagaur,Multiple Disability,0,6,1,1,2
Rajasthan,Nagaur,Multiple Disability,6,15,23,15,38
Rajasthan,Nagaur,Multiple Disability,15,35,66,39,105
Rajasthan,Nagaur,Multiple Disability,35,60,70,18,88
Rajasthan,Nagaur,Multiple Disability,60,80,11,7,18
Rajasthan,Nagaur,Multiple Disability,80,100,0,1,1
Tamil Nadu,Nagapattinam,Multiple Disability,0,6,6,2,8
Tamil Nadu,Nagapattinam,Multiple Disability,6,15,37,22,59
Tamil Nadu,Nagapattinam,Multiple Disability,15,35,61,24,85
Tamil Nadu,Nagapattinam,Multiple Disability,35,60,21,16,37
Tamil Nadu,Nagapattinam,Multiple Disability,60,80,2,1,3
Tamil Nadu,Nagapattinam,Multiple Disability,80,100,1,0,1
Assam,Nagaon,Multiple Disability,6,15,1,2,3
Assam,Nagaon,Multiple Disability,15,35,5,1,6
Assam,Nagaon,Multiple Disability,35,60,4,0,4
Assam,Nagaon,Multiple Disability,60,80,1,0,1
Odisha,Nabarangpur,Multiple Disability,0,6,2,0,2
Odisha,Nabarangpur,Multiple Disability,6,15,8,2,10
Odisha,Nabarangpur,Multiple Disability,15,35,9,5,14
Odisha,Nabarangpur,Multiple Disability,35,60,11,2,13
Odisha,Nabarangpur,Multiple Disability,60,80,5,0,5
Odisha,Nabarangpur,Multiple Disability,80,100,1,0,1
Karnataka,Mysuru,Multiple Disability,0,6,7,3,10
Karnataka,Mysuru,Multiple Disability,6,15,35,30,65
Karnataka,Mysuru,Multiple Disability,15,35,83,63,146
Karnataka,Mysuru,Multiple Disability,35,60,99,50,149
Karnataka,Mysuru,Multiple Disability,60,80,22,3,25
Karnataka,Mysuru,Multiple Disability,80,100,1,0,1
Bihar,Muzaffarpur,Multiple Disability,6,15,9,4,13
Bihar,Muzaffarpur,Multiple Disability,15,35,43,10,53
Bihar,Muzaffarpur,Multiple Disability,35,60,31,3,34
Bihar,Muzaffarpur,Multiple Disability,60,80,8,0,8
Uttar Pradesh,Muzaffarnagar,Multiple Disability,0,6,13,7,20
Uttar Pradesh,Muzaffarnagar,Multiple Disability,6,15,103,64,167
Uttar Pradesh,Muzaffarnagar,Multiple Disability,15,35,318,130,448
Uttar Pradesh,Muzaffarnagar,Multiple Disability,35,60,189,72,261
Uttar Pradesh,Muzaffarnagar,Multiple Disability,60,80,59,19,78
Uttar Pradesh,Muzaffarnagar,Multiple Disability,80,100,2,2,4
West Bengal,Murshidabad,Multiple Disability,6,15,3,0,3
West Bengal,Murshidabad,Multiple Disability,15,35,2,1,3
West Bengal,Murshidabad,Multiple Disability,35,60,3,0,3
Bihar,Munger,Multiple Disability,6,15,2,6,8
Bihar,Munger,Multiple Disability,15,35,78,32,110
Bihar,Munger,Multiple Disability,35,60,45,8,53
Bihar,Munger,Multiple Disability,60,80,6,0,6
Chhattisgarh,Mungeli,Multiple Disability,6,15,3,0,3
Chhattisgarh,Mungeli,Multiple Disability,15,35,8,6,14
Chhattisgarh,Mungeli,Multiple Disability,35,60,7,7,14
Chhattisgarh,Mungeli,Multiple Disability,60,80,1,1,2
Maharashtra,Mumbai Suburban,Multiple Disability,0,6,153,68,221
Maharashtra,Mumbai Suburban,Multiple Disability,6,15,689,356,1045
Maharashtra,Mumbai Suburban,Multiple Disability,15,35,723,346,1069
Maharashtra,Mumbai Suburban,Multiple Disability,35,60,189,79,268
Maharashtra,Mumbai Suburban,Multiple Disability,60,80,55,11,66
Maharashtra,Mumbai Suburban,Multiple Disability,80,100,3,1,4
Maharashtra,Mumbai,Multiple Disability,0,6,34,7,41
Maharashtra,Mumbai,Multiple Disability,6,15,109,52,161
Maharashtra,Mumbai,Multiple Disability,15,35,185,91,276
Maharashtra,Mumbai,Multiple Disability,35,60,73,22,95
Maharashtra,Mumbai,Multiple Disability,60,80,28,1,29
Maharashtra,Mumbai,Multiple Disability,80,100,1,0,1
Madhya Pradesh,Morena,Multiple Disability,6,15,15,5,20
Madhya Pradesh,Morena,Multiple Disability,15,35,56,20,76
Madhya Pradesh,Morena,Multiple Disability,35,60,41,5,46
Madhya Pradesh,Morena,Multiple Disability,60,80,11,5,16
Madhya Pradesh,Morena,Multiple Disability,80,100,6,0,6
Gujarat,Morbi,Multiple Disability,0,6,14,8,22
Gujarat,Morbi,Multiple Disability,6,15,92,63,155
Gujarat,Morbi,Multiple Disability,15,35,64,46,110
Gujarat,Morbi,Multiple Disability,35,60,28,18,46
Gujarat,Morbi,Multiple Disability,60,80,3,0,3
Uttar Pradesh,Moradabad,Multiple Disability,6,15,6,6,12
Uttar Pradesh,Moradabad,Multiple Disability,15,35,74,32,106
Uttar Pradesh,Moradabad,Multiple Disability,35,60,48,18,66
Uttar Pradesh,Moradabad,Multiple Disability,60,80,4,2,6
Nagaland,Mon,Multiple Disability,0,6,1,0,1
Nagaland,Mon,Multiple Disability,35,60,2,1,3
Nagaland,Mokokchung,Multiple Disability,6,15,1,0,1
Nagaland,Mokokchung,Multiple Disability,15,35,2,0,2
Nagaland,Mokokchung,Multiple Disability,35,60,2,1,3
Nagaland,Mokokchung,Multiple Disability,60,80,2,1,3
Punjab,Moga,Multiple Disability,0,6,0,1,1
Punjab,Moga,Multiple Disability,6,15,14,10,24
Punjab,Moga,Multiple Disability,15,35,58,31,89
Punjab,Moga,Multiple Disability,35,60,70,29,99
Punjab,Moga,Multiple Disability,60,80,16,1,17
Punjab,Moga,Multiple Disability,80,100,2,0,2
Uttar Pradesh,Mirzapur,Multiple Disability,6,15,3,2,5
Uttar Pradesh,Mirzapur,Multiple Disability,15,35,44,9,53
Uttar Pradesh,Mirzapur,Multiple Disability,35,60,33,11,44
Uttar Pradesh,Mirzapur,Multiple Disability,60,80,8,1,9
Uttar Pradesh,Meerut,Multiple Disability,0,6,5,2,7
Uttar Pradesh,Meerut,Multiple Disability,6,15,3,0,3
Uttar Pradesh,Meerut,Multiple Disability,15,35,26,6,32
Uttar Pradesh,Meerut,Multiple Disability,35,60,25,6,31
Uttar Pradesh,Meerut,Multiple Disability,60,80,5,1,6
West Bengal,Medinipur West,Multiple Disability,6,15,0,1,1
Odisha,Mayurbhanj,Multiple Disability,0,6,109,52,161
Odisha,Mayurbhanj,Multiple Disability,6,15,165,125,290
Odisha,Mayurbhanj,Multiple Disability,15,35,92,87,179
Odisha,Mayurbhanj,Multiple Disability,35,60,48,19,67
Odisha,Mayurbhanj,Multiple Disability,60,80,32,14,46
Odisha,Mayurbhanj,Multiple Disability,80,100,7,1,8
Tamil Nadu,Mayiladuthurai,Multiple Disability,0,6,15,16,31
Tamil Nadu,Mayiladuthurai,Multiple Disability,6,15,49,33,82
Tamil Nadu,Mayiladuthurai,Multiple Disability,15,35,73,32,105
Tamil Nadu,Mayiladuthurai,Multiple Disability,35,60,12,2,14
Uttar Pradesh,Mau,Multiple Disability,0,6,0,2,2
Uttar Pradesh,Mau,Multiple Disability,6,15,0,1,1
Uttar Pradesh,Mau,Multiple Disability,15,35,7,5,12
Uttar Pradesh,Mau,Multiple Disability,35,60,6,2,8
Uttar Pradesh,Mathura,Multiple Disability,0,6,2,1,3
Uttar Pradesh,Mathura,Multiple Disability,6,15,37,14,51
Uttar Pradesh,Mathura,Multiple Disability,15,35,120,32,152
Uttar Pradesh,Mathura,Multiple Disability,35,60,35,11,46
Uttar Pradesh,Mathura,Multiple Disability,60,80,10,3,13
Uttar Pradesh,Mathura,Multiple Disability,80,100,1,0,1
Assam,Marigaon,Multiple Disability,0,6,0,1,1
Assam,Marigaon,Multiple Disability,6,15,5,2,7
Assam,Marigaon,Multiple Disability,15,35,7,5,12
Assam,Marigaon,Multiple Disability,35,60,4,3,7
Assam,Marigaon,Multiple Disability,60,80,0,1,1
Punjab,Mansa,Multiple Disability,0,6,2,0,2
Punjab,Mansa,Multiple Disability,6,15,15,7,22
Punjab,Mansa,Multiple Disability,15,35,91,39,130
Punjab,Mansa,Multiple Disability,35,60,54,24,78
Punjab,Mansa,Multiple Disability,60,80,16,3,19
Punjab,Mansa,Multiple Disability,80,100,2,0,2
Sikkim,Mangan,Multiple Disability,6,15,4,0,4
Sikkim,Mangan,Multiple Disability,15,35,4,5,9
Sikkim,Mangan,Multiple Disability,35,60,3,8,11
Sikkim,Mangan,Multiple Disability,60,80,1,0,1
Karnataka,Mandya,Multiple Disability,0,6,1,0,1
Karnataka,Mandya,Multiple Disability,6,15,10,5,15
Karnataka,Mandya,Multiple Disability,15,35,43,25,68
Karnataka,Mandya,Multiple Disability,35,60,55,25,80
Karnataka,Mandya,Multiple Disability,60,80,20,4,24
Madhya Pradesh,Mandsaur,Multiple Disability,0,6,5,3,8
Madhya Pradesh,Mandsaur,Multiple Disability,6,15,20,14,34
Madhya Pradesh,Mandsaur,Multiple Disability,15,35,37,21,58
Madhya Pradesh,Mandsaur,Multiple Disability,35,60,18,12,30
Madhya Pradesh,Mandsaur,Multiple Disability,60,80,2,6,8
Madhya Pradesh,Mandsaur,Multiple Disability,80,100,6,1,7
Madhya Pradesh,Mandla,Multiple Disability,6,15,4,2,6
Madhya Pradesh,Mandla,Multiple Disability,15,35,13,11,24
Madhya Pradesh,Mandla,Multiple Disability,35,60,17,7,24
Madhya Pradesh,Mandla,Multiple Disability,60,80,6,1,7
Himachal Pradesh,Mandi,Multiple Disability,0,6,0,1,1
Himachal Pradesh,Mandi,Multiple Disability,6,15,16,8,24
Himachal Pradesh,Mandi,Multiple Disability,15,35,74,35,109
Himachal Pradesh,Mandi,Multiple Disability,35,60,138,40,178
Himachal Pradesh,Mandi,Multiple Disability,60,80,51,13,64
Himachal Pradesh,Mandi,Multiple Disability,80,100,7,1,8
Mizoram,Mamit,Multiple Disability,6,15,1,1,2
Mizoram,Mamit,Multiple Disability,15,35,1,3,4
Mizoram,Mamit,Multiple Disability,35,60,1,3,4
Mizoram,Mamit,Multiple Disability,60,80,2,1,3
Odisha,Malkangiri,Multiple Disability,0,6,5,2,7
Odisha,Malkangiri,Multiple Disability,6,15,30,31,61
Odisha,Malkangiri,Multiple Disability,15,35,83,49,132
Odisha,Malkangiri,Multiple Disability,35,60,62,42,104
Odisha,Malkangiri,Multiple Disability,60,80,19,9,28
Odisha,Malkangiri,Multiple Disability,80,100,2,0,2
Punjab,Malerkotla,Multiple Disability,0,6,0,2,2
Punjab,Malerkotla,Multiple Disability,6,15,3,2,5
Punjab,Malerkotla,Multiple Disability,15,35,17,15,32
Punjab,Malerkotla,Multiple Disability,35,60,17,4,21
Punjab,Malerkotla,Multiple Disability,60,80,0,1,1
West Bengal,Maldah,Multiple Disability,0,6,0,1,1
Kerala,Malappuram,Multiple Disability,0,6,33,20,53
Kerala,Malappuram,Multiple Disability,6,15,441,269,710
Kerala,Malappuram,Multiple Disability,15,35,946,616,1562
Kerala,Malappuram,Multiple Disability,35,60,647,421,1068
Kerala,Malappuram,Multiple Disability,60,80,160,81,241
Kerala,Malappuram,Multiple Disability,80,100,6,4,10
Assam,Majuli,Multiple Disability,0,6,3,5,8
Assam,Majuli,Multiple Disability,6,15,10,9,19
Assam,Majuli,Multiple Disability,15,35,20,20,40
Assam,Majuli,Multiple Disability,35,60,20,11,31
Assam,Majuli,Multiple Disability,60,80,4,5,9
Uttar Pradesh,Mainpuri,Multiple Disability,6,15,6,1,7
Uttar Pradesh,Mainpuri,Multiple Disability,15,35,57,21,78
Uttar Pradesh,Mainpuri,Multiple Disability,35,60,46,13,59
Uttar Pradesh,Mainpuri,Multiple Disability,60,80,13,1,14
Uttar Pradesh,Mainpuri,Multiple Disability,80,100,2,0,2
Uttar Pradesh,Mahoba,Multiple Disability,0,6,4,2,6
Uttar Pradesh,Mahoba,Multiple Disability,6,15,24,15,39
Uttar Pradesh,Mahoba,Multiple Disability,15,35,94,32,126
Uttar Pradesh,Mahoba,Multiple Disability,35,60,60,23,83
Uttar Pradesh,Mahoba,Multiple Disability,60,80,14,6,20
Uttar Pradesh,Mahoba,Multiple Disability,80,100,2,0,2
Gujarat,Mahisagar,Multiple Disability,0,6,12,4,16
Gujarat,Mahisagar,Multiple Disability,6,15,89,33,122
Gujarat,Mahisagar,Multiple Disability,15,35,71,45,116
Gujarat,Mahisagar,Multiple Disability,35,60,15,8,23
Gujarat,Mahisagar,Multiple Disability,60,80,6,1,7
Gujarat,Mahesana,Multiple Disability,0,6,39,11,50
Gujarat,Mahesana,Multiple Disability,6,15,253,133,386
Gujarat,Mahesana,Multiple Disability,15,35,291,129,420
Gujarat,Mahesana,Multiple Disability,35,60,94,36,130
Gujarat,Mahesana,Multiple Disability,60,80,18,2,20
Haryana,Mahendragarh,Multiple Disability,0,6,4,0,4
Haryana,Mahendragarh,Multiple Disability,6,15,8,4,12
Haryana,Mahendragarh,Multiple Disability,15,35,107,30,137
Haryana,Mahendragarh,Multiple Disability,35,60,94,15,109
Haryana,Mahendragarh,Multiple Disability,60,80,15,15,30
Haryana,Mahendragarh,Multiple Disability,80,100,2,1,3
Puducherry,Mahe,Multiple Disability,6,15,1,1,2
Puducherry,Mahe,Multiple Disability,15,35,2,0,2
Puducherry,Mahe,Multiple Disability,35,60,1,0,1
Puducherry,Mahe,Multiple Disability,60,80,0,1,1
Chhattisgarh,Mahasamund,Multiple Disability,6,15,11,5,16
Chhattisgarh,Mahasamund,Multiple Disability,15,35,18,11,29
Chhattisgarh,Mahasamund,Multiple Disability,35,60,4,6,10
Chhattisgarh,Mahasamund,Multiple Disability,60,80,1,0,1
Uttar Pradesh,Maharajganj,Multiple Disability,6,15,6,2,8
Uttar Pradesh,Maharajganj,Multiple Disability,15,35,30,15,45
Uttar Pradesh,Maharajganj,Multiple Disability,35,60,12,5,17
Uttar Pradesh,Maharajganj,Multiple Disability,60,80,6,0,6
Telangana,Mahabubabad,Multiple Disability,15,35,2,0,2
Tamil Nadu,Madurai,Multiple Disability,0,6,13,5,18
Tamil Nadu,Madurai,Multiple Disability,6,15,27,20,47
Tamil Nadu,Madurai,Multiple Disability,15,35,36,23,59
Tamil Nadu,Madurai,Multiple Disability,35,60,26,7,33
Tamil Nadu,Madurai,Multiple Disability,60,80,3,2,5
Tamil Nadu,Madurai,Multiple Disability,80,100,0,1,1
Bihar,Madhubani,Multiple Disability,6,15,1,0,1
Bihar,Madhubani,Multiple Disability,15,35,4,3,7
Bihar,Madhubani,Multiple Disability,35,60,4,2,6
Bihar,Madhubani,Multiple Disability,60,80,2,0,2
Bihar,Madhepura,Multiple Disability,6,15,7,2,9
Bihar,Madhepura,Multiple Disability,15,35,11,4,15
Bihar,Madhepura,Multiple Disability,35,60,5,3,8
Bihar,Madhepura,Multiple Disability,60,80,1,1,2
Mizoram,Lunglei,Multiple Disability,0,6,2,1,3
Mizoram,Lunglei,Multiple Disability,6,15,1,3,4
Mizoram,Lunglei,Multiple Disability,15,35,8,3,11
Mizoram,Lunglei,Multiple Disability,35,60,5,5,10
Mizoram,Lunglei,Multiple Disability,60,80,1,2,3
Punjab,Ludhiana,Multiple Disability,0,6,8,2,10
Punjab,Ludhiana,Multiple Disability,6,15,37,16,53
Punjab,Ludhiana,Multiple Disability,15,35,101,53,154
Punjab,Ludhiana,Multiple Disability,35,60,100,30,130
Punjab,Ludhiana,Multiple Disability,60,80,29,5,34
Punjab,Ludhiana,Multiple Disability,80,100,2,0,2
Uttar Pradesh,Lucknow,Multiple Disability,0,6,22,18,40
Uttar Pradesh,Lucknow,Multiple Disability,6,15,167,103,270
Uttar Pradesh,Lucknow,Multiple Disability,15,35,454,201,655
Uttar Pradesh,Lucknow,Multiple Disability,35,60,344,128,472
Uttar Pradesh,Lucknow,Multiple Disability,60,80,87,13,100
Uttar Pradesh,Lucknow,Multiple Disability,80,100,2,1,3
Arunachal Pradesh,Lower Subansiri,Multiple Disability,35,60,1,0,1
Arunachal Pradesh,Lower Siang,Multiple Disability,15,35,2,0,2
Arunachal Pradesh,Lower Siang,Multiple Disability,35,60,2,1,3
Arunachal Pradesh,Lower Dibang Valley,Multiple Disability,6,15,0,3,3
Arunachal Pradesh,Lower Dibang Valley,Multiple Disability,15,35,5,2,7
Arunachal Pradesh,Lower Dibang Valley,Multiple Disability,35,60,1,1,2
Arunachal Pradesh,Lower Dibang Valley,Multiple Disability,60,80,1,0,1
Nagaland,Longleng,Multiple Disability,15,35,0,1,1
Arunachal Pradesh,Longding,Multiple Disability,35,60,1,0,1
Arunachal Pradesh,Lohit,Multiple Disability,15,35,0,2,2
Jharkhand,Lohardaga,Multiple Disability,6,15,6,4,10
Jharkhand,Lohardaga,Multiple Disability,15,35,17,11,28
Jharkhand,Lohardaga,Multiple Disability,35,60,13,7,20
Jharkhand,Lohardaga,Multiple Disability,60,80,3,0,3
Arunachal Pradesh,Leparada,Multiple Disability,15,35,1,1,2
Ladakh,Leh Ladakh,Multiple Disability,0,6,3,1,4
Ladakh,Leh Ladakh,Multiple Disability,6,15,12,6,18
Ladakh,Leh Ladakh,Multiple Disability,15,35,18,21,39
Ladakh,Leh Ladakh,Multiple Disability,35,60,23,23,46
Ladakh,Leh Ladakh,Multiple Disability,60,80,6,4,10
Ladakh,Leh Ladakh,Multiple Disability,80,100,0,1,1
Mizoram,Lawngtlai,Multiple Disability,6,15,1,0,1
Mizoram,Lawngtlai,Multiple Disability,15,35,1,1,2
Mizoram,Lawngtlai,Multiple Disability,35,60,1,0,1
Maharashtra,Latur,Multiple Disability,0,6,1,2,3
Maharashtra,Latur,Multiple Disability,6,15,30,13,43
Maharashtra,Latur,Multiple Disability,15,35,98,51,149
Maharashtra,Latur,Multiple Disability,35,60,93,30,123
Maharashtra,Latur,Multiple Disability,60,80,41,6,47
Maharashtra,Latur,Multiple Disability,80,100,5,0,5
Jharkhand,Latehar,Multiple Disability,0,6,1,0,1
Jharkhand,Latehar,Multiple Disability,6,15,2,1,3
Jharkhand,Latehar,Multiple Disability,15,35,2,1,3
Jharkhand,Latehar,Multiple Disability,35,60,2,0,2
Uttar Pradesh,Lalitpur,Multiple Disability,0,6,0,1,1
Uttar Pradesh,Lalitpur,Multiple Disability,6,15,8,7,15
Uttar Pradesh,Lalitpur,Multiple Disability,15,35,48,19,67
Uttar Pradesh,Lalitpur,Multiple Disability,35,60,55,21,76
Uttar Pradesh,Lalitpur,Multiple Disability,60,80,8,3,11
Lakshadweep,Lakshadweep District,Multiple Disability,0,6,1,0,1
Lakshadweep,Lakshadweep District,Multiple Disability,6,15,6,6,12
Lakshadweep,Lakshadweep District,Multiple Disability,15,35,25,15,40
Lakshadweep,Lakshadweep District,Multiple Disability,35,60,11,5,16
Lakshadweep,Lakshadweep District,Multiple Disability,60,80,1,0,1
Bihar,Lakhisarai,Multiple Disability,6,15,7,6,13
Bihar,Lakhisarai,Multiple Disability,15,35,24,8,32
Bihar,Lakhisarai,Multiple Disability,35,60,12,6,18
Bihar,Lakhisarai,Multiple Disability,60,80,2,0,2
Assam,Lakhimpur,Multiple Disability,0,6,16,10,26
Assam,Lakhimpur,Multiple Disability,6,15,88,55,143
Assam,Lakhimpur,Multiple Disability,15,35,111,83,194
Assam,Lakhimpur,Multiple Disability,35,60,86,54,140
Assam,Lakhimpur,Multiple Disability,60,80,9,6,15
Himachal Pradesh,Lahul And Spiti,Multiple Disability,6,15,3,1,4
Himachal Pradesh,Lahul And Spiti,Multiple Disability,15,35,2,2,4
Himachal Pradesh,Lahul And Spiti,Multiple Disability,35,60,6,4,10
Himachal Pradesh,Lahul And Spiti,Multiple Disability,60,80,0,1,1
Uttar Pradesh,Kushi Nagar,Multiple Disability,6,15,5,2,7
Uttar Pradesh,Kushi Nagar,Multiple Disability,15,35,26,10,36
Uttar Pradesh,Kushi Nagar,Multiple Disability,35,60,20,4,24
Uttar Pradesh,Kushi Nagar,Multiple Disability,60,80,4,2,6
Arunachal Pradesh,Kurung Kumey,Multiple Disability,15,35,0,1,1
Haryana,Kurukshetra,Multiple Disability,0,6,1,2,3
Haryana,Kurukshetra,Multiple Disability,6,15,20,10,30
Haryana,Kurukshetra,Multiple Disability,15,35,51,26,77
Haryana,Kurukshetra,Multiple Disability,35,60,62,17,79
Haryana,Kurukshetra,Multiple Disability,60,80,7,4,11
Haryana,Kurukshetra,Multiple Disability,80,100,1,0,1
Andhra Pradesh,Kurnool,Multiple Disability,0,6,0,3,3
Andhra Pradesh,Kurnool,Multiple Disability,6,15,13,1,14
Andhra Pradesh,Kurnool,Multiple Disability,15,35,37,8,45
Andhra Pradesh,Kurnool,Multiple Disability,35,60,8,3,11
Andhra Pradesh,Kurnool,Multiple Disability,60,80,1,0,1
Jammu And Kashmir,Kupwara,Multiple Disability,0,6,6,7,13
Jammu And Kashmir,Kupwara,Multiple Disability,6,15,66,41,107
Jammu And Kashmir,Kupwara,Multiple Disability,15,35,122,95,217
Jammu And Kashmir,Kupwara,Multiple Disability,35,60,106,82,188
Jammu And Kashmir,Kupwara,Multiple Disability,60,80,18,4,22
Jammu And Kashmir,Kupwara,Multiple Disability,80,100,2,0,2
Himachal Pradesh,Kullu,Multiple Disability,6,15,5,5,10
Himachal Pradesh,Kullu,Multiple Disability,15,35,27,17,44
Himachal Pradesh,Kullu,Multiple Disability,35,60,32,10,42
Himachal Pradesh,Kullu,Multiple Disability,60,80,17,2,19
Himachal Pradesh,Kullu,Multiple Disability,80,100,1,0,1
Jammu And Kashmir,Kulgam,Multiple Disability,6,15,6,5,11
Jammu And Kashmir,Kulgam,Multiple Disability,15,35,19,10,29
Jammu And Kashmir,Kulgam,Multiple Disability,35,60,15,12,27
Jammu And Kashmir,Kulgam,Multiple Disability,60,80,3,0,3
Tamil Nadu,Krishnagiri,Multiple Disability,0,6,3,1,4
Tamil Nadu,Krishnagiri,Multiple Disability,6,15,53,47,100
Tamil Nadu,Krishnagiri,Multiple Disability,15,35,74,43,117
Tamil Nadu,Krishnagiri,Multiple Disability,35,60,13,13,26
Tamil Nadu,Krishnagiri,Multiple Disability,60,80,5,0,5
Tamil Nadu,Krishnagiri,Multiple Disability,80,100,2,0,2
Andhra Pradesh,Krishna,Multiple Disability,6,15,3,0,3
Andhra Pradesh,Krishna,Multiple Disability,15,35,6,3,9
Andhra Pradesh,Krishna,Multiple Disability,35,60,2,1,3
Arunachal Pradesh,Kra Daadi,Multiple Disability,6,15,1,0,1
Kerala,Kozhikode,Multiple Disability,0,6,7,4,11
Kerala,Kozhikode,Multiple Disability,6,15,42,26,68
Kerala,Kozhikode,Multiple Disability,15,35,72,50,122
Kerala,Kozhikode,Multiple Disability,35,60,70,48,118
Kerala,Kozhikode,Multiple Disability,60,80,23,12,35
Kerala,Kozhikode,Multiple Disability,80,100,1,1,2
Kerala,Kottayam,Multiple Disability,0,6,16,8,24
Kerala,Kottayam,Multiple Disability,6,15,29,24,53
Kerala,Kottayam,Multiple Disability,15,35,51,21,72
Kerala,Kottayam,Multiple Disability,35,60,22,17,39
Kerala,Kottayam,Multiple Disability,60,80,6,4,10
Rajasthan,Kota,Multiple Disability,6,15,10,8,18
Rajasthan,Kota,Multiple Disability,15,35,34,16,50
Rajasthan,Kota,Multiple Disability,35,60,24,14,38
Rajasthan,Kota,Multiple Disability,60,80,14,5,19
Rajasthan,Kota,Multiple Disability,80,100,3,1,4
Chhattisgarh,Korea,Multiple Disability,6,15,8,7,15
Chhattisgarh,Korea,Multiple Disability,15,35,22,11,33
Chhattisgarh,Korea,Multiple Disability,35,60,13,7,20
Chhattisgarh,Korea,Multiple Disability,60,80,4,1,5
Chhattisgarh,Korba,Multiple Disability,0,6,5,3,8
Chhattisgarh,Korba,Multiple Disability,6,15,53,56,109
Chhattisgarh,Korba,Multiple Disability,15,35,187,129,316
Chhattisgarh,Korba,Multiple Disability,35,60,61,31,92
Chhattisgarh,Korba,Multiple Disability,60,80,7,8,15
Odisha,Koraput,Multiple Disability,0,6,11,3,14
Odisha,Koraput,Multiple Disability,6,15,34,22,56
Odisha,Koraput,Multiple Disability,15,35,21,30,51
Odisha,Koraput,Multiple Disability,35,60,26,16,42
Odisha,Koraput,Multiple Disability,60,80,13,5,18
Karnataka,Koppal,Multiple Disability,6,15,11,6,17
Karnataka,Koppal,Multiple Disability,15,35,25,14,39
Karnataka,Koppal,Multiple Disability,35,60,11,7,18
Karnataka,Koppal,Multiple Disability,60,80,5,1,6
Chhattisgarh,Kondagaon,Multiple Disability,0,6,2,7,9
Chhattisgarh,Kondagaon,Multiple Disability,6,15,83,80,163
Chhattisgarh,Kondagaon,Multiple Disability,15,35,122,122,244
Chhattisgarh,Kondagaon,Multiple Disability,35,60,59,25,84
Chhattisgarh,Kondagaon,Multiple Disability,60,80,14,3,17
Chhattisgarh,Kondagaon,Multiple Disability,80,100,2,1,3
Kerala,Kollam,Multiple Disability,0,6,3,2,5
Kerala,Kollam,Multiple Disability,6,15,32,22,54
Kerala,Kollam,Multiple Disability,15,35,111,81,192
Kerala,Kollam,Multiple Disability,35,60,115,60,175
Kerala,Kollam,Multiple Disability,60,80,40,15,55
Kerala,Kollam,Multiple Disability,80,100,1,0,1
Maharashtra,Kolhapur,Multiple Disability,0,6,27,15,42
Maharashtra,Kolhapur,Multiple Disability,6,15,246,145,391
Maharashtra,Kolhapur,Multiple Disability,15,35,157,81,238
Maharashtra,Kolhapur,Multiple Disability,35,60,83,28,111
Maharashtra,Kolhapur,Multiple Disability,60,80,20,2,22
Maharashtra,Kolhapur,Multiple Disability,80,100,1,0,1
Mizoram,Kolasib,Multiple Disability,6,15,3,2,5
Mizoram,Kolasib,Multiple Disability,15,35,4,5,9
Mizoram,Kolasib,Multiple Disability,35,60,2,0,2
Mizoram,Kolasib,Multiple Disability,60,80,1,4,5
Karnataka,Kolar,Multiple Disability,0,6,3,3,6
Karnataka,Kolar,Multiple Disability,6,15,42,22,64
Karnataka,Kolar,Multiple Disability,15,35,120,91,211
Karnataka,Kolar,Multiple Disability,35,60,138,57,195
Karnataka,Kolar,Multiple Disability,60,80,28,10,38
Karnataka,Kolar,Multiple Disability,80,100,2,0,2
Assam,Kokrajhar,Multiple Disability,0,6,1,1,2
Assam,Kokrajhar,Multiple Disability,6,15,16,8,24
Assam,Kokrajhar,Multiple Disability,15,35,20,13,33
Assam,Kokrajhar,Multiple Disability,35,60,14,8,22
Assam,Kokrajhar,Multiple Disability,60,80,2,1,3
Nagaland,Kohima,Multiple Disability,0,6,3,0,3
Nagaland,Kohima,Multiple Disability,6,15,13,19,32
Nagaland,Kohima,Multiple Disability,15,35,29,20,49
Nagaland,Kohima,Multiple Disability,35,60,11,10,21
Nagaland,Kohima,Multiple Disability,60,80,2,2,4
Jharkhand,Koderma,Multiple Disability,6,15,8,3,11
Jharkhand,Koderma,Multiple Disability,15,35,19,12,31
Jharkhand,Koderma,Multiple Disability,35,60,12,7,19
Jharkhand,Koderma,Multiple Disability,60,80,2,0,2
Karnataka,Kodagu,Multiple Disability,0,6,9,8,17
Karnataka,Kodagu,Multiple Disability,6,15,37,35,72
Karnataka,Kodagu,Multiple Disability,15,35,91,72,163
Karnataka,Kodagu,Multiple Disability,35,60,73,56,129
Karnataka,Kodagu,Multiple Disability,60,80,49,17,66
Karnataka,Kodagu,Multiple Disability,80,100,4,1,5
Jammu And Kashmir,Kishtwar,Multiple Disability,0,6,1,1,2
Jammu And Kashmir,Kishtwar,Multiple Disability,6,15,28,18,46
Jammu And Kashmir,Kishtwar,Multiple Disability,15,35,62,44,106
Jammu And Kashmir,Kishtwar,Multiple Disability,35,60,36,15,51
Jammu And Kashmir,Kishtwar,Multiple Disability,60,80,9,3,12
Jammu And Kashmir,Kishtwar,Multiple Disability,80,100,1,0,1
Bihar,Kishanganj,Multiple Disability,6,15,18,6,24
Bihar,Kishanganj,Multiple Disability,15,35,48,42,90
Bihar,Kishanganj,Multiple Disability,35,60,27,12,39
Bihar,Kishanganj,Multiple Disability,60,80,7,1,8
Nagaland,Kiphire,Multiple Disability,15,35,1,0,1
Himachal Pradesh,Kinnaur,Multiple Disability,6,15,1,0,1
Himachal Pradesh,Kinnaur,Multiple Disability,15,35,1,0,1
Himachal Pradesh,Kinnaur,Multiple Disability,60,80,1,0,1
Himachal Pradesh,Kinnaur,Multiple Disability,80,100,1,0,1
Jharkhand,Khunti,Multiple Disability,6,15,1,2,3
Jharkhand,Khunti,Multiple Disability,15,35,7,7,14
Jharkhand,Khunti,Multiple Disability,35,60,7,6,13
Jharkhand,Khunti,Multiple Disability,60,80,2,1,3
Jharkhand,Khunti,Multiple Disability,80,100,0,1,1
Tripura,Khowai,Multiple Disability,0,6,5,6,11
Tripura,Khowai,Multiple Disability,6,15,27,21,48
Tripura,Khowai,Multiple Disability,15,35,37,25,62
Tripura,Khowai,Multiple Disability,35,60,26,18,44
Tripura,Khowai,Multiple Disability,60,80,3,4,7
Tripura,Khowai,Multiple Disability,80,100,2,1,3
Odisha,Khordha,Multiple Disability,0,6,18,4,22
Odisha,Khordha,Multiple Disability,6,15,74,62,136
Odisha,Khordha,Multiple Disability,15,35,83,41,124
Odisha,Khordha,Multiple Disability,35,60,92,26,118
Odisha,Khordha,Multiple Disability,60,80,31,5,36
Odisha,Khordha,Multiple Disability,80,100,1,2,3
Uttar Pradesh,Kheri,Multiple Disability,0,6,2,4,6
Uttar Pradesh,Kheri,Multiple Disability,6,15,29,10,39
Uttar Pradesh,Kheri,Multiple Disability,15,35,212,72,284
Uttar Pradesh,Kheri,Multiple Disability,35,60,153,41,194
Uttar Pradesh,Kheri,Multiple Disability,60,80,40,8,48
Uttar Pradesh,Kheri,Multiple Disability,80,100,2,0,2
Gujarat,Kheda,Multiple Disability,0,6,63,45,108
Gujarat,Kheda,Multiple Disability,6,15,419,191,610
Gujarat,Kheda,Multiple Disability,15,35,264,140,404
Gujarat,Kheda,Multiple Disability,35,60,54,19,73
Gujarat,Kheda,Multiple Disability,60,80,12,3,15
Mizoram,Khawzawl,Multiple Disability,0,6,1,0,1
Madhya Pradesh,Khargone,Multiple Disability,0,6,2,2,4
Madhya Pradesh,Khargone,Multiple Disability,6,15,50,37,87
Madhya Pradesh,Khargone,Multiple Disability,15,35,82,51,133
Madhya Pradesh,Khargone,Multiple Disability,35,60,37,35,72
Madhya Pradesh,Khargone,Multiple Disability,60,80,12,4,16
Madhya Pradesh,Khargone,Multiple Disability,80,100,0,1,1
Bihar,Khagaria,Multiple Disability,6,15,5,0,5
Bihar,Khagaria,Multiple Disability,15,35,19,5,24
Bihar,Khagaria,Multiple Disability,35,60,13,3,16
Bihar,Khagaria,Multiple Disability,60,80,1,0,1
Odisha,Kendujhar,Multiple Disability,0,6,3,1,4
Odisha,Kendujhar,Multiple Disability,6,15,32,14,46
Odisha,Kendujhar,Multiple Disability,15,35,38,15,53
Odisha,Kendujhar,Multiple Disability,35,60,27,13,40
Odisha,Kendujhar,Multiple Disability,60,80,7,4,11
Odisha,Kendrapara,Multiple Disability,6,15,7,3,10
Odisha,Kendrapara,Multiple Disability,15,35,10,5,15
Odisha,Kendrapara,Multiple Disability,35,60,28,6,34
Odisha,Kendrapara,Multiple Disability,60,80,8,2,10
Uttar Pradesh,Kaushambi,Multiple Disability,6,15,4,1,5
Uttar Pradesh,Kaushambi,Multiple Disability,15,35,82,33,115
Uttar Pradesh,Kaushambi,Multiple Disability,35,60,90,16,106
Uttar Pradesh,Kaushambi,Multiple Disability,60,80,22,3,25
Madhya Pradesh,Katni,Multiple Disability,0,6,17,14,31
Madhya Pradesh,Katni,Multiple Disability,6,15,51,37,88
Madhya Pradesh,Katni,Multiple Disability,15,35,51,37,88
Madhya Pradesh,Katni,Multiple Disability,35,60,39,14,53
Madhya Pradesh,Katni,Multiple Disability,60,80,16,3,19
Madhya Pradesh,Katni,Multiple Disability,80,100,1,2,3
Bihar,Katihar,Multiple Disability,0,6,2,0,2
Bihar,Katihar,Multiple Disability,6,15,25,19,44
Bihar,Katihar,Multiple Disability,15,35,46,21,67
Bihar,Katihar,Multiple Disability,35,60,29,11,40
Bihar,Katihar,Multiple Disability,60,80,7,4,11
Jammu And Kashmir,Kathua,Multiple Disability,0,6,1,0,1
Jammu And Kashmir,Kathua,Multiple Disability,6,15,5,2,7
Jammu And Kashmir,Kathua,Multiple Disability,15,35,12,4,16
Jammu And Kashmir,Kathua,Multiple Disability,35,60,26,4,30
Jammu And Kashmir,Kathua,Multiple Disability,60,80,3,2,5
Uttar Pradesh,Kasganj,Multiple Disability,6,15,1,0,1
Uttar Pradesh,Kasganj,Multiple Disability,15,35,6,2,8
Uttar Pradesh,Kasganj,Multiple Disability,35,60,5,2,7
Uttar Pradesh,Kasganj,Multiple Disability,60,80,1,0,1
Kerala,Kasaragod,Multiple Disability,0,6,20,11,31
Kerala,Kasaragod,Multiple Disability,6,15,33,28,61
Kerala,Kasaragod,Multiple Disability,15,35,45,24,69
Kerala,Kasaragod,Multiple Disability,35,60,32,26,58
Kerala,Kasaragod,Multiple Disability,60,80,11,8,19
Tamil Nadu,Karur,Multiple Disability,0,6,16,11,27
Tamil Nadu,Karur,Multiple Disability,6,15,79,54,133
Tamil Nadu,Karur,Multiple Disability,15,35,78,42,120
Tamil Nadu,Karur,Multiple Disability,35,60,29,12,41
Tamil Nadu,Karur,Multiple Disability,60,80,7,1,8
Haryana,Karnal,Multiple Disability,0,6,1,1,2
Haryana,Karnal,Multiple Disability,6,15,19,7,26
Haryana,Karnal,Multiple Disability,15,35,54,17,71
Haryana,Karnal,Multiple Disability,35,60,36,9,45
Haryana,Karnal,Multiple Disability,60,80,9,5,14
Haryana,Karnal,Multiple Disability,80,100,1,0,1
Assam,Karimganj,Multiple Disability,0,6,5,1,6
Assam,Karimganj,Multiple Disability,6,15,40,20,60
Assam,Karimganj,Multiple Disability,15,35,18,15,33
Assam,Karimganj,Multiple Disability,35,60,10,9,19
Assam,Karimganj,Multiple Disability,60,80,3,0,3
Ladakh,Kargil,Multiple Disability,0,6,5,6,11
Ladakh,Kargil,Multiple Disability,6,15,25,13,38
Ladakh,Kargil,Multiple Disability,15,35,44,25,69
Ladakh,Kargil,Multiple Disability,35,60,23,23,46
Ladakh,Kargil,Multiple Disability,60,80,26,17,43
Ladakh,Kargil,Multiple Disability,80,100,5,0,5
Assam,Karbi Anglong,Multiple Disability,0,6,3,1,4
Assam,Karbi Anglong,Multiple Disability,6,15,15,20,35
Assam,Karbi Anglong,Multiple Disability,15,35,32,21,53
Assam,Karbi Anglong,Multiple Disability,35,60,26,26,52
Assam,Karbi Anglong,Multiple Disability,60,80,11,11,22
Assam,Karbi Anglong,Multiple Disability,80,100,2,0,2
Rajasthan,Karauli,Multiple Disability,6,15,8,2,10
Rajasthan,Karauli,Multiple Disability,15,35,11,4,15
Rajasthan,Karauli,Multiple Disability,35,60,12,2,14
Puducherry,Karaikal,Multiple Disability,15,35,4,0,4
Puducherry,Karaikal,Multiple Disability,35,60,12,5,17
Puducherry,Karaikal,Multiple Disability,60,80,5,1,6
Punjab,Kapurthala,Multiple Disability,0,6,1,1,2
Punjab,Kapurthala,Multiple Disability,6,15,13,5,18
Punjab,Kapurthala,Multiple Disability,15,35,29,12,41
Punjab,Kapurthala,Multiple Disability,35,60,21,11,32
Punjab,Kapurthala,Multiple Disability,60,80,11,1,12
Punjab,Kapurthala,Multiple Disability,80,100,1,0,1
Uttar Pradesh,Kanpur Nagar,Multiple Disability,0,6,3,0,3
Uttar Pradesh,Kanpur Nagar,Multiple Disability,6,15,8,8,16
Uttar Pradesh,Kanpur Nagar,Multiple Disability,15,35,66,29,95
Uttar Pradesh,Kanpur Nagar,Multiple Disability,35,60,66,17,83
Uttar Pradesh,Kanpur Nagar,Multiple Disability,60,80,34,6,40
Uttar Pradesh,Kanpur Nagar,Multiple Disability,80,100,4,0,4
Uttar Pradesh,Kanpur Dehat,Multiple Disability,0,6,0,1,1
Uttar Pradesh,Kanpur Dehat,Multiple Disability,6,15,2,1,3
Uttar Pradesh,Kanpur Dehat,Multiple Disability,15,35,24,4,28
Uttar Pradesh,Kanpur Dehat,Multiple Disability,35,60,18,4,22
Uttar Pradesh,Kanpur Dehat,Multiple Disability,60,80,5,1,6
Kerala,Kannur,Multiple Disability,0,6,14,3,17
Kerala,Kannur,Multiple Disability,6,15,49,43,92
Kerala,Kannur,Multiple Disability,15,35,92,51,143
Kerala,Kannur,Multiple Disability,35,60,59,22,81
Kerala,Kannur,Multiple Disability,60,80,14,1,15
Kerala,Kannur,Multiple Disability,80,100,1,1,2
Tamil Nadu,Kanniyakumari,Multiple Disability,0,6,17,13,30
Tamil Nadu,Kanniyakumari,Multiple Disability,6,15,64,25,89
Tamil Nadu,Kanniyakumari,Multiple Disability,15,35,63,44,107
Tamil Nadu,Kanniyakumari,Multiple Disability,35,60,31,16,47
Tamil Nadu,Kanniyakumari,Multiple Disability,60,80,4,2,6
Tamil Nadu,Kanniyakumari,Multiple Disability,80,100,1,0,1
Uttar Pradesh,Kannauj,Multiple Disability,0,6,1,0,1
Uttar Pradesh,Kannauj,Multiple Disability,6,15,7,7,14
Uttar Pradesh,Kannauj,Multiple Disability,15,35,84,26,110
Uttar Pradesh,Kannauj,Multiple Disability,35,60,103,20,123
Uttar Pradesh,Kannauj,Multiple Disability,60,80,65,7,72
Uttar Pradesh,Kannauj,Multiple Disability,80,100,7,0,7
Chhattisgarh,Kanker,Multiple Disability,0,6,13,8,21
Chhattisgarh,Kanker,Multiple Disability,6,15,83,74,157
Chhattisgarh,Kanker,Multiple Disability,15,35,114,75,189
Chhattisgarh,Kanker,Multiple Disability,35,60,51,48,99
Chhattisgarh,Kanker,Multiple Disability,60,80,16,5,21
Chhattisgarh,Kanker,Multiple Disability,80,100,4,0,4
Himachal Pradesh,Kangra,Multiple Disability,0,6,1,1,2
Himachal Pradesh,Kangra,Multiple Disability,6,15,15,13,28
Himachal Pradesh,Kangra,Multiple Disability,15,35,55,29,84
Himachal Pradesh,Kangra,Multiple Disability,35,60,98,29,127
Himachal Pradesh,Kangra,Multiple Disability,60,80,35,4,39
Himachal Pradesh,Kangra,Multiple Disability,80,100,2,2,4
Manipur,Kangpokpi,Multiple Disability,6,15,3,0,3
Manipur,Kangpokpi,Multiple Disability,15,35,0,2,2
Manipur,Kangpokpi,Multiple Disability,35,60,2,0,2
Odisha,Kandhamal,Multiple Disability,0,6,1,1,2
Odisha,Kandhamal,Multiple Disability,6,15,9,4,13
Odisha,Kandhamal,Multiple Disability,15,35,21,8,29
Odisha,Kandhamal,Multiple Disability,35,60,24,10,34
Odisha,Kandhamal,Multiple Disability,60,80,6,3,9
Odisha,Kandhamal,Multiple Disability,80,100,1,0,1
Tamil Nadu,Kanchipuram,Multiple Disability,0,6,7,2,9
Tamil Nadu,Kanchipuram,Multiple Disability,6,15,146,94,240
Tamil Nadu,Kanchipuram,Multiple Disability,15,35,166,98,264
Tamil Nadu,Kanchipuram,Multiple Disability,35,60,43,24,67
Tamil Nadu,Kanchipuram,Multiple Disability,60,80,8,4,12
Assam,Kamrup Metro,Multiple Disability,0,6,1,1,2
Assam,Kamrup Metro,Multiple Disability,6,15,13,11,24
Assam,Kamrup Metro,Multiple Disability,15,35,12,15,27
Assam,Kamrup Metro,Multiple Disability,35,60,8,3,11
Assam,Kamrup,Multiple Disability,0,6,1,2,3
Assam,Kamrup,Multiple Disability,6,15,5,4,9
Assam,Kamrup,Multiple Disability,15,35,13,8,21
Assam,Kamrup,Multiple Disability,35,60,2,2,4
Assam,Kamrup,Multiple Disability,60,80,1,3,4
Manipur,Kamjong,Multiple Disability,0,6,1,0,1
Manipur,Kamjong,Multiple Disability,6,15,0,1,1
Manipur,Kamjong,Multiple Disability,15,35,4,0,4
Manipur,Kamjong,Multiple Disability,35,60,0,3,3
Tamil Nadu,Kallakurichi,Multiple Disability,0,6,16,15,31
Tamil Nadu,Kallakurichi,Multiple Disability,6,15,77,51,128
Tamil Nadu,Kallakurichi,Multiple Disability,15,35,50,29,79
Tamil Nadu,Kallakurichi,Multiple Disability,35,60,15,7,22
Tamil Nadu,Kallakurichi,Multiple Disability,60,80,2,1,3
Tamil Nadu,Kallakurichi,Multiple Disability,80,100,1,0,1
Odisha,Kalahandi,Multiple Disability,0,6,0,1,1
Odisha,Kalahandi,Multiple Disability,6,15,13,13,26
Odisha,Kalahandi,Multiple Disability,15,35,35,35,70
Odisha,Kalahandi,Multiple Disability,35,60,40,22,62
Odisha,Kalahandi,Multiple Disability,60,80,9,1,10
Odisha,Kalahandi,Multiple Disability,80,100,1,0,1
Karnataka,Kalaburagi,Multiple Disability,0,6,3,3,6
Karnataka,Kalaburagi,Multiple Disability,6,15,30,16,46
Karnataka,Kalaburagi,Multiple Disability,15,35,59,42,101
Karnataka,Kalaburagi,Multiple Disability,35,60,78,22,100
Karnataka,Kalaburagi,Multiple Disability,60,80,23,5,28
Karnataka,Kalaburagi,Multiple Disability,80,100,1,0,1
Manipur,Kakching,Multiple Disability,0,6,2,1,3
Manipur,Kakching,Multiple Disability,6,15,6,6,12
Manipur,Kakching,Multiple Disability,15,35,4,3,7
Manipur,Kakching,Multiple Disability,35,60,2,0,2
Manipur,Kakching,Multiple Disability,60,80,1,0,1
Haryana,Kaithal,Multiple Disability,0,6,3,3,6
Haryana,Kaithal,Multiple Disability,6,15,30,18,48
Haryana,Kaithal,Multiple Disability,15,35,56,30,86
Haryana,Kaithal,Multiple Disability,35,60,48,13,61
Haryana,Kaithal,Multiple Disability,60,80,6,3,9
Bihar,Kaimur (Bhabua),Multiple Disability,0,6,3,2,5
Bihar,Kaimur (Bhabua),Multiple Disability,6,15,48,24,72
Bihar,Kaimur (Bhabua),Multiple Disability,15,35,84,34,118
Bihar,Kaimur (Bhabua),Multiple Disability,35,60,55,26,81
Bihar,Kaimur (Bhabua),Multiple Disability,60,80,16,7,23
Bihar,Kaimur (Bhabua),Multiple Disability,80,100,1,0,1
Gujarat,Kachchh,Multiple Disability,0,6,21,7,28
Gujarat,Kachchh,Multiple Disability,6,15,140,74,214
Gujarat,Kachchh,Multiple Disability,15,35,119,45,164
Gujarat,Kachchh,Multiple Disability,35,60,28,13,41
Gujarat,Kachchh,Multiple Disability,60,80,3,3,6
Gujarat,Kachchh,Multiple Disability,80,100,1,0,1
Chhattisgarh,Kabirdham,Multiple Disability,0,6,0,1,1
Chhattisgarh,Kabirdham,Multiple Disability,6,15,27,25,52
Chhattisgarh,Kabirdham,Multiple Disability,15,35,50,27,77
Chhattisgarh,Kabirdham,Multiple Disability,35,60,13,3,16
Chhattisgarh,Kabirdham,Multiple Disability,60,80,2,0,2
Chhattisgarh,Kabirdham,Multiple Disability,80,100,1,0,1
Gujarat,Junagadh,Multiple Disability,0,6,7,1,8
Gujarat,Junagadh,Multiple Disability,6,15,31,20,51
Gujarat,Junagadh,Multiple Disability,15,35,40,25,65
Gujarat,Junagadh,Multiple Disability,35,60,15,7,22
Gujarat,Junagadh,Multiple Disability,60,80,3,0,3
Gujarat,Junagadh,Multiple Disability,80,100,1,0,1
Assam,Jorhat,Multiple Disability,0,6,0,2,2
Assam,Jorhat,Multiple Disability,6,15,9,11,20
Assam,Jorhat,Multiple Disability,15,35,21,21,42
Assam,Jorhat,Multiple Disability,35,60,16,7,23
Assam,Jorhat,Multiple Disability,60,80,1,0,1
Rajasthan,Jodhpur,Multiple Disability,0,6,2,2,4
Rajasthan,Jodhpur,Multiple Disability,6,15,48,30,78
Rajasthan,Jodhpur,Multiple Disability,15,35,98,43,141
Rajasthan,Jodhpur,Multiple Disability,35,60,62,11,73
Rajasthan,Jodhpur,Multiple Disability,60,80,9,4,13
Manipur,Jiribam,Multiple Disability,6,15,1,0,1
Manipur,Jiribam,Multiple Disability,15,35,0,1,1
Manipur,Jiribam,Multiple Disability,35,60,1,0,1
Haryana,Jind,Multiple Disability,0,6,1,2,3
Haryana,Jind,Multiple Disability,6,15,23,6,29
Haryana,Jind,Multiple Disability,15,35,26,14,40
Haryana,Jind,Multiple Disability,35,60,32,8,40
Haryana,Jind,Multiple Disability,60,80,5,0,5
Rajasthan,Jhunjhunu,Multiple Disability,0,6,2,0,2
Rajasthan,Jhunjhunu,Multiple Disability,6,15,23,11,34
Rajasthan,Jhunjhunu,Multiple Disability,15,35,106,48,154
Rajasthan,Jhunjhunu,Multiple Disability,35,60,78,26,104
Rajasthan,Jhunjhunu,Multiple Disability,60,80,23,14,37
Rajasthan,Jhunjhunu,Multiple Disability,80,100,1,1,2
Odisha,Jharsuguda,Multiple Disability,0,6,1,0,1
Odisha,Jharsuguda,Multiple Disability,6,15,12,6,18
Odisha,Jharsuguda,Multiple Disability,15,35,19,17,36
Odisha,Jharsuguda,Multiple Disability,35,60,22,13,35
Odisha,Jharsuguda,Multiple Disability,60,80,4,5,9
Odisha,Jharsuguda,Multiple Disability,80,100,1,0,1
Uttar Pradesh,Jhansi,Multiple Disability,0,6,0,1,1
Uttar Pradesh,Jhansi,Multiple Disability,6,15,17,12,29
Uttar Pradesh,Jhansi,Multiple Disability,15,35,82,32,114
Uttar Pradesh,Jhansi,Multiple Disability,35,60,68,13,81
Uttar Pradesh,Jhansi,Multiple Disability,60,80,15,1,16
Rajasthan,Jhalawar,Multiple Disability,0,6,0,1,1
Rajasthan,Jhalawar,Multiple Disability,6,15,18,10,28
Rajasthan,Jhalawar,Multiple Disability,15,35,48,25,73
Rajasthan,Jhalawar,Multiple Disability,35,60,26,24,50
Rajasthan,Jhalawar,Multiple Disability,60,80,26,11,37
Rajasthan,Jhalawar,Multiple Disability,80,100,6,14,20
Haryana,Jhajjar,Multiple Disability,0,6,1,0,1
Haryana,Jhajjar,Multiple Disability,6,15,7,2,9
Haryana,Jhajjar,Multiple Disability,15,35,30,10,40
Haryana,Jhajjar,Multiple Disability,35,60,23,3,26
Haryana,Jhajjar,Multiple Disability,60,80,2,0,2
Madhya Pradesh,Jhabua,Multiple Disability,0,6,1,1,2
Madhya Pradesh,Jhabua,Multiple Disability,6,15,67,36,103
Madhya Pradesh,Jhabua,Multiple Disability,15,35,139,84,223
Madhya Pradesh,Jhabua,Multiple Disability,35,60,83,37,120
Madhya Pradesh,Jhabua,Multiple Disability,60,80,17,11,28
Madhya Pradesh,Jhabua,Multiple Disability,80,100,3,0,3
Bihar,Jehanabad,Multiple Disability,15,35,5,2,7
Bihar,Jehanabad,Multiple Disability,35,60,7,8,15
Bihar,Jehanabad,Multiple Disability,60,80,4,1,5
Uttar Pradesh,Jaunpur,Multiple Disability,0,6,4,2,6
Uttar Pradesh,Jaunpur,Multiple Disability,6,15,88,46,134
Uttar Pradesh,Jaunpur,Multiple Disability,15,35,103,35,138
Uttar Pradesh,Jaunpur,Multiple Disability,35,60,70,16,86
Uttar Pradesh,Jaunpur,Multiple Disability,60,80,16,3,19
Uttar Pradesh,Jaunpur,Multiple Disability,80,100,1,0,1
Chhattisgarh,Jashpur,Multiple Disability,0,6,0,2,2
Chhattisgarh,Jashpur,Multiple Disability,6,15,5,5,10
Chhattisgarh,Jashpur,Multiple Disability,15,35,15,9,24
Chhattisgarh,Jashpur,Multiple Disability,35,60,8,5,13
Chhattisgarh,Jashpur,Multiple Disability,60,80,3,1,4
Chhattisgarh,Janjgir-Champa,Multiple Disability,0,6,23,11,34
Chhattisgarh,Janjgir-Champa,Multiple Disability,6,15,218,139,357
Chhattisgarh,Janjgir-Champa,Multiple Disability,15,35,427,357,784
Chhattisgarh,Janjgir-Champa,Multiple Disability,35,60,154,97,251
Chhattisgarh,Janjgir-Champa,Multiple Disability,60,80,19,10,29
Chhattisgarh,Janjgir-Champa,Multiple Disability,80,100,3,2,5
Bihar,Jamui,Multiple Disability,0,6,0,1,1
Bihar,Jamui,Multiple Disability,6,15,25,20,45
Bihar,Jamui,Multiple Disability,15,35,35,19,54
Bihar,Jamui,Multiple Disability,35,60,31,9,40
Bihar,Jamui,Multiple Disability,60,80,6,4,10
Jharkhand,Jamtara,Multiple Disability,0,6,1,0,1
Jharkhand,Jamtara,Multiple Disability,6,15,12,12,24
Jharkhand,Jamtara,Multiple Disability,15,35,46,34,80
Jharkhand,Jamtara,Multiple Disability,35,60,32,13,45
Jharkhand,Jamtara,Multiple Disability,60,80,6,0,6
Gujarat,Jamnagar,Multiple Disability,0,6,28,15,43
Gujarat,Jamnagar,Multiple Disability,6,15,93,51,144
Gujarat,Jamnagar,Multiple Disability,15,35,89,42,131
Gujarat,Jamnagar,Multiple Disability,35,60,40,16,56
Gujarat,Jamnagar,Multiple Disability,60,80,20,3,23
Gujarat,Jamnagar,Multiple Disability,80,100,2,0,2
Jammu And Kashmir,Jammu,Multiple Disability,0,6,1,0,1
Jammu And Kashmir,Jammu,Multiple Disability,6,15,20,8,28
Jammu And Kashmir,Jammu,Multiple Disability,15,35,117,56,173
Jammu And Kashmir,Jammu,Multiple Disability,35,60,105,48,153
Jammu And Kashmir,Jammu,Multiple Disability,60,80,22,8,30
Jammu And Kashmir,Jammu,Multiple Disability,80,100,2,2,4
Rajasthan,Jalore,Multiple Disability,6,15,19,4,23
Rajasthan,Jalore,Multiple Disability,15,35,57,25,82
Rajasthan,Jalore,Multiple Disability,35,60,45,18,63
Rajasthan,Jalore,Multiple Disability,60,80,9,10,19
Rajasthan,Jalore,Multiple Disability,80,100,1,0,1
Maharashtra,Jalna,Multiple Disability,0,6,1,1,2
Maharashtra,Jalna,Multiple Disability,6,15,7,1,8
Maharashtra,Jalna,Multiple Disability,15,35,35,8,43
Maharashtra,Jalna,Multiple Disability,35,60,38,9,47
Maharashtra,Jalna,Multiple Disability,60,80,10,6,16
Maharashtra,Jalna,Multiple Disability,80,100,1,0,1
Maharashtra,Jalgaon,Multiple Disability,6,15,7,3,10
Maharashtra,Jalgaon,Multiple Disability,15,35,19,8,27
Maharashtra,Jalgaon,Multiple Disability,35,60,33,20,53
Maharashtra,Jalgaon,Multiple Disability,60,80,11,0,11
Maharashtra,Jalgaon,Multiple Disability,80,100,1,0,1
Uttar Pradesh,Jalaun,Multiple Disability,0,6,0,2,2
Uttar Pradesh,Jalaun,Multiple Disability,6,15,12,6,18
Uttar Pradesh,Jalaun,Multiple Disability,15,35,108,61,169
Uttar Pradesh,Jalaun,Multiple Disability,35,60,127,46,173
Uttar Pradesh,Jalaun,Multiple Disability,60,80,40,8,48
Uttar Pradesh,Jalaun,Multiple Disability,80,100,2,0,2
Punjab,Jalandhar,Multiple Disability,0,6,12,3,15
Punjab,Jalandhar,Multiple Disability,6,15,39,28,67
Punjab,Jalandhar,Multiple Disability,15,35,80,41,121
Punjab,Jalandhar,Multiple Disability,35,60,84,41,125
Punjab,Jalandhar,Multiple Disability,60,80,25,6,31
Punjab,Jalandhar,Multiple Disability,80,100,2,0,2
Odisha,Jajapur,Multiple Disability,0,6,0,1,1
Odisha,Jajapur,Multiple Disability,6,15,8,6,14
Odisha,Jajapur,Multiple Disability,15,35,26,11,37
Odisha,Jajapur,Multiple Disability,35,60,38,11,49
Odisha,Jajapur,Multiple Disability,60,80,11,2,13
Odisha,Jajapur,Multiple Disability,80,100,3,0,3
Rajasthan,Jaisalmer,Multiple Disability,6,15,2,2,4
Rajasthan,Jaisalmer,Multiple Disability,15,35,15,7,22
Rajasthan,Jaisalmer,Multiple Disability,35,60,8,1,9
Rajasthan,Jaisalmer,Multiple Disability,60,80,3,2,5
Rajasthan,Jaisalmer,Multiple Disability,80,100,2,0,2
Rajasthan,Jaipur,Multiple Disability,0,6,12,7,19
Rajasthan,Jaipur,Multiple Disability,6,15,104,69,173
Rajasthan,Jaipur,Multiple Disability,15,35,197,115,312
Rajasthan,Jaipur,Multiple Disability,35,60,104,52,156
Rajasthan,Jaipur,Multiple Disability,60,80,20,19,39
Rajasthan,Jaipur,Multiple Disability,80,100,1,1,2
Odisha,Jagatsinghapur,Multiple Disability,0,6,1,0,1
Odisha,Jagatsinghapur,Multiple Disability,6,15,2,2,4
Odisha,Jagatsinghapur,Multiple Disability,15,35,12,7,19
Odisha,Jagatsinghapur,Multiple Disability,35,60,17,9,26
Odisha,Jagatsinghapur,Multiple Disability,60,80,9,2,11
Madhya Pradesh,Jabalpur,Multiple Disability,0,6,52,34,86
Madhya Pradesh,Jabalpur,Multiple Disability,6,15,207,117,324
Madhya Pradesh,Jabalpur,Multiple Disability,15,35,213,134,347
Madhya Pradesh,Jabalpur,Multiple Disability,35,60,152,54,206
Madhya Pradesh,Jabalpur,Multiple Disability,60,80,36,10,46
Madhya Pradesh,Jabalpur,Multiple Disability,80,100,5,3,8
Madhya Pradesh,Indore,Multiple Disability,0,6,9,3,12
Madhya Pradesh,Indore,Multiple Disability,6,15,77,42,119
Madhya Pradesh,Indore,Multiple Disability,15,35,159,94,253
Madhya Pradesh,Indore,Multiple Disability,35,60,92,31,123
Madhya Pradesh,Indore,Multiple Disability,60,80,28,9,37
Madhya Pradesh,Indore,Multiple Disability,80,100,2,0,2
Manipur,Imphal West,Multiple Disability,0,6,3,2,5
Manipur,Imphal West,Multiple Disability,6,15,11,8,19
Manipur,Imphal West,Multiple Disability,15,35,20,14,34
Manipur,Imphal West,Multiple Disability,35,60,23,13,36
Manipur,Imphal West,Multiple Disability,60,80,1,3,4
Manipur,Imphal West,Multiple Disability,80,100,1,0,1
Manipur,Imphal East,Multiple Disability,0,6,5,2,7
Manipur,Imphal East,Multiple Disability,6,15,23,15,38
Manipur,Imphal East,Multiple Disability,15,35,34,19,53
Manipur,Imphal East,Multiple Disability,35,60,25,27,52
Manipur,Imphal East,Multiple Disability,60,80,3,6,9
Kerala,Idukki,Multiple Disability,0,6,0,1,1
Kerala,Idukki,Multiple Disability,6,15,15,8,23
Kerala,Idukki,Multiple Disability,15,35,30,22,52
Kerala,Idukki,Multiple Disability,35,60,24,19,43
Kerala,Idukki,Multiple Disability,60,80,10,6,16
West Bengal,Howrah,Multiple Disability,6,15,1,0,1
West Bengal,Howrah,Multiple Disability,15,35,0,1,1
West Bengal,Howrah,Multiple Disability,35,60,0,1,1
Punjab,Hoshiarpur,Multiple Disability,0,6,11,6,17
Punjab,Hoshiarpur,Multiple Disability,6,15,74,50,124
Punjab,Hoshiarpur,Multiple Disability,15,35,162,92,254
Punjab,Hoshiarpur,Multiple Disability,35,60,163,49,212
Punjab,Hoshiarpur,Multiple Disability,60,80,26,8,34
Punjab,Hoshiarpur,Multiple Disability,80,100,2,0,2
Assam,Hojai,Multiple Disability,0,6,6,0,6
Assam,Hojai,Multiple Disability,6,15,10,12,22
Assam,Hojai,Multiple Disability,15,35,28,17,45
Assam,Hojai,Multiple Disability,35,60,19,4,23
Assam,Hojai,Multiple Disability,60,80,1,3,4
Assam,Hojai,Multiple Disability,80,100,1,0,1
Mizoram,Hnahthial,Multiple Disability,35,60,1,0,1
Haryana,Hisar,Multiple Disability,0,6,1,0,1
Haryana,Hisar,Multiple Disability,6,15,47,25,72
Haryana,Hisar,Multiple Disability,15,35,153,67,220
Haryana,Hisar,Multiple Disability,35,60,86,25,111
Haryana,Hisar,Multiple Disability,60,80,17,6,23
Maharashtra,Hingoli,Multiple Disability,6,15,5,0,5
Maharashtra,Hingoli,Multiple Disability,15,35,18,2,20
Maharashtra,Hingoli,Multiple Disability,35,60,12,2,14
Maharashtra,Hingoli,Multiple Disability,60,80,5,0,5
Jharkhand,Hazaribagh,Multiple Disability,0,6,6,2,8
Jharkhand,Hazaribagh,Multiple Disability,6,15,42,25,67
Jharkhand,Hazaribagh,Multiple Disability,15,35,132,69,201
Jharkhand,Hazaribagh,Multiple Disability,35,60,71,40,111
Jharkhand,Hazaribagh,Multiple Disability,60,80,20,5,25
Jharkhand,Hazaribagh,Multiple Disability,80,100,1,1,2
Karnataka,Haveri,Multiple Disability,0,6,30,24,54
Karnataka,Haveri,Multiple Disability,6,15,209,138,347
Karnataka,Haveri,Multiple Disability,15,35,176,116,292
Karnataka,Haveri,Multiple Disability,35,60,150,57,207
Karnataka,Haveri,Multiple Disability,60,80,42,12,54
Uttar Pradesh,Hathras,Multiple Disability,0,6,3,5,8
Uttar Pradesh,Hathras,Multiple Disability,6,15,28,18,46
Uttar Pradesh,Hathras,Multiple Disability,15,35,89,38,127
Uttar Pradesh,Hathras,Multiple Disability,35,60,72,15,87
Uttar Pradesh,Hathras,Multiple Disability,60,80,15,5,20
Uttar Pradesh,Hathras,Multiple Disability,80,100,1,0,1
Karnataka,Hassan,Multiple Disability,0,6,5,3,8
Karnataka,Hassan,Multiple Disability,6,15,20,23,43
Karnataka,Hassan,Multiple Disability,15,35,95,83,178
Karnataka,Hassan,Multiple Disability,35,60,128,82,210
Karnataka,Hassan,Multiple Disability,60,80,48,24,72
Karnataka,Hassan,Multiple Disability,80,100,5,0,5
Uttarakhand,Haridwar,Multiple Disability,0,6,10,0,10
Uttarakhand,Haridwar,Multiple Disability,6,15,64,35,99
Uttarakhand,Haridwar,Multiple Disability,15,35,143,61,204
Uttarakhand,Haridwar,Multiple Disability,35,60,89,46,135
Uttarakhand,Haridwar,Multiple Disability,60,80,17,5,22
Uttarakhand,Haridwar,Multiple Disability,80,100,0,2,2
Uttar Pradesh,Hardoi,Multiple Disability,6,15,3,1,4
Uttar Pradesh,Hardoi,Multiple Disability,15,35,57,24,81
Uttar Pradesh,Hardoi,Multiple Disability,35,60,59,23,82
Uttar Pradesh,Hardoi,Multiple Disability,60,80,17,3,20
Uttar Pradesh,Hardoi,Multiple Disability,80,100,3,0,3
Madhya Pradesh,Harda,Multiple Disability,0,6,1,1,2
Madhya Pradesh,Harda,Multiple Disability,6,15,9,2,11
Madhya Pradesh,Harda,Multiple Disability,15,35,15,6,21
Madhya Pradesh,Harda,Multiple Disability,35,60,10,7,17
Madhya Pradesh,Harda,Multiple Disability,60,80,6,3,9
Madhya Pradesh,Harda,Multiple Disability,80,100,1,0,1
Uttar Pradesh,Hapur,Multiple Disability,6,15,3,0,3
Uttar Pradesh,Hapur,Multiple Disability,15,35,17,6,23
Uttar Pradesh,Hapur,Multiple Disability,35,60,15,6,21
Uttar Pradesh,Hapur,Multiple Disability,60,80,4,1,5
Rajasthan,Hanumangarh,Multiple Disability,0,6,5,3,8
Rajasthan,Hanumangarh,Multiple Disability,6,15,19,7,26
Rajasthan,Hanumangarh,Multiple Disability,15,35,53,29,82
Rajasthan,Hanumangarh,Multiple Disability,35,60,28,18,46
Rajasthan,Hanumangarh,Multiple Disability,60,80,11,1,12
Rajasthan,Hanumangarh,Multiple Disability,80,100,1,1,2
Himachal Pradesh,Hamirpur,Multiple Disability,0,6,1,2,3
Himachal Pradesh,Hamirpur,Multiple Disability,6,15,9,6,15
Himachal Pradesh,Hamirpur,Multiple Disability,15,35,43,15,58
Himachal Pradesh,Hamirpur,Multiple Disability,35,60,45,24,69
Himachal Pradesh,Hamirpur,Multiple Disability,60,80,21,5,26
Himachal Pradesh,Hamirpur,Multiple Disability,80,100,1,2,3
Uttar Pradesh,Hamirpur,Multiple Disability,0,6,4,1,5
Uttar Pradesh,Hamirpur,Multiple Disability,6,15,70,44,114
Uttar Pradesh,Hamirpur,Multiple Disability,15,35,136,57,193
Uttar Pradesh,Hamirpur,Multiple Disability,35,60,122,38,160
Uttar Pradesh,Hamirpur,Multiple Disability,60,80,31,5,36
Uttar Pradesh,Hamirpur,Multiple Disability,80,100,2,0,2
Assam,Hailakandi,Multiple Disability,0,6,24,13,37
Assam,Hailakandi,Multiple Disability,6,15,54,35,89
Assam,Hailakandi,Multiple Disability,15,35,34,28,62
Assam,Hailakandi,Multiple Disability,35,60,14,6,20
Assam,Hailakandi,Multiple Disability,60,80,0,1,1
Sikkim,Gyalshing,Multiple Disability,6,15,4,4,8
Sikkim,Gyalshing,Multiple Disability,15,35,7,12,19
Sikkim,Gyalshing,Multiple Disability,35,60,10,20,30
Sikkim,Gyalshing,Multiple Disability,60,80,0,3,3
Madhya Pradesh,Gwalior,Multiple Disability,0,6,4,2,6
Madhya Pradesh,Gwalior,Multiple Disability,6,15,23,11,34
Madhya Pradesh,Gwalior,Multiple Disability,15,35,68,26,94
Madhya Pradesh,Gwalior,Multiple Disability,35,60,30,6,36
Madhya Pradesh,Gwalior,Multiple Disability,60,80,2,0,2
Haryana,Gurugram,Multiple Disability,0,6,1,0,1
Haryana,Gurugram,Multiple Disability,6,15,15,7,22
Haryana,Gurugram,Multiple Disability,15,35,48,17,65
Haryana,Gurugram,Multiple Disability,35,60,24,4,28
Haryana,Gurugram,Multiple Disability,60,80,2,1,3
Punjab,Gurdaspur,Multiple Disability,0,6,2,1,3
Punjab,Gurdaspur,Multiple Disability,6,15,5,3,8
Punjab,Gurdaspur,Multiple Disability,15,35,43,18,61
Punjab,Gurdaspur,Multiple Disability,35,60,59,17,76
Punjab,Gurdaspur,Multiple Disability,60,80,9,2,11
Andhra Pradesh,Guntur,Multiple Disability,0,6,4,3,7
Andhra Pradesh,Guntur,Multiple Disability,6,15,9,6,15
Andhra Pradesh,Guntur,Multiple Disability,15,35,25,10,35
Andhra Pradesh,Guntur,Multiple Disability,35,60,16,4,20
Andhra Pradesh,Guntur,Multiple Disability,60,80,2,1,3
Madhya Pradesh,Guna,Multiple Disability,0,6,33,29,62
Madhya Pradesh,Guna,Multiple Disability,6,15,106,42,148
Madhya Pradesh,Guna,Multiple Disability,15,35,129,52,181
Madhya Pradesh,Guna,Multiple Disability,35,60,32,17,49
Madhya Pradesh,Guna,Multiple Disability,60,80,12,3,15
Madhya Pradesh,Guna,Multiple Disability,80,100,2,0,2
Jharkhand,Gumla,Multiple Disability,0,6,6,2,8
Jharkhand,Gumla,Multiple Disability,6,15,49,46,95
Jharkhand,Gumla,Multiple Disability,15,35,141,93,234
Jharkhand,Gumla,Multiple Disability,35,60,95,57,152
Jharkhand,Gumla,Multiple Disability,60,80,24,15,39
Jharkhand,Gumla,Multiple Disability,80,100,3,1,4
Uttar Pradesh,Gorakhpur,Multiple Disability,0,6,3,2,5
Uttar Pradesh,Gorakhpur,Multiple Disability,6,15,38,19,57
Uttar Pradesh,Gorakhpur,Multiple Disability,15,35,163,68,231
Uttar Pradesh,Gorakhpur,Multiple Disability,35,60,150,27,177
Uttar Pradesh,Gorakhpur,Multiple Disability,60,80,38,5,43
Uttar Pradesh,Gorakhpur,Multiple Disability,80,100,2,0,2
Bihar,Gopalganj,Multiple Disability,0,6,0,3,3
Bihar,Gopalganj,Multiple Disability,6,15,13,6,19
Bihar,Gopalganj,Multiple Disability,15,35,36,6,42
Bihar,Gopalganj,Multiple Disability,35,60,26,2,28
Bihar,Gopalganj,Multiple Disability,60,80,6,1,7
Bihar,Gopalganj,Multiple Disability,80,100,1,0,1
Maharashtra,Gondia,Multiple Disability,0,6,5,4,9
Maharashtra,Gondia,Multiple Disability,6,15,10,2,12
Maharashtra,Gondia,Multiple Disability,15,35,13,10,23
Maharashtra,Gondia,Multiple Disability,35,60,18,3,21
Maharashtra,Gondia,Multiple Disability,60,80,2,0,2
Uttar Pradesh,Gonda,Multiple Disability,0,6,1,1,2
Uttar Pradesh,Gonda,Multiple Disability,6,15,83,40,123
Uttar Pradesh,Gonda,Multiple Disability,15,35,160,79,239
Uttar Pradesh,Gonda,Multiple Disability,35,60,105,31,136
Uttar Pradesh,Gonda,Multiple Disability,60,80,36,3,39
Tripura,Gomati,Multiple Disability,0,6,6,1,7
Tripura,Gomati,Multiple Disability,6,15,15,24,39
Tripura,Gomati,Multiple Disability,15,35,57,30,87
Tripura,Gomati,Multiple Disability,35,60,35,16,51
Tripura,Gomati,Multiple Disability,60,80,9,2,11
Tripura,Gomati,Multiple Disability,80,100,1,0,1
Assam,Golaghat,Multiple Disability,6,15,8,3,11
Assam,Golaghat,Multiple Disability,15,35,25,18,43
Assam,Golaghat,Multiple Disability,35,60,16,11,27
Assam,Golaghat,Multiple Disability,60,80,4,1,5
Jharkhand,Godda,Multiple Disability,0,6,0,1,1
Jharkhand,Godda,Multiple Disability,6,15,25,8,33
Jharkhand,Godda,Multiple Disability,15,35,102,59,161
Jharkhand,Godda,Multiple Disability,35,60,65,31,96
Jharkhand,Godda,Multiple Disability,60,80,22,12,34
Jharkhand,Godda,Multiple Disability,80,100,2,6,8
Assam,Goalpara,Multiple Disability,0,6,31,17,48
Assam,Goalpara,Multiple Disability,6,15,172,91,263
Assam,Goalpara,Multiple Disability,15,35,186,135,321
Assam,Goalpara,Multiple Disability,35,60,173,122,295
Assam,Goalpara,Multiple Disability,60,80,64,39,103
Assam,Goalpara,Multiple Disability,80,100,1,2,3
Jharkhand,Giridih,Multiple Disability,0,6,4,0,4
Jharkhand,Giridih,Multiple Disability,6,15,27,19,46
Jharkhand,Giridih,Multiple Disability,15,35,48,22,70
Jharkhand,Giridih,Multiple Disability,35,60,27,10,37
Jharkhand,Giridih,Multiple Disability,60,80,1,4,5
Gujarat,Gir Somnath,Multiple Disability,0,6,37,20,57
Gujarat,Gir Somnath,Multiple Disability,6,15,139,95,234
Gujarat,Gir Somnath,Multiple Disability,15,35,92,57,149
Gujarat,Gir Somnath,Multiple Disability,35,60,19,7,26
Gujarat,Gir Somnath,Multiple Disability,60,80,3,1,4
Uttar Pradesh,Ghazipur,Multiple Disability,0,6,1,0,1
Uttar Pradesh,Ghazipur,Multiple Disability,6,15,10,5,15
Uttar Pradesh,Ghazipur,Multiple Disability,15,35,51,16,67
Uttar Pradesh,Ghazipur,Multiple Disability,35,60,52,13,65
Uttar Pradesh,Ghazipur,Multiple Disability,60,80,23,5,28
Uttar Pradesh,Ghazipur,Multiple Disability,80,100,1,0,1
Uttar Pradesh,Ghaziabad,Multiple Disability,0,6,1,0,1
Uttar Pradesh,Ghaziabad,Multiple Disability,6,15,5,2,7
Uttar Pradesh,Ghaziabad,Multiple Disability,15,35,24,3,27
Uttar Pradesh,Ghaziabad,Multiple Disability,35,60,18,6,24
Uttar Pradesh,Ghaziabad,Multiple Disability,60,80,0,1,1
Bihar,Gaya,Multiple Disability,6,15,1,0,1
Bihar,Gaya,Multiple Disability,15,35,5,1,6
Bihar,Gaya,Multiple Disability,35,60,0,1,1
Uttar Pradesh,Gautam Buddha Nagar,Multiple Disability,0,6,3,4,7
Uttar Pradesh,Gautam Buddha Nagar,Multiple Disability,6,15,30,12,42
Uttar Pradesh,Gautam Buddha Nagar,Multiple Disability,15,35,33,15,48
Uttar Pradesh,Gautam Buddha Nagar,Multiple Disability,35,60,14,4,18
Uttar Pradesh,Gautam Buddha Nagar,Multiple Disability,60,80,4,2,6
Uttar Pradesh,Gautam Buddha Nagar,Multiple Disability,80,100,1,0,1
Chhattisgarh,Gaurella Pendra Marwahi,Multiple Disability,15,35,0,1,1
Chhattisgarh,Gaurella Pendra Marwahi,Multiple Disability,35,60,1,1,2
Chhattisgarh,Gariyaband,Multiple Disability,0,6,10,8,18
Chhattisgarh,Gariyaband,Multiple Disability,6,15,53,48,101
Chhattisgarh,Gariyaband,Multiple Disability,15,35,108,80,188
Chhattisgarh,Gariyaband,Multiple Disability,35,60,47,22,69
Chhattisgarh,Gariyaband,Multiple Disability,60,80,7,3,10
Jharkhand,Garhwa,Multiple Disability,6,15,11,3,14
Jharkhand,Garhwa,Multiple Disability,15,35,51,28,79
Jharkhand,Garhwa,Multiple Disability,35,60,26,15,41
Jharkhand,Garhwa,Multiple Disability,60,80,5,2,7
Jharkhand,Garhwa,Multiple Disability,80,100,2,1,3
Odisha,Ganjam,Multiple Disability,0,6,6,3,9
Odisha,Ganjam,Multiple Disability,6,15,54,30,84
Odisha,Ganjam,Multiple Disability,15,35,184,95,279
Odisha,Ganjam,Multiple Disability,35,60,340,130,470
Odisha,Ganjam,Multiple Disability,60,80,90,41,131
Odisha,Ganjam,Multiple Disability,80,100,3,2,5
Sikkim,Gangtok,Multiple Disability,0,6,1,0,1
Sikkim,Gangtok,Multiple Disability,6,15,17,2,19
Sikkim,Gangtok,Multiple Disability,15,35,20,11,31
Sikkim,Gangtok,Multiple Disability,35,60,18,13,31
Sikkim,Gangtok,Multiple Disability,60,80,2,2,4
Rajasthan,Ganganagar,Multiple Disability,0,6,2,0,2
Rajasthan,Ganganagar,Multiple Disability,6,15,16,9,25
Rajasthan,Ganganagar,Multiple Disability,15,35,75,28,103
Rajasthan,Ganganagar,Multiple Disability,35,60,46,20,66
Rajasthan,Ganganagar,Multiple Disability,60,80,14,8,22
Rajasthan,Ganganagar,Multiple Disability,80,100,4,0,4
Gujarat,Gandhinagar,Multiple Disability,0,6,21,9,30
Gujarat,Gandhinagar,Multiple Disability,6,15,75,42,117
Gujarat,Gandhinagar,Multiple Disability,15,35,58,23,81
Gujarat,Gandhinagar,Multiple Disability,35,60,28,11,39
Gujarat,Gandhinagar,Multiple Disability,60,80,9,1,10
Jammu And Kashmir,Ganderbal,Multiple Disability,0,6,11,7,18
Jammu And Kashmir,Ganderbal,Multiple Disability,6,15,29,19,48
Jammu And Kashmir,Ganderbal,Multiple Disability,15,35,79,47,126
Jammu And Kashmir,Ganderbal,Multiple Disability,35,60,59,46,105
Jammu And Kashmir,Ganderbal,Multiple Disability,60,80,15,11,26
Jammu And Kashmir,Ganderbal,Multiple Disability,80,100,2,1,3
Odisha,Gajapati,Multiple Disability,6,15,1,0,1
Odisha,Gajapati,Multiple Disability,15,35,8,2,10
Odisha,Gajapati,Multiple Disability,35,60,11,9,20
Odisha,Gajapati,Multiple Disability,60,80,13,7,20
Maharashtra,Gadchiroli,Multiple Disability,6,15,3,0,3
Maharashtra,Gadchiroli,Multiple Disability,15,35,10,6,16
Maharashtra,Gadchiroli,Multiple Disability,35,60,7,5,12
Maharashtra,Gadchiroli,Multiple Disability,60,80,2,0,2
Maharashtra,Gadchiroli,Multiple Disability,80,100,2,0,2
Karnataka,Gadag,Multiple Disability,0,6,4,1,5
Karnataka,Gadag,Multiple Disability,6,15,29,16,45
Karnataka,Gadag,Multiple Disability,15,35,55,40,95
Karnataka,Gadag,Multiple Disability,35,60,30,15,45
Karnataka,Gadag,Multiple Disability,60,80,8,0,8
Uttar Pradesh,Firozabad,Multiple Disability,0,6,4,3,7
Uttar Pradesh,Firozabad,Multiple Disability,6,15,45,36,81
Uttar Pradesh,Firozabad,Multiple Disability,15,35,143,70,213
Uttar Pradesh,Firozabad,Multiple Disability,35,60,82,27,109
Uttar Pradesh,Firozabad,Multiple Disability,60,80,12,2,14
Uttar Pradesh,Firozabad,Multiple Disability,80,100,2,1,3
Punjab,Ferozepur,Multiple Disability,0,6,0,1,1
Punjab,Ferozepur,Multiple Disability,6,15,4,6,10
Punjab,Ferozepur,Multiple Disability,15,35,24,10,34
Punjab,Ferozepur,Multiple Disability,35,60,8,3,11
Punjab,Ferozepur,Multiple Disability,60,80,1,0,1
Punjab,Fazilka,Multiple Disability,0,6,1,1,2
Punjab,Fazilka,Multiple Disability,6,15,18,12,30
Punjab,Fazilka,Multiple Disability,15,35,32,10,42
Punjab,Fazilka,Multiple Disability,35,60,28,8,36
Punjab,Fazilka,Multiple Disability,60,80,3,0,3
Punjab,Fazilka,Multiple Disability,80,100,1,0,1
Uttar Pradesh,Fatehpur,Multiple Disability,0,6,2,3,5
Uttar Pradesh,Fatehpur,Multiple Disability,6,15,36,28,64
Uttar Pradesh,Fatehpur,Multiple Disability,15,35,127,41,168
Uttar Pradesh,Fatehpur,Multiple Disability,35,60,133,41,174
Uttar Pradesh,Fatehpur,Multiple Disability,60,80,48,4,52
Uttar Pradesh,Fatehpur,Multiple Disability,80,100,2,0,2
Punjab,Fatehgarh Sahib,Multiple Disability,0,6,4,0,4
Punjab,Fatehgarh Sahib,Multiple Disability,6,15,15,11,26
Punjab,Fatehgarh Sahib,Multiple Disability,15,35,52,28,80
Punjab,Fatehgarh Sahib,Multiple Disability,35,60,51,20,71
Punjab,Fatehgarh Sahib,Multiple Disability,60,80,12,6,18
Punjab,Fatehgarh Sahib,Multiple Disability,80,100,1,0,1
Haryana,Fatehabad,Multiple Disability,0,6,3,1,4
Haryana,Fatehabad,Multiple Disability,6,15,35,25,60
Haryana,Fatehabad,Multiple Disability,15,35,50,20,70
Haryana,Fatehabad,Multiple Disability,35,60,24,7,31
Haryana,Fatehabad,Multiple Disability,60,80,3,1,4
Haryana,Fatehabad,Multiple Disability,80,100,3,0,3
Uttar Pradesh,Farrukhabad,Multiple Disability,6,15,12,5,17
Uttar Pradesh,Farrukhabad,Multiple Disability,15,35,100,27,127
Uttar Pradesh,Farrukhabad,Multiple Disability,35,60,115,32,147
Uttar Pradesh,Farrukhabad,Multiple Disability,60,80,33,7,40
Uttar Pradesh,Farrukhabad,Multiple Disability,80,100,1,2,3
Punjab,Faridkot,Multiple Disability,6,15,7,3,10
Punjab,Faridkot,Multiple Disability,15,35,17,5,22
Punjab,Faridkot,Multiple Disability,35,60,20,4,24
Punjab,Faridkot,Multiple Disability,60,80,8,2,10
Punjab,Faridkot,Multiple Disability,80,100,1,0,1
Haryana,Faridabad,Multiple Disability,0,6,4,2,6
Haryana,Faridabad,Multiple Disability,6,15,28,23,51
Haryana,Faridabad,Multiple Disability,15,35,63,30,93
Haryana,Faridabad,Multiple Disability,35,60,19,7,26
Haryana,Faridabad,Multiple Disability,60,80,4,0,4
Uttar Pradesh,Etawah,Multiple Disability,6,15,12,8,20
Uttar Pradesh,Etawah,Multiple Disability,15,35,162,50,212
Uttar Pradesh,Etawah,Multiple Disability,35,60,200,55,255
Uttar Pradesh,Etawah,Multiple Disability,60,80,46,11,57
Uttar Pradesh,Etawah,Multiple Disability,80,100,1,0,1
Uttar Pradesh,Etah,Multiple Disability,6,15,1,1,2
Uttar Pradesh,Etah,Multiple Disability,15,35,8,0,8
Uttar Pradesh,Etah,Multiple Disability,35,60,4,1,5
Uttar Pradesh,Etah,Multiple Disability,60,80,1,0,1
Tamil Nadu,Erode,Multiple Disability,0,6,19,8,27
Tamil Nadu,Erode,Multiple Disability,6,15,193,99,292
Tamil Nadu,Erode,Multiple Disability,15,35,198,121,319
Tamil Nadu,Erode,Multiple Disability,35,60,46,23,69
Tamil Nadu,Erode,Multiple Disability,60,80,5,5,10
Tamil Nadu,Erode,Multiple Disability,80,100,2,0,2
Kerala,Ernakulam,Multiple Disability,0,6,19,4,23
Kerala,Ernakulam,Multiple Disability,6,15,75,39,114
Kerala,Ernakulam,Multiple Disability,15,35,82,72,154
Kerala,Ernakulam,Multiple Disability,35,60,53,25,78
Kerala,Ernakulam,Multiple Disability,60,80,16,3,19
Meghalaya,Eastern West Khasi Hills,Multiple Disability,6,15,1,0,1
Meghalaya,Eastern West Khasi Hills,Multiple Disability,15,35,3,0,3
Jharkhand,East Singhbum,Multiple Disability,6,15,12,3,15
Jharkhand,East Singhbum,Multiple Disability,15,35,66,83,149
Jharkhand,East Singhbum,Multiple Disability,35,60,70,47,117
Jharkhand,East Singhbum,Multiple Disability,60,80,20,7,27
Jharkhand,East Singhbum,Multiple Disability,80,100,1,2,3
Arunachal Pradesh,East Siang,Multiple Disability,0,6,1,0,1
Arunachal Pradesh,East Siang,Multiple Disability,6,15,1,0,1
Arunachal Pradesh,East Siang,Multiple Disability,15,35,3,1,4
Arunachal Pradesh,East Siang,Multiple Disability,35,60,0,1,1
Arunachal Pradesh,East Siang,Multiple Disability,60,80,0,1,1
Madhya Pradesh,East Nimar,Multiple Disability,6,15,1,2,3
Madhya Pradesh,East Nimar,Multiple Disability,15,35,16,10,26
Madhya Pradesh,East Nimar,Multiple Disability,35,60,15,6,21
Madhya Pradesh,East Nimar,Multiple Disability,60,80,4,0,4
Madhya Pradesh,East Nimar,Multiple Disability,80,100,0,1,1
Meghalaya,East Khasi Hills,Multiple Disability,0,6,2,0,2
Meghalaya,East Khasi Hills,Multiple Disability,6,15,15,10,25
Meghalaya,East Khasi Hills,Multiple Disability,15,35,26,20,46
Meghalaya,East Khasi Hills,Multiple Disability,35,60,17,6,23
Meghalaya,East Khasi Hills,Multiple Disability,60,80,3,3,6
Arunachal Pradesh,East Kameng,Multiple Disability,0,6,3,0,3
Arunachal Pradesh,East Kameng,Multiple Disability,6,15,8,3,11
Arunachal Pradesh,East Kameng,Multiple Disability,15,35,11,11,22
Arunachal Pradesh,East Kameng,Multiple Disability,35,60,9,1,10
Arunachal Pradesh,East Kameng,Multiple Disability,60,80,0,2,2
Arunachal Pradesh,East Kameng,Multiple Disability,80,100,0,2,2
Meghalaya,East Jaintia Hills,Multiple Disability,0,6,2,3,5
Meghalaya,East Jaintia Hills,Multiple Disability,6,15,14,15,29
Meghalaya,East Jaintia Hills,Multiple Disability,15,35,17,12,29
Meghalaya,East Jaintia Hills,Multiple Disability,35,60,4,9,13
Meghalaya,East Jaintia Hills,Multiple Disability,60,80,0,3,3
Andhra Pradesh,East Godavari,Multiple Disability,6,15,1,1,2
Andhra Pradesh,East Godavari,Multiple Disability,15,35,8,5,13
Andhra Pradesh,East Godavari,Multiple Disability,35,60,1,2,3
Meghalaya,East Garo Hills,Multiple Disability,6,15,2,0,2
Meghalaya,East Garo Hills,Multiple Disability,15,35,0,2,2
Delhi,East,Multiple Disability,0,6,39,22,61
Delhi,East,Multiple Disability,6,15,139,50,189
Delhi,East,Multiple Disability,15,35,31,11,42
Delhi,East,Multiple Disability,35,60,11,3,14
Delhi,East,Multiple Disability,60,80,2,3,5
Chhattisgarh,Durg,Multiple Disability,0,6,1,1,2
Chhattisgarh,Durg,Multiple Disability,6,15,23,20,43
Chhattisgarh,Durg,Multiple Disability,15,35,67,45,112
Chhattisgarh,Durg,Multiple Disability,35,60,39,20,59
Chhattisgarh,Durg,Multiple Disability,60,80,6,2,8
Rajasthan,Dungarpur,Multiple Disability,6,15,6,8,14
Rajasthan,Dungarpur,Multiple Disability,15,35,20,7,27
Rajasthan,Dungarpur,Multiple Disability,35,60,8,1,9
Rajasthan,Dungarpur,Multiple Disability,80,100,1,0,1
Jharkhand,Dumka,Multiple Disability,0,6,3,2,5
Jharkhand,Dumka,Multiple Disability,6,15,52,39,91
Jharkhand,Dumka,Multiple Disability,15,35,125,66,191
Jharkhand,Dumka,Multiple Disability,35,60,98,45,143
Jharkhand,Dumka,Multiple Disability,60,80,24,6,30
Jharkhand,Dumka,Multiple Disability,80,100,0,1,1
Gujarat,Dohad,Multiple Disability,0,6,20,13,33
Gujarat,Dohad,Multiple Disability,6,15,228,148,376
Gujarat,Dohad,Multiple Disability,15,35,310,224,534
Gujarat,Dohad,Multiple Disability,35,60,89,56,145
Gujarat,Dohad,Multiple Disability,60,80,13,2,15
Jammu And Kashmir,Doda,Multiple Disability,0,6,1,1,2
Jammu And Kashmir,Doda,Multiple Disability,6,15,12,7,19
Jammu And Kashmir,Doda,Multiple Disability,15,35,34,13,47
Jammu And Kashmir,Doda,Multiple Disability,35,60,34,20,54
Jammu And Kashmir,Doda,Multiple Disability,60,80,9,2,11
Jammu And Kashmir,Doda,Multiple Disability,80,100,2,1,3
Dadra Nagar Haveli And Daman And Diu,Diu,Multiple Disability,6,15,4,5,9
Dadra Nagar Haveli And Daman And Diu,Diu,Multiple Disability,15,35,33,16,49
Dadra Nagar Haveli And Daman And Diu,Diu,Multiple Disability,35,60,10,11,21
Dadra Nagar Haveli And Daman And Diu,Diu,Multiple Disability,60,80,1,3,4
Madhya Pradesh,Dindori,Multiple Disability,0,6,1,1,2
Madhya Pradesh,Dindori,Multiple Disability,6,15,8,6,14
Madhya Pradesh,Dindori,Multiple Disability,15,35,12,13,25
Madhya Pradesh,Dindori,Multiple Disability,35,60,7,6,13
Madhya Pradesh,Dindori,Multiple Disability,60,80,1,2,3
Tamil Nadu,Dindigul,Multiple Disability,0,6,1,4,5
Tamil Nadu,Dindigul,Multiple Disability,6,15,32,13,45
Tamil Nadu,Dindigul,Multiple Disability,15,35,60,33,93
Tamil Nadu,Dindigul,Multiple Disability,35,60,24,9,33
Tamil Nadu,Dindigul,Multiple Disability,60,80,5,3,8
Nagaland,Dimapur,Multiple Disability,6,15,0,1,1
Nagaland,Dimapur,Multiple Disability,15,35,1,2,3
Nagaland,Dimapur,Multiple Disability,35,60,1,0,1
Nagaland,Dimapur,Multiple Disability,60,80,1,0,1
Assam,Dima Hasao,Multiple Disability,6,15,2,0,2
Assam,Dima Hasao,Multiple Disability,15,35,3,0,3
Assam,Dima Hasao,Multiple Disability,35,60,0,1,1
Assam,Dibrugarh,Multiple Disability,6,15,9,2,11
Assam,Dibrugarh,Multiple Disability,15,35,14,9,23
Assam,Dibrugarh,Multiple Disability,35,60,3,6,9
Arunachal Pradesh,Dibang Valley,Multiple Disability,6,15,1,0,1
Maharashtra,Dhule,Multiple Disability,6,15,2,1,3
Maharashtra,Dhule,Multiple Disability,15,35,48,13,61
Maharashtra,Dhule,Multiple Disability,35,60,44,19,63
Maharashtra,Dhule,Multiple Disability,60,80,8,0,8
Assam,Dhubri,Multiple Disability,0,6,3,0,3
Assam,Dhubri,Multiple Disability,6,15,13,7,20
Assam,Dhubri,Multiple Disability,15,35,24,17,41
Assam,Dhubri,Multiple Disability,35,60,15,3,18
Assam,Dhubri,Multiple Disability,60,80,3,0,3
Rajasthan,Dholpur,Multiple Disability,0,6,1,0,1
Rajasthan,Dholpur,Multiple Disability,6,15,4,1,5
Rajasthan,Dholpur,Multiple Disability,15,35,12,6,18
Rajasthan,Dholpur,Multiple Disability,35,60,14,3,17
Rajasthan,Dholpur,Multiple Disability,60,80,3,1,4
Rajasthan,Dholpur,Multiple Disability,80,100,0,1,1
Odisha,Dhenkanal,Multiple Disability,0,6,2,2,4
Odisha,Dhenkanal,Multiple Disability,6,15,15,10,25
Odisha,Dhenkanal,Multiple Disability,15,35,18,12,30
Odisha,Dhenkanal,Multiple Disability,35,60,25,9,34
Odisha,Dhenkanal,Multiple Disability,60,80,10,1,11
Odisha,Dhenkanal,Multiple Disability,80,100,1,0,1
Assam,Dhemaji,Multiple Disability,0,6,5,6,11
Assam,Dhemaji,Multiple Disability,6,15,33,28,61
Assam,Dhemaji,Multiple Disability,15,35,76,41,117
Assam,Dhemaji,Multiple Disability,35,60,70,28,98
Assam,Dhemaji,Multiple Disability,60,80,11,9,20
Karnataka,Dharwad,Multiple Disability,0,6,4,1,5
Karnataka,Dharwad,Multiple Disability,6,15,27,10,37
Karnataka,Dharwad,Multiple Disability,15,35,44,22,66
Karnataka,Dharwad,Multiple Disability,35,60,38,16,54
Karnataka,Dharwad,Multiple Disability,60,80,5,2,7
Tamil Nadu,Dharmapuri,Multiple Disability,0,6,4,3,7
Tamil Nadu,Dharmapuri,Multiple Disability,6,15,29,18,47
Tamil Nadu,Dharmapuri,Multiple Disability,15,35,70,35,105
Tamil Nadu,Dharmapuri,Multiple Disability,35,60,30,6,36
Tamil Nadu,Dharmapuri,Multiple Disability,60,80,6,1,7
Madhya Pradesh,Dhar,Multiple Disability,0,6,1,1,2
Madhya Pradesh,Dhar,Multiple Disability,6,15,16,13,29
Madhya Pradesh,Dhar,Multiple Disability,15,35,114,60,174
Madhya Pradesh,Dhar,Multiple Disability,35,60,85,48,133
Madhya Pradesh,Dhar,Multiple Disability,60,80,15,7,22
Jharkhand,Dhanbad,Multiple Disability,0,6,2,2,4
Jharkhand,Dhanbad,Multiple Disability,6,15,30,19,49
Jharkhand,Dhanbad,Multiple Disability,15,35,104,45,149
Jharkhand,Dhanbad,Multiple Disability,35,60,61,28,89
Jharkhand,Dhanbad,Multiple Disability,60,80,9,0,9
Chhattisgarh,Dhamtari,Multiple Disability,0,6,2,1,3
Chhattisgarh,Dhamtari,Multiple Disability,6,15,11,7,18
Chhattisgarh,Dhamtari,Multiple Disability,15,35,20,17,37
Chhattisgarh,Dhamtari,Multiple Disability,35,60,16,5,21
Chhattisgarh,Dhamtari,Multiple Disability,60,80,4,2,6
Tripura,Dhalai,Multiple Disability,0,6,1,1,2
Tripura,Dhalai,Multiple Disability,6,15,29,27,56
Tripura,Dhalai,Multiple Disability,15,35,55,59,114
Tripura,Dhalai,Multiple Disability,35,60,40,19,59
Tripura,Dhalai,Multiple Disability,60,80,19,10,29
Tripura,Dhalai,Multiple Disability,80,100,2,2,4
Madhya Pradesh,Dewas,Multiple Disability,6,15,10,7,17
Madhya Pradesh,Dewas,Multiple Disability,15,35,42,20,62
Madhya Pradesh,Dewas,Multiple Disability,35,60,33,14,47
Madhya Pradesh,Dewas,Multiple Disability,60,80,8,3,11
Gujarat,Devbhumi Dwarka,Multiple Disability,0,6,5,1,6
Gujarat,Devbhumi Dwarka,Multiple Disability,6,15,22,10,32
Gujarat,Devbhumi Dwarka,Multiple Disability,15,35,17,11,28
Gujarat,Devbhumi Dwarka,Multiple Disability,35,60,7,4,11
Gujarat,Devbhumi Dwarka,Multiple Disability,60,80,2,1,3
Uttar Pradesh,Deoria,Multiple Disability,0,6,9,5,14
Uttar Pradesh,Deoria,Multiple Disability,6,15,62,54,116
Uttar Pradesh,Deoria,Multiple Disability,15,35,304,150,454
Uttar Pradesh,Deoria,Multiple Disability,35,60,172,65,237
Uttar Pradesh,Deoria,Multiple Disability,60,80,29,6,35
Uttar Pradesh,Deoria,Multiple Disability,80,100,2,0,2
Jharkhand,Deoghar,Multiple Disability,0,6,3,3,6
Jharkhand,Deoghar,Multiple Disability,6,15,26,14,40
Jharkhand,Deoghar,Multiple Disability,15,35,89,49,138
Jharkhand,Deoghar,Multiple Disability,35,60,47,17,64
Jharkhand,Deoghar,Multiple Disability,60,80,13,4,17
Jharkhand,Deoghar,Multiple Disability,80,100,1,0,1
Odisha,Deogarh,Multiple Disability,15,35,3,3,6
Odisha,Deogarh,Multiple Disability,35,60,6,3,9
Odisha,Deogarh,Multiple Disability,60,80,1,0,1
Uttarakhand,Dehradun,Multiple Disability,0,6,18,10,28
Uttarakhand,Dehradun,Multiple Disability,6,15,87,43,130
Uttarakhand,Dehradun,Multiple Disability,15,35,185,88,273
Uttarakhand,Dehradun,Multiple Disability,35,60,185,82,267
Uttarakhand,Dehradun,Multiple Disability,60,80,24,26,50
Uttarakhand,Dehradun,Multiple Disability,80,100,3,2,5
Karnataka,Davangere,Multiple Disability,0,6,10,3,13
Karnataka,Davangere,Multiple Disability,6,15,48,27,75
Karnataka,Davangere,Multiple Disability,15,35,77,40,117
Karnataka,Davangere,Multiple Disability,35,60,85,49,134
Karnataka,Davangere,Multiple Disability,60,80,23,6,29
Rajasthan,Dausa,Multiple Disability,6,15,5,0,5
Rajasthan,Dausa,Multiple Disability,15,35,32,14,46
Rajasthan,Dausa,Multiple Disability,35,60,22,4,26
Rajasthan,Dausa,Multiple Disability,60,80,6,2,8
Rajasthan,Dausa,Multiple Disability,80,100,1,0,1
Madhya Pradesh,Datia,Multiple Disability,0,6,9,0,9
Madhya Pradesh,Datia,Multiple Disability,6,15,26,12,38
Madhya Pradesh,Datia,Multiple Disability,15,35,37,22,59
Madhya Pradesh,Datia,Multiple Disability,35,60,13,6,19
Madhya Pradesh,Datia,Multiple Disability,60,80,8,0,8
Madhya Pradesh,Datia,Multiple Disability,80,100,0,1,1
Assam,Darrang,Multiple Disability,0,6,3,1,4
Assam,Darrang,Multiple Disability,6,15,26,19,45
Assam,Darrang,Multiple Disability,15,35,66,49,115
Assam,Darrang,Multiple Disability,35,60,79,50,129
Assam,Darrang,Multiple Disability,60,80,24,8,32
Assam,Darrang,Multiple Disability,80,100,2,0,2
West Bengal,Darjeeling,Multiple Disability,0,6,0,1,1
Bihar,Darbhanga,Multiple Disability,6,15,7,3,10
Bihar,Darbhanga,Multiple Disability,15,35,35,18,53
Bihar,Darbhanga,Multiple Disability,35,60,23,11,34
Bihar,Darbhanga,Multiple Disability,60,80,1,2,3
Chhattisgarh,Dantewada,Multiple Disability,6,15,5,9,14
Chhattisgarh,Dantewada,Multiple Disability,15,35,23,9,32
Chhattisgarh,Dantewada,Multiple Disability,35,60,9,6,15
Chhattisgarh,Dantewada,Multiple Disability,60,80,1,1,2
Gujarat,Dang,Multiple Disability,0,6,3,3,6
Gujarat,Dang,Multiple Disability,6,15,25,11,36
Gujarat,Dang,Multiple Disability,15,35,18,12,30
Gujarat,Dang,Multiple Disability,35,60,9,3,12
Gujarat,Dang,Multiple Disability,60,80,1,0,1
Madhya Pradesh,Damoh,Multiple Disability,6,15,15,20,35
Madhya Pradesh,Damoh,Multiple Disability,15,35,90,51,141
Madhya Pradesh,Damoh,Multiple Disability,35,60,60,39,99
Madhya Pradesh,Damoh,Multiple Disability,60,80,18,5,23
Dadra Nagar Haveli And Daman And Diu,Daman,Multiple Disability,0,6,0,1,1
Dadra Nagar Haveli And Daman And Diu,Daman,Multiple Disability,6,15,11,12,23
Dadra Nagar Haveli And Daman And Diu,Daman,Multiple Disability,15,35,14,12,26
Dadra Nagar Haveli And Daman And Diu,Daman,Multiple Disability,35,60,6,7,13
Dadra Nagar Haveli And Daman And Diu,Daman,Multiple Disability,60,80,2,0,2
Karnataka,Dakshina Kannada,Multiple Disability,0,6,12,11,23
Karnataka,Dakshina Kannada,Multiple Disability,6,15,148,101,249
Karnataka,Dakshina Kannada,Multiple Disability,15,35,248,145,393
Karnataka,Dakshina Kannada,Multiple Disability,35,60,148,74,222
Karnataka,Dakshina Kannada,Multiple Disability,60,80,50,10,60
Karnataka,Dakshina Kannada,Multiple Disability,80,100,3,1,4
Dadra Nagar Haveli And Daman And Diu,Dadra And Nagar Haveli,Multiple Disability,0,6,4,3,7
Dadra Nagar Haveli And Daman And Diu,Dadra And Nagar Haveli,Multiple Disability,6,15,36,20,56
Dadra Nagar Haveli And Daman And Diu,Dadra And Nagar Haveli,Multiple Disability,15,35,24,8,32
Dadra Nagar Haveli And Daman And Diu,Dadra And Nagar Haveli,Multiple Disability,35,60,4,0,4
Dadra Nagar Haveli And Daman And Diu,Dadra And Nagar Haveli,Multiple Disability,60,80,3,1,4
Odisha,Cuttack,Multiple Disability,0,6,3,1,4
Odisha,Cuttack,Multiple Disability,6,15,26,9,35
Odisha,Cuttack,Multiple Disability,15,35,33,23,56
Odisha,Cuttack,Multiple Disability,35,60,35,14,49
Odisha,Cuttack,Multiple Disability,60,80,13,6,19
Odisha,Cuttack,Multiple Disability,80,100,1,0,1
Tamil Nadu,Cuddalore,Multiple Disability,0,6,13,7,20
Tamil Nadu,Cuddalore,Multiple Disability,6,15,132,71,203
Tamil Nadu,Cuddalore,Multiple Disability,15,35,210,132,342
Tamil Nadu,Cuddalore,Multiple Disability,35,60,39,18,57
Tamil Nadu,Cuddalore,Multiple Disability,60,80,3,1,4
West Bengal,Coochbehar,Multiple Disability,15,35,2,0,2
West Bengal,Coochbehar,Multiple Disability,35,60,1,0,1
Tamil Nadu,Coimbatore,Multiple Disability,0,6,5,2,7
Tamil Nadu,Coimbatore,Multiple Disability,6,15,39,33,72
Tamil Nadu,Coimbatore,Multiple Disability,15,35,65,27,92
Tamil Nadu,Coimbatore,Multiple Disability,35,60,33,13,46
Tamil Nadu,Coimbatore,Multiple Disability,60,80,8,2,10
Rajasthan,Churu,Multiple Disability,0,6,1,0,1
Rajasthan,Churu,Multiple Disability,6,15,4,6,10
Rajasthan,Churu,Multiple Disability,15,35,20,6,26
Rajasthan,Churu,Multiple Disability,35,60,13,2,15
Rajasthan,Churu,Multiple Disability,60,80,1,0,1
Manipur,Churachandpur,Multiple Disability,0,6,9,5,14
Manipur,Churachandpur,Multiple Disability,6,15,27,17,44
Manipur,Churachandpur,Multiple Disability,15,35,20,15,35
Manipur,Churachandpur,Multiple Disability,35,60,15,12,27
Manipur,Churachandpur,Multiple Disability,60,80,7,3,10
Manipur,Churachandpur,Multiple Disability,80,100,1,0,1
Rajasthan,Chittorgarh,Multiple Disability,0,6,2,2,4
Rajasthan,Chittorgarh,Multiple Disability,6,15,17,10,27
Rajasthan,Chittorgarh,Multiple Disability,15,35,51,31,82
Rajasthan,Chittorgarh,Multiple Disability,35,60,40,25,65
Rajasthan,Chittorgarh,Multiple Disability,60,80,10,4,14
Rajasthan,Chittorgarh,Multiple Disability,80,100,4,2,6
Andhra Pradesh,Chittoor,Multiple Disability,0,6,1,0,1
Andhra Pradesh,Chittoor,Multiple Disability,6,15,2,1,3
Andhra Pradesh,Chittoor,Multiple Disability,15,35,2,0,2
Andhra Pradesh,Chittoor,Multiple Disability,35,60,3,2,5
Uttar Pradesh,Chitrakoot,Multiple Disability,0,6,6,6,12
Uttar Pradesh,Chitrakoot,Multiple Disability,6,15,76,59,135
Uttar Pradesh,Chitrakoot,Multiple Disability,15,35,167,72,239
Uttar Pradesh,Chitrakoot,Multiple Disability,35,60,134,32,166
Uttar Pradesh,Chitrakoot,Multiple Disability,60,80,38,10,48
Uttar Pradesh,Chitrakoot,Multiple Disability,80,100,1,0,1
Karnataka,Chitradurga,Multiple Disability,0,6,9,3,12
Karnataka,Chitradurga,Multiple Disability,6,15,49,35,84
Karnataka,Chitradurga,Multiple Disability,15,35,96,66,162
Karnataka,Chitradurga,Multiple Disability,35,60,120,59,179
Karnataka,Chitradurga,Multiple Disability,60,80,28,7,35
Karnataka,Chitradurga,Multiple Disability,80,100,1,1,2
Assam,Chirang,Multiple Disability,0,6,0,1,1
Assam,Chirang,Multiple Disability,6,15,2,1,3
Assam,Chirang,Multiple Disability,15,35,4,5,9
Assam,Chirang,Multiple Disability,35,60,2,3,5
Karnataka,Chikkamagaluru,Multiple Disability,0,6,13,7,20
Karnataka,Chikkamagaluru,Multiple Disability,6,15,67,38,105
Karnataka,Chikkamagaluru,Multiple Disability,15,35,204,131,335
Karnataka,Chikkamagaluru,Multiple Disability,35,60,168,116,284
Karnataka,Chikkamagaluru,Multiple Disability,60,80,56,21,77
Karnataka,Chikkamagaluru,Multiple Disability,80,100,3,3,6
Karnataka,Chikkaballapura,Multiple Disability,0,6,2,5,7
Karnataka,Chikkaballapura,Multiple Disability,6,15,52,28,80
Karnataka,Chikkaballapura,Multiple Disability,15,35,87,47,134
Karnataka,Chikkaballapura,Multiple Disability,35,60,119,51,170
Karnataka,Chikkaballapura,Multiple Disability,60,80,35,8,43
Karnataka,Chikkaballapura,Multiple Disability,80,100,1,1,2
Gujarat,Chhotaudepur,Multiple Disability,0,6,9,5,14
Gujarat,Chhotaudepur,Multiple Disability,6,15,50,25,75
Gujarat,Chhotaudepur,Multiple Disability,15,35,52,32,84
Gujarat,Chhotaudepur,Multiple Disability,35,60,12,16,28
Gujarat,Chhotaudepur,Multiple Disability,60,80,2,0,2
Madhya Pradesh,Chhindwara,Multiple Disability,0,6,9,3,12
Madhya Pradesh,Chhindwara,Multiple Disability,6,15,132,94,226
Madhya Pradesh,Chhindwara,Multiple Disability,15,35,231,169,400
Madhya Pradesh,Chhindwara,Multiple Disability,35,60,108,55,163
Madhya Pradesh,Chhindwara,Multiple Disability,60,80,30,5,35
Madhya Pradesh,Chhindwara,Multiple Disability,80,100,4,1,5
Madhya Pradesh,Chhatarpur,Multiple Disability,0,6,4,1,5
Madhya Pradesh,Chhatarpur,Multiple Disability,6,15,13,8,21
Madhya Pradesh,Chhatarpur,Multiple Disability,15,35,59,39,98
Madhya Pradesh,Chhatarpur,Multiple Disability,35,60,56,13,69
Madhya Pradesh,Chhatarpur,Multiple Disability,60,80,18,6,24
Tamil Nadu,Chennai,Multiple Disability,0,6,85,50,135
Tamil Nadu,Chennai,Multiple Disability,6,15,620,281,901
Tamil Nadu,Chennai,Multiple Disability,15,35,620,319,939
Tamil Nadu,Chennai,Multiple Disability,35,60,170,99,269
Tamil Nadu,Chennai,Multiple Disability,60,80,37,10,47
Tamil Nadu,Chennai,Multiple Disability,80,100,1,0,1
Tamil Nadu,Chengalpattu,Multiple Disability,0,6,33,21,54
Tamil Nadu,Chengalpattu,Multiple Disability,6,15,157,88,245
Tamil Nadu,Chengalpattu,Multiple Disability,15,35,144,66,210
Tamil Nadu,Chengalpattu,Multiple Disability,35,60,40,15,55
Tamil Nadu,Chengalpattu,Multiple Disability,60,80,9,2,11
Tamil Nadu,Chengalpattu,Multiple Disability,80,100,0,1,1
Jharkhand,Chatra,Multiple Disability,6,15,2,6,8
Jharkhand,Chatra,Multiple Disability,15,35,4,2,6
Jharkhand,Chatra,Multiple Disability,35,60,4,1,5
Haryana,Charki Dadri,Multiple Disability,6,15,3,0,3
Haryana,Charki Dadri,Multiple Disability,15,35,31,2,33
Haryana,Charki Dadri,Multiple Disability,35,60,11,0,11
Assam,Charaideo,Multiple Disability,6,15,1,0,1
Assam,Charaideo,Multiple Disability,15,35,2,2,4
Assam,Charaideo,Multiple Disability,35,60,2,0,2
Arunachal Pradesh,Changlang,Multiple Disability,0,6,1,3,4
Arunachal Pradesh,Changlang,Multiple Disability,6,15,4,3,7
Arunachal Pradesh,Changlang,Multiple Disability,15,35,10,3,13
Arunachal Pradesh,Changlang,Multiple Disability,35,60,11,9,20
Arunachal Pradesh,Changlang,Multiple Disability,60,80,4,1,5
Arunachal Pradesh,Changlang,Multiple Disability,80,100,1,0,1
Maharashtra,Chandrapur,Multiple Disability,0,6,49,31,80
Maharashtra,Chandrapur,Multiple Disability,6,15,279,188,467
Maharashtra,Chandrapur,Multiple Disability,15,35,95,81,176
Maharashtra,Chandrapur,Multiple Disability,35,60,28,10,38
Maharashtra,Chandrapur,Multiple Disability,60,80,2,1,3
Chandigarh,Chandigarh,Multiple Disability,0,6,23,7,30
Chandigarh,Chandigarh,Multiple Disability,6,15,96,25,121
Chandigarh,Chandigarh,Multiple Disability,15,35,93,37,130
Chandigarh,Chandigarh,Multiple Disability,35,60,70,17,87
Chandigarh,Chandigarh,Multiple Disability,60,80,33,7,40
Chandigarh,Chandigarh,Multiple Disability,80,100,3,2,5
Manipur,Chandel,Multiple Disability,0,6,1,1,2
Manipur,Chandel,Multiple Disability,6,15,3,0,3
Manipur,Chandel,Multiple Disability,15,35,7,1,8
Manipur,Chandel,Multiple Disability,35,60,8,1,9
Manipur,Chandel,Multiple Disability,60,80,6,2,8
Manipur,Chandel,Multiple Disability,80,100,2,0,2
Uttar Pradesh,Chandauli,Multiple Disability,0,6,1,1,2
Uttar Pradesh,Chandauli,Multiple Disability,6,15,9,7,16
Uttar Pradesh,Chandauli,Multiple Disability,15,35,37,12,49
Uttar Pradesh,Chandauli,Multiple Disability,35,60,24,12,36
Uttar Pradesh,Chandauli,Multiple Disability,60,80,2,0,2
Uttar Pradesh,Chandauli,Multiple Disability,80,100,0,1,1
Mizoram,Champhai,Multiple Disability,15,35,3,1,4
Mizoram,Champhai,Multiple Disability,35,60,1,2,3
Mizoram,Champhai,Multiple Disability,80,100,1,0,1
Uttarakhand,Champawat,Multiple Disability,0,6,1,0,1
Uttarakhand,Champawat,Multiple Disability,6,15,5,2,7
Uttarakhand,Champawat,Multiple Disability,15,35,29,17,46
Uttarakhand,Champawat,Multiple Disability,35,60,32,15,47
Uttarakhand,Champawat,Multiple Disability,60,80,5,1,6
Uttarakhand,Chamoli,Multiple Disability,6,15,2,6,8
Uttarakhand,Chamoli,Multiple Disability,15,35,23,15,38
Uttarakhand,Chamoli,Multiple Disability,35,60,30,21,51
Uttarakhand,Chamoli,Multiple Disability,60,80,12,6,18
Himachal Pradesh,Chamba,Multiple Disability,6,15,9,7,16
Himachal Pradesh,Chamba,Multiple Disability,15,35,43,26,69
Himachal Pradesh,Chamba,Multiple Disability,35,60,31,5,36
Himachal Pradesh,Chamba,Multiple Disability,60,80,8,3,11
Karnataka,Chamarajanagara,Multiple Disability,0,6,1,2,3
Karnataka,Chamarajanagara,Multiple Disability,6,15,28,22,50
Karnataka,Chamarajanagara,Multiple Disability,15,35,60,54,114
Karnataka,Chamarajanagara,Multiple Disability,35,60,47,39,86
Karnataka,Chamarajanagara,Multiple Disability,60,80,13,3,16
Delhi,Central,Multiple Disability,0,6,25,8,33
Delhi,Central,Multiple Disability,6,15,58,37,95
Delhi,Central,Multiple Disability,15,35,16,16,32
Delhi,Central,Multiple Disability,35,60,14,1,15
Delhi,Central,Multiple Disability,60,80,3,0,3
Assam,Cachar,Multiple Disability,0,6,89,63,152
Assam,Cachar,Multiple Disability,6,15,287,193,480
Assam,Cachar,Multiple Disability,15,35,149,111,260
Assam,Cachar,Multiple Disability,35,60,31,24,55
Assam,Cachar,Multiple Disability,60,80,3,1,4
Bihar,Buxar,Multiple Disability,6,15,2,2,4
Bihar,Buxar,Multiple Disability,15,35,19,5,24
Bihar,Buxar,Multiple Disability,35,60,14,8,22
Bihar,Buxar,Multiple Disability,60,80,5,1,6
Madhya Pradesh,Burhanpur,Multiple Disability,0,6,3,2,5
Madhya Pradesh,Burhanpur,Multiple Disability,6,15,18,10,28
Madhya Pradesh,Burhanpur,Multiple Disability,15,35,13,16,29
Madhya Pradesh,Burhanpur,Multiple Disability,35,60,19,6,25
Madhya Pradesh,Burhanpur,Multiple Disability,60,80,5,1,6
Rajasthan,Bundi,Multiple Disability,6,15,12,16,28
Rajasthan,Bundi,Multiple Disability,15,35,53,26,79
Rajasthan,Bundi,Multiple Disability,35,60,29,17,46
Rajasthan,Bundi,Multiple Disability,60,80,15,10,25
Rajasthan,Bundi,Multiple Disability,80,100,0,1,1
Maharashtra,Buldhana,Multiple Disability,0,6,12,12,24
Maharashtra,Buldhana,Multiple Disability,6,15,115,51,166
Maharashtra,Buldhana,Multiple Disability,15,35,209,102,311
Maharashtra,Buldhana,Multiple Disability,35,60,79,44,123
Maharashtra,Buldhana,Multiple Disability,60,80,22,10,32
Maharashtra,Buldhana,Multiple Disability,80,100,2,1,3
Uttar Pradesh,Bulandshahr,Multiple Disability,6,15,27,12,39
Uttar Pradesh,Bulandshahr,Multiple Disability,15,35,116,20,136
Uttar Pradesh,Bulandshahr,Multiple Disability,35,60,99,16,115
Uttar Pradesh,Bulandshahr,Multiple Disability,60,80,36,9,45
Uttar Pradesh,Bulandshahr,Multiple Disability,80,100,4,2,6
Jammu And Kashmir,Budgam,Multiple Disability,0,6,3,2,5
Jammu And Kashmir,Budgam,Multiple Disability,6,15,17,6,23
Jammu And Kashmir,Budgam,Multiple Disability,15,35,30,18,48
Jammu And Kashmir,Budgam,Multiple Disability,35,60,22,9,31
Jammu And Kashmir,Budgam,Multiple Disability,60,80,5,0,5
Jammu And Kashmir,Budgam,Multiple Disability,80,100,0,1,1
Uttar Pradesh,Budaun,Multiple Disability,6,15,1,1,2
Uttar Pradesh,Budaun,Multiple Disability,15,35,20,6,26
Uttar Pradesh,Budaun,Multiple Disability,35,60,26,2,28
Uttar Pradesh,Budaun,Multiple Disability,60,80,8,0,8
Odisha,Boudh,Multiple Disability,0,6,2,1,3
Odisha,Boudh,Multiple Disability,6,15,31,17,48
Odisha,Boudh,Multiple Disability,15,35,44,26,70
Odisha,Boudh,Multiple Disability,35,60,42,16,58
Odisha,Boudh,Multiple Disability,60,80,3,3,6
Gujarat,Botad,Multiple Disability,0,6,10,10,20
Gujarat,Botad,Multiple Disability,6,15,117,72,189
Gujarat,Botad,Multiple Disability,15,35,111,79,190
Gujarat,Botad,Multiple Disability,35,60,53,25,78
Gujarat,Botad,Multiple Disability,60,80,10,4,14
Assam,Bongaigaon,Multiple Disability,0,6,9,6,15
Assam,Bongaigaon,Multiple Disability,6,15,37,38,75
Assam,Bongaigaon,Multiple Disability,15,35,70,49,119
Assam,Bongaigaon,Multiple Disability,35,60,49,20,69
Assam,Bongaigaon,Multiple Disability,60,80,4,1,5
Jharkhand,Bokaro,Multiple Disability,6,15,8,6,14
Jharkhand,Bokaro,Multiple Disability,15,35,47,33,80
Jharkhand,Bokaro,Multiple Disability,35,60,35,13,48
Jharkhand,Bokaro,Multiple Disability,60,80,5,0,5
Assam,Biswanath,Multiple Disability,0,6,3,0,3
Assam,Biswanath,Multiple Disability,6,15,9,1,10
Assam,Biswanath,Multiple Disability,15,35,8,1,9
Assam,Biswanath,Multiple Disability,35,60,11,1,12
Manipur,Bishnupur,Multiple Disability,0,6,4,1,5
Manipur,Bishnupur,Multiple Disability,6,15,11,11,22
Manipur,Bishnupur,Multiple Disability,15,35,11,10,21
Manipur,Bishnupur,Multiple Disability,35,60,12,5,17
Manipur,Bishnupur,Multiple Disability,60,80,4,3,7
Manipur,Bishnupur,Multiple Disability,80,100,1,2,3
West Bengal,Birbhum,Multiple Disability,15,35,2,1,3
Chhattisgarh,Bilaspur,Multiple Disability,0,6,1,0,1
Chhattisgarh,Bilaspur,Multiple Disability,6,15,6,4,10
Chhattisgarh,Bilaspur,Multiple Disability,15,35,15,11,26
Chhattisgarh,Bilaspur,Multiple Disability,35,60,6,1,7
Chhattisgarh,Bilaspur,Multiple Disability,60,80,1,0,1
Himachal Pradesh,Bilaspur,Multiple Disability,0,6,1,0,1
Himachal Pradesh,Bilaspur,Multiple Disability,6,15,14,10,24
Himachal Pradesh,Bilaspur,Multiple Disability,15,35,37,16,53
Himachal Pradesh,Bilaspur,Multiple Disability,35,60,39,8,47
Himachal Pradesh,Bilaspur,Multiple Disability,60,80,9,3,12
Himachal Pradesh,Bilaspur,Multiple Disability,80,100,2,0,2
Rajasthan,Bikaner,Multiple Disability,0,6,10,9,19
Rajasthan,Bikaner,Multiple Disability,6,15,164,101,265
Rajasthan,Bikaner,Multiple Disability,15,35,197,86,283
Rajasthan,Bikaner,Multiple Disability,35,60,102,30,132
Rajasthan,Bikaner,Multiple Disability,60,80,12,9,21
Rajasthan,Bikaner,Multiple Disability,80,100,2,2,4
Uttar Pradesh,Bijnor,Multiple Disability,0,6,3,3,6
Uttar Pradesh,Bijnor,Multiple Disability,6,15,23,12,35
Uttar Pradesh,Bijnor,Multiple Disability,15,35,58,24,82
Uttar Pradesh,Bijnor,Multiple Disability,35,60,37,4,41
Uttar Pradesh,Bijnor,Multiple Disability,60,80,8,1,9
Uttar Pradesh,Bijnor,Multiple Disability,80,100,1,0,1
Chhattisgarh,Bijapur,Multiple Disability,6,15,19,12,31
Chhattisgarh,Bijapur,Multiple Disability,15,35,33,33,66
Chhattisgarh,Bijapur,Multiple Disability,35,60,29,18,47
Chhattisgarh,Bijapur,Multiple Disability,60,80,3,20,23
Chhattisgarh,Bijapur,Multiple Disability,80,100,1,0,1
Karnataka,Bidar,Multiple Disability,0,6,8,5,13
Karnataka,Bidar,Multiple Disability,6,15,61,64,125
Karnataka,Bidar,Multiple Disability,15,35,145,97,242
Karnataka,Bidar,Multiple Disability,35,60,127,51,178
Karnataka,Bidar,Multiple Disability,60,80,24,2,26
Karnataka,Bidar,Multiple Disability,80,100,1,0,1
Madhya Pradesh,Bhopal,Multiple Disability,0,6,23,8,31
Madhya Pradesh,Bhopal,Multiple Disability,6,15,177,101,278
Madhya Pradesh,Bhopal,Multiple Disability,15,35,406,245,651
Madhya Pradesh,Bhopal,Multiple Disability,35,60,195,92,287
Madhya Pradesh,Bhopal,Multiple Disability,60,80,26,12,38
Madhya Pradesh,Bhopal,Multiple Disability,80,100,1,0,1
Bihar,Bhojpur,Multiple Disability,0,6,2,1,3
Bihar,Bhojpur,Multiple Disability,6,15,33,15,48
Bihar,Bhojpur,Multiple Disability,15,35,52,10,62
Bihar,Bhojpur,Multiple Disability,35,60,28,5,33
Bihar,Bhojpur,Multiple Disability,60,80,12,2,14
Bihar,Bhojpur,Multiple Disability,80,100,2,0,2
Haryana,Bhiwani,Multiple Disability,6,15,15,1,16
Haryana,Bhiwani,Multiple Disability,15,35,26,13,39
Haryana,Bhiwani,Multiple Disability,35,60,43,4,47
Haryana,Bhiwani,Multiple Disability,60,80,3,1,4
Haryana,Bhiwani,Multiple Disability,80,100,0,1,1
Madhya Pradesh,Bhind,Multiple Disability,6,15,15,4,19
Madhya Pradesh,Bhind,Multiple Disability,15,35,42,15,57
Madhya Pradesh,Bhind,Multiple Disability,35,60,35,9,44
Madhya Pradesh,Bhind,Multiple Disability,60,80,11,5,16
Madhya Pradesh,Bhind,Multiple Disability,80,100,2,0,2
Rajasthan,Bhilwara,Multiple Disability,0,6,1,0,1
Rajasthan,Bhilwara,Multiple Disability,6,15,23,20,43
Rajasthan,Bhilwara,Multiple Disability,15,35,85,52,137
Rajasthan,Bhilwara,Multiple Disability,35,60,78,45,123
Rajasthan,Bhilwara,Multiple Disability,60,80,38,23,61
Rajasthan,Bhilwara,Multiple Disability,80,100,4,5,9
Gujarat,Bhavnagar,Multiple Disability,0,6,38,24,62
Gujarat,Bhavnagar,Multiple Disability,6,15,357,196,553
Gujarat,Bhavnagar,Multiple Disability,15,35,293,140,433
Gujarat,Bhavnagar,Multiple Disability,35,60,47,20,67
Gujarat,Bhavnagar,Multiple Disability,60,80,8,3,11
Gujarat,Bharuch,Multiple Disability,0,6,23,11,34
Gujarat,Bharuch,Multiple Disability,6,15,98,79,177
Gujarat,Bharuch,Multiple Disability,15,35,223,150,373
Gujarat,Bharuch,Multiple Disability,35,60,131,59,190
Gujarat,Bharuch,Multiple Disability,60,80,33,9,42
Gujarat,Bharuch,Multiple Disability,80,100,2,1,3
Rajasthan,Bharatpur,Multiple Disability,0,6,3,0,3
Rajasthan,Bharatpur,Multiple Disability,6,15,16,13,29
Rajasthan,Bharatpur,Multiple Disability,15,35,138,42,180
Rajasthan,Bharatpur,Multiple Disability,35,60,68,11,79
Rajasthan,Bharatpur,Multiple Disability,60,80,12,5,17
Rajasthan,Bharatpur,Multiple Disability,80,100,1,0,1
Arunachal Pradesh,Bhandara,Multiple Disability,35,60,1,0,1
Maharashtra,Bhandara,Multiple Disability,0,6,1,1,2
Maharashtra,Bhandara,Multiple Disability,6,15,6,8,14
Maharashtra,Bhandara,Multiple Disability,15,35,24,16,40
Maharashtra,Bhandara,Multiple Disability,35,60,29,7,36
Maharashtra,Bhandara,Multiple Disability,60,80,11,3,14
Bihar,Bhagalpur,Multiple Disability,0,6,3,2,5
Bihar,Bhagalpur,Multiple Disability,6,15,27,13,40
Bihar,Bhagalpur,Multiple Disability,15,35,76,39,115
Bihar,Bhagalpur,Multiple Disability,35,60,50,11,61
Bihar,Bhagalpur,Multiple Disability,60,80,9,1,10
Bihar,Bhagalpur,Multiple Disability,80,100,1,1,2
Odisha,Bhadrak,Multiple Disability,0,6,1,0,1
Odisha,Bhadrak,Multiple Disability,6,15,0,3,3
Odisha,Bhadrak,Multiple Disability,15,35,2,5,7
Odisha,Bhadrak,Multiple Disability,35,60,4,0,4
Odisha,Bhadrak,Multiple Disability,60,80,0,2,2
Uttar Pradesh,Bhadohi,Multiple Disability,6,15,0,1,1
Uttar Pradesh,Bhadohi,Multiple Disability,15,35,8,4,12
Uttar Pradesh,Bhadohi,Multiple Disability,35,60,18,2,20
Uttar Pradesh,Bhadohi,Multiple Disability,60,80,3,0,3
Madhya Pradesh,Betul,Multiple Disability,0,6,0,2,2
Madhya Pradesh,Betul,Multiple Disability,6,15,30,12,42
Madhya Pradesh,Betul,Multiple Disability,15,35,46,21,67
Madhya Pradesh,Betul,Multiple Disability,35,60,38,13,51
Madhya Pradesh,Betul,Multiple Disability,60,80,5,1,6
Madhya Pradesh,Betul,Multiple Disability,80,100,1,0,1
Karnataka,Bengaluru Urban,Multiple Disability,0,6,30,18,48
Karnataka,Bengaluru Urban,Multiple Disability,6,15,208,124,332
Karnataka,Bengaluru Urban,Multiple Disability,15,35,276,146,422
Karnataka,Bengaluru Urban,Multiple Disability,35,60,123,51,174
Karnataka,Bengaluru Urban,Multiple Disability,60,80,21,5,26
Karnataka,Bengaluru Urban,Multiple Disability,80,100,4,0,4
Karnataka,Bengaluru Rural,Multiple Disability,0,6,0,3,3
Karnataka,Bengaluru Rural,Multiple Disability,6,15,51,30,81
Karnataka,Bengaluru Rural,Multiple Disability,15,35,148,76,224
Karnataka,Bengaluru Rural,Multiple Disability,35,60,158,73,231
Karnataka,Bengaluru Rural,Multiple Disability,60,80,38,14,52
Chhattisgarh,Bemetara,Multiple Disability,0,6,1,1,2
Chhattisgarh,Bemetara,Multiple Disability,6,15,36,24,60
Chhattisgarh,Bemetara,Multiple Disability,15,35,70,46,116
Chhattisgarh,Bemetara,Multiple Disability,35,60,18,7,25
Chhattisgarh,Bemetara,Multiple Disability,60,80,4,1,5
Karnataka,Belagavi,Multiple Disability,0,6,25,14,39
Karnataka,Belagavi,Multiple Disability,6,15,102,58,160
Karnataka,Belagavi,Multiple Disability,15,35,149,72,221
Karnataka,Belagavi,Multiple Disability,35,60,163,67,230
Karnataka,Belagavi,Multiple Disability,60,80,55,7,62
Karnataka,Belagavi,Multiple Disability,80,100,3,0,3
Bihar,Begusarai,Multiple Disability,0,6,0,2,2
Bihar,Begusarai,Multiple Disability,6,15,25,12,37
Bihar,Begusarai,Multiple Disability,15,35,30,14,44
Bihar,Begusarai,Multiple Disability,35,60,22,2,24
Bihar,Begusarai,Multiple Disability,60,80,7,1,8
Maharashtra,Beed,Multiple Disability,0,6,6,0,6
Maharashtra,Beed,Multiple Disability,6,15,32,10,42
Maharashtra,Beed,Multiple Disability,15,35,48,20,68
Maharashtra,Beed,Multiple Disability,35,60,44,14,58
Maharashtra,Beed,Multiple Disability,60,80,15,2,17
Maharashtra,Beed,Multiple Disability,80,100,1,1,2
Punjab,Bathinda,Multiple Disability,0,6,1,1,2
Punjab,Bathinda,Multiple Disability,6,15,26,24,50
Punjab,Bathinda,Multiple Disability,15,35,82,39,121
Punjab,Bathinda,Multiple Disability,35,60,57,16,73
Punjab,Bathinda,Multiple Disability,60,80,19,0,19
Punjab,Bathinda,Multiple Disability,80,100,1,1,2
Uttar Pradesh,Basti,Multiple Disability,0,6,1,0,1
Uttar Pradesh,Basti,Multiple Disability,6,15,0,1,1
Uttar Pradesh,Basti,Multiple Disability,15,35,17,8,25
Uttar Pradesh,Basti,Multiple Disability,35,60,7,1,8
Uttar Pradesh,Basti,Multiple Disability,60,80,5,2,7
Chhattisgarh,Bastar,Multiple Disability,0,6,6,1,7
Chhattisgarh,Bastar,Multiple Disability,6,15,37,27,64
Chhattisgarh,Bastar,Multiple Disability,15,35,64,39,103
Chhattisgarh,Bastar,Multiple Disability,35,60,18,13,31
Chhattisgarh,Bastar,Multiple Disability,60,80,3,5,8
Chhattisgarh,Bastar,Multiple Disability,80,100,1,0,1
Madhya Pradesh,Barwani,Multiple Disability,6,15,20,17,37
Madhya Pradesh,Barwani,Multiple Disability,15,35,80,45,125
Madhya Pradesh,Barwani,Multiple Disability,35,60,72,45,117
Madhya Pradesh,Barwani,Multiple Disability,60,80,17,14,31
Madhya Pradesh,Barwani,Multiple Disability,80,100,1,1,2
Assam,Barpeta,Multiple Disability,6,15,4,2,6
Assam,Barpeta,Multiple Disability,15,35,6,2,8
Assam,Barpeta,Multiple Disability,35,60,2,3,5
Assam,Barpeta,Multiple Disability,60,80,1,2,3
Punjab,Barnala,Multiple Disability,0,6,1,1,2
Punjab,Barnala,Multiple Disability,6,15,13,6,19
Punjab,Barnala,Multiple Disability,15,35,30,10,40
Punjab,Barnala,Multiple Disability,35,60,38,9,47
Punjab,Barnala,Multiple Disability,60,80,13,2,15
Rajasthan,Barmer,Multiple Disability,0,6,1,0,1
Rajasthan,Barmer,Multiple Disability,6,15,12,4,16
Rajasthan,Barmer,Multiple Disability,15,35,65,24,89
Rajasthan,Barmer,Multiple Disability,35,60,48,12,60
Rajasthan,Barmer,Multiple Disability,60,80,11,4,15
Rajasthan,Barmer,Multiple Disability,80,100,1,1,2
Odisha,Bargarh,Multiple Disability,0,6,3,4,7
Odisha,Bargarh,Multiple Disability,6,15,19,19,38
Odisha,Bargarh,Multiple Disability,15,35,57,51,108
Odisha,Bargarh,Multiple Disability,35,60,42,33,75
Odisha,Bargarh,Multiple Disability,60,80,14,5,19
Odisha,Bargarh,Multiple Disability,80,100,2,0,2
Uttar Pradesh,Bareilly,Multiple Disability,0,6,2,1,3
Uttar Pradesh,Bareilly,Multiple Disability,6,15,35,22,57
Uttar Pradesh,Bareilly,Multiple Disability,15,35,244,91,335
Uttar Pradesh,Bareilly,Multiple Disability,35,60,162,36,198
Uttar Pradesh,Bareilly,Multiple Disability,60,80,26,6,32
Rajasthan,Baran,Multiple Disability,0,6,1,0,1
Rajasthan,Baran,Multiple Disability,6,15,9,3,12
Rajasthan,Baran,Multiple Disability,15,35,10,11,21
Rajasthan,Baran,Multiple Disability,35,60,10,3,13
Rajasthan,Baran,Multiple Disability,60,80,2,3,5
Rajasthan,Baran,Multiple Disability,80,100,1,1,2
Jammu And Kashmir,Baramulla,Multiple Disability,0,6,2,1,3
Jammu And Kashmir,Baramulla,Multiple Disability,6,15,21,15,36
Jammu And Kashmir,Baramulla,Multiple Disability,15,35,55,38,93
Jammu And Kashmir,Baramulla,Multiple Disability,35,60,41,17,58
Jammu And Kashmir,Baramulla,Multiple Disability,60,80,8,5,13
Jammu And Kashmir,Baramulla,Multiple Disability,80,100,2,0,2
Uttar Pradesh,Barabanki,Multiple Disability,0,6,0,1,1
Uttar Pradesh,Barabanki,Multiple Disability,6,15,10,5,15
Uttar Pradesh,Barabanki,Multiple Disability,15,35,68,22,90
Uttar Pradesh,Barabanki,Multiple Disability,35,60,84,20,104
Uttar Pradesh,Barabanki,Multiple Disability,60,80,24,1,25
Uttar Pradesh,Barabanki,Multiple Disability,80,100,0,1,1
Rajasthan,Banswara,Multiple Disability,0,6,1,1,2
Rajasthan,Banswara,Multiple Disability,6,15,14,18,32
Rajasthan,Banswara,Multiple Disability,15,35,30,20,50
Rajasthan,Banswara,Multiple Disability,35,60,21,6,27
Rajasthan,Banswara,Multiple Disability,60,80,8,3,11
Rajasthan,Banswara,Multiple Disability,80,100,0,1,1
West Bengal,Bankura,Multiple Disability,35,60,1,0,1
Bihar,Banka,Multiple Disability,0,6,2,0,2
Bihar,Banka,Multiple Disability,6,15,23,13,36
Bihar,Banka,Multiple Disability,15,35,63,25,88
Bihar,Banka,Multiple Disability,35,60,41,18,59
Bihar,Banka,Multiple Disability,60,80,5,3,8
Bihar,Banka,Multiple Disability,80,100,2,0,2
Jammu And Kashmir,Bandipora,Multiple Disability,0,6,30,23,53
Jammu And Kashmir,Bandipora,Multiple Disability,6,15,90,88,178
Jammu And Kashmir,Bandipora,Multiple Disability,15,35,225,203,428
Jammu And Kashmir,Bandipora,Multiple Disability,35,60,152,111,263
Jammu And Kashmir,Bandipora,Multiple Disability,60,80,23,20,43
Jammu And Kashmir,Bandipora,Multiple Disability,80,100,1,1,2
Uttar Pradesh,Banda,Multiple Disability,0,6,3,3,6
Uttar Pradesh,Banda,Multiple Disability,6,15,39,30,69
Uttar Pradesh,Banda,Multiple Disability,15,35,96,45,141
Uttar Pradesh,Banda,Multiple Disability,35,60,78,27,105
Uttar Pradesh,Banda,Multiple Disability,60,80,22,1,23
Uttar Pradesh,Banda,Multiple Disability,80,100,3,0,3
Gujarat,Banas Kantha,Multiple Disability,0,6,57,40,97
Gujarat,Banas Kantha,Multiple Disability,6,15,419,254,673
Gujarat,Banas Kantha,Multiple Disability,15,35,423,205,628
Gujarat,Banas Kantha,Multiple Disability,35,60,102,51,153
Gujarat,Banas Kantha,Multiple Disability,60,80,14,4,18
Gujarat,Banas Kantha,Multiple Disability,80,100,1,0,1
Chhattisgarh,Balrampur,Multiple Disability,0,6,2,1,3
Chhattisgarh,Balrampur,Multiple Disability,6,15,53,44,97
Chhattisgarh,Balrampur,Multiple Disability,15,35,75,44,119
Chhattisgarh,Balrampur,Multiple Disability,35,60,29,18,47
Chhattisgarh,Balrampur,Multiple Disability,60,80,3,3,6
Chhattisgarh,Balrampur,Multiple Disability,80,100,1,0,1
Uttar Pradesh,Balrampur,Multiple Disability,0,6,5,2,7
Uttar Pradesh,Balrampur,Multiple Disability,6,15,43,23,66
Uttar Pradesh,Balrampur,Multiple Disability,15,35,102,44,146
Uttar Pradesh,Balrampur,Multiple Disability,35,60,42,19,61
Uttar Pradesh,Balrampur,Multiple Disability,60,80,12,4,16
Uttar Pradesh,Balrampur,Multiple Disability,80,100,1,0,1
Chhattisgarh,Baloda Bazar,Multiple Disability,6,15,18,8,26
Chhattisgarh,Baloda Bazar,Multiple Disability,15,35,38,43,81
Chhattisgarh,Baloda Bazar,Multiple Disability,35,60,43,19,62
Chhattisgarh,Baloda Bazar,Multiple Disability,60,80,5,1,6
Chhattisgarh,Balod,Multiple Disability,6,15,7,0,7
Chhattisgarh,Balod,Multiple Disability,15,35,8,7,15
Chhattisgarh,Balod,Multiple Disability,35,60,8,4,12
Chhattisgarh,Balod,Multiple Disability,60,80,1,1,2
Uttar Pradesh,Ballia,Multiple Disability,0,6,0,1,1
Uttar Pradesh,Ballia,Multiple Disability,6,15,8,7,15
Uttar Pradesh,Ballia,Multiple Disability,15,35,66,17,83
Uttar Pradesh,Ballia,Multiple Disability,35,60,41,8,49
Uttar Pradesh,Ballia,Multiple Disability,60,80,14,2,16
Karnataka,Ballari,Multiple Disability,0,6,15,12,27
Karnataka,Ballari,Multiple Disability,6,15,189,102,291
Karnataka,Ballari,Multiple Disability,15,35,270,156,426
Karnataka,Ballari,Multiple Disability,35,60,196,107,303
Karnataka,Ballari,Multiple Disability,60,80,27,8,35
Karnataka,Ballari,Multiple Disability,80,100,3,0,3
Odisha,Baleshwar,Multiple Disability,0,6,0,2,2
Odisha,Baleshwar,Multiple Disability,6,15,19,17,36
Odisha,Baleshwar,Multiple Disability,15,35,79,39,118
Odisha,Baleshwar,Multiple Disability,35,60,59,44,103
Odisha,Baleshwar,Multiple Disability,60,80,24,8,32
Odisha,Baleshwar,Multiple Disability,80,100,1,0,1
Odisha,Balangir,Multiple Disability,0,6,2,2,4
Odisha,Balangir,Multiple Disability,6,15,22,15,37
Odisha,Balangir,Multiple Disability,15,35,49,42,91
Odisha,Balangir,Multiple Disability,35,60,37,11,48
Odisha,Balangir,Multiple Disability,60,80,7,5,12
Odisha,Balangir,Multiple Disability,80,100,0,1,1
Madhya Pradesh,Balaghat,Multiple Disability,0,6,49,22,71
Madhya Pradesh,Balaghat,Multiple Disability,6,15,112,87,199
Madhya Pradesh,Balaghat,Multiple Disability,15,35,137,72,209
Madhya Pradesh,Balaghat,Multiple Disability,35,60,94,41,135
Madhya Pradesh,Balaghat,Multiple Disability,60,80,25,7,32
Madhya Pradesh,Balaghat,Multiple Disability,80,100,1,0,1
Assam,Baksa,Multiple Disability,0,6,0,2,2
Assam,Baksa,Multiple Disability,6,15,4,3,7
Assam,Baksa,Multiple Disability,15,35,5,8,13
Assam,Baksa,Multiple Disability,35,60,4,5,9
Assam,Baksa,Multiple Disability,60,80,1,1,2
Assam,Bajali,Multiple Disability,60,80,1,0,1
Uttar Pradesh,Bahraich,Multiple Disability,6,15,7,5,12
Uttar Pradesh,Bahraich,Multiple Disability,15,35,23,7,30
Uttar Pradesh,Bahraich,Multiple Disability,35,60,29,6,35
Uttar Pradesh,Bahraich,Multiple Disability,60,80,8,0,8
Uttar Pradesh,Bahraich,Multiple Disability,80,100,1,0,1
Uttar Pradesh,Baghpat,Multiple Disability,6,15,1,1,2
Uttar Pradesh,Baghpat,Multiple Disability,15,35,22,4,26
Uttar Pradesh,Baghpat,Multiple Disability,35,60,9,3,12
Uttar Pradesh,Baghpat,Multiple Disability,60,80,3,1,4
Uttar Pradesh,Baghpat,Multiple Disability,80,100,1,0,1
Uttarakhand,Bageshwar,Multiple Disability,0,6,1,0,1
Uttarakhand,Bageshwar,Multiple Disability,6,15,6,5,11
Uttarakhand,Bageshwar,Multiple Disability,15,35,23,20,43
Uttarakhand,Bageshwar,Multiple Disability,35,60,30,20,50
Uttarakhand,Bageshwar,Multiple Disability,60,80,2,2,4
Karnataka,Bagalkote,Multiple Disability,0,6,18,20,38
Karnataka,Bagalkote,Multiple Disability,6,15,187,115,302
Karnataka,Bagalkote,Multiple Disability,15,35,263,199,462
Karnataka,Bagalkote,Multiple Disability,35,60,180,86,266
Karnataka,Bagalkote,Multiple Disability,60,80,26,17,43
Uttar Pradesh,Azamgarh,Multiple Disability,15,35,9,2,11
Uttar Pradesh,Azamgarh,Multiple Disability,35,60,2,1,3
Uttar Pradesh,Ayodhya,Multiple Disability,6,15,3,1,4
Uttar Pradesh,Ayodhya,Multiple Disability,15,35,30,11,41
Uttar Pradesh,Ayodhya,Multiple Disability,35,60,13,5,18
Uttar Pradesh,Ayodhya,Multiple Disability,60,80,5,1,6
Uttar Pradesh,Ayodhya,Multiple Disability,80,100,1,0,1
Bihar,Aurangabad,Multiple Disability,6,15,2,0,2
Bihar,Aurangabad,Multiple Disability,15,35,4,0,4
Maharashtra,Aurangabad,Multiple Disability,0,6,11,5,16
Maharashtra,Aurangabad,Multiple Disability,6,15,68,17,85
Maharashtra,Aurangabad,Multiple Disability,15,35,35,16,51
Maharashtra,Aurangabad,Multiple Disability,35,60,17,4,21
Maharashtra,Aurangabad,Multiple Disability,60,80,3,0,3
Maharashtra,Aurangabad,Multiple Disability,80,100,1,0,1
Uttar Pradesh,Auraiya,Multiple Disability,6,15,21,20,41
Uttar Pradesh,Auraiya,Multiple Disability,15,35,87,32,119
Uttar Pradesh,Auraiya,Multiple Disability,35,60,68,15,83
Uttar Pradesh,Auraiya,Multiple Disability,60,80,35,4,39
Uttar Pradesh,Auraiya,Multiple Disability,80,100,1,1,2
Madhya Pradesh,Ashoknagar,Multiple Disability,6,15,4,2,6
Madhya Pradesh,Ashoknagar,Multiple Disability,15,35,28,14,42
Madhya Pradesh,Ashoknagar,Multiple Disability,35,60,47,12,59
Madhya Pradesh,Ashoknagar,Multiple Disability,60,80,31,5,36
Madhya Pradesh,Ashoknagar,Multiple Disability,80,100,3,1,4
Bihar,Arwal,Multiple Disability,0,6,4,0,4
Bihar,Arwal,Multiple Disability,6,15,2,3,5
Bihar,Arwal,Multiple Disability,15,35,13,1,14
Bihar,Arwal,Multiple Disability,35,60,7,0,7
Bihar,Arwal,Multiple Disability,60,80,1,0,1
Gujarat,Arvalli,Multiple Disability,0,6,14,5,19
Gujarat,Arvalli,Multiple Disability,6,15,93,53,146
Gujarat,Arvalli,Multiple Disability,15,35,88,40,128
Gujarat,Arvalli,Multiple Disability,35,60,15,6,21
Gujarat,Arvalli,Multiple Disability,60,80,3,0,3
Gujarat,Arvalli,Multiple Disability,80,100,1,0,1
Tamil Nadu,Ariyalur,Multiple Disability,0,6,14,6,20
Tamil Nadu,Ariyalur,Multiple Disability,6,15,80,41,121
Tamil Nadu,Ariyalur,Multiple Disability,15,35,68,43,111
Tamil Nadu,Ariyalur,Multiple Disability,35,60,16,17,33
Tamil Nadu,Ariyalur,Multiple Disability,60,80,6,0,6
Tamil Nadu,Ariyalur,Multiple Disability,80,100,1,0,1
Bihar,Araria,Multiple Disability,0,6,1,1,2
Bihar,Araria,Multiple Disability,6,15,10,17,27
Bihar,Araria,Multiple Disability,15,35,26,13,39
Bihar,Araria,Multiple Disability,35,60,20,4,24
Bihar,Araria,Multiple Disability,60,80,1,1,2
Bihar,Araria,Multiple Disability,80,100,0,1,1
Madhya Pradesh,Anuppur,Multiple Disability,0,6,0,1,1
Madhya Pradesh,Anuppur,Multiple Disability,6,15,8,4,12
Madhya Pradesh,Anuppur,Multiple Disability,15,35,14,15,29
Madhya Pradesh,Anuppur,Multiple Disability,35,60,17,5,22
Madhya Pradesh,Anuppur,Multiple Disability,60,80,2,2,4
Odisha,Anugul,Multiple Disability,0,6,2,1,3
Odisha,Anugul,Multiple Disability,6,15,12,3,15
Odisha,Anugul,Multiple Disability,15,35,42,20,62
Odisha,Anugul,Multiple Disability,35,60,44,18,62
Odisha,Anugul,Multiple Disability,60,80,15,4,19
Arunachal Pradesh,Anjaw,Multiple Disability,6,15,1,0,1
Arunachal Pradesh,Anjaw,Multiple Disability,15,35,2,0,2
Arunachal Pradesh,Anjaw,Multiple Disability,35,60,2,1,3
Arunachal Pradesh,Anjaw,Multiple Disability,60,80,1,0,1
Jammu And Kashmir,Anantnag,Multiple Disability,0,6,3,2,5
Jammu And Kashmir,Anantnag,Multiple Disability,6,15,16,10,26
Jammu And Kashmir,Anantnag,Multiple Disability,15,35,30,20,50
Jammu And Kashmir,Anantnag,Multiple Disability,35,60,52,26,78
Jammu And Kashmir,Anantnag,Multiple Disability,60,80,11,5,16
Jammu And Kashmir,Anantnag,Multiple Disability,80,100,2,0,2
Andhra Pradesh,Anantapur,Multiple Disability,6,15,12,2,14
Andhra Pradesh,Anantapur,Multiple Disability,15,35,19,6,25
Andhra Pradesh,Anantapur,Multiple Disability,35,60,8,2,10
Andhra Pradesh,Anantapur,Multiple Disability,60,80,1,1,2
Gujarat,Anand,Multiple Disability,0,6,46,32,78
Gujarat,Anand,Multiple Disability,6,15,349,209,558
Gujarat,Anand,Multiple Disability,15,35,268,146,414
Gujarat,Anand,Multiple Disability,35,60,79,43,122
Gujarat,Anand,Multiple Disability,60,80,14,2,16
Gujarat,Anand,Multiple Disability,80,100,3,0,3
Uttar Pradesh,Amroha,Multiple Disability,0,6,1,2,3
Uttar Pradesh,Amroha,Multiple Disability,6,15,15,6,21
Uttar Pradesh,Amroha,Multiple Disability,15,35,129,56,185
Uttar Pradesh,Amroha,Multiple Disability,35,60,86,23,109
Uttar Pradesh,Amroha,Multiple Disability,60,80,16,4,20
Uttar Pradesh,Amroha,Multiple Disability,80,100,3,1,4
Punjab,Amritsar,Multiple Disability,0,6,2,3,5
Punjab,Amritsar,Multiple Disability,6,15,12,2,14
Punjab,Amritsar,Multiple Disability,15,35,42,20,62
Punjab,Amritsar,Multiple Disability,35,60,49,13,62
Punjab,Amritsar,Multiple Disability,60,80,16,2,18
Gujarat,Amreli,Multiple Disability,0,6,4,6,10
Gujarat,Amreli,Multiple Disability,6,15,49,35,84
Gujarat,Amreli,Multiple Disability,15,35,70,45,115
Gujarat,Amreli,Multiple Disability,35,60,32,13,45
Gujarat,Amreli,Multiple Disability,60,80,8,1,9
Maharashtra,Amravati,Multiple Disability,0,6,1,0,1
Maharashtra,Amravati,Multiple Disability,6,15,10,6,16
Maharashtra,Amravati,Multiple Disability,15,35,39,21,60
Maharashtra,Amravati,Multiple Disability,35,60,61,25,86
Maharashtra,Amravati,Multiple Disability,60,80,27,3,30
Maharashtra,Amravati,Multiple Disability,80,100,2,0,2
Uttar Pradesh,Amethi,Multiple Disability,15,35,5,4,9
Uttar Pradesh,Amethi,Multiple Disability,35,60,4,0,4
Uttar Pradesh,Amethi,Multiple Disability,60,80,2,0,2
Uttar Pradesh,Ambedkar Nagar,Multiple Disability,0,6,2,1,3
Uttar Pradesh,Ambedkar Nagar,Multiple Disability,6,15,14,15,29
Uttar Pradesh,Ambedkar Nagar,Multiple Disability,15,35,101,38,139
Uttar Pradesh,Ambedkar Nagar,Multiple Disability,35,60,74,25,99
Uttar Pradesh,Ambedkar Nagar,Multiple Disability,60,80,16,2,18
Haryana,Ambala,Multiple Disability,0,6,5,7,12
Haryana,Ambala,Multiple Disability,6,15,42,29,71
Haryana,Ambala,Multiple Disability,15,35,87,36,123
Haryana,Ambala,Multiple Disability,35,60,62,19,81
Haryana,Ambala,Multiple Disability,60,80,16,8,24
Haryana,Ambala,Multiple Disability,80,100,2,0,2
Rajasthan,Alwar,Multiple Disability,0,6,3,1,4
Rajasthan,Alwar,Multiple Disability,6,15,39,20,59
Rajasthan,Alwar,Multiple Disability,15,35,109,45,154
Rajasthan,Alwar,Multiple Disability,35,60,70,21,91
Rajasthan,Alwar,Multiple Disability,60,80,17,8,25
Rajasthan,Alwar,Multiple Disability,80,100,1,3,4
Uttarakhand,Almora,Multiple Disability,15,35,14,0,14
Uttarakhand,Almora,Multiple Disability,35,60,7,7,14
Uttarakhand,Almora,Multiple Disability,60,80,1,2,3
Madhya Pradesh,Alirajpur,Multiple Disability,6,15,40,38,78
Madhya Pradesh,Alirajpur,Multiple Disability,15,35,83,62,145
Madhya Pradesh,Alirajpur,Multiple Disability,35,60,49,24,73
Madhya Pradesh,Alirajpur,Multiple Disability,60,80,12,7,19
Uttar Pradesh,Aligarh,Multiple Disability,0,6,0,2,2
Uttar Pradesh,Aligarh,Multiple Disability,6,15,21,9,30
Uttar Pradesh,Aligarh,Multiple Disability,15,35,55,25,80
Uttar Pradesh,Aligarh,Multiple Disability,35,60,35,15,50
Uttar Pradesh,Aligarh,Multiple Disability,60,80,13,3,16
Uttar Pradesh,Aligarh,Multiple Disability,80,100,3,1,4
Kerala,Alappuzha,Multiple Disability,0,6,4,3,7
Kerala,Alappuzha,Multiple Disability,6,15,34,20,54
Kerala,Alappuzha,Multiple Disability,15,35,102,41,143
Kerala,Alappuzha,Multiple Disability,35,60,74,59,133
Kerala,Alappuzha,Multiple Disability,60,80,13,14,27
Kerala,Alappuzha,Multiple Disability,80,100,1,0,1
Maharashtra,Akola,Multiple Disability,0,6,94,54,148
Maharashtra,Akola,Multiple Disability,6,15,252,178,430
Maharashtra,Akola,Multiple Disability,15,35,232,146,378
Maharashtra,Akola,Multiple Disability,35,60,229,90,319
Maharashtra,Akola,Multiple Disability,60,80,84,33,117
Maharashtra,Akola,Multiple Disability,80,100,3,3,6
Rajasthan,Ajmer,Multiple Disability,6,15,13,10,23
Rajasthan,Ajmer,Multiple Disability,15,35,26,20,46
Rajasthan,Ajmer,Multiple Disability,35,60,26,9,35
Rajasthan,Ajmer,Multiple Disability,60,80,4,6,10
Mizoram,Aizawl,Multiple Disability,0,6,4,1,5
Mizoram,Aizawl,Multiple Disability,6,15,11,13,24
Mizoram,Aizawl,Multiple Disability,15,35,22,15,37
Mizoram,Aizawl,Multiple Disability,35,60,22,7,29
Mizoram,Aizawl,Multiple Disability,60,80,6,3,9
Mizoram,Aizawl,Multiple Disability,80,100,2,1,3
Maharashtra,Ahmednagar,Multiple Disability,0,6,19,4,23
Maharashtra,Ahmednagar,Multiple Disability,6,15,42,15,57
Maharashtra,Ahmednagar,Multiple Disability,15,35,56,20,76
Maharashtra,Ahmednagar,Multiple Disability,35,60,35,9,44
Maharashtra,Ahmednagar,Multiple Disability,60,80,6,0,6
Maharashtra,Ahmednagar,Multiple Disability,80,100,1,0,1
Gujarat,Ahmadabad,Multiple Disability,0,6,61,28,89
Gujarat,Ahmadabad,Multiple Disability,6,15,395,161,556
Gujarat,Ahmadabad,Multiple Disability,15,35,309,165,474
Gujarat,Ahmadabad,Multiple Disability,35,60,64,16,80
Gujarat,Ahmadabad,Multiple Disability,60,80,10,4,14
Uttar Pradesh,Agra,Multiple Disability,0,6,0,1,1
Uttar Pradesh,Agra,Multiple Disability,6,15,4,2,6
Uttar Pradesh,Agra,Multiple Disability,15,35,22,7,29
Uttar Pradesh,Agra,Multiple Disability,35,60,9,1,10
Uttar Pradesh,Agra,Multiple Disability,60,80,1,1,2
Uttar Pradesh,Agra,Multiple Disability,80,100,0,1,1
Madhya Pradesh,Agar Malwa,Multiple Disability,0,6,15,11,26
Madhya Pradesh,Agar Malwa,Multiple Disability,6,15,81,47,128
Madhya Pradesh,Agar Malwa,Multiple Disability,15,35,48,34,82
Madhya Pradesh,Agar Malwa,Multiple Disability,35,60,27,13,40
Madhya Pradesh,Agar Malwa,Multiple Disability,60,80,9,2,11
Madhya Pradesh,Agar Malwa,Multiple Disability,80,100,0,1,1
West Bengal,24 Paraganas South,Multiple Disability,6,15,1,1,2
West Bengal,24 Paraganas South,Multiple Disability,15,35,3,0,3
West Bengal,24 Paraganas South,Multiple Disability,35,60,2,1,3
Maharashtra,Yavatmal,Multiple Sclerosis,15,35,1,2,3
Maharashtra,Yavatmal,Multiple Sclerosis,35,60,2,1,3
Puducherry,Yanam,Multiple Sclerosis,15,35,1,0,1
Puducherry,Yanam,Multiple Sclerosis,35,60,0,1,1
Haryana,Yamunanagar,Multiple Sclerosis,15,35,1,2,3
Haryana,Yamunanagar,Multiple Sclerosis,35,60,1,2,3
Haryana,Yamunanagar,Multiple Sclerosis,60,80,1,0,1
Karnataka,Yadgir,Multiple Sclerosis,15,35,0,1,1
Karnataka,Yadgir,Multiple Sclerosis,35,60,1,0,1
Jharkhand,West Singhbhum,Multiple Sclerosis,6,15,2,0,2
Jharkhand,West Singhbhum,Multiple Sclerosis,15,35,0,1,1
Delhi,West,Multiple Sclerosis,15,35,2,1,3
Delhi,West,Multiple Sclerosis,35,60,3,2,5
Delhi,West,Multiple Sclerosis,60,80,1,1,2
Kerala,Wayanad,Multiple Sclerosis,35,60,1,0,1
Maharashtra,Washim,Multiple Sclerosis,15,35,0,1,1
Maharashtra,Washim,Multiple Sclerosis,35,60,1,0,1
Maharashtra,Washim,Multiple Sclerosis,60,80,1,0,1
Maharashtra,Wardha,Multiple Sclerosis,15,35,1,0,1
Maharashtra,Wardha,Multiple Sclerosis,35,60,1,1,2
Tamil Nadu,Virudhunagar,Multiple Sclerosis,0,6,0,1,1
Tamil Nadu,Virudhunagar,Multiple Sclerosis,6,15,4,2,6
Tamil Nadu,Virudhunagar,Multiple Sclerosis,15,35,10,4,14
Tamil Nadu,Virudhunagar,Multiple Sclerosis,35,60,3,1,4
Tamil Nadu,Villupuram,Multiple Sclerosis,6,15,2,0,2
Tamil Nadu,Villupuram,Multiple Sclerosis,15,35,2,0,2
Tamil Nadu,Villupuram,Multiple Sclerosis,35,60,0,1,1
Tamil Nadu,Villupuram,Multiple Sclerosis,60,80,1,0,1
Karnataka,Vijayapura,Multiple Sclerosis,6,15,0,1,1
Karnataka,Vijayapura,Multiple Sclerosis,15,35,1,1,2
Karnataka,Vijayapura,Multiple Sclerosis,35,60,2,0,2
Madhya Pradesh,Vidisha,Multiple Sclerosis,6,15,8,4,12
Madhya Pradesh,Vidisha,Multiple Sclerosis,15,35,45,14,59
Madhya Pradesh,Vidisha,Multiple Sclerosis,35,60,31,16,47
Madhya Pradesh,Vidisha,Multiple Sclerosis,60,80,9,1,10
Madhya Pradesh,Vidisha,Multiple Sclerosis,80,100,1,0,1
Tamil Nadu,Vellore,Multiple Sclerosis,6,15,1,2,3
Tamil Nadu,Vellore,Multiple Sclerosis,15,35,10,4,14
Tamil Nadu,Vellore,Multiple Sclerosis,35,60,10,5,15
Tamil Nadu,Vellore,Multiple Sclerosis,60,80,2,0,2
Tamil Nadu,Vellore,Multiple Sclerosis,80,100,1,0,1
Uttar Pradesh,Varanasi,Multiple Sclerosis,15,35,1,0,1
Uttar Pradesh,Varanasi,Multiple Sclerosis,35,60,1,0,1
Uttar Pradesh,Varanasi,Multiple Sclerosis,60,80,1,0,1
Gujarat,Valsad,Multiple Sclerosis,35,60,1,0,1
Bihar,Vaishali,Multiple Sclerosis,6,15,1,1,2
Bihar,Vaishali,Multiple Sclerosis,15,35,9,5,14
Bihar,Vaishali,Multiple Sclerosis,35,60,6,1,7
Bihar,Vaishali,Multiple Sclerosis,60,80,4,0,4
Gujarat,Vadodara,Multiple Sclerosis,35,60,1,0,1
Karnataka,Uttara Kannada,Multiple Sclerosis,35,60,0,2,2
Uttarakhand,Uttar Kashi,Multiple Sclerosis,15,35,6,0,6
Uttarakhand,Uttar Kashi,Multiple Sclerosis,35,60,16,7,23
Uttarakhand,Uttar Kashi,Multiple Sclerosis,60,80,1,0,1
Uttar Pradesh,Unnao,Multiple Sclerosis,15,35,4,1,5
Uttar Pradesh,Unnao,Multiple Sclerosis,35,60,7,1,8
Uttar Pradesh,Unnao,Multiple Sclerosis,60,80,1,2,3
Himachal Pradesh,Una,Multiple Sclerosis,15,35,2,1,3
Himachal Pradesh,Una,Multiple Sclerosis,35,60,1,0,1
Himachal Pradesh,Una,Multiple Sclerosis,60,80,2,1,3
Madhya Pradesh,Umaria,Multiple Sclerosis,6,15,3,0,3
Madhya Pradesh,Umaria,Multiple Sclerosis,15,35,5,0,5
Madhya Pradesh,Umaria,Multiple Sclerosis,35,60,1,2,3
Madhya Pradesh,Ujjain,Multiple Sclerosis,15,35,1,1,2
Madhya Pradesh,Ujjain,Multiple Sclerosis,35,60,3,1,4
Karnataka,Udupi,Multiple Sclerosis,15,35,1,1,2
Karnataka,Udupi,Multiple Sclerosis,35,60,2,1,3
Karnataka,Udupi,Multiple Sclerosis,60,80,1,0,1
Jammu And Kashmir,Udhampur,Multiple Sclerosis,35,60,0,1,1
Uttarakhand,Udam Singh Nagar,Multiple Sclerosis,0,6,2,1,3
Uttarakhand,Udam Singh Nagar,Multiple Sclerosis,6,15,26,13,39
Uttarakhand,Udam Singh Nagar,Multiple Sclerosis,15,35,198,104,302
Uttarakhand,Udam Singh Nagar,Multiple Sclerosis,35,60,169,52,221
Uttarakhand,Udam Singh Nagar,Multiple Sclerosis,60,80,14,3,17
Assam,Udalguri,Multiple Sclerosis,15,35,1,1,2
Assam,Udalguri,Multiple Sclerosis,35,60,2,2,4
Rajasthan,Udaipur,Multiple Sclerosis,6,15,0,1,1
Rajasthan,Udaipur,Multiple Sclerosis,15,35,0,3,3
Rajasthan,Udaipur,Multiple Sclerosis,35,60,0,1,1
Rajasthan,Udaipur,Multiple Sclerosis,60,80,1,2,3
Tamil Nadu,Tuticorin,Multiple Sclerosis,15,35,2,0,2
Tamil Nadu,Tuticorin,Multiple Sclerosis,35,60,2,2,4
Karnataka,Tumakuru,Multiple Sclerosis,0,6,1,3,4
Karnataka,Tumakuru,Multiple Sclerosis,6,15,10,3,13
Karnataka,Tumakuru,Multiple Sclerosis,15,35,18,9,27
Karnataka,Tumakuru,Multiple Sclerosis,35,60,21,11,32
Karnataka,Tumakuru,Multiple Sclerosis,60,80,3,1,4
Rajasthan,Tonk,Multiple Sclerosis,15,35,1,0,1
Rajasthan,Tonk,Multiple Sclerosis,60,80,1,0,1
Tamil Nadu,Tiruvannamalai,Multiple Sclerosis,0,6,0,1,1
Tamil Nadu,Tiruvannamalai,Multiple Sclerosis,6,15,1,0,1
Tamil Nadu,Tiruvannamalai,Multiple Sclerosis,15,35,8,1,9
Tamil Nadu,Tiruvannamalai,Multiple Sclerosis,35,60,0,2,2
Tamil Nadu,Tiruvannamalai,Multiple Sclerosis,60,80,3,1,4
Tamil Nadu,Tirupathur,Multiple Sclerosis,15,35,2,2,4
Tamil Nadu,Tiruchirappalli,Multiple Sclerosis,6,15,0,1,1
Tamil Nadu,Tiruchirappalli,Multiple Sclerosis,15,35,2,2,4
Tamil Nadu,Tiruchirappalli,Multiple Sclerosis,60,80,1,0,1
Kerala,Thrissur,Multiple Sclerosis,15,35,1,0,1
Kerala,Thrissur,Multiple Sclerosis,35,60,3,3,6
Tamil Nadu,Thiruvarur,Multiple Sclerosis,15,35,1,0,1
Kerala,Thiruvananthapuram,Multiple Sclerosis,15,35,2,7,9
Kerala,Thiruvananthapuram,Multiple Sclerosis,35,60,5,8,13
Tamil Nadu,Thiruvallur,Multiple Sclerosis,15,35,3,3,6
Tamil Nadu,Thiruvallur,Multiple Sclerosis,35,60,4,8,12
Tamil Nadu,Thiruvallur,Multiple Sclerosis,60,80,0,1,1
Tamil Nadu,Theni,Multiple Sclerosis,15,35,1,1,2
Tamil Nadu,Theni,Multiple Sclerosis,35,60,1,0,1
Tamil Nadu,Theni,Multiple Sclerosis,60,80,1,0,1
Tamil Nadu,The Nilgiris,Multiple Sclerosis,35,60,2,0,2
Tamil Nadu,The Nilgiris,Multiple Sclerosis,60,80,1,0,1
Tamil Nadu,Thanjavur,Multiple Sclerosis,15,35,1,1,2
Tamil Nadu,Thanjavur,Multiple Sclerosis,35,60,0,3,3
Maharashtra,Thane,Multiple Sclerosis,6,15,0,1,1
Maharashtra,Thane,Multiple Sclerosis,15,35,3,2,5
Maharashtra,Thane,Multiple Sclerosis,35,60,6,4,10
Maharashtra,Thane,Multiple Sclerosis,60,80,6,0,6
Tamil Nadu,Tenkasi,Multiple Sclerosis,6,15,1,0,1
Uttarakhand,Tehri Garhwal,Multiple Sclerosis,6,15,0,1,1
Uttarakhand,Tehri Garhwal,Multiple Sclerosis,15,35,1,2,3
Uttarakhand,Tehri Garhwal,Multiple Sclerosis,35,60,0,1,1
Punjab,Tarn Taran,Multiple Sclerosis,6,15,1,3,4
Punjab,Tarn Taran,Multiple Sclerosis,15,35,4,1,5
Punjab,Tarn Taran,Multiple Sclerosis,35,60,6,1,7
Punjab,Tarn Taran,Multiple Sclerosis,60,80,2,0,2
Gujarat,Tapi,Multiple Sclerosis,15,35,3,0,3
Chhattisgarh,Surguja,Multiple Sclerosis,6,15,1,0,1
Chhattisgarh,Surguja,Multiple Sclerosis,15,35,1,0,1
Chhattisgarh,Surguja,Multiple Sclerosis,35,60,1,0,1
Gujarat,Surendranagar,Multiple Sclerosis,6,15,0,1,1
Gujarat,Surendranagar,Multiple Sclerosis,15,35,2,1,3
Gujarat,Surendranagar,Multiple Sclerosis,60,80,0,1,1
Gujarat,Surat,Multiple Sclerosis,15,35,2,2,4
Gujarat,Surat,Multiple Sclerosis,35,60,2,1,3
Chhattisgarh,Surajpur,Multiple Sclerosis,6,15,6,6,12
Chhattisgarh,Surajpur,Multiple Sclerosis,15,35,23,19,42
Chhattisgarh,Surajpur,Multiple Sclerosis,35,60,5,5,10
Chhattisgarh,Surajpur,Multiple Sclerosis,60,80,1,0,1
Bihar,Supaul,Multiple Sclerosis,15,35,2,0,2
Odisha,Sundargarh,Multiple Sclerosis,6,15,0,1,1
Odisha,Sundargarh,Multiple Sclerosis,15,35,1,0,1
Odisha,Sundargarh,Multiple Sclerosis,35,60,7,3,10
Odisha,Sundargarh,Multiple Sclerosis,60,80,2,0,2
Uttar Pradesh,Sultanpur,Multiple Sclerosis,6,15,3,1,4
Uttar Pradesh,Sultanpur,Multiple Sclerosis,15,35,9,3,12
Uttar Pradesh,Sultanpur,Multiple Sclerosis,35,60,14,1,15
Jammu And Kashmir,Srinagar,Multiple Sclerosis,6,15,0,1,1
Jammu And Kashmir,Srinagar,Multiple Sclerosis,15,35,1,2,3
Jammu And Kashmir,Srinagar,Multiple Sclerosis,35,60,1,1,2
Punjab,Sri Muktsar Sahib,Multiple Sclerosis,6,15,1,1,2
Punjab,Sri Muktsar Sahib,Multiple Sclerosis,15,35,5,3,8
Punjab,Sri Muktsar Sahib,Multiple Sclerosis,35,60,13,6,19
Punjab,Sri Muktsar Sahib,Multiple Sclerosis,60,80,1,3,4
Delhi,South West,Multiple Sclerosis,15,35,2,0,2
Delhi,South West,Multiple Sclerosis,35,60,1,0,1
Goa,South Goa,Multiple Sclerosis,35,60,0,1,1
Goa,South Goa,Multiple Sclerosis,60,80,0,1,1
Delhi,South East,Multiple Sclerosis,15,35,0,1,1
Delhi,South East,Multiple Sclerosis,35,60,1,0,1
Andaman And Nicobar Islands,South Andamans,Multiple Sclerosis,15,35,0,1,1
Andaman And Nicobar Islands,South Andamans,Multiple Sclerosis,35,60,2,2,4
Delhi,South,Multiple Sclerosis,15,35,0,1,1
Delhi,South,Multiple Sclerosis,35,60,0,2,2
Assam,Sonitpur,Multiple Sclerosis,15,35,1,1,2
Haryana,Sonipat,Multiple Sclerosis,15,35,3,1,4
Haryana,Sonipat,Multiple Sclerosis,35,60,0,1,1
Uttar Pradesh,Sonbhadra,Multiple Sclerosis,6,15,2,0,2
Uttar Pradesh,Sonbhadra,Multiple Sclerosis,15,35,4,1,5
Uttar Pradesh,Sonbhadra,Multiple Sclerosis,35,60,8,3,11
Maharashtra,Solapur,Multiple Sclerosis,15,35,1,0,1
Maharashtra,Solapur,Multiple Sclerosis,35,60,1,4,5
Himachal Pradesh,Solan,Multiple Sclerosis,15,35,1,0,1
Himachal Pradesh,Solan,Multiple Sclerosis,35,60,2,0,2
Himachal Pradesh,Solan,Multiple Sclerosis,60,80,1,0,1
Bihar,Siwan,Multiple Sclerosis,15,35,4,2,6
Bihar,Siwan,Multiple Sclerosis,35,60,0,1,1
Assam,Sivasagar,Multiple Sclerosis,15,35,1,0,1
Tamil Nadu,Sivaganga,Multiple Sclerosis,6,15,1,0,1
Tamil Nadu,Sivaganga,Multiple Sclerosis,15,35,1,1,2
Uttar Pradesh,Sitapur,Multiple Sclerosis,15,35,11,3,14
Uttar Pradesh,Sitapur,Multiple Sclerosis,35,60,13,4,17
Bihar,Sitamarhi,Multiple Sclerosis,6,15,1,1,2
Bihar,Sitamarhi,Multiple Sclerosis,15,35,3,3,6
Bihar,Sitamarhi,Multiple Sclerosis,60,80,0,1,1
Haryana,Sirsa,Multiple Sclerosis,35,60,0,1,1
Rajasthan,Sirohi,Multiple Sclerosis,15,35,1,0,1
Rajasthan,Sirohi,Multiple Sclerosis,35,60,3,0,3
Himachal Pradesh,Sirmaur,Multiple Sclerosis,15,35,2,2,4
Himachal Pradesh,Sirmaur,Multiple Sclerosis,35,60,2,0,2
Madhya Pradesh,Singrauli,Multiple Sclerosis,6,15,0,1,1
Madhya Pradesh,Singrauli,Multiple Sclerosis,15,35,3,1,4
Madhya Pradesh,Singrauli,Multiple Sclerosis,35,60,1,0,1
Maharashtra,Sindhudurg,Multiple Sclerosis,6,15,2,4,6
Maharashtra,Sindhudurg,Multiple Sclerosis,15,35,30,12,42
Maharashtra,Sindhudurg,Multiple Sclerosis,35,60,60,26,86
Maharashtra,Sindhudurg,Multiple Sclerosis,60,80,30,6,36
Maharashtra,Sindhudurg,Multiple Sclerosis,80,100,2,0,2
Rajasthan,Sikar,Multiple Sclerosis,6,15,2,0,2
Rajasthan,Sikar,Multiple Sclerosis,15,35,2,1,3
Rajasthan,Sikar,Multiple Sclerosis,35,60,0,1,1
Madhya Pradesh,Sidhi,Multiple Sclerosis,6,15,1,2,3
Madhya Pradesh,Sidhi,Multiple Sclerosis,15,35,5,3,8
Madhya Pradesh,Sidhi,Multiple Sclerosis,35,60,5,0,5
Madhya Pradesh,Sidhi,Multiple Sclerosis,60,80,3,1,4
Uttar Pradesh,Siddharth Nagar,Multiple Sclerosis,0,6,1,0,1
Uttar Pradesh,Siddharth Nagar,Multiple Sclerosis,6,15,1,1,2
Uttar Pradesh,Siddharth Nagar,Multiple Sclerosis,15,35,18,6,24
Uttar Pradesh,Siddharth Nagar,Multiple Sclerosis,35,60,20,4,24
Uttar Pradesh,Siddharth Nagar,Multiple Sclerosis,60,80,5,1,6
Uttar Pradesh,Shravasti,Multiple Sclerosis,15,35,2,2,4
Uttar Pradesh,Shravasti,Multiple Sclerosis,35,60,9,1,10
Uttar Pradesh,Shravasti,Multiple Sclerosis,60,80,7,0,7
Jammu And Kashmir,Shopian,Multiple Sclerosis,35,60,1,0,1
Madhya Pradesh,Shivpuri,Multiple Sclerosis,15,35,1,2,3
Madhya Pradesh,Shivpuri,Multiple Sclerosis,35,60,5,1,6
Karnataka,Shivamogga,Multiple Sclerosis,6,15,0,1,1
Karnataka,Shivamogga,Multiple Sclerosis,15,35,1,1,2
Karnataka,Shivamogga,Multiple Sclerosis,35,60,5,4,9
Madhya Pradesh,Sheopur,Multiple Sclerosis,6,15,1,0,1
Madhya Pradesh,Sheopur,Multiple Sclerosis,15,35,2,1,3
Madhya Pradesh,Sheopur,Multiple Sclerosis,60,80,0,1,1
Bihar,Sheohar,Multiple Sclerosis,6,15,1,2,3
Bihar,Sheohar,Multiple Sclerosis,15,35,3,0,3
Bihar,Sheohar,Multiple Sclerosis,35,60,3,2,5
Bihar,Sheohar,Multiple Sclerosis,60,80,1,0,1
Bihar,Sheikhpura,Multiple Sclerosis,6,15,1,0,1
Bihar,Sheikhpura,Multiple Sclerosis,15,35,0,1,1
Bihar,Sheikhpura,Multiple Sclerosis,35,60,1,0,1
Uttar Pradesh,Shamli,Multiple Sclerosis,6,15,1,0,1
Uttar Pradesh,Shamli,Multiple Sclerosis,15,35,4,1,5
Uttar Pradesh,Shamli,Multiple Sclerosis,35,60,6,2,8
Madhya Pradesh,Shajapur,Multiple Sclerosis,15,35,0,1,1
Uttar Pradesh,Shahjahanpur,Multiple Sclerosis,6,15,2,1,3
Uttar Pradesh,Shahjahanpur,Multiple Sclerosis,15,35,45,14,59
Uttar Pradesh,Shahjahanpur,Multiple Sclerosis,35,60,43,9,52
Uttar Pradesh,Shahjahanpur,Multiple Sclerosis,60,80,15,2,17
Uttar Pradesh,Shahjahanpur,Multiple Sclerosis,80,100,0,1,1
Punjab,Shahid Bhagat Singh Nagar,Multiple Sclerosis,35,60,3,0,3
Punjab,Shahid Bhagat Singh Nagar,Multiple Sclerosis,60,80,2,1,3
Madhya Pradesh,Shahdol,Multiple Sclerosis,0,6,1,0,1
Madhya Pradesh,Shahdol,Multiple Sclerosis,6,15,1,1,2
Madhya Pradesh,Shahdol,Multiple Sclerosis,15,35,7,2,9
Madhya Pradesh,Shahdol,Multiple Sclerosis,35,60,3,2,5
Delhi,Shahdara,Multiple Sclerosis,15,35,1,0,1
Delhi,Shahdara,Multiple Sclerosis,35,60,2,0,2
Madhya Pradesh,Seoni,Multiple Sclerosis,6,15,1,0,1
Madhya Pradesh,Seoni,Multiple Sclerosis,15,35,1,2,3
Madhya Pradesh,Seoni,Multiple Sclerosis,35,60,5,3,8
Madhya Pradesh,Sehore,Multiple Sclerosis,0,6,1,0,1
Madhya Pradesh,Sehore,Multiple Sclerosis,15,35,1,0,1
Madhya Pradesh,Sehore,Multiple Sclerosis,35,60,1,0,1
Rajasthan,Sawai Madhopur,Multiple Sclerosis,0,6,1,0,1
Rajasthan,Sawai Madhopur,Multiple Sclerosis,6,15,1,3,4
Rajasthan,Sawai Madhopur,Multiple Sclerosis,15,35,3,3,6
Rajasthan,Sawai Madhopur,Multiple Sclerosis,35,60,1,0,1
Madhya Pradesh,Satna,Multiple Sclerosis,6,15,0,1,1
Madhya Pradesh,Satna,Multiple Sclerosis,15,35,2,1,3
Madhya Pradesh,Satna,Multiple Sclerosis,35,60,1,1,2
Madhya Pradesh,Satna,Multiple Sclerosis,60,80,0,1,1
Maharashtra,Satara,Multiple Sclerosis,6,15,1,0,1
Maharashtra,Satara,Multiple Sclerosis,15,35,5,2,7
Maharashtra,Satara,Multiple Sclerosis,35,60,7,1,8
Maharashtra,Satara,Multiple Sclerosis,60,80,4,1,5
Bihar,Saran,Multiple Sclerosis,6,15,0,2,2
Bihar,Saran,Multiple Sclerosis,15,35,5,1,6
Bihar,Saran,Multiple Sclerosis,35,60,7,1,8
Bihar,Saran,Multiple Sclerosis,60,80,1,0,1
Bihar,Saran,Multiple Sclerosis,80,100,1,0,1
Jharkhand,Saraikela Kharsawan,Multiple Sclerosis,6,15,1,0,1
Jharkhand,Saraikela Kharsawan,Multiple Sclerosis,15,35,3,1,4
Jharkhand,Saraikela Kharsawan,Multiple Sclerosis,35,60,1,0,1
Jharkhand,Saraikela Kharsawan,Multiple Sclerosis,60,80,1,0,1
Uttar Pradesh,Sant Kabeer Nagar,Multiple Sclerosis,15,35,6,4,10
Uttar Pradesh,Sant Kabeer Nagar,Multiple Sclerosis,35,60,9,0,9
Uttar Pradesh,Sant Kabeer Nagar,Multiple Sclerosis,60,80,1,0,1
Punjab,Sangrur,Multiple Sclerosis,6,15,1,2,3
Punjab,Sangrur,Multiple Sclerosis,15,35,9,4,13
Punjab,Sangrur,Multiple Sclerosis,35,60,14,6,20
Punjab,Sangrur,Multiple Sclerosis,60,80,3,0,3
Maharashtra,Sangli,Multiple Sclerosis,35,60,1,1,2
Odisha,Sambalpur,Multiple Sclerosis,35,60,1,0,1
Bihar,Samastipur,Multiple Sclerosis,0,6,0,1,1
Bihar,Samastipur,Multiple Sclerosis,6,15,2,1,3
Bihar,Samastipur,Multiple Sclerosis,15,35,10,3,13
Bihar,Samastipur,Multiple Sclerosis,35,60,20,2,22
Bihar,Samastipur,Multiple Sclerosis,60,80,6,1,7
Tamil Nadu,Salem,Multiple Sclerosis,15,35,1,1,2
Jharkhand,Sahebganj,Multiple Sclerosis,6,15,1,2,3
Jharkhand,Sahebganj,Multiple Sclerosis,15,35,3,4,7
Jharkhand,Sahebganj,Multiple Sclerosis,35,60,2,1,3
Bihar,Saharsa,Multiple Sclerosis,6,15,1,4,5
Bihar,Saharsa,Multiple Sclerosis,15,35,6,1,7
Bihar,Saharsa,Multiple Sclerosis,35,60,7,2,9
Bihar,Saharsa,Multiple Sclerosis,60,80,4,0,4
Uttar Pradesh,Saharanpur,Multiple Sclerosis,6,15,1,1,2
Uttar Pradesh,Saharanpur,Multiple Sclerosis,15,35,12,7,19
Uttar Pradesh,Saharanpur,Multiple Sclerosis,35,60,24,8,32
Uttar Pradesh,Saharanpur,Multiple Sclerosis,60,80,4,2,6
Madhya Pradesh,Sagar,Multiple Sclerosis,6,15,4,7,11
Madhya Pradesh,Sagar,Multiple Sclerosis,15,35,39,24,63
Madhya Pradesh,Sagar,Multiple Sclerosis,35,60,23,16,39
Madhya Pradesh,Sagar,Multiple Sclerosis,60,80,2,1,3
Punjab,S.A.S Nagar,Multiple Sclerosis,6,15,1,1,2
Punjab,S.A.S Nagar,Multiple Sclerosis,15,35,8,3,11
Punjab,S.A.S Nagar,Multiple Sclerosis,35,60,7,8,15
Punjab,S.A.S Nagar,Multiple Sclerosis,60,80,0,1,1
Punjab,Rupnagar,Multiple Sclerosis,6,15,1,0,1
Punjab,Rupnagar,Multiple Sclerosis,15,35,4,1,5
Punjab,Rupnagar,Multiple Sclerosis,35,60,0,1,1
Punjab,Rupnagar,Multiple Sclerosis,60,80,1,0,1
Uttarakhand,Rudra Prayag,Multiple Sclerosis,15,35,2,3,5
Uttarakhand,Rudra Prayag,Multiple Sclerosis,35,60,4,1,5
Uttarakhand,Rudra Prayag,Multiple Sclerosis,60,80,2,1,3
Bihar,Rohtas,Multiple Sclerosis,6,15,5,4,9
Bihar,Rohtas,Multiple Sclerosis,15,35,9,3,12
Bihar,Rohtas,Multiple Sclerosis,35,60,19,3,22
Bihar,Rohtas,Multiple Sclerosis,60,80,4,2,6
Haryana,Rohtak,Multiple Sclerosis,15,35,4,3,7
Haryana,Rohtak,Multiple Sclerosis,35,60,8,2,10
Haryana,Rohtak,Multiple Sclerosis,60,80,1,2,3
Haryana,Rewari,Multiple Sclerosis,35,60,2,1,3
Madhya Pradesh,Rewa,Multiple Sclerosis,15,35,2,1,3
Jammu And Kashmir,Reasi,Multiple Sclerosis,15,35,1,0,1
Jammu And Kashmir,Reasi,Multiple Sclerosis,35,60,0,2,2
Odisha,Rayagada,Multiple Sclerosis,6,15,1,1,2
Maharashtra,Ratnagiri,Multiple Sclerosis,15,35,0,1,1
Maharashtra,Ratnagiri,Multiple Sclerosis,35,60,2,0,2
Madhya Pradesh,Ratlam,Multiple Sclerosis,15,35,2,2,4
Madhya Pradesh,Ratlam,Multiple Sclerosis,35,60,2,1,3
Tamil Nadu,Ranipet,Multiple Sclerosis,15,35,4,4,8
Tamil Nadu,Ranipet,Multiple Sclerosis,35,60,1,1,2
Jharkhand,Ranchi,Multiple Sclerosis,15,35,2,0,2
Jharkhand,Ranchi,Multiple Sclerosis,35,60,1,1,2
Uttar Pradesh,Rampur,Multiple Sclerosis,6,15,0,1,1
Uttar Pradesh,Rampur,Multiple Sclerosis,15,35,14,2,16
Uttar Pradesh,Rampur,Multiple Sclerosis,35,60,13,2,15
Uttar Pradesh,Rampur,Multiple Sclerosis,60,80,2,0,2
Jharkhand,Ramgarh,Multiple Sclerosis,6,15,2,1,3
Jharkhand,Ramgarh,Multiple Sclerosis,15,35,21,25,46
Jharkhand,Ramgarh,Multiple Sclerosis,35,60,24,25,49
Jharkhand,Ramgarh,Multiple Sclerosis,60,80,7,6,13
Jharkhand,Ramgarh,Multiple Sclerosis,80,100,1,0,1
Jammu And Kashmir,Ramban,Multiple Sclerosis,15,35,0,2,2
Karnataka,Ramanagara,Multiple Sclerosis,15,35,1,2,3
Karnataka,Ramanagara,Multiple Sclerosis,35,60,10,3,13
Karnataka,Ramanagara,Multiple Sclerosis,60,80,5,0,5
Rajasthan,Rajsamand,Multiple Sclerosis,0,6,1,0,1
Rajasthan,Rajsamand,Multiple Sclerosis,6,15,5,6,11
Rajasthan,Rajsamand,Multiple Sclerosis,15,35,24,13,37
Rajasthan,Rajsamand,Multiple Sclerosis,35,60,16,12,28
Rajasthan,Rajsamand,Multiple Sclerosis,60,80,4,3,7
Rajasthan,Rajsamand,Multiple Sclerosis,80,100,0,1,1
Jammu And Kashmir,Rajouri,Multiple Sclerosis,15,35,2,2,4
Jammu And Kashmir,Rajouri,Multiple Sclerosis,35,60,3,0,3
Chhattisgarh,Rajnandgaon,Multiple Sclerosis,6,15,2,1,3
Chhattisgarh,Rajnandgaon,Multiple Sclerosis,15,35,8,2,10
Chhattisgarh,Rajnandgaon,Multiple Sclerosis,35,60,1,0,1
Chhattisgarh,Rajnandgaon,Multiple Sclerosis,60,80,1,0,1
Chhattisgarh,Rajnandgaon,Multiple Sclerosis,80,100,1,0,1
Madhya Pradesh,Rajgarh,Multiple Sclerosis,6,15,0,1,1
Madhya Pradesh,Rajgarh,Multiple Sclerosis,15,35,4,0,4
Madhya Pradesh,Rajgarh,Multiple Sclerosis,35,60,2,4,6
Madhya Pradesh,Rajgarh,Multiple Sclerosis,60,80,3,0,3
Madhya Pradesh,Raisen,Multiple Sclerosis,6,15,1,2,3
Madhya Pradesh,Raisen,Multiple Sclerosis,15,35,8,0,8
Madhya Pradesh,Raisen,Multiple Sclerosis,35,60,2,0,2
Madhya Pradesh,Raisen,Multiple Sclerosis,60,80,1,1,2
Chhattisgarh,Raipur,Multiple Sclerosis,15,35,2,0,2
Chhattisgarh,Raipur,Multiple Sclerosis,35,60,0,1,1
Chhattisgarh,Raigarh,Multiple Sclerosis,15,35,2,1,3
Maharashtra,Raigad,Multiple Sclerosis,15,35,2,0,2
Maharashtra,Raigad,Multiple Sclerosis,60,80,1,0,1
Karnataka,Raichur,Multiple Sclerosis,15,35,0,1,1
Karnataka,Raichur,Multiple Sclerosis,35,60,1,1,2
Uttar Pradesh,Rae Bareli,Multiple Sclerosis,15,35,0,1,1
Uttar Pradesh,Rae Bareli,Multiple Sclerosis,35,60,1,1,2
Uttar Pradesh,Rae Bareli,Multiple Sclerosis,60,80,1,0,1
Bihar,Purnia,Multiple Sclerosis,15,35,2,1,3
Bihar,Purnia,Multiple Sclerosis,35,60,3,0,3
Odisha,Puri,Multiple Sclerosis,6,15,1,0,1
Odisha,Puri,Multiple Sclerosis,15,35,4,1,5
Odisha,Puri,Multiple Sclerosis,35,60,6,2,8
Odisha,Puri,Multiple Sclerosis,60,80,3,1,4
Odisha,Puri,Multiple Sclerosis,80,100,1,0,1
Bihar,Purbi Champaran,Multiple Sclerosis,6,15,2,2,4
Bihar,Purbi Champaran,Multiple Sclerosis,15,35,9,6,15
Bihar,Purbi Champaran,Multiple Sclerosis,35,60,11,2,13
Bihar,Purbi Champaran,Multiple Sclerosis,60,80,6,0,6
Maharashtra,Pune,Multiple Sclerosis,6,15,2,0,2
Maharashtra,Pune,Multiple Sclerosis,15,35,5,8,13
Maharashtra,Pune,Multiple Sclerosis,35,60,10,17,27
Maharashtra,Pune,Multiple Sclerosis,60,80,1,5,6
Jammu And Kashmir,Pulwama,Multiple Sclerosis,15,35,0,1,1
Jammu And Kashmir,Pulwama,Multiple Sclerosis,35,60,1,1,2
Tamil Nadu,Pudukkottai,Multiple Sclerosis,15,35,1,0,1
Uttar Pradesh,Prayagraj,Multiple Sclerosis,15,35,5,1,6
Uttar Pradesh,Prayagraj,Multiple Sclerosis,35,60,6,2,8
Uttar Pradesh,Prayagraj,Multiple Sclerosis,60,80,2,0,2
Rajasthan,Pratapgarh,Multiple Sclerosis,15,35,0,4,4
Rajasthan,Pratapgarh,Multiple Sclerosis,35,60,2,0,2
Rajasthan,Pratapgarh,Multiple Sclerosis,60,80,2,0,2
Rajasthan,Pratapgarh,Multiple Sclerosis,80,100,0,1,1
Uttar Pradesh,Pratapgarh,Multiple Sclerosis,15,35,5,2,7
Uttar Pradesh,Pratapgarh,Multiple Sclerosis,35,60,11,3,14
Uttar Pradesh,Pratapgarh,Multiple Sclerosis,60,80,2,0,2
Jammu And Kashmir,Poonch,Multiple Sclerosis,6,15,4,4,8
Jammu And Kashmir,Poonch,Multiple Sclerosis,15,35,4,7,11
Jammu And Kashmir,Poonch,Multiple Sclerosis,35,60,10,14,24
Jammu And Kashmir,Poonch,Multiple Sclerosis,60,80,1,0,1
Puducherry,Pondicherry,Multiple Sclerosis,15,35,2,0,2
Puducherry,Pondicherry,Multiple Sclerosis,35,60,1,0,1
Uttarakhand,Pithoragarh,Multiple Sclerosis,15,35,0,1,1
Uttar Pradesh,Pilibhit,Multiple Sclerosis,6,15,1,0,1
Uttar Pradesh,Pilibhit,Multiple Sclerosis,15,35,19,7,26
Uttar Pradesh,Pilibhit,Multiple Sclerosis,35,60,20,6,26
Uttar Pradesh,Pilibhit,Multiple Sclerosis,60,80,7,2,9
Uttarakhand,Pauri Garhwal,Multiple Sclerosis,6,15,1,1,2
Uttarakhand,Pauri Garhwal,Multiple Sclerosis,15,35,5,1,6
Uttarakhand,Pauri Garhwal,Multiple Sclerosis,35,60,3,0,3
Bihar,Patna,Multiple Sclerosis,0,6,1,0,1
Bihar,Patna,Multiple Sclerosis,6,15,4,1,5
Bihar,Patna,Multiple Sclerosis,15,35,6,4,10
Bihar,Patna,Multiple Sclerosis,35,60,4,2,6
Punjab,Patiala,Multiple Sclerosis,6,15,3,1,4
Punjab,Patiala,Multiple Sclerosis,15,35,16,6,22
Punjab,Patiala,Multiple Sclerosis,35,60,19,10,29
Punjab,Patiala,Multiple Sclerosis,60,80,4,2,6
Punjab,Patiala,Multiple Sclerosis,80,100,1,0,1
Punjab,Pathankot,Multiple Sclerosis,6,15,2,0,2
Punjab,Pathankot,Multiple Sclerosis,15,35,3,1,4
Punjab,Pathankot,Multiple Sclerosis,35,60,3,5,8
Punjab,Pathankot,Multiple Sclerosis,60,80,1,1,2
Kerala,Pathanamthitta,Multiple Sclerosis,15,35,0,4,4
Kerala,Pathanamthitta,Multiple Sclerosis,35,60,2,1,3
Bihar,Pashchim Champaran,Multiple Sclerosis,6,15,2,1,3
Bihar,Pashchim Champaran,Multiple Sclerosis,15,35,1,1,2
Bihar,Pashchim Champaran,Multiple Sclerosis,35,60,1,0,1
Maharashtra,Parbhani,Multiple Sclerosis,6,15,1,0,1
Maharashtra,Parbhani,Multiple Sclerosis,35,60,9,1,10
Maharashtra,Parbhani,Multiple Sclerosis,60,80,2,2,4
Madhya Pradesh,Panna,Multiple Sclerosis,15,35,1,2,3
Haryana,Panipat,Multiple Sclerosis,15,35,2,2,4
Haryana,Panipat,Multiple Sclerosis,35,60,5,2,7
Haryana,Panchkula,Multiple Sclerosis,35,60,0,1,1
Gujarat,Panch Mahals,Multiple Sclerosis,6,15,0,1,1
Rajasthan,Pali,Multiple Sclerosis,15,35,1,0,1
Maharashtra,Palghar,Multiple Sclerosis,6,15,2,0,2
Maharashtra,Palghar,Multiple Sclerosis,15,35,3,1,4
Maharashtra,Palghar,Multiple Sclerosis,35,60,15,3,18
Maharashtra,Palghar,Multiple Sclerosis,60,80,6,0,6
Jharkhand,Palamu,Multiple Sclerosis,15,35,1,0,1
Jharkhand,Palamu,Multiple Sclerosis,35,60,1,0,1
Kerala,Palakkad,Multiple Sclerosis,6,15,1,0,1
Kerala,Palakkad,Multiple Sclerosis,15,35,2,3,5
Kerala,Palakkad,Multiple Sclerosis,35,60,3,2,5
Maharashtra,Osmanabad,Multiple Sclerosis,15,35,2,1,3
Maharashtra,Osmanabad,Multiple Sclerosis,35,60,8,1,9
Maharashtra,Osmanabad,Multiple Sclerosis,60,80,3,1,4
Haryana,Nuh,Multiple Sclerosis,15,35,2,0,2
Haryana,Nuh,Multiple Sclerosis,35,60,1,0,1
Odisha,Nuapada,Multiple Sclerosis,6,15,1,0,1
Odisha,Nuapada,Multiple Sclerosis,15,35,1,1,2
Odisha,Nuapada,Multiple Sclerosis,60,80,1,0,1
Delhi,North West,Multiple Sclerosis,15,35,4,2,6
Delhi,North West,Multiple Sclerosis,35,60,2,3,5
Goa,North Goa,Multiple Sclerosis,15,35,1,0,1
Goa,North Goa,Multiple Sclerosis,35,60,3,0,3
Andaman And Nicobar Islands,North And Middle Andaman,Multiple Sclerosis,15,35,2,0,2
Andaman And Nicobar Islands,North And Middle Andaman,Multiple Sclerosis,35,60,1,0,1
Delhi,North,Multiple Sclerosis,15,35,0,1,1
Delhi,North,Multiple Sclerosis,35,60,2,0,2
Madhya Pradesh,Niwari,Multiple Sclerosis,6,15,1,1,2
Madhya Pradesh,Niwari,Multiple Sclerosis,15,35,2,2,4
Madhya Pradesh,Niwari,Multiple Sclerosis,35,60,14,5,19
Madhya Pradesh,Niwari,Multiple Sclerosis,60,80,1,0,1
Andaman And Nicobar Islands,Nicobars,Multiple Sclerosis,6,15,1,0,1
Madhya Pradesh,Neemuch,Multiple Sclerosis,15,35,0,1,1
Odisha,Nayagarh,Multiple Sclerosis,15,35,1,1,2
Odisha,Nayagarh,Multiple Sclerosis,35,60,10,1,11
Odisha,Nayagarh,Multiple Sclerosis,60,80,1,1,2
Bihar,Nawada,Multiple Sclerosis,6,15,0,1,1
Bihar,Nawada,Multiple Sclerosis,15,35,4,3,7
Bihar,Nawada,Multiple Sclerosis,35,60,2,2,4
Bihar,Nawada,Multiple Sclerosis,60,80,0,1,1
Maharashtra,Nashik,Multiple Sclerosis,15,35,1,2,3
Madhya Pradesh,Narsinghpur,Multiple Sclerosis,6,15,4,1,5
Madhya Pradesh,Narsinghpur,Multiple Sclerosis,15,35,13,10,23
Madhya Pradesh,Narsinghpur,Multiple Sclerosis,35,60,23,10,33
Madhya Pradesh,Narsinghpur,Multiple Sclerosis,60,80,3,4,7
Madhya Pradesh,Narmadapuram,Multiple Sclerosis,6,15,1,0,1
Madhya Pradesh,Narmadapuram,Multiple Sclerosis,15,35,6,7,13
Madhya Pradesh,Narmadapuram,Multiple Sclerosis,35,60,5,4,9
Maharashtra,Nandurbar,Multiple Sclerosis,6,15,1,0,1
Maharashtra,Nandurbar,Multiple Sclerosis,15,35,1,0,1
Maharashtra,Nandurbar,Multiple Sclerosis,35,60,3,0,3
Maharashtra,Nanded,Multiple Sclerosis,6,15,2,2,4
Maharashtra,Nanded,Multiple Sclerosis,15,35,6,3,9
Maharashtra,Nanded,Multiple Sclerosis,35,60,11,5,16
Maharashtra,Nanded,Multiple Sclerosis,60,80,1,0,1
Arunachal Pradesh,Namsai,Multiple Sclerosis,35,60,1,0,1
Sikkim,Namchi,Multiple Sclerosis,15,35,1,0,1
Tamil Nadu,Namakkal,Multiple Sclerosis,6,15,0,1,1
Tamil Nadu,Namakkal,Multiple Sclerosis,15,35,2,3,5
Tamil Nadu,Namakkal,Multiple Sclerosis,35,60,1,0,1
Assam,Nalbari,Multiple Sclerosis,6,15,0,1,1
Assam,Nalbari,Multiple Sclerosis,15,35,1,0,1
Assam,Nalbari,Multiple Sclerosis,35,60,0,1,1
Bihar,Nalanda,Multiple Sclerosis,6,15,1,0,1
Bihar,Nalanda,Multiple Sclerosis,15,35,5,2,7
Bihar,Nalanda,Multiple Sclerosis,35,60,5,0,5
Bihar,Nalanda,Multiple Sclerosis,60,80,1,0,1
Uttarakhand,Nainital,Multiple Sclerosis,15,35,0,1,1
Uttarakhand,Nainital,Multiple Sclerosis,35,60,1,1,2
Rajasthan,Nagaur,Multiple Sclerosis,6,15,1,3,4
Rajasthan,Nagaur,Multiple Sclerosis,15,35,1,1,2
Rajasthan,Nagaur,Multiple Sclerosis,35,60,1,0,1
Rajasthan,Nagaur,Multiple Sclerosis,60,80,1,0,1
Tamil Nadu,Nagapattinam,Multiple Sclerosis,15,35,1,0,1
Assam,Nagaon,Multiple Sclerosis,6,15,0,1,1
Assam,Nagaon,Multiple Sclerosis,15,35,3,1,4
Assam,Nagaon,Multiple Sclerosis,35,60,1,0,1
Odisha,Nabarangpur,Multiple Sclerosis,6,15,1,1,2
Odisha,Nabarangpur,Multiple Sclerosis,15,35,0,2,2
Odisha,Nabarangpur,Multiple Sclerosis,35,60,3,0,3
Odisha,Nabarangpur,Multiple Sclerosis,60,80,1,0,1
Karnataka,Mysuru,Multiple Sclerosis,6,15,1,0,1
Karnataka,Mysuru,Multiple Sclerosis,15,35,2,1,3
Karnataka,Mysuru,Multiple Sclerosis,35,60,4,1,5
Karnataka,Mysuru,Multiple Sclerosis,60,80,0,1,1
Bihar,Muzaffarpur,Multiple Sclerosis,0,6,1,0,1
Bihar,Muzaffarpur,Multiple Sclerosis,6,15,1,1,2
Bihar,Muzaffarpur,Multiple Sclerosis,15,35,6,1,7
Bihar,Muzaffarpur,Multiple Sclerosis,35,60,7,1,8
Bihar,Muzaffarpur,Multiple Sclerosis,60,80,1,0,1
Uttar Pradesh,Muzaffarnagar,Multiple Sclerosis,15,35,4,3,7
Uttar Pradesh,Muzaffarnagar,Multiple Sclerosis,35,60,13,0,13
Uttar Pradesh,Muzaffarnagar,Multiple Sclerosis,60,80,1,0,1
Bihar,Munger,Multiple Sclerosis,15,35,1,0,1
Bihar,Munger,Multiple Sclerosis,35,60,3,0,3
Chhattisgarh,Mungeli,Multiple Sclerosis,6,15,3,0,3
Chhattisgarh,Mungeli,Multiple Sclerosis,15,35,3,8,11
Chhattisgarh,Mungeli,Multiple Sclerosis,35,60,2,1,3
Chhattisgarh,Mungeli,Multiple Sclerosis,60,80,1,0,1
Maharashtra,Mumbai Suburban,Multiple Sclerosis,15,35,2,1,3
Maharashtra,Mumbai,Multiple Sclerosis,15,35,2,1,3
Maharashtra,Mumbai,Multiple Sclerosis,35,60,1,5,6
Madhya Pradesh,Morena,Multiple Sclerosis,6,15,5,1,6
Madhya Pradesh,Morena,Multiple Sclerosis,15,35,4,0,4
Madhya Pradesh,Morena,Multiple Sclerosis,35,60,4,2,6
Madhya Pradesh,Morena,Multiple Sclerosis,60,80,1,0,1
Uttar Pradesh,Moradabad,Multiple Sclerosis,0,6,3,0,3
Uttar Pradesh,Moradabad,Multiple Sclerosis,6,15,1,2,3
Uttar Pradesh,Moradabad,Multiple Sclerosis,15,35,0,2,2
Uttar Pradesh,Moradabad,Multiple Sclerosis,35,60,2,0,2
Uttar Pradesh,Moradabad,Multiple Sclerosis,60,80,1,0,1
Nagaland,Mon,Multiple Sclerosis,6,15,3,0,3
Nagaland,Mon,Multiple Sclerosis,15,35,15,3,18
Nagaland,Mon,Multiple Sclerosis,35,60,13,1,14
Nagaland,Mon,Multiple Sclerosis,60,80,3,0,3
Nagaland,Mon,Multiple Sclerosis,80,100,1,0,1
Punjab,Moga,Multiple Sclerosis,6,15,1,0,1
Punjab,Moga,Multiple Sclerosis,15,35,2,0,2
Punjab,Moga,Multiple Sclerosis,35,60,3,2,5
Uttar Pradesh,Mirzapur,Multiple Sclerosis,15,35,8,4,12
Uttar Pradesh,Mirzapur,Multiple Sclerosis,35,60,9,0,9
Uttar Pradesh,Meerut,Multiple Sclerosis,6,15,1,0,1
Uttar Pradesh,Meerut,Multiple Sclerosis,15,35,5,3,8
Uttar Pradesh,Meerut,Multiple Sclerosis,35,60,6,2,8
Uttar Pradesh,Meerut,Multiple Sclerosis,60,80,1,1,2
Odisha,Mayurbhanj,Multiple Sclerosis,80,100,1,0,1
Uttar Pradesh,Mau,Multiple Sclerosis,15,35,1,0,1
Uttar Pradesh,Mau,Multiple Sclerosis,35,60,2,1,3
Uttar Pradesh,Mathura,Multiple Sclerosis,35,60,1,0,1
Punjab,Mansa,Multiple Sclerosis,6,15,1,0,1
Punjab,Mansa,Multiple Sclerosis,15,35,4,6,10
Punjab,Mansa,Multiple Sclerosis,35,60,7,1,8
Punjab,Mansa,Multiple Sclerosis,60,80,1,1,2
Karnataka,Mandya,Multiple Sclerosis,6,15,1,0,1
Karnataka,Mandya,Multiple Sclerosis,15,35,2,1,3
Karnataka,Mandya,Multiple Sclerosis,35,60,3,3,6
Madhya Pradesh,Mandsaur,Multiple Sclerosis,15,35,2,1,3
Madhya Pradesh,Mandsaur,Multiple Sclerosis,35,60,1,0,1
Madhya Pradesh,Mandla,Multiple Sclerosis,6,15,1,0,1
Madhya Pradesh,Mandla,Multiple Sclerosis,15,35,5,2,7
Madhya Pradesh,Mandla,Multiple Sclerosis,35,60,3,2,5
Madhya Pradesh,Mandla,Multiple Sclerosis,60,80,1,0,1
Himachal Pradesh,Mandi,Multiple Sclerosis,6,15,1,0,1
Himachal Pradesh,Mandi,Multiple Sclerosis,15,35,2,5,7
Himachal Pradesh,Mandi,Multiple Sclerosis,35,60,6,2,8
Himachal Pradesh,Mandi,Multiple Sclerosis,60,80,1,0,1
Odisha,Malkangiri,Multiple Sclerosis,0,6,1,0,1
Odisha,Malkangiri,Multiple Sclerosis,6,15,2,1,3
Odisha,Malkangiri,Multiple Sclerosis,15,35,4,1,5
Odisha,Malkangiri,Multiple Sclerosis,35,60,2,2,4
Odisha,Malkangiri,Multiple Sclerosis,60,80,0,2,2
Kerala,Malappuram,Multiple Sclerosis,6,15,1,0,1
Kerala,Malappuram,Multiple Sclerosis,15,35,1,4,5
Kerala,Malappuram,Multiple Sclerosis,35,60,3,1,4
Kerala,Malappuram,Multiple Sclerosis,60,80,2,0,2
Assam,Majuli,Multiple Sclerosis,15,35,2,0,2
Assam,Majuli,Multiple Sclerosis,60,80,1,0,1
Uttar Pradesh,Mainpuri,Multiple Sclerosis,6,15,1,0,1
Uttar Pradesh,Mainpuri,Multiple Sclerosis,15,35,10,3,13
Uttar Pradesh,Mainpuri,Multiple Sclerosis,35,60,7,4,11
Uttar Pradesh,Mainpuri,Multiple Sclerosis,60,80,2,0,2
Uttar Pradesh,Mainpuri,Multiple Sclerosis,80,100,1,0,1
Uttar Pradesh,Mahoba,Multiple Sclerosis,6,15,1,0,1
Uttar Pradesh,Mahoba,Multiple Sclerosis,15,35,21,7,28
Uttar Pradesh,Mahoba,Multiple Sclerosis,35,60,41,9,50
Uttar Pradesh,Mahoba,Multiple Sclerosis,60,80,15,0,15
Uttar Pradesh,Mahoba,Multiple Sclerosis,80,100,1,0,1
Gujarat,Mahesana,Multiple Sclerosis,15,35,0,1,1
Haryana,Mahendragarh,Multiple Sclerosis,15,35,3,1,4
Haryana,Mahendragarh,Multiple Sclerosis,35,60,2,0,2
Chhattisgarh,Mahasamund,Multiple Sclerosis,6,15,3,3,6
Chhattisgarh,Mahasamund,Multiple Sclerosis,15,35,6,9,15
Chhattisgarh,Mahasamund,Multiple Sclerosis,35,60,15,8,23
Chhattisgarh,Mahasamund,Multiple Sclerosis,60,80,2,0,2
Chhattisgarh,Mahasamund,Multiple Sclerosis,80,100,0,1,1
Uttar Pradesh,Maharajganj,Multiple Sclerosis,6,15,0,1,1
Uttar Pradesh,Maharajganj,Multiple Sclerosis,15,35,1,0,1
Uttar Pradesh,Maharajganj,Multiple Sclerosis,35,60,2,1,3
Tamil Nadu,Madurai,Multiple Sclerosis,0,6,1,0,1
Tamil Nadu,Madurai,Multiple Sclerosis,6,15,3,1,4
Tamil Nadu,Madurai,Multiple Sclerosis,15,35,5,3,8
Tamil Nadu,Madurai,Multiple Sclerosis,35,60,0,3,3
Bihar,Madhubani,Multiple Sclerosis,6,15,1,0,1
Bihar,Madhubani,Multiple Sclerosis,15,35,8,1,9
Bihar,Madhubani,Multiple Sclerosis,35,60,4,2,6
Bihar,Madhubani,Multiple Sclerosis,60,80,4,0,4
Bihar,Madhepura,Multiple Sclerosis,6,15,13,10,23
Bihar,Madhepura,Multiple Sclerosis,15,35,50,20,70
Bihar,Madhepura,Multiple Sclerosis,35,60,48,19,67
Bihar,Madhepura,Multiple Sclerosis,60,80,22,6,28
Punjab,Ludhiana,Multiple Sclerosis,6,15,7,3,10
Punjab,Ludhiana,Multiple Sclerosis,15,35,30,17,47
Punjab,Ludhiana,Multiple Sclerosis,35,60,59,30,89
Punjab,Ludhiana,Multiple Sclerosis,60,80,12,0,12
Uttar Pradesh,Lucknow,Multiple Sclerosis,6,15,1,0,1
Uttar Pradesh,Lucknow,Multiple Sclerosis,15,35,12,6,18
Uttar Pradesh,Lucknow,Multiple Sclerosis,35,60,26,7,33
Uttar Pradesh,Lucknow,Multiple Sclerosis,60,80,7,0,7
Maharashtra,Latur,Multiple Sclerosis,6,15,3,2,5
Maharashtra,Latur,Multiple Sclerosis,15,35,10,4,14
Maharashtra,Latur,Multiple Sclerosis,35,60,20,4,24
Maharashtra,Latur,Multiple Sclerosis,60,80,1,2,3
Jharkhand,Latehar,Multiple Sclerosis,6,15,0,1,1
Jharkhand,Latehar,Multiple Sclerosis,15,35,24,15,39
Jharkhand,Latehar,Multiple Sclerosis,35,60,9,12,21
Jharkhand,Latehar,Multiple Sclerosis,60,80,6,1,7
Jharkhand,Latehar,Multiple Sclerosis,80,100,1,0,1
Uttar Pradesh,Lalitpur,Multiple Sclerosis,15,35,5,0,5
Uttar Pradesh,Lalitpur,Multiple Sclerosis,35,60,6,1,7
Uttar Pradesh,Lalitpur,Multiple Sclerosis,60,80,2,1,3
Bihar,Lakhisarai,Multiple Sclerosis,6,15,0,1,1
Bihar,Lakhisarai,Multiple Sclerosis,15,35,3,0,3
Bihar,Lakhisarai,Multiple Sclerosis,35,60,2,0,2
Assam,Lakhimpur,Multiple Sclerosis,15,35,0,1,1
Assam,Lakhimpur,Multiple Sclerosis,35,60,1,0,1
Uttar Pradesh,Kushi Nagar,Multiple Sclerosis,15,35,0,2,2
Uttar Pradesh,Kushi Nagar,Multiple Sclerosis,35,60,2,1,3
Uttar Pradesh,Kushi Nagar,Multiple Sclerosis,60,80,1,0,1
Haryana,Kurukshetra,Multiple Sclerosis,15,35,1,1,2
Haryana,Kurukshetra,Multiple Sclerosis,35,60,4,1,5
Andhra Pradesh,Kurnool,Multiple Sclerosis,15,35,1,0,1
Andhra Pradesh,Kurnool,Multiple Sclerosis,35,60,1,0,1
Jammu And Kashmir,Kupwara,Multiple Sclerosis,6,15,0,1,1
Jammu And Kashmir,Kupwara,Multiple Sclerosis,15,35,5,10,15
Jammu And Kashmir,Kupwara,Multiple Sclerosis,35,60,6,6,12
Jammu And Kashmir,Kupwara,Multiple Sclerosis,60,80,1,0,1
Himachal Pradesh,Kullu,Multiple Sclerosis,6,15,2,0,2
Himachal Pradesh,Kullu,Multiple Sclerosis,35,60,1,0,1
Jammu And Kashmir,Kulgam,Multiple Sclerosis,35,60,0,1,1
Tamil Nadu,Krishnagiri,Multiple Sclerosis,6,15,1,3,4
Tamil Nadu,Krishnagiri,Multiple Sclerosis,15,35,7,11,18
Tamil Nadu,Krishnagiri,Multiple Sclerosis,35,60,14,2,16
Tamil Nadu,Krishnagiri,Multiple Sclerosis,60,80,5,0,5
Kerala,Kozhikode,Multiple Sclerosis,35,60,3,0,3
Kerala,Kozhikode,Multiple Sclerosis,60,80,1,0,1
Kerala,Kottayam,Multiple Sclerosis,6,15,1,0,1
Kerala,Kottayam,Multiple Sclerosis,15,35,0,1,1
Kerala,Kottayam,Multiple Sclerosis,35,60,1,0,1
Kerala,Kottayam,Multiple Sclerosis,60,80,1,1,2
Rajasthan,Kota,Multiple Sclerosis,35,60,1,0,1
Chhattisgarh,Korba,Multiple Sclerosis,15,35,3,1,4
Chhattisgarh,Korba,Multiple Sclerosis,35,60,2,0,2
Odisha,Koraput,Multiple Sclerosis,15,35,1,1,2
Karnataka,Koppal,Multiple Sclerosis,15,35,2,1,3
Karnataka,Koppal,Multiple Sclerosis,35,60,1,0,1
Chhattisgarh,Kondagaon,Multiple Sclerosis,15,35,4,3,7
Chhattisgarh,Kondagaon,Multiple Sclerosis,35,60,3,2,5
Kerala,Kollam,Multiple Sclerosis,15,35,1,3,4
Kerala,Kollam,Multiple Sclerosis,35,60,1,2,3
Maharashtra,Kolhapur,Multiple Sclerosis,15,35,4,1,5
Maharashtra,Kolhapur,Multiple Sclerosis,35,60,3,3,6
Karnataka,Kolar,Multiple Sclerosis,6,15,1,1,2
Karnataka,Kolar,Multiple Sclerosis,15,35,5,8,13
Karnataka,Kolar,Multiple Sclerosis,35,60,3,5,8
Karnataka,Kolar,Multiple Sclerosis,60,80,1,0,1
Assam,Kokrajhar,Multiple Sclerosis,0,6,0,1,1
Jharkhand,Koderma,Multiple Sclerosis,6,15,3,1,4
Jharkhand,Koderma,Multiple Sclerosis,15,35,3,4,7
Jharkhand,Koderma,Multiple Sclerosis,35,60,3,1,4
Jharkhand,Koderma,Multiple Sclerosis,60,80,2,1,3
Jammu And Kashmir,Kishtwar,Multiple Sclerosis,15,35,2,1,3
Jammu And Kashmir,Kishtwar,Multiple Sclerosis,35,60,3,1,4
Bihar,Kishanganj,Multiple Sclerosis,6,15,0,1,1
Bihar,Kishanganj,Multiple Sclerosis,15,35,2,1,3
Bihar,Kishanganj,Multiple Sclerosis,35,60,2,0,2
Jharkhand,Khunti,Multiple Sclerosis,15,35,0,1,1
Jharkhand,Khunti,Multiple Sclerosis,35,60,1,0,1
Jharkhand,Khunti,Multiple Sclerosis,60,80,1,0,1
Odisha,Khordha,Multiple Sclerosis,15,35,1,0,1
Odisha,Khordha,Multiple Sclerosis,60,80,2,0,2
Odisha,Khordha,Multiple Sclerosis,80,100,1,0,1
Uttar Pradesh,Kheri,Multiple Sclerosis,6,15,1,1,2
Uttar Pradesh,Kheri,Multiple Sclerosis,15,35,17,6,23
Uttar Pradesh,Kheri,Multiple Sclerosis,35,60,16,4,20
Uttar Pradesh,Kheri,Multiple Sclerosis,60,80,4,0,4
Madhya Pradesh,Khargone,Multiple Sclerosis,15,35,5,2,7
Madhya Pradesh,Khargone,Multiple Sclerosis,35,60,4,4,8
Madhya Pradesh,Khargone,Multiple Sclerosis,60,80,1,0,1
Bihar,Khagaria,Multiple Sclerosis,15,35,4,0,4
Bihar,Khagaria,Multiple Sclerosis,35,60,2,1,3
Bihar,Khagaria,Multiple Sclerosis,60,80,1,0,1
Odisha,Kendrapara,Multiple Sclerosis,6,15,0,1,1
Odisha,Kendrapara,Multiple Sclerosis,35,60,1,0,1
Uttar Pradesh,Kaushambi,Multiple Sclerosis,15,35,23,2,25
Uttar Pradesh,Kaushambi,Multiple Sclerosis,35,60,25,6,31
Uttar Pradesh,Kaushambi,Multiple Sclerosis,60,80,8,0,8
Madhya Pradesh,Katni,Multiple Sclerosis,6,15,2,0,2
Madhya Pradesh,Katni,Multiple Sclerosis,15,35,5,0,5
Madhya Pradesh,Katni,Multiple Sclerosis,35,60,2,2,4
Madhya Pradesh,Katni,Multiple Sclerosis,60,80,1,0,1
Bihar,Katihar,Multiple Sclerosis,6,15,0,3,3
Bihar,Katihar,Multiple Sclerosis,15,35,2,1,3
Bihar,Katihar,Multiple Sclerosis,35,60,2,2,4
Jammu And Kashmir,Kathua,Multiple Sclerosis,15,35,2,1,3
Jammu And Kashmir,Kathua,Multiple Sclerosis,35,60,5,6,11
Jammu And Kashmir,Kathua,Multiple Sclerosis,60,80,1,0,1
Uttar Pradesh,Kasganj,Multiple Sclerosis,15,35,27,6,33
Uttar Pradesh,Kasganj,Multiple Sclerosis,35,60,18,6,24
Uttar Pradesh,Kasganj,Multiple Sclerosis,60,80,3,2,5
Kerala,Kasaragod,Multiple Sclerosis,35,60,1,0,1
Tamil Nadu,Karur,Multiple Sclerosis,15,35,0,1,1
Tamil Nadu,Karur,Multiple Sclerosis,35,60,1,0,1
Haryana,Karnal,Multiple Sclerosis,6,15,0,2,2
Haryana,Karnal,Multiple Sclerosis,15,35,0,1,1
Haryana,Karnal,Multiple Sclerosis,35,60,1,2,3
Assam,Karimganj,Multiple Sclerosis,15,35,1,0,1
Assam,Karimganj,Multiple Sclerosis,35,60,2,0,2
Assam,Karbi Anglong,Multiple Sclerosis,6,15,0,1,1
Puducherry,Karaikal,Multiple Sclerosis,15,35,1,0,1
Puducherry,Karaikal,Multiple Sclerosis,35,60,0,1,1
Punjab,Kapurthala,Multiple Sclerosis,35,60,3,0,3
Uttar Pradesh,Kanpur Nagar,Multiple Sclerosis,6,15,1,0,1
Uttar Pradesh,Kanpur Nagar,Multiple Sclerosis,15,35,3,0,3
Uttar Pradesh,Kanpur Nagar,Multiple Sclerosis,35,60,13,3,16
Uttar Pradesh,Kanpur Nagar,Multiple Sclerosis,60,80,3,1,4
Uttar Pradesh,Kanpur Dehat,Multiple Sclerosis,15,35,8,3,11
Uttar Pradesh,Kanpur Dehat,Multiple Sclerosis,35,60,7,2,9
Uttar Pradesh,Kanpur Dehat,Multiple Sclerosis,60,80,2,0,2
Kerala,Kannur,Multiple Sclerosis,35,60,3,0,3
Kerala,Kannur,Multiple Sclerosis,60,80,1,0,1
Tamil Nadu,Kanniyakumari,Multiple Sclerosis,6,15,0,1,1
Tamil Nadu,Kanniyakumari,Multiple Sclerosis,15,35,1,1,2
Tamil Nadu,Kanniyakumari,Multiple Sclerosis,35,60,1,0,1
Uttar Pradesh,Kannauj,Multiple Sclerosis,15,35,0,1,1
Uttar Pradesh,Kannauj,Multiple Sclerosis,35,60,1,0,1
Chhattisgarh,Kanker,Multiple Sclerosis,0,6,1,0,1
Chhattisgarh,Kanker,Multiple Sclerosis,6,15,1,1,2
Chhattisgarh,Kanker,Multiple Sclerosis,15,35,7,5,12
Chhattisgarh,Kanker,Multiple Sclerosis,35,60,4,1,5
Chhattisgarh,Kanker,Multiple Sclerosis,60,80,3,0,3
Himachal Pradesh,Kangra,Multiple Sclerosis,6,15,1,1,2
Himachal Pradesh,Kangra,Multiple Sclerosis,15,35,4,2,6
Himachal Pradesh,Kangra,Multiple Sclerosis,35,60,5,0,5
Himachal Pradesh,Kangra,Multiple Sclerosis,80,100,0,1,1
Manipur,Kangpokpi,Multiple Sclerosis,15,35,0,1,1
Odisha,Kandhamal,Multiple Sclerosis,15,35,1,0,1
Odisha,Kandhamal,Multiple Sclerosis,35,60,1,3,4
Odisha,Kandhamal,Multiple Sclerosis,60,80,1,0,1
Tamil Nadu,Kanchipuram,Multiple Sclerosis,6,15,0,1,1
Tamil Nadu,Kanchipuram,Multiple Sclerosis,15,35,5,2,7
Tamil Nadu,Kanchipuram,Multiple Sclerosis,35,60,3,3,6
Tamil Nadu,Kanchipuram,Multiple Sclerosis,60,80,1,0,1
Assam,Kamrup Metro,Multiple Sclerosis,15,35,0,1,1
Assam,Kamrup,Multiple Sclerosis,35,60,1,0,1
Tamil Nadu,Kallakurichi,Multiple Sclerosis,6,15,0,1,1
Tamil Nadu,Kallakurichi,Multiple Sclerosis,15,35,0,1,1
Tamil Nadu,Kallakurichi,Multiple Sclerosis,35,60,0,1,1
Tamil Nadu,Kallakurichi,Multiple Sclerosis,60,80,0,1,1
Odisha,Kalahandi,Multiple Sclerosis,15,35,1,0,1
Odisha,Kalahandi,Multiple Sclerosis,35,60,0,1,1
Karnataka,Kalaburagi,Multiple Sclerosis,6,15,2,0,2
Karnataka,Kalaburagi,Multiple Sclerosis,15,35,4,2,6
Karnataka,Kalaburagi,Multiple Sclerosis,35,60,4,1,5
Haryana,Kaithal,Multiple Sclerosis,6,15,1,0,1
Haryana,Kaithal,Multiple Sclerosis,15,35,1,0,1
Haryana,Kaithal,Multiple Sclerosis,35,60,2,0,2
Haryana,Kaithal,Multiple Sclerosis,60,80,1,0,1
Bihar,Kaimur (Bhabua),Multiple Sclerosis,6,15,5,3,8
Bihar,Kaimur (Bhabua),Multiple Sclerosis,15,35,21,10,31
Bihar,Kaimur (Bhabua),Multiple Sclerosis,35,60,25,14,39
Bihar,Kaimur (Bhabua),Multiple Sclerosis,60,80,14,6,20
Bihar,Kaimur (Bhabua),Multiple Sclerosis,80,100,1,0,1
Chhattisgarh,Kabirdham,Multiple Sclerosis,6,15,1,1,2
Chhattisgarh,Kabirdham,Multiple Sclerosis,15,35,0,2,2
Gujarat,Junagadh,Multiple Sclerosis,6,15,0,1,1
Gujarat,Junagadh,Multiple Sclerosis,15,35,1,0,1
Gujarat,Junagadh,Multiple Sclerosis,35,60,1,3,4
Rajasthan,Jodhpur,Multiple Sclerosis,15,35,0,1,1
Rajasthan,Jodhpur,Multiple Sclerosis,35,60,3,0,3
Rajasthan,Jhunjhunu,Multiple Sclerosis,6,15,1,0,1
Rajasthan,Jhunjhunu,Multiple Sclerosis,15,35,2,2,4
Rajasthan,Jhunjhunu,Multiple Sclerosis,35,60,2,1,3
Rajasthan,Jhunjhunu,Multiple Sclerosis,60,80,1,0,1
Odisha,Jharsuguda,Multiple Sclerosis,6,15,2,1,3
Odisha,Jharsuguda,Multiple Sclerosis,15,35,2,1,3
Odisha,Jharsuguda,Multiple Sclerosis,35,60,4,0,4
Odisha,Jharsuguda,Multiple Sclerosis,60,80,2,0,2
Odisha,Jharsuguda,Multiple Sclerosis,80,100,1,0,1
Uttar Pradesh,Jhansi,Multiple Sclerosis,6,15,0,1,1
Uttar Pradesh,Jhansi,Multiple Sclerosis,15,35,2,3,5
Uttar Pradesh,Jhansi,Multiple Sclerosis,35,60,8,3,11
Rajasthan,Jhalawar,Multiple Sclerosis,0,6,0,1,1
Rajasthan,Jhalawar,Multiple Sclerosis,15,35,1,0,1
Rajasthan,Jhalawar,Multiple Sclerosis,35,60,2,0,2
Rajasthan,Jhalawar,Multiple Sclerosis,60,80,0,1,1
Haryana,Jhajjar,Multiple Sclerosis,35,60,3,0,3
Madhya Pradesh,Jhabua,Multiple Sclerosis,6,15,1,0,1
Madhya Pradesh,Jhabua,Multiple Sclerosis,15,35,3,0,3
Madhya Pradesh,Jhabua,Multiple Sclerosis,35,60,12,11,23
Madhya Pradesh,Jhabua,Multiple Sclerosis,60,80,3,2,5
Madhya Pradesh,Jhabua,Multiple Sclerosis,80,100,1,0,1
Bihar,Jehanabad,Multiple Sclerosis,15,35,2,1,3
Bihar,Jehanabad,Multiple Sclerosis,35,60,1,0,1
Uttar Pradesh,Jaunpur,Multiple Sclerosis,0,6,0,1,1
Uttar Pradesh,Jaunpur,Multiple Sclerosis,6,15,2,0,2
Uttar Pradesh,Jaunpur,Multiple Sclerosis,15,35,14,2,16
Uttar Pradesh,Jaunpur,Multiple Sclerosis,35,60,16,5,21
Uttar Pradesh,Jaunpur,Multiple Sclerosis,60,80,2,0,2
Chhattisgarh,Jashpur,Multiple Sclerosis,35,60,1,0,1
Chhattisgarh,Janjgir-Champa,Multiple Sclerosis,6,15,0,1,1
Chhattisgarh,Janjgir-Champa,Multiple Sclerosis,15,35,1,1,2
Chhattisgarh,Janjgir-Champa,Multiple Sclerosis,35,60,0,1,1
Bihar,Jamui,Multiple Sclerosis,6,15,3,0,3
Bihar,Jamui,Multiple Sclerosis,15,35,3,1,4
Bihar,Jamui,Multiple Sclerosis,35,60,2,1,3
Jharkhand,Jamtara,Multiple Sclerosis,15,35,2,0,2
Jharkhand,Jamtara,Multiple Sclerosis,35,60,2,0,2
Gujarat,Jamnagar,Multiple Sclerosis,15,35,1,0,1
Gujarat,Jamnagar,Multiple Sclerosis,35,60,0,1,1
Jammu And Kashmir,Jammu,Multiple Sclerosis,6,15,0,1,1
Jammu And Kashmir,Jammu,Multiple Sclerosis,15,35,3,3,6
Jammu And Kashmir,Jammu,Multiple Sclerosis,35,60,7,3,10
Jammu And Kashmir,Jammu,Multiple Sclerosis,60,80,1,0,1
Rajasthan,Jalore,Multiple Sclerosis,6,15,2,3,5
Rajasthan,Jalore,Multiple Sclerosis,15,35,4,2,6
Rajasthan,Jalore,Multiple Sclerosis,35,60,10,4,14
Rajasthan,Jalore,Multiple Sclerosis,60,80,1,1,2
Maharashtra,Jalna,Multiple Sclerosis,35,60,4,2,6
Maharashtra,Jalgaon,Multiple Sclerosis,6,15,0,1,1
Maharashtra,Jalgaon,Multiple Sclerosis,15,35,0,1,1
Maharashtra,Jalgaon,Multiple Sclerosis,35,60,3,0,3
Maharashtra,Jalgaon,Multiple Sclerosis,60,80,2,1,3
Uttar Pradesh,Jalaun,Multiple Sclerosis,15,35,4,3,7
Uttar Pradesh,Jalaun,Multiple Sclerosis,35,60,9,4,13
Uttar Pradesh,Jalaun,Multiple Sclerosis,60,80,3,2,5
Punjab,Jalandhar,Multiple Sclerosis,15,35,0,7,7
Punjab,Jalandhar,Multiple Sclerosis,35,60,5,6,11
Punjab,Jalandhar,Multiple Sclerosis,60,80,3,1,4
Odisha,Jajapur,Multiple Sclerosis,6,15,1,0,1
Odisha,Jajapur,Multiple Sclerosis,35,60,3,0,3
Rajasthan,Jaisalmer,Multiple Sclerosis,35,60,2,0,2
Rajasthan,Jaipur,Multiple Sclerosis,6,15,2,2,4
Rajasthan,Jaipur,Multiple Sclerosis,15,35,11,5,16
Rajasthan,Jaipur,Multiple Sclerosis,35,60,11,2,13
Rajasthan,Jaipur,Multiple Sclerosis,60,80,4,0,4
Rajasthan,Jaipur,Multiple Sclerosis,80,100,1,0,1
Odisha,Jagatsinghapur,Multiple Sclerosis,6,15,1,0,1
Odisha,Jagatsinghapur,Multiple Sclerosis,15,35,0,1,1
Odisha,Jagatsinghapur,Multiple Sclerosis,35,60,2,0,2
Odisha,Jagatsinghapur,Multiple Sclerosis,60,80,0,1,1
Madhya Pradesh,Jabalpur,Multiple Sclerosis,15,35,3,1,4
Madhya Pradesh,Jabalpur,Multiple Sclerosis,35,60,6,2,8
Madhya Pradesh,Jabalpur,Multiple Sclerosis,60,80,1,0,1
Madhya Pradesh,Indore,Multiple Sclerosis,15,35,8,3,11
Madhya Pradesh,Indore,Multiple Sclerosis,35,60,7,1,8
Madhya Pradesh,Indore,Multiple Sclerosis,60,80,1,0,1
Manipur,Imphal West,Multiple Sclerosis,35,60,1,0,1
Kerala,Idukki,Multiple Sclerosis,6,15,0,1,1
Kerala,Idukki,Multiple Sclerosis,35,60,2,2,4
Kerala,Idukki,Multiple Sclerosis,60,80,1,1,2
Punjab,Hoshiarpur,Multiple Sclerosis,0,6,1,1,2
Punjab,Hoshiarpur,Multiple Sclerosis,15,35,14,10,24
Punjab,Hoshiarpur,Multiple Sclerosis,35,60,42,17,59
Punjab,Hoshiarpur,Multiple Sclerosis,60,80,13,1,14
Assam,Hojai,Multiple Sclerosis,15,35,1,0,1
Haryana,Hisar,Multiple Sclerosis,15,35,3,3,6
Haryana,Hisar,Multiple Sclerosis,35,60,3,0,3
Haryana,Hisar,Multiple Sclerosis,60,80,1,0,1
Maharashtra,Hingoli,Multiple Sclerosis,15,35,2,2,4
Maharashtra,Hingoli,Multiple Sclerosis,35,60,4,0,4
Jharkhand,Hazaribagh,Multiple Sclerosis,15,35,4,3,7
Jharkhand,Hazaribagh,Multiple Sclerosis,35,60,5,0,5
Jharkhand,Hazaribagh,Multiple Sclerosis,60,80,2,0,2
Karnataka,Haveri,Multiple Sclerosis,6,15,3,1,4
Karnataka,Haveri,Multiple Sclerosis,15,35,5,2,7
Karnataka,Haveri,Multiple Sclerosis,35,60,10,10,20
Karnataka,Haveri,Multiple Sclerosis,60,80,6,1,7
Karnataka,Haveri,Multiple Sclerosis,80,100,1,0,1
Uttar Pradesh,Hathras,Multiple Sclerosis,15,35,8,0,8
Uttar Pradesh,Hathras,Multiple Sclerosis,35,60,4,1,5
Uttar Pradesh,Hathras,Multiple Sclerosis,60,80,5,1,6
Karnataka,Hassan,Multiple Sclerosis,6,15,2,0,2
Karnataka,Hassan,Multiple Sclerosis,15,35,9,5,14
Karnataka,Hassan,Multiple Sclerosis,35,60,3,4,7
Karnataka,Hassan,Multiple Sclerosis,60,80,3,1,4
Uttarakhand,Haridwar,Multiple Sclerosis,6,15,1,0,1
Uttarakhand,Haridwar,Multiple Sclerosis,15,35,2,1,3
Uttarakhand,Haridwar,Multiple Sclerosis,35,60,5,0,5
Uttar Pradesh,Hardoi,Multiple Sclerosis,6,15,1,0,1
Uttar Pradesh,Hardoi,Multiple Sclerosis,15,35,21,2,23
Uttar Pradesh,Hardoi,Multiple Sclerosis,35,60,37,6,43
Uttar Pradesh,Hardoi,Multiple Sclerosis,60,80,18,0,18
Uttar Pradesh,Hardoi,Multiple Sclerosis,80,100,1,0,1
Madhya Pradesh,Harda,Multiple Sclerosis,35,60,2,0,2
Uttar Pradesh,Hapur,Multiple Sclerosis,15,35,1,0,1
Uttar Pradesh,Hapur,Multiple Sclerosis,35,60,2,0,2
Rajasthan,Hanumangarh,Multiple Sclerosis,15,35,3,2,5
Rajasthan,Hanumangarh,Multiple Sclerosis,35,60,0,3,3
Himachal Pradesh,Hamirpur,Multiple Sclerosis,35,60,2,1,3
Uttar Pradesh,Hamirpur,Multiple Sclerosis,0,6,0,1,1
Uttar Pradesh,Hamirpur,Multiple Sclerosis,6,15,18,9,27
Uttar Pradesh,Hamirpur,Multiple Sclerosis,15,35,7,5,12
Uttar Pradesh,Hamirpur,Multiple Sclerosis,35,60,14,3,17
Uttar Pradesh,Hamirpur,Multiple Sclerosis,60,80,4,1,5
Madhya Pradesh,Gwalior,Multiple Sclerosis,6,15,0,1,1
Madhya Pradesh,Gwalior,Multiple Sclerosis,15,35,1,0,1
Madhya Pradesh,Gwalior,Multiple Sclerosis,35,60,2,0,2
Haryana,Gurugram,Multiple Sclerosis,15,35,0,3,3
Haryana,Gurugram,Multiple Sclerosis,35,60,1,1,2
Punjab,Gurdaspur,Multiple Sclerosis,6,15,1,0,1
Punjab,Gurdaspur,Multiple Sclerosis,15,35,4,1,5
Punjab,Gurdaspur,Multiple Sclerosis,35,60,1,1,2
Punjab,Gurdaspur,Multiple Sclerosis,60,80,1,1,2
Andhra Pradesh,Guntur,Multiple Sclerosis,6,15,1,0,1
Andhra Pradesh,Guntur,Multiple Sclerosis,35,60,0,1,1
Madhya Pradesh,Guna,Multiple Sclerosis,15,35,3,1,4
Jharkhand,Gumla,Multiple Sclerosis,6,15,2,6,8
Jharkhand,Gumla,Multiple Sclerosis,15,35,25,10,35
Jharkhand,Gumla,Multiple Sclerosis,35,60,28,13,41
Jharkhand,Gumla,Multiple Sclerosis,60,80,17,6,23
Uttar Pradesh,Gorakhpur,Multiple Sclerosis,6,15,2,2,4
Uttar Pradesh,Gorakhpur,Multiple Sclerosis,15,35,16,4,20
Uttar Pradesh,Gorakhpur,Multiple Sclerosis,35,60,21,6,27
Uttar Pradesh,Gorakhpur,Multiple Sclerosis,60,80,4,1,5
Uttar Pradesh,Gorakhpur,Multiple Sclerosis,80,100,1,0,1
Bihar,Gopalganj,Multiple Sclerosis,15,35,1,0,1
Bihar,Gopalganj,Multiple Sclerosis,35,60,3,0,3
Bihar,Gopalganj,Multiple Sclerosis,60,80,1,0,1
Maharashtra,Gondia,Multiple Sclerosis,15,35,1,0,1
Maharashtra,Gondia,Multiple Sclerosis,35,60,1,0,1
Uttar Pradesh,Gonda,Multiple Sclerosis,6,15,4,1,5
Uttar Pradesh,Gonda,Multiple Sclerosis,15,35,17,5,22
Uttar Pradesh,Gonda,Multiple Sclerosis,35,60,20,8,28
Uttar Pradesh,Gonda,Multiple Sclerosis,60,80,6,1,7
Assam,Golaghat,Multiple Sclerosis,6,15,1,0,1
Assam,Golaghat,Multiple Sclerosis,15,35,0,1,1
Assam,Golaghat,Multiple Sclerosis,35,60,1,0,1
Jharkhand,Godda,Multiple Sclerosis,6,15,6,2,8
Jharkhand,Godda,Multiple Sclerosis,15,35,28,7,35
Jharkhand,Godda,Multiple Sclerosis,35,60,19,7,26
Jharkhand,Godda,Multiple Sclerosis,60,80,8,1,9
Jharkhand,Godda,Multiple Sclerosis,80,100,0,1,1
Assam,Goalpara,Multiple Sclerosis,6,15,3,0,3
Assam,Goalpara,Multiple Sclerosis,15,35,5,2,7
Assam,Goalpara,Multiple Sclerosis,35,60,4,1,5
Assam,Goalpara,Multiple Sclerosis,60,80,0,1,1
Jharkhand,Giridih,Multiple Sclerosis,6,15,1,0,1
Jharkhand,Giridih,Multiple Sclerosis,15,35,4,4,8
Jharkhand,Giridih,Multiple Sclerosis,35,60,1,1,2
Uttar Pradesh,Ghazipur,Multiple Sclerosis,15,35,12,0,12
Uttar Pradesh,Ghazipur,Multiple Sclerosis,35,60,6,4,10
Uttar Pradesh,Ghazipur,Multiple Sclerosis,60,80,1,1,2
Uttar Pradesh,Ghaziabad,Multiple Sclerosis,6,15,1,0,1
Uttar Pradesh,Ghaziabad,Multiple Sclerosis,15,35,3,2,5
Uttar Pradesh,Ghaziabad,Multiple Sclerosis,35,60,5,0,5
Bihar,Gaya,Multiple Sclerosis,15,35,0,1,1
Bihar,Gaya,Multiple Sclerosis,60,80,1,0,1
Uttar Pradesh,Gautam Buddha Nagar,Multiple Sclerosis,6,15,0,1,1
Uttar Pradesh,Gautam Buddha Nagar,Multiple Sclerosis,15,35,4,0,4
Uttar Pradesh,Gautam Buddha Nagar,Multiple Sclerosis,35,60,4,4,8
Chhattisgarh,Gariyaband,Multiple Sclerosis,6,15,5,6,11
Chhattisgarh,Gariyaband,Multiple Sclerosis,15,35,38,24,62
Chhattisgarh,Gariyaband,Multiple Sclerosis,35,60,52,22,74
Chhattisgarh,Gariyaband,Multiple Sclerosis,60,80,10,4,14
Jharkhand,Garhwa,Multiple Sclerosis,6,15,0,1,1
Jharkhand,Garhwa,Multiple Sclerosis,15,35,2,0,2
Jharkhand,Garhwa,Multiple Sclerosis,35,60,4,1,5
Odisha,Ganjam,Multiple Sclerosis,15,35,1,0,1
Sikkim,Gangtok,Multiple Sclerosis,15,35,0,1,1
Sikkim,Gangtok,Multiple Sclerosis,35,60,1,0,1
Rajasthan,Ganganagar,Multiple Sclerosis,0,6,0,1,1
Rajasthan,Ganganagar,Multiple Sclerosis,6,15,1,0,1
Rajasthan,Ganganagar,Multiple Sclerosis,15,35,5,2,7
Rajasthan,Ganganagar,Multiple Sclerosis,35,60,2,4,6
Gujarat,Gandhinagar,Multiple Sclerosis,35,60,1,0,1
Jammu And Kashmir,Ganderbal,Multiple Sclerosis,6,15,3,0,3
Jammu And Kashmir,Ganderbal,Multiple Sclerosis,15,35,4,2,6
Odisha,Gajapati,Multiple Sclerosis,35,60,0,1,1
Maharashtra,Gadchiroli,Multiple Sclerosis,6,15,1,0,1
Maharashtra,Gadchiroli,Multiple Sclerosis,15,35,4,1,5
Maharashtra,Gadchiroli,Multiple Sclerosis,35,60,5,1,6
Maharashtra,Gadchiroli,Multiple Sclerosis,60,80,1,0,1
Karnataka,Gadag,Multiple Sclerosis,0,6,1,0,1
Karnataka,Gadag,Multiple Sclerosis,6,15,3,0,3
Karnataka,Gadag,Multiple Sclerosis,15,35,1,2,3
Karnataka,Gadag,Multiple Sclerosis,35,60,1,2,3
Karnataka,Gadag,Multiple Sclerosis,80,100,1,0,1
Uttar Pradesh,Firozabad,Multiple Sclerosis,6,15,2,2,4
Uttar Pradesh,Firozabad,Multiple Sclerosis,15,35,7,0,7
Uttar Pradesh,Firozabad,Multiple Sclerosis,35,60,4,3,7
Uttar Pradesh,Firozabad,Multiple Sclerosis,60,80,1,0,1
Punjab,Ferozepur,Multiple Sclerosis,6,15,1,0,1
Punjab,Ferozepur,Multiple Sclerosis,15,35,1,1,2
Punjab,Ferozepur,Multiple Sclerosis,35,60,1,2,3
Punjab,Fazilka,Multiple Sclerosis,0,6,0,1,1
Punjab,Fazilka,Multiple Sclerosis,6,15,1,0,1
Punjab,Fazilka,Multiple Sclerosis,15,35,1,0,1
Punjab,Fazilka,Multiple Sclerosis,35,60,5,1,6
Punjab,Fazilka,Multiple Sclerosis,60,80,1,1,2
Uttar Pradesh,Fatehpur,Multiple Sclerosis,15,35,13,2,15
Uttar Pradesh,Fatehpur,Multiple Sclerosis,35,60,18,2,20
Uttar Pradesh,Fatehpur,Multiple Sclerosis,60,80,6,1,7
Uttar Pradesh,Fatehpur,Multiple Sclerosis,80,100,4,0,4
Punjab,Fatehgarh Sahib,Multiple Sclerosis,6,15,0,1,1
Punjab,Fatehgarh Sahib,Multiple Sclerosis,15,35,1,0,1
Punjab,Fatehgarh Sahib,Multiple Sclerosis,35,60,9,4,13
Punjab,Fatehgarh Sahib,Multiple Sclerosis,60,80,2,0,2
Haryana,Fatehabad,Multiple Sclerosis,6,15,1,0,1
Haryana,Fatehabad,Multiple Sclerosis,15,35,3,2,5
Haryana,Fatehabad,Multiple Sclerosis,35,60,7,1,8
Uttar Pradesh,Farrukhabad,Multiple Sclerosis,6,15,1,1,2
Uttar Pradesh,Farrukhabad,Multiple Sclerosis,15,35,18,5,23
Uttar Pradesh,Farrukhabad,Multiple Sclerosis,35,60,39,4,43
Uttar Pradesh,Farrukhabad,Multiple Sclerosis,60,80,7,2,9
Punjab,Faridkot,Multiple Sclerosis,15,35,1,0,1
Punjab,Faridkot,Multiple Sclerosis,35,60,0,1,1
Haryana,Faridabad,Multiple Sclerosis,15,35,0,1,1
Uttar Pradesh,Etawah,Multiple Sclerosis,6,15,2,0,2
Uttar Pradesh,Etawah,Multiple Sclerosis,15,35,21,3,24
Uttar Pradesh,Etawah,Multiple Sclerosis,35,60,34,9,43
Uttar Pradesh,Etawah,Multiple Sclerosis,60,80,8,1,9
Uttar Pradesh,Etah,Multiple Sclerosis,15,35,18,6,24
Uttar Pradesh,Etah,Multiple Sclerosis,35,60,22,7,29
Uttar Pradesh,Etah,Multiple Sclerosis,60,80,2,3,5
Tamil Nadu,Erode,Multiple Sclerosis,6,15,1,0,1
Tamil Nadu,Erode,Multiple Sclerosis,15,35,0,2,2
Tamil Nadu,Erode,Multiple Sclerosis,35,60,0,2,2
Kerala,Ernakulam,Multiple Sclerosis,15,35,0,1,1
Kerala,Ernakulam,Multiple Sclerosis,35,60,1,3,4
Kerala,Ernakulam,Multiple Sclerosis,60,80,0,1,1
Jharkhand,East Singhbum,Multiple Sclerosis,6,15,1,0,1
Jharkhand,East Singhbum,Multiple Sclerosis,15,35,11,10,21
Jharkhand,East Singhbum,Multiple Sclerosis,35,60,13,6,19
Jharkhand,East Singhbum,Multiple Sclerosis,60,80,3,1,4
Madhya Pradesh,East Nimar,Multiple Sclerosis,6,15,2,2,4
Madhya Pradesh,East Nimar,Multiple Sclerosis,15,35,8,1,9
Madhya Pradesh,East Nimar,Multiple Sclerosis,35,60,2,0,2
Madhya Pradesh,East Nimar,Multiple Sclerosis,60,80,1,0,1
Arunachal Pradesh,East Kameng,Multiple Sclerosis,15,35,1,0,1
Delhi,East,Multiple Sclerosis,15,35,2,1,3
Delhi,East,Multiple Sclerosis,35,60,1,0,1
Chhattisgarh,Durg,Multiple Sclerosis,15,35,2,5,7
Chhattisgarh,Durg,Multiple Sclerosis,35,60,2,0,2
Rajasthan,Dungarpur,Multiple Sclerosis,6,15,0,1,1
Jharkhand,Dumka,Multiple Sclerosis,6,15,3,2,5
Jharkhand,Dumka,Multiple Sclerosis,15,35,3,2,5
Jharkhand,Dumka,Multiple Sclerosis,35,60,5,3,8
Jharkhand,Dumka,Multiple Sclerosis,60,80,3,1,4
Gujarat,Dohad,Multiple Sclerosis,6,15,1,0,1
Jammu And Kashmir,Doda,Multiple Sclerosis,6,15,0,1,1
Jammu And Kashmir,Doda,Multiple Sclerosis,15,35,3,1,4
Jammu And Kashmir,Doda,Multiple Sclerosis,35,60,0,4,4
Jammu And Kashmir,Doda,Multiple Sclerosis,60,80,1,1,2
Madhya Pradesh,Dindori,Multiple Sclerosis,6,15,4,1,5
Madhya Pradesh,Dindori,Multiple Sclerosis,15,35,5,8,13
Madhya Pradesh,Dindori,Multiple Sclerosis,35,60,2,1,3
Tamil Nadu,Dindigul,Multiple Sclerosis,15,35,2,2,4
Tamil Nadu,Dindigul,Multiple Sclerosis,35,60,4,2,6
Assam,Dima Hasao,Multiple Sclerosis,35,60,5,0,5
Assam,Dima Hasao,Multiple Sclerosis,60,80,0,1,1
Assam,Dibrugarh,Multiple Sclerosis,15,35,1,0,1
Assam,Dibrugarh,Multiple Sclerosis,35,60,0,1,1
Maharashtra,Dhule,Multiple Sclerosis,6,15,2,0,2
Maharashtra,Dhule,Multiple Sclerosis,15,35,5,3,8
Maharashtra,Dhule,Multiple Sclerosis,35,60,15,2,17
Maharashtra,Dhule,Multiple Sclerosis,60,80,3,1,4
Assam,Dhubri,Multiple Sclerosis,6,15,1,0,1
Assam,Dhubri,Multiple Sclerosis,15,35,1,1,2
Assam,Dhubri,Multiple Sclerosis,35,60,0,1,1
Assam,Dhubri,Multiple Sclerosis,80,100,1,0,1
Odisha,Dhenkanal,Multiple Sclerosis,6,15,2,0,2
Odisha,Dhenkanal,Multiple Sclerosis,15,35,4,2,6
Odisha,Dhenkanal,Multiple Sclerosis,35,60,3,4,7
Odisha,Dhenkanal,Multiple Sclerosis,60,80,3,1,4
Assam,Dhemaji,Multiple Sclerosis,35,60,0,1,1
Karnataka,Dharwad,Multiple Sclerosis,15,35,1,0,1
Karnataka,Dharwad,Multiple Sclerosis,35,60,0,1,1
Karnataka,Dharwad,Multiple Sclerosis,60,80,1,0,1
Tamil Nadu,Dharmapuri,Multiple Sclerosis,6,15,0,3,3
Tamil Nadu,Dharmapuri,Multiple Sclerosis,15,35,5,4,9
Tamil Nadu,Dharmapuri,Multiple Sclerosis,35,60,1,1,2
Tamil Nadu,Dharmapuri,Multiple Sclerosis,60,80,0,1,1
Madhya Pradesh,Dhar,Multiple Sclerosis,6,15,4,2,6
Madhya Pradesh,Dhar,Multiple Sclerosis,15,35,6,5,11
Madhya Pradesh,Dhar,Multiple Sclerosis,35,60,6,0,6
Jharkhand,Dhanbad,Multiple Sclerosis,15,35,6,4,10
Jharkhand,Dhanbad,Multiple Sclerosis,35,60,3,3,6
Jharkhand,Dhanbad,Multiple Sclerosis,60,80,1,0,1
Chhattisgarh,Dhamtari,Multiple Sclerosis,0,6,0,1,1
Chhattisgarh,Dhamtari,Multiple Sclerosis,6,15,3,4,7
Chhattisgarh,Dhamtari,Multiple Sclerosis,15,35,11,7,18
Chhattisgarh,Dhamtari,Multiple Sclerosis,35,60,6,2,8
Madhya Pradesh,Dewas,Multiple Sclerosis,6,15,2,1,3
Madhya Pradesh,Dewas,Multiple Sclerosis,15,35,7,2,9
Madhya Pradesh,Dewas,Multiple Sclerosis,35,60,6,1,7
Madhya Pradesh,Dewas,Multiple Sclerosis,60,80,3,1,4
Uttar Pradesh,Deoria,Multiple Sclerosis,6,15,2,0,2
Uttar Pradesh,Deoria,Multiple Sclerosis,15,35,19,3,22
Uttar Pradesh,Deoria,Multiple Sclerosis,35,60,19,4,23
Uttar Pradesh,Deoria,Multiple Sclerosis,60,80,1,1,2
Uttar Pradesh,Deoria,Multiple Sclerosis,80,100,1,0,1
Jharkhand,Deoghar,Multiple Sclerosis,6,15,1,0,1
Jharkhand,Deoghar,Multiple Sclerosis,15,35,3,1,4
Jharkhand,Deoghar,Multiple Sclerosis,35,60,5,1,6
Jharkhand,Deoghar,Multiple Sclerosis,60,80,1,0,1
Odisha,Deogarh,Multiple Sclerosis,35,60,1,1,2
Uttarakhand,Dehradun,Multiple Sclerosis,6,15,2,0,2
Uttarakhand,Dehradun,Multiple Sclerosis,15,35,3,1,4
Uttarakhand,Dehradun,Multiple Sclerosis,35,60,7,1,8
Uttarakhand,Dehradun,Multiple Sclerosis,60,80,1,0,1
Karnataka,Davangere,Multiple Sclerosis,6,15,1,0,1
Karnataka,Davangere,Multiple Sclerosis,15,35,1,0,1
Karnataka,Davangere,Multiple Sclerosis,35,60,4,1,5
Karnataka,Davangere,Multiple Sclerosis,60,80,1,1,2
Rajasthan,Dausa,Multiple Sclerosis,6,15,1,0,1
Rajasthan,Dausa,Multiple Sclerosis,15,35,4,4,8
Rajasthan,Dausa,Multiple Sclerosis,35,60,6,3,9
Bihar,Darbhanga,Multiple Sclerosis,6,15,3,1,4
Bihar,Darbhanga,Multiple Sclerosis,15,35,2,3,5
Bihar,Darbhanga,Multiple Sclerosis,35,60,2,0,2
Madhya Pradesh,Damoh,Multiple Sclerosis,6,15,1,2,3
Madhya Pradesh,Damoh,Multiple Sclerosis,15,35,23,12,35
Madhya Pradesh,Damoh,Multiple Sclerosis,35,60,35,16,51
Madhya Pradesh,Damoh,Multiple Sclerosis,60,80,2,3,5
Madhya Pradesh,Damoh,Multiple Sclerosis,80,100,1,0,1
Karnataka,Dakshina Kannada,Multiple Sclerosis,0,6,1,0,1
Karnataka,Dakshina Kannada,Multiple Sclerosis,6,15,0,1,1
Karnataka,Dakshina Kannada,Multiple Sclerosis,15,35,0,1,1
Karnataka,Dakshina Kannada,Multiple Sclerosis,35,60,2,1,3
Odisha,Cuttack,Multiple Sclerosis,0,6,1,1,2
Odisha,Cuttack,Multiple Sclerosis,6,15,2,1,3
Odisha,Cuttack,Multiple Sclerosis,15,35,1,2,3
Odisha,Cuttack,Multiple Sclerosis,35,60,5,0,5
Odisha,Cuttack,Multiple Sclerosis,60,80,4,2,6
Tamil Nadu,Cuddalore,Multiple Sclerosis,6,15,1,0,1
Tamil Nadu,Cuddalore,Multiple Sclerosis,15,35,2,2,4
Tamil Nadu,Cuddalore,Multiple Sclerosis,35,60,0,3,3
Tamil Nadu,Coimbatore,Multiple Sclerosis,6,15,0,1,1
Tamil Nadu,Coimbatore,Multiple Sclerosis,35,60,4,1,5
Tamil Nadu,Coimbatore,Multiple Sclerosis,60,80,2,0,2
Rajasthan,Churu,Multiple Sclerosis,0,6,1,1,2
Rajasthan,Churu,Multiple Sclerosis,6,15,1,0,1
Rajasthan,Churu,Multiple Sclerosis,15,35,1,0,1
Rajasthan,Churu,Multiple Sclerosis,35,60,2,0,2
Rajasthan,Chittorgarh,Multiple Sclerosis,6,15,3,1,4
Rajasthan,Chittorgarh,Multiple Sclerosis,15,35,2,0,2
Rajasthan,Chittorgarh,Multiple Sclerosis,35,60,4,1,5
Rajasthan,Chittorgarh,Multiple Sclerosis,60,80,2,0,2
Uttar Pradesh,Chitrakoot,Multiple Sclerosis,6,15,3,1,4
Uttar Pradesh,Chitrakoot,Multiple Sclerosis,15,35,8,3,11
Uttar Pradesh,Chitrakoot,Multiple Sclerosis,35,60,7,1,8
Uttar Pradesh,Chitrakoot,Multiple Sclerosis,60,80,2,0,2
Karnataka,Chitradurga,Multiple Sclerosis,6,15,3,2,5
Karnataka,Chitradurga,Multiple Sclerosis,15,35,8,7,15
Karnataka,Chitradurga,Multiple Sclerosis,35,60,14,5,19
Karnataka,Chitradurga,Multiple Sclerosis,60,80,5,0,5
Karnataka,Chikkamagaluru,Multiple Sclerosis,6,15,2,1,3
Karnataka,Chikkamagaluru,Multiple Sclerosis,15,35,1,1,2
Karnataka,Chikkamagaluru,Multiple Sclerosis,35,60,5,4,9
Karnataka,Chikkamagaluru,Multiple Sclerosis,60,80,1,0,1
Karnataka,Chikkaballapura,Multiple Sclerosis,15,35,1,2,3
Karnataka,Chikkaballapura,Multiple Sclerosis,35,60,4,0,4
Gujarat,Chhotaudepur,Multiple Sclerosis,6,15,0,1,1
Gujarat,Chhotaudepur,Multiple Sclerosis,15,35,0,1,1
Madhya Pradesh,Chhindwara,Multiple Sclerosis,6,15,1,3,4
Madhya Pradesh,Chhindwara,Multiple Sclerosis,15,35,5,3,8
Madhya Pradesh,Chhindwara,Multiple Sclerosis,35,60,6,2,8
Madhya Pradesh,Chhindwara,Multiple Sclerosis,60,80,1,1,2
Madhya Pradesh,Chhatarpur,Multiple Sclerosis,6,15,1,0,1
Madhya Pradesh,Chhatarpur,Multiple Sclerosis,15,35,6,1,7
Madhya Pradesh,Chhatarpur,Multiple Sclerosis,35,60,1,3,4
Madhya Pradesh,Chhatarpur,Multiple Sclerosis,60,80,1,1,2
Tamil Nadu,Chennai,Multiple Sclerosis,6,15,1,0,1
Tamil Nadu,Chennai,Multiple Sclerosis,15,35,7,9,16
Tamil Nadu,Chennai,Multiple Sclerosis,35,60,13,26,39
Tamil Nadu,Chennai,Multiple Sclerosis,60,80,3,2,5
Tamil Nadu,Chengalpattu,Multiple Sclerosis,15,35,0,2,2
Tamil Nadu,Chengalpattu,Multiple Sclerosis,35,60,0,1,1
Jharkhand,Chatra,Multiple Sclerosis,15,35,1,1,2
Haryana,Charki Dadri,Multiple Sclerosis,6,15,0,1,1
Haryana,Charki Dadri,Multiple Sclerosis,15,35,0,1,1
Maharashtra,Chandrapur,Multiple Sclerosis,35,60,1,0,1
Chandigarh,Chandigarh,Multiple Sclerosis,6,15,0,1,1
Chandigarh,Chandigarh,Multiple Sclerosis,15,35,0,2,2
Chandigarh,Chandigarh,Multiple Sclerosis,35,60,7,3,10
Chandigarh,Chandigarh,Multiple Sclerosis,60,80,1,1,2
Uttarakhand,Champawat,Multiple Sclerosis,6,15,1,0,1
Uttarakhand,Champawat,Multiple Sclerosis,15,35,1,3,4
Uttarakhand,Champawat,Multiple Sclerosis,35,60,8,1,9
Uttarakhand,Champawat,Multiple Sclerosis,60,80,3,1,4
Uttarakhand,Champawat,Multiple Sclerosis,80,100,0,1,1
Uttarakhand,Chamoli,Multiple Sclerosis,6,15,1,5,6
Uttarakhand,Chamoli,Multiple Sclerosis,15,35,6,6,12
Uttarakhand,Chamoli,Multiple Sclerosis,35,60,17,2,19
Uttarakhand,Chamoli,Multiple Sclerosis,60,80,2,0,2
Himachal Pradesh,Chamba,Multiple Sclerosis,35,60,1,0,1
Karnataka,Chamarajanagara,Multiple Sclerosis,15,35,1,2,3
Karnataka,Chamarajanagara,Multiple Sclerosis,35,60,5,0,5
Karnataka,Chamarajanagara,Multiple Sclerosis,60,80,1,1,2
Delhi,Central,Multiple Sclerosis,15,35,1,0,1
Assam,Cachar,Multiple Sclerosis,6,15,1,1,2
Assam,Cachar,Multiple Sclerosis,15,35,9,1,10
Assam,Cachar,Multiple Sclerosis,35,60,4,1,5
Bihar,Buxar,Multiple Sclerosis,15,35,1,2,3
Bihar,Buxar,Multiple Sclerosis,35,60,2,0,2
Madhya Pradesh,Burhanpur,Multiple Sclerosis,6,15,3,0,3
Madhya Pradesh,Burhanpur,Multiple Sclerosis,15,35,2,1,3
Madhya Pradesh,Burhanpur,Multiple Sclerosis,35,60,2,0,2
Rajasthan,Bundi,Multiple Sclerosis,6,15,0,2,2
Rajasthan,Bundi,Multiple Sclerosis,15,35,1,1,2
Rajasthan,Bundi,Multiple Sclerosis,35,60,0,1,1
Maharashtra,Buldhana,Multiple Sclerosis,35,60,1,0,1
Maharashtra,Buldhana,Multiple Sclerosis,60,80,1,0,1
Uttar Pradesh,Bulandshahr,Multiple Sclerosis,6,15,1,0,1
Uttar Pradesh,Bulandshahr,Multiple Sclerosis,15,35,12,4,16
Uttar Pradesh,Bulandshahr,Multiple Sclerosis,35,60,18,1,19
Uttar Pradesh,Bulandshahr,Multiple Sclerosis,60,80,3,0,3
Uttar Pradesh,Bulandshahr,Multiple Sclerosis,80,100,0,1,1
Jammu And Kashmir,Budgam,Multiple Sclerosis,15,35,2,1,3
Jammu And Kashmir,Budgam,Multiple Sclerosis,35,60,2,3,5
Uttar Pradesh,Budaun,Multiple Sclerosis,6,15,1,0,1
Uttar Pradesh,Budaun,Multiple Sclerosis,15,35,3,0,3
Uttar Pradesh,Budaun,Multiple Sclerosis,35,60,4,0,4
Uttar Pradesh,Budaun,Multiple Sclerosis,60,80,1,1,2
Odisha,Boudh,Multiple Sclerosis,0,6,0,1,1
Odisha,Boudh,Multiple Sclerosis,15,35,2,0,2
Odisha,Boudh,Multiple Sclerosis,35,60,1,0,1
Gujarat,Botad,Multiple Sclerosis,15,35,1,0,1
Assam,Bongaigaon,Multiple Sclerosis,15,35,1,0,1
Assam,Bongaigaon,Multiple Sclerosis,35,60,0,1,1
Jharkhand,Bokaro,Multiple Sclerosis,6,15,0,2,2
Jharkhand,Bokaro,Multiple Sclerosis,15,35,16,8,24
Jharkhand,Bokaro,Multiple Sclerosis,35,60,17,3,20
Jharkhand,Bokaro,Multiple Sclerosis,60,80,2,1,3
Jharkhand,Bokaro,Multiple Sclerosis,80,100,1,0,1
Assam,Biswanath,Multiple Sclerosis,6,15,1,0,1
Assam,Biswanath,Multiple Sclerosis,15,35,0,1,1
Manipur,Bishnupur,Multiple Sclerosis,35,60,0,1,1
Chhattisgarh,Bilaspur,Multiple Sclerosis,6,15,1,0,1
Chhattisgarh,Bilaspur,Multiple Sclerosis,15,35,3,0,3
Himachal Pradesh,Bilaspur,Multiple Sclerosis,15,35,1,0,1
Himachal Pradesh,Bilaspur,Multiple Sclerosis,35,60,3,0,3
Uttar Pradesh,Bijnor,Multiple Sclerosis,15,35,18,9,27
Uttar Pradesh,Bijnor,Multiple Sclerosis,35,60,18,2,20
Uttar Pradesh,Bijnor,Multiple Sclerosis,60,80,2,0,2
Chhattisgarh,Bijapur,Multiple Sclerosis,15,35,3,0,3
Chhattisgarh,Bijapur,Multiple Sclerosis,35,60,0,2,2
Karnataka,Bidar,Multiple Sclerosis,0,6,0,1,1
Karnataka,Bidar,Multiple Sclerosis,6,15,0,2,2
Karnataka,Bidar,Multiple Sclerosis,15,35,7,2,9
Karnataka,Bidar,Multiple Sclerosis,35,60,16,1,17
Karnataka,Bidar,Multiple Sclerosis,60,80,4,0,4
Madhya Pradesh,Bhopal,Multiple Sclerosis,6,15,7,3,10
Madhya Pradesh,Bhopal,Multiple Sclerosis,15,35,30,7,37
Madhya Pradesh,Bhopal,Multiple Sclerosis,35,60,30,20,50
Madhya Pradesh,Bhopal,Multiple Sclerosis,60,80,3,0,3
Bihar,Bhojpur,Multiple Sclerosis,6,15,1,1,2
Bihar,Bhojpur,Multiple Sclerosis,15,35,3,3,6
Bihar,Bhojpur,Multiple Sclerosis,35,60,1,1,2
Bihar,Bhojpur,Multiple Sclerosis,60,80,1,1,2
Haryana,Bhiwani,Multiple Sclerosis,6,15,2,0,2
Haryana,Bhiwani,Multiple Sclerosis,15,35,2,3,5
Haryana,Bhiwani,Multiple Sclerosis,35,60,4,2,6
Haryana,Bhiwani,Multiple Sclerosis,60,80,1,2,3
Madhya Pradesh,Bhind,Multiple Sclerosis,35,60,3,1,4
Rajasthan,Bhilwara,Multiple Sclerosis,6,15,2,0,2
Rajasthan,Bhilwara,Multiple Sclerosis,15,35,1,0,1
Rajasthan,Bhilwara,Multiple Sclerosis,35,60,5,1,6
Rajasthan,Bhilwara,Multiple Sclerosis,60,80,0,1,1
Gujarat,Bhavnagar,Multiple Sclerosis,60,80,1,1,2
Rajasthan,Bharatpur,Multiple Sclerosis,35,60,1,0,1
Maharashtra,Bhandara,Multiple Sclerosis,15,35,1,1,2
Maharashtra,Bhandara,Multiple Sclerosis,35,60,0,1,1
Maharashtra,Bhandara,Multiple Sclerosis,60,80,1,0,1
Bihar,Bhagalpur,Multiple Sclerosis,6,15,1,0,1
Bihar,Bhagalpur,Multiple Sclerosis,15,35,4,0,4
Bihar,Bhagalpur,Multiple Sclerosis,35,60,5,0,5
Bihar,Bhagalpur,Multiple Sclerosis,60,80,2,0,2
Odisha,Bhadrak,Multiple Sclerosis,6,15,4,0,4
Odisha,Bhadrak,Multiple Sclerosis,15,35,2,2,4
Odisha,Bhadrak,Multiple Sclerosis,35,60,4,1,5
Odisha,Bhadrak,Multiple Sclerosis,60,80,1,1,2
Madhya Pradesh,Betul,Multiple Sclerosis,15,35,2,4,6
Madhya Pradesh,Betul,Multiple Sclerosis,35,60,3,0,3
Karnataka,Bengaluru Urban,Multiple Sclerosis,6,15,0,1,1
Karnataka,Bengaluru Urban,Multiple Sclerosis,15,35,9,6,15
Karnataka,Bengaluru Urban,Multiple Sclerosis,35,60,21,21,42
Karnataka,Bengaluru Urban,Multiple Sclerosis,60,80,7,0,7
Karnataka,Bengaluru Rural,Multiple Sclerosis,0,6,2,0,2
Karnataka,Bengaluru Rural,Multiple Sclerosis,6,15,0,1,1
Karnataka,Bengaluru Rural,Multiple Sclerosis,15,35,7,5,12
Karnataka,Bengaluru Rural,Multiple Sclerosis,35,60,1,2,3
Karnataka,Bengaluru Rural,Multiple Sclerosis,60,80,1,1,2
Chhattisgarh,Bemetara,Multiple Sclerosis,0,6,1,0,1
Karnataka,Belagavi,Multiple Sclerosis,0,6,1,1,2
Karnataka,Belagavi,Multiple Sclerosis,6,15,4,2,6
Karnataka,Belagavi,Multiple Sclerosis,15,35,16,7,23
Karnataka,Belagavi,Multiple Sclerosis,35,60,5,5,10
Karnataka,Belagavi,Multiple Sclerosis,60,80,4,2,6
Karnataka,Belagavi,Multiple Sclerosis,80,100,1,0,1
Bihar,Begusarai,Multiple Sclerosis,15,35,2,3,5
Bihar,Begusarai,Multiple Sclerosis,35,60,4,2,6
Bihar,Begusarai,Multiple Sclerosis,80,100,1,0,1
Maharashtra,Beed,Multiple Sclerosis,6,15,1,0,1
Maharashtra,Beed,Multiple Sclerosis,15,35,4,0,4
Maharashtra,Beed,Multiple Sclerosis,35,60,10,1,11
Maharashtra,Beed,Multiple Sclerosis,60,80,1,0,1
Punjab,Bathinda,Multiple Sclerosis,15,35,1,0,1
Punjab,Bathinda,Multiple Sclerosis,35,60,2,0,2
Uttar Pradesh,Basti,Multiple Sclerosis,15,35,5,0,5
Uttar Pradesh,Basti,Multiple Sclerosis,35,60,7,2,9
Uttar Pradesh,Basti,Multiple Sclerosis,60,80,3,1,4
Chhattisgarh,Bastar,Multiple Sclerosis,15,35,2,0,2
Madhya Pradesh,Barwani,Multiple Sclerosis,15,35,11,3,14
Madhya Pradesh,Barwani,Multiple Sclerosis,35,60,7,1,8
Madhya Pradesh,Barwani,Multiple Sclerosis,60,80,1,0,1
Assam,Barpeta,Multiple Sclerosis,6,15,3,1,4
Assam,Barpeta,Multiple Sclerosis,15,35,5,1,6
Assam,Barpeta,Multiple Sclerosis,35,60,6,0,6
Punjab,Barnala,Multiple Sclerosis,6,15,2,0,2
Punjab,Barnala,Multiple Sclerosis,15,35,4,0,4
Punjab,Barnala,Multiple Sclerosis,35,60,6,1,7
Punjab,Barnala,Multiple Sclerosis,60,80,1,0,1
Rajasthan,Barmer,Multiple Sclerosis,6,15,1,3,4
Rajasthan,Barmer,Multiple Sclerosis,15,35,3,1,4
Rajasthan,Barmer,Multiple Sclerosis,35,60,4,3,7
Odisha,Bargarh,Multiple Sclerosis,15,35,0,1,1
Odisha,Bargarh,Multiple Sclerosis,35,60,1,1,2
Uttar Pradesh,Bareilly,Multiple Sclerosis,15,35,13,4,17
Uttar Pradesh,Bareilly,Multiple Sclerosis,35,60,22,5,27
Uttar Pradesh,Bareilly,Multiple Sclerosis,60,80,4,1,5
Uttar Pradesh,Bareilly,Multiple Sclerosis,80,100,1,0,1
Rajasthan,Baran,Multiple Sclerosis,15,35,3,0,3
Rajasthan,Baran,Multiple Sclerosis,35,60,1,0,1
Jammu And Kashmir,Baramulla,Multiple Sclerosis,6,15,1,0,1
Jammu And Kashmir,Baramulla,Multiple Sclerosis,15,35,3,0,3
Jammu And Kashmir,Baramulla,Multiple Sclerosis,35,60,6,2,8
Uttar Pradesh,Barabanki,Multiple Sclerosis,6,15,2,0,2
Uttar Pradesh,Barabanki,Multiple Sclerosis,15,35,7,4,11
Uttar Pradesh,Barabanki,Multiple Sclerosis,35,60,15,0,15
Uttar Pradesh,Barabanki,Multiple Sclerosis,60,80,1,0,1
Rajasthan,Banswara,Multiple Sclerosis,6,15,2,5,7
Rajasthan,Banswara,Multiple Sclerosis,15,35,6,4,10
Rajasthan,Banswara,Multiple Sclerosis,35,60,4,4,8
Rajasthan,Banswara,Multiple Sclerosis,60,80,1,0,1
Bihar,Banka,Multiple Sclerosis,6,15,1,0,1
Bihar,Banka,Multiple Sclerosis,15,35,3,5,8
Bihar,Banka,Multiple Sclerosis,35,60,2,1,3
Jammu And Kashmir,Bandipora,Multiple Sclerosis,6,15,1,1,2
Jammu And Kashmir,Bandipora,Multiple Sclerosis,15,35,3,5,8
Jammu And Kashmir,Bandipora,Multiple Sclerosis,35,60,7,4,11
Uttar Pradesh,Banda,Multiple Sclerosis,15,35,5,0,5
Uttar Pradesh,Banda,Multiple Sclerosis,35,60,13,0,13
Uttar Pradesh,Banda,Multiple Sclerosis,60,80,2,0,2
Chhattisgarh,Balrampur,Multiple Sclerosis,0,6,1,0,1
Chhattisgarh,Balrampur,Multiple Sclerosis,6,15,8,2,10
Chhattisgarh,Balrampur,Multiple Sclerosis,15,35,8,7,15
Chhattisgarh,Balrampur,Multiple Sclerosis,35,60,5,4,9
Chhattisgarh,Balrampur,Multiple Sclerosis,60,80,3,0,3
Chhattisgarh,Balrampur,Multiple Sclerosis,80,100,0,1,1
Uttar Pradesh,Balrampur,Multiple Sclerosis,6,15,1,0,1
Uttar Pradesh,Balrampur,Multiple Sclerosis,15,35,5,0,5
Uttar Pradesh,Balrampur,Multiple Sclerosis,35,60,3,1,4
Uttar Pradesh,Balrampur,Multiple Sclerosis,60,80,1,0,1
Chhattisgarh,Baloda Bazar,Multiple Sclerosis,6,15,2,2,4
Chhattisgarh,Baloda Bazar,Multiple Sclerosis,15,35,12,5,17
Chhattisgarh,Baloda Bazar,Multiple Sclerosis,35,60,5,5,10
Chhattisgarh,Baloda Bazar,Multiple Sclerosis,60,80,3,2,5
Chhattisgarh,Balod,Multiple Sclerosis,6,15,1,0,1
Uttar Pradesh,Ballia,Multiple Sclerosis,15,35,28,4,32
Uttar Pradesh,Ballia,Multiple Sclerosis,35,60,46,7,53
Uttar Pradesh,Ballia,Multiple Sclerosis,60,80,17,1,18
Karnataka,Ballari,Multiple Sclerosis,6,15,3,0,3
Karnataka,Ballari,Multiple Sclerosis,15,35,7,4,11
Karnataka,Ballari,Multiple Sclerosis,35,60,2,3,5
Odisha,Baleshwar,Multiple Sclerosis,0,6,1,1,2
Odisha,Baleshwar,Multiple Sclerosis,6,15,9,3,12
Odisha,Baleshwar,Multiple Sclerosis,15,35,8,4,12
Odisha,Baleshwar,Multiple Sclerosis,35,60,23,16,39
Odisha,Baleshwar,Multiple Sclerosis,60,80,1,4,5
Odisha,Balangir,Multiple Sclerosis,6,15,2,1,3
Odisha,Balangir,Multiple Sclerosis,15,35,1,0,1
Odisha,Balangir,Multiple Sclerosis,35,60,6,2,8
Odisha,Balangir,Multiple Sclerosis,60,80,1,0,1
Odisha,Balangir,Multiple Sclerosis,80,100,1,0,1
Madhya Pradesh,Balaghat,Multiple Sclerosis,6,15,10,7,17
Madhya Pradesh,Balaghat,Multiple Sclerosis,15,35,25,15,40
Madhya Pradesh,Balaghat,Multiple Sclerosis,35,60,18,10,28
Madhya Pradesh,Balaghat,Multiple Sclerosis,60,80,4,2,6
Uttar Pradesh,Bahraich,Multiple Sclerosis,6,15,2,0,2
Uttar Pradesh,Bahraich,Multiple Sclerosis,15,35,6,1,7
Uttar Pradesh,Bahraich,Multiple Sclerosis,35,60,8,0,8
Uttar Pradesh,Bahraich,Multiple Sclerosis,60,80,1,0,1
Uttar Pradesh,Baghpat,Multiple Sclerosis,15,35,2,4,6
Uttar Pradesh,Baghpat,Multiple Sclerosis,35,60,4,0,4
Uttar Pradesh,Baghpat,Multiple Sclerosis,60,80,0,1,1
Uttarakhand,Bageshwar,Multiple Sclerosis,15,35,1,4,5
Uttarakhand,Bageshwar,Multiple Sclerosis,35,60,10,1,11
Uttarakhand,Bageshwar,Multiple Sclerosis,60,80,3,2,5
Karnataka,Bagalkote,Multiple Sclerosis,6,15,1,0,1
Karnataka,Bagalkote,Multiple Sclerosis,15,35,4,0,4
Karnataka,Bagalkote,Multiple Sclerosis,35,60,2,1,3
Uttar Pradesh,Azamgarh,Multiple Sclerosis,15,35,1,0,1
Uttar Pradesh,Ayodhya,Multiple Sclerosis,6,15,1,0,1
Uttar Pradesh,Ayodhya,Multiple Sclerosis,15,35,1,0,1
Uttar Pradesh,Ayodhya,Multiple Sclerosis,35,60,2,0,2
Bihar,Aurangabad,Multiple Sclerosis,6,15,2,0,2
Bihar,Aurangabad,Multiple Sclerosis,15,35,4,3,7
Bihar,Aurangabad,Multiple Sclerosis,35,60,5,2,7
Bihar,Aurangabad,Multiple Sclerosis,60,80,1,0,1
Maharashtra,Aurangabad,Multiple Sclerosis,15,35,1,1,2
Maharashtra,Aurangabad,Multiple Sclerosis,60,80,2,0,2
Uttar Pradesh,Auraiya,Multiple Sclerosis,6,15,2,0,2
Uttar Pradesh,Auraiya,Multiple Sclerosis,15,35,1,3,4
Uttar Pradesh,Auraiya,Multiple Sclerosis,35,60,8,1,9
Uttar Pradesh,Auraiya,Multiple Sclerosis,60,80,1,0,1
Bihar,Arwal,Multiple Sclerosis,6,15,2,0,2
Bihar,Arwal,Multiple Sclerosis,15,35,2,2,4
Bihar,Arwal,Multiple Sclerosis,35,60,2,0,2
Bihar,Arwal,Multiple Sclerosis,60,80,2,1,3
Gujarat,Arvalli,Multiple Sclerosis,6,15,0,1,1
Gujarat,Arvalli,Multiple Sclerosis,15,35,0,1,1
Tamil Nadu,Ariyalur,Multiple Sclerosis,15,35,2,1,3
Bihar,Araria,Multiple Sclerosis,0,6,1,0,1
Bihar,Araria,Multiple Sclerosis,15,35,1,0,1
Bihar,Araria,Multiple Sclerosis,35,60,3,0,3
Madhya Pradesh,Anuppur,Multiple Sclerosis,0,6,0,1,1
Madhya Pradesh,Anuppur,Multiple Sclerosis,6,15,2,0,2
Madhya Pradesh,Anuppur,Multiple Sclerosis,15,35,3,0,3
Odisha,Anugul,Multiple Sclerosis,6,15,0,1,1
Odisha,Anugul,Multiple Sclerosis,15,35,2,0,2
Odisha,Anugul,Multiple Sclerosis,35,60,0,5,5
Odisha,Anugul,Multiple Sclerosis,60,80,1,0,1
Jammu And Kashmir,Anantnag,Multiple Sclerosis,6,15,0,2,2
Jammu And Kashmir,Anantnag,Multiple Sclerosis,15,35,0,1,1
Jammu And Kashmir,Anantnag,Multiple Sclerosis,35,60,0,1,1
Gujarat,Anand,Multiple Sclerosis,6,15,1,0,1
Gujarat,Anand,Multiple Sclerosis,15,35,1,0,1
Gujarat,Anand,Multiple Sclerosis,35,60,1,0,1
Uttar Pradesh,Amroha,Multiple Sclerosis,15,35,11,1,12
Uttar Pradesh,Amroha,Multiple Sclerosis,35,60,7,0,7
Uttar Pradesh,Amroha,Multiple Sclerosis,60,80,2,0,2
Punjab,Amritsar,Multiple Sclerosis,15,35,0,1,1
Punjab,Amritsar,Multiple Sclerosis,35,60,9,3,12
Punjab,Amritsar,Multiple Sclerosis,60,80,1,0,1
Gujarat,Amreli,Multiple Sclerosis,6,15,2,5,7
Maharashtra,Amravati,Multiple Sclerosis,15,35,3,3,6
Maharashtra,Amravati,Multiple Sclerosis,35,60,4,1,5
Maharashtra,Amravati,Multiple Sclerosis,60,80,3,0,3
Uttar Pradesh,Amethi,Multiple Sclerosis,15,35,1,2,3
Uttar Pradesh,Amethi,Multiple Sclerosis,35,60,2,1,3
Uttar Pradesh,Amethi,Multiple Sclerosis,60,80,1,0,1
Uttar Pradesh,Ambedkar Nagar,Multiple Sclerosis,15,35,6,2,8
Uttar Pradesh,Ambedkar Nagar,Multiple Sclerosis,35,60,2,0,2
Haryana,Ambala,Multiple Sclerosis,15,35,2,2,4
Haryana,Ambala,Multiple Sclerosis,35,60,3,3,6
Haryana,Ambala,Multiple Sclerosis,60,80,3,0,3
Rajasthan,Alwar,Multiple Sclerosis,6,15,0,1,1
Rajasthan,Alwar,Multiple Sclerosis,15,35,5,1,6
Rajasthan,Alwar,Multiple Sclerosis,35,60,4,4,8
Rajasthan,Alwar,Multiple Sclerosis,60,80,2,0,2
Uttarakhand,Almora,Multiple Sclerosis,35,60,1,0,1
Madhya Pradesh,Alirajpur,Multiple Sclerosis,0,6,0,1,1
Madhya Pradesh,Alirajpur,Multiple Sclerosis,6,15,2,2,4
Madhya Pradesh,Alirajpur,Multiple Sclerosis,15,35,8,4,12
Madhya Pradesh,Alirajpur,Multiple Sclerosis,35,60,24,7,31
Madhya Pradesh,Alirajpur,Multiple Sclerosis,60,80,2,1,3
Uttar Pradesh,Aligarh,Multiple Sclerosis,6,15,3,2,5
Uttar Pradesh,Aligarh,Multiple Sclerosis,15,35,19,5,24
Uttar Pradesh,Aligarh,Multiple Sclerosis,35,60,29,7,36
Uttar Pradesh,Aligarh,Multiple Sclerosis,60,80,5,1,6
Uttar Pradesh,Aligarh,Multiple Sclerosis,80,100,1,0,1
Kerala,Alappuzha,Multiple Sclerosis,15,35,0,1,1
Kerala,Alappuzha,Multiple Sclerosis,35,60,1,2,3
Maharashtra,Akola,Multiple Sclerosis,60,80,1,0,1
Rajasthan,Ajmer,Multiple Sclerosis,6,15,1,0,1
Rajasthan,Ajmer,Multiple Sclerosis,15,35,1,0,1
Rajasthan,Ajmer,Multiple Sclerosis,35,60,2,1,3
Mizoram,Aizawl,Multiple Sclerosis,15,35,0,1,1
Mizoram,Aizawl,Multiple Sclerosis,35,60,0,1,1
Maharashtra,Ahmednagar,Multiple Sclerosis,15,35,2,0,2
Maharashtra,Ahmednagar,Multiple Sclerosis,35,60,3,2,5
Maharashtra,Ahmednagar,Multiple Sclerosis,60,80,1,0,1
Gujarat,Ahmadabad,Multiple Sclerosis,6,15,0,1,1
Gujarat,Ahmadabad,Multiple Sclerosis,15,35,3,5,8
Gujarat,Ahmadabad,Multiple Sclerosis,35,60,4,0,4
Gujarat,Ahmadabad,Multiple Sclerosis,60,80,2,0,2
Uttar Pradesh,Agra,Multiple Sclerosis,6,15,1,0,1
Uttar Pradesh,Agra,Multiple Sclerosis,35,60,2,1,3
Madhya Pradesh,Agar Malwa,Multiple Sclerosis,60,80,0,1,1
Maharashtra,Yavatmal,Muscular Dystrophy,6,15,10,2,12
Maharashtra,Yavatmal,Muscular Dystrophy,15,35,43,12,55
Maharashtra,Yavatmal,Muscular Dystrophy,35,60,104,30,134
Maharashtra,Yavatmal,Muscular Dystrophy,60,80,15,5,20
Maharashtra,Yavatmal,Muscular Dystrophy,80,100,1,0,1
Puducherry,Yanam,Muscular Dystrophy,15,35,1,1,2
Puducherry,Yanam,Muscular Dystrophy,35,60,3,3,6
Haryana,Yamunanagar,Muscular Dystrophy,6,15,10,0,10
Haryana,Yamunanagar,Muscular Dystrophy,15,35,5,1,6
Haryana,Yamunanagar,Muscular Dystrophy,35,60,6,5,11
Karnataka,Yadgir,Muscular Dystrophy,6,15,2,3,5
Karnataka,Yadgir,Muscular Dystrophy,15,35,2,1,3
Karnataka,Yadgir,Muscular Dystrophy,35,60,2,0,2
Karnataka,Yadgir,Muscular Dystrophy,60,80,0,1,1
Nagaland,Wokha,Muscular Dystrophy,15,35,1,0,1
Nagaland,Wokha,Muscular Dystrophy,35,60,2,0,2
Jharkhand,West Singhbhum,Muscular Dystrophy,6,15,1,2,3
Jharkhand,West Singhbhum,Muscular Dystrophy,15,35,2,2,4
Jharkhand,West Singhbhum,Muscular Dystrophy,35,60,3,1,4
Arunachal Pradesh,West Siang,Muscular Dystrophy,35,60,1,0,1
Meghalaya,West Jaintia Hills,Muscular Dystrophy,6,15,2,0,2
Meghalaya,West Jaintia Hills,Muscular Dystrophy,15,35,0,1,1
Andhra Pradesh,West Godavari,Muscular Dystrophy,6,15,1,0,1
Delhi,West,Muscular Dystrophy,6,15,15,0,15
Delhi,West,Muscular Dystrophy,15,35,22,2,24
Delhi,West,Muscular Dystrophy,35,60,6,4,10
Kerala,Wayanad,Muscular Dystrophy,6,15,7,0,7
Kerala,Wayanad,Muscular Dystrophy,15,35,8,7,15
Kerala,Wayanad,Muscular Dystrophy,35,60,17,5,22
Kerala,Wayanad,Muscular Dystrophy,60,80,6,1,7
Maharashtra,Washim,Muscular Dystrophy,6,15,8,1,9
Maharashtra,Washim,Muscular Dystrophy,15,35,20,11,31
Maharashtra,Washim,Muscular Dystrophy,35,60,38,17,55
Maharashtra,Washim,Muscular Dystrophy,60,80,17,8,25
Maharashtra,Washim,Muscular Dystrophy,80,100,2,0,2
Maharashtra,Wardha,Muscular Dystrophy,6,15,26,1,27
Maharashtra,Wardha,Muscular Dystrophy,15,35,25,5,30
Maharashtra,Wardha,Muscular Dystrophy,35,60,11,0,11
Maharashtra,Wardha,Muscular Dystrophy,60,80,0,1,1
Andhra Pradesh,Vizianagaram,Muscular Dystrophy,15,35,1,0,1
Andhra Pradesh,Vizianagaram,Muscular Dystrophy,35,60,1,0,1
Andhra Pradesh,Visakhapatanam,Muscular Dystrophy,6,15,1,0,1
Andhra Pradesh,Visakhapatanam,Muscular Dystrophy,15,35,2,1,3
Andhra Pradesh,Visakhapatanam,Muscular Dystrophy,35,60,3,2,5
Tamil Nadu,Virudhunagar,Muscular Dystrophy,6,15,35,9,44
Tamil Nadu,Virudhunagar,Muscular Dystrophy,15,35,27,16,43
Tamil Nadu,Virudhunagar,Muscular Dystrophy,35,60,22,8,30
Tamil Nadu,Villupuram,Muscular Dystrophy,0,6,0,2,2
Tamil Nadu,Villupuram,Muscular Dystrophy,6,15,33,9,42
Tamil Nadu,Villupuram,Muscular Dystrophy,15,35,52,15,67
Tamil Nadu,Villupuram,Muscular Dystrophy,35,60,20,11,31
Tamil Nadu,Villupuram,Muscular Dystrophy,60,80,7,4,11
Karnataka,Vijayapura,Muscular Dystrophy,0,6,1,0,1
Karnataka,Vijayapura,Muscular Dystrophy,6,15,17,8,25
Karnataka,Vijayapura,Muscular Dystrophy,15,35,22,8,30
Karnataka,Vijayapura,Muscular Dystrophy,35,60,15,5,20
Karnataka,Vijayapura,Muscular Dystrophy,60,80,3,1,4
Madhya Pradesh,Vidisha,Muscular Dystrophy,0,6,1,0,1
Madhya Pradesh,Vidisha,Muscular Dystrophy,6,15,14,11,25
Madhya Pradesh,Vidisha,Muscular Dystrophy,15,35,40,22,62
Madhya Pradesh,Vidisha,Muscular Dystrophy,35,60,66,15,81
Madhya Pradesh,Vidisha,Muscular Dystrophy,60,80,19,9,28
Tamil Nadu,Vellore,Muscular Dystrophy,0,6,2,0,2
Tamil Nadu,Vellore,Muscular Dystrophy,6,15,19,7,26
Tamil Nadu,Vellore,Muscular Dystrophy,15,35,62,26,88
Tamil Nadu,Vellore,Muscular Dystrophy,35,60,44,21,65
Tamil Nadu,Vellore,Muscular Dystrophy,60,80,9,5,14
Uttar Pradesh,Varanasi,Muscular Dystrophy,6,15,21,2,23
Uttar Pradesh,Varanasi,Muscular Dystrophy,15,35,55,12,67
Uttar Pradesh,Varanasi,Muscular Dystrophy,35,60,32,8,40
Uttar Pradesh,Varanasi,Muscular Dystrophy,60,80,6,0,6
Uttar Pradesh,Varanasi,Muscular Dystrophy,80,100,1,0,1
Gujarat,Valsad,Muscular Dystrophy,6,15,1,0,1
Gujarat,Valsad,Muscular Dystrophy,15,35,2,1,3
Gujarat,Valsad,Muscular Dystrophy,35,60,0,2,2
Gujarat,Valsad,Muscular Dystrophy,60,80,1,0,1
Bihar,Vaishali,Muscular Dystrophy,0,6,2,0,2
Bihar,Vaishali,Muscular Dystrophy,6,15,29,10,39
Bihar,Vaishali,Muscular Dystrophy,15,35,79,33,112
Bihar,Vaishali,Muscular Dystrophy,35,60,63,19,82
Bihar,Vaishali,Muscular Dystrophy,60,80,12,4,16
Gujarat,Vadodara,Muscular Dystrophy,6,15,5,1,6
Gujarat,Vadodara,Muscular Dystrophy,15,35,4,0,4
Gujarat,Vadodara,Muscular Dystrophy,35,60,1,1,2
Karnataka,Uttara Kannada,Muscular Dystrophy,6,15,6,2,8
Karnataka,Uttara Kannada,Muscular Dystrophy,15,35,8,9,17
Karnataka,Uttara Kannada,Muscular Dystrophy,35,60,8,8,16
Karnataka,Uttara Kannada,Muscular Dystrophy,60,80,0,2,2
Uttarakhand,Uttar Kashi,Muscular Dystrophy,6,15,2,3,5
Uttarakhand,Uttar Kashi,Muscular Dystrophy,15,35,11,5,16
Uttarakhand,Uttar Kashi,Muscular Dystrophy,35,60,9,5,14
Uttarakhand,Uttar Kashi,Muscular Dystrophy,60,80,1,0,1
Arunachal Pradesh,Upper Subansiri,Muscular Dystrophy,15,35,0,1,1
Arunachal Pradesh,Upper Siang,Muscular Dystrophy,15,35,0,2,2
Arunachal Pradesh,Upper Siang,Muscular Dystrophy,35,60,1,0,1
Uttar Pradesh,Unnao,Muscular Dystrophy,6,15,2,1,3
Uttar Pradesh,Unnao,Muscular Dystrophy,15,35,48,14,62
Uttar Pradesh,Unnao,Muscular Dystrophy,35,60,73,21,94
Uttar Pradesh,Unnao,Muscular Dystrophy,60,80,15,5,20
Uttar Pradesh,Unnao,Muscular Dystrophy,80,100,3,0,3
Himachal Pradesh,Una,Muscular Dystrophy,6,15,0,1,1
Himachal Pradesh,Una,Muscular Dystrophy,15,35,7,4,11
Himachal Pradesh,Una,Muscular Dystrophy,35,60,14,10,24
Himachal Pradesh,Una,Muscular Dystrophy,60,80,7,2,9
Madhya Pradesh,Umaria,Muscular Dystrophy,0,6,1,0,1
Madhya Pradesh,Umaria,Muscular Dystrophy,6,15,9,1,10
Madhya Pradesh,Umaria,Muscular Dystrophy,15,35,7,3,10
Madhya Pradesh,Umaria,Muscular Dystrophy,35,60,4,9,13
Madhya Pradesh,Umaria,Muscular Dystrophy,60,80,4,1,5
Manipur,Ukhrul,Muscular Dystrophy,35,60,1,0,1
Madhya Pradesh,Ujjain,Muscular Dystrophy,0,6,1,0,1
Madhya Pradesh,Ujjain,Muscular Dystrophy,6,15,23,5,28
Madhya Pradesh,Ujjain,Muscular Dystrophy,15,35,22,4,26
Madhya Pradesh,Ujjain,Muscular Dystrophy,35,60,7,1,8
Madhya Pradesh,Ujjain,Muscular Dystrophy,60,80,1,2,3
Karnataka,Udupi,Muscular Dystrophy,6,15,3,2,5
Karnataka,Udupi,Muscular Dystrophy,15,35,17,2,19
Karnataka,Udupi,Muscular Dystrophy,35,60,25,7,32
Karnataka,Udupi,Muscular Dystrophy,60,80,9,0,9
Jammu And Kashmir,Udhampur,Muscular Dystrophy,0,6,1,0,1
Jammu And Kashmir,Udhampur,Muscular Dystrophy,6,15,12,0,12
Jammu And Kashmir,Udhampur,Muscular Dystrophy,15,35,6,0,6
Jammu And Kashmir,Udhampur,Muscular Dystrophy,35,60,4,2,6
Uttarakhand,Udam Singh Nagar,Muscular Dystrophy,6,15,11,2,13
Uttarakhand,Udam Singh Nagar,Muscular Dystrophy,15,35,41,16,57
Uttarakhand,Udam Singh Nagar,Muscular Dystrophy,35,60,53,17,70
Uttarakhand,Udam Singh Nagar,Muscular Dystrophy,60,80,4,2,6
Assam,Udalguri,Muscular Dystrophy,6,15,1,0,1
Assam,Udalguri,Muscular Dystrophy,15,35,2,0,2
Assam,Udalguri,Muscular Dystrophy,35,60,4,4,8
Rajasthan,Udaipur,Muscular Dystrophy,0,6,1,1,2
Rajasthan,Udaipur,Muscular Dystrophy,6,15,5,5,10
Rajasthan,Udaipur,Muscular Dystrophy,15,35,22,7,29
Rajasthan,Udaipur,Muscular Dystrophy,35,60,26,9,35
Rajasthan,Udaipur,Muscular Dystrophy,60,80,13,4,17
Rajasthan,Udaipur,Muscular Dystrophy,80,100,0,1,1
Tamil Nadu,Tuticorin,Muscular Dystrophy,0,6,0,1,1
Tamil Nadu,Tuticorin,Muscular Dystrophy,6,15,17,7,24
Tamil Nadu,Tuticorin,Muscular Dystrophy,15,35,32,10,42
Tamil Nadu,Tuticorin,Muscular Dystrophy,35,60,13,10,23
Tamil Nadu,Tuticorin,Muscular Dystrophy,60,80,3,1,4
Karnataka,Tumakuru,Muscular Dystrophy,0,6,1,0,1
Karnataka,Tumakuru,Muscular Dystrophy,6,15,16,3,19
Karnataka,Tumakuru,Muscular Dystrophy,15,35,23,3,26
Karnataka,Tumakuru,Muscular Dystrophy,35,60,49,15,64
Karnataka,Tumakuru,Muscular Dystrophy,60,80,10,0,10
Nagaland,Tuensang,Muscular Dystrophy,15,35,0,2,2
Nagaland,Tuensang,Muscular Dystrophy,60,80,1,0,1
Rajasthan,Tonk,Muscular Dystrophy,0,6,1,0,1
Rajasthan,Tonk,Muscular Dystrophy,6,15,9,2,11
Rajasthan,Tonk,Muscular Dystrophy,15,35,12,13,25
Rajasthan,Tonk,Muscular Dystrophy,35,60,13,3,16
Rajasthan,Tonk,Muscular Dystrophy,60,80,0,1,1
Tamil Nadu,Tiruvannamalai,Muscular Dystrophy,0,6,5,2,7
Tamil Nadu,Tiruvannamalai,Muscular Dystrophy,6,15,34,5,39
Tamil Nadu,Tiruvannamalai,Muscular Dystrophy,15,35,26,20,46
Tamil Nadu,Tiruvannamalai,Muscular Dystrophy,35,60,19,13,32
Tamil Nadu,Tiruvannamalai,Muscular Dystrophy,60,80,2,0,2
Tamil Nadu,Tiruppur,Muscular Dystrophy,0,6,4,0,4
Tamil Nadu,Tiruppur,Muscular Dystrophy,6,15,41,5,46
Tamil Nadu,Tiruppur,Muscular Dystrophy,15,35,35,9,44
Tamil Nadu,Tiruppur,Muscular Dystrophy,35,60,17,7,24
Tamil Nadu,Tiruppur,Muscular Dystrophy,60,80,2,0,2
Tamil Nadu,Tiruppur,Muscular Dystrophy,80,100,1,0,1
Tamil Nadu,Tirupathur,Muscular Dystrophy,0,6,6,2,8
Tamil Nadu,Tirupathur,Muscular Dystrophy,6,15,10,9,19
Tamil Nadu,Tirupathur,Muscular Dystrophy,15,35,17,5,22
Tamil Nadu,Tirupathur,Muscular Dystrophy,35,60,5,3,8
Tamil Nadu,Tirupathur,Muscular Dystrophy,60,80,2,0,2
Tamil Nadu,Tirunelveli,Muscular Dystrophy,6,15,34,11,45
Tamil Nadu,Tirunelveli,Muscular Dystrophy,15,35,69,27,96
Tamil Nadu,Tirunelveli,Muscular Dystrophy,35,60,47,13,60
Tamil Nadu,Tirunelveli,Muscular Dystrophy,60,80,4,1,5
Tamil Nadu,Tiruchirappalli,Muscular Dystrophy,0,6,6,0,6
Tamil Nadu,Tiruchirappalli,Muscular Dystrophy,6,15,81,11,92
Tamil Nadu,Tiruchirappalli,Muscular Dystrophy,15,35,89,26,115
Tamil Nadu,Tiruchirappalli,Muscular Dystrophy,35,60,39,17,56
Tamil Nadu,Tiruchirappalli,Muscular Dystrophy,60,80,4,3,7
Arunachal Pradesh,Tirap,Muscular Dystrophy,15,35,1,0,1
Arunachal Pradesh,Tirap,Muscular Dystrophy,35,60,1,0,1
Assam,Tinsukia,Muscular Dystrophy,15,35,1,0,1
Assam,Tinsukia,Muscular Dystrophy,35,60,3,1,4
Assam,Tinsukia,Muscular Dystrophy,60,80,0,1,1
Madhya Pradesh,Tikamgarh,Muscular Dystrophy,0,6,1,0,1
Madhya Pradesh,Tikamgarh,Muscular Dystrophy,6,15,3,1,4
Madhya Pradesh,Tikamgarh,Muscular Dystrophy,15,35,13,2,15
Madhya Pradesh,Tikamgarh,Muscular Dystrophy,35,60,7,0,7
Madhya Pradesh,Tikamgarh,Muscular Dystrophy,60,80,2,0,2
Kerala,Thrissur,Muscular Dystrophy,0,6,2,0,2
Kerala,Thrissur,Muscular Dystrophy,6,15,19,0,19
Kerala,Thrissur,Muscular Dystrophy,15,35,29,13,42
Kerala,Thrissur,Muscular Dystrophy,35,60,34,12,46
Kerala,Thrissur,Muscular Dystrophy,60,80,3,2,5
Tamil Nadu,Thiruvarur,Muscular Dystrophy,6,15,16,3,19
Tamil Nadu,Thiruvarur,Muscular Dystrophy,15,35,31,9,40
Tamil Nadu,Thiruvarur,Muscular Dystrophy,35,60,10,8,18
Tamil Nadu,Thiruvarur,Muscular Dystrophy,60,80,4,0,4
Kerala,Thiruvananthapuram,Muscular Dystrophy,6,15,12,4,16
Kerala,Thiruvananthapuram,Muscular Dystrophy,15,35,21,3,24
Kerala,Thiruvananthapuram,Muscular Dystrophy,35,60,27,6,33
Kerala,Thiruvananthapuram,Muscular Dystrophy,60,80,5,0,5
Tamil Nadu,Thiruvallur,Muscular Dystrophy,0,6,1,1,2
Tamil Nadu,Thiruvallur,Muscular Dystrophy,6,15,33,7,40
Tamil Nadu,Thiruvallur,Muscular Dystrophy,15,35,54,22,76
Tamil Nadu,Thiruvallur,Muscular Dystrophy,35,60,17,12,29
Tamil Nadu,Thiruvallur,Muscular Dystrophy,60,80,1,2,3
Tamil Nadu,Theni,Muscular Dystrophy,0,6,1,0,1
Tamil Nadu,Theni,Muscular Dystrophy,6,15,20,3,23
Tamil Nadu,Theni,Muscular Dystrophy,15,35,27,8,35
Tamil Nadu,Theni,Muscular Dystrophy,35,60,9,2,11
Tamil Nadu,The Nilgiris,Muscular Dystrophy,0,6,1,0,1
Tamil Nadu,The Nilgiris,Muscular Dystrophy,6,15,10,1,11
Tamil Nadu,The Nilgiris,Muscular Dystrophy,15,35,21,7,28
Tamil Nadu,The Nilgiris,Muscular Dystrophy,35,60,12,7,19
Tamil Nadu,The Nilgiris,Muscular Dystrophy,60,80,0,2,2
Tamil Nadu,The Nilgiris,Muscular Dystrophy,80,100,1,0,1
Tamil Nadu,Thanjavur,Muscular Dystrophy,0,6,1,2,3
Tamil Nadu,Thanjavur,Muscular Dystrophy,6,15,41,10,51
Tamil Nadu,Thanjavur,Muscular Dystrophy,15,35,69,28,97
Tamil Nadu,Thanjavur,Muscular Dystrophy,35,60,38,16,54
Tamil Nadu,Thanjavur,Muscular Dystrophy,60,80,4,3,7
Maharashtra,Thane,Muscular Dystrophy,0,6,4,0,4
Maharashtra,Thane,Muscular Dystrophy,6,15,42,10,52
Maharashtra,Thane,Muscular Dystrophy,15,35,102,36,138
Maharashtra,Thane,Muscular Dystrophy,35,60,170,69,239
Maharashtra,Thane,Muscular Dystrophy,60,80,48,12,60
Maharashtra,Thane,Muscular Dystrophy,80,100,0,1,1
Tamil Nadu,Tenkasi,Muscular Dystrophy,6,15,20,2,22
Tamil Nadu,Tenkasi,Muscular Dystrophy,15,35,23,2,25
Tamil Nadu,Tenkasi,Muscular Dystrophy,35,60,11,2,13
Tamil Nadu,Tenkasi,Muscular Dystrophy,60,80,1,0,1
Manipur,Tengnoupal,Muscular Dystrophy,6,15,1,2,3
Manipur,Tengnoupal,Muscular Dystrophy,15,35,2,0,2
Manipur,Tengnoupal,Muscular Dystrophy,35,60,0,1,1
Uttarakhand,Tehri Garhwal,Muscular Dystrophy,6,15,4,3,7
Uttarakhand,Tehri Garhwal,Muscular Dystrophy,15,35,32,12,44
Uttarakhand,Tehri Garhwal,Muscular Dystrophy,35,60,72,20,92
Uttarakhand,Tehri Garhwal,Muscular Dystrophy,60,80,14,1,15
Uttarakhand,Tehri Garhwal,Muscular Dystrophy,80,100,1,0,1
Punjab,Tarn Taran,Muscular Dystrophy,0,6,0,1,1
Punjab,Tarn Taran,Muscular Dystrophy,6,15,4,0,4
Punjab,Tarn Taran,Muscular Dystrophy,15,35,26,9,35
Punjab,Tarn Taran,Muscular Dystrophy,35,60,48,19,67
Punjab,Tarn Taran,Muscular Dystrophy,60,80,5,2,7
Gujarat,Tapi,Muscular Dystrophy,6,15,3,0,3
Gujarat,Tapi,Muscular Dystrophy,15,35,2,0,2
Gujarat,Tapi,Muscular Dystrophy,35,60,1,0,1
Gujarat,Tapi,Muscular Dystrophy,60,80,1,0,1
Manipur,Tamenglong,Muscular Dystrophy,6,15,0,1,1
Manipur,Tamenglong,Muscular Dystrophy,15,35,0,1,1
Manipur,Tamenglong,Muscular Dystrophy,35,60,0,2,2
Chhattisgarh,Surguja,Muscular Dystrophy,0,6,2,0,2
Chhattisgarh,Surguja,Muscular Dystrophy,6,15,10,5,15
Chhattisgarh,Surguja,Muscular Dystrophy,15,35,18,3,21
Chhattisgarh,Surguja,Muscular Dystrophy,35,60,11,3,14
Chhattisgarh,Surguja,Muscular Dystrophy,60,80,2,3,5
Chhattisgarh,Surguja,Muscular Dystrophy,80,100,1,0,1
Gujarat,Surendranagar,Muscular Dystrophy,15,35,0,2,2
Gujarat,Surendranagar,Muscular Dystrophy,35,60,7,2,9
Gujarat,Surendranagar,Muscular Dystrophy,60,80,5,0,5
Gujarat,Surat,Muscular Dystrophy,0,6,0,1,1
Gujarat,Surat,Muscular Dystrophy,15,35,30,4,34
Gujarat,Surat,Muscular Dystrophy,35,60,27,3,30
Gujarat,Surat,Muscular Dystrophy,60,80,2,0,2
Chhattisgarh,Surajpur,Muscular Dystrophy,6,15,1,1,2
Chhattisgarh,Surajpur,Muscular Dystrophy,15,35,4,3,7
Chhattisgarh,Surajpur,Muscular Dystrophy,35,60,4,1,5
Chhattisgarh,Surajpur,Muscular Dystrophy,60,80,2,0,2
Bihar,Supaul,Muscular Dystrophy,6,15,1,0,1
Bihar,Supaul,Muscular Dystrophy,15,35,5,3,8
Bihar,Supaul,Muscular Dystrophy,35,60,3,0,3
Odisha,Sundargarh,Muscular Dystrophy,0,6,1,0,1
Odisha,Sundargarh,Muscular Dystrophy,6,15,13,6,19
Odisha,Sundargarh,Muscular Dystrophy,15,35,24,11,35
Odisha,Sundargarh,Muscular Dystrophy,35,60,48,25,73
Odisha,Sundargarh,Muscular Dystrophy,60,80,14,6,20
Uttar Pradesh,Sultanpur,Muscular Dystrophy,6,15,10,2,12
Uttar Pradesh,Sultanpur,Muscular Dystrophy,15,35,86,24,110
Uttar Pradesh,Sultanpur,Muscular Dystrophy,35,60,119,24,143
Uttar Pradesh,Sultanpur,Muscular Dystrophy,60,80,27,5,32
Chhattisgarh,Sukma,Muscular Dystrophy,6,15,1,1,2
Chhattisgarh,Sukma,Muscular Dystrophy,35,60,1,0,1
Jammu And Kashmir,Srinagar,Muscular Dystrophy,6,15,1,0,1
Jammu And Kashmir,Srinagar,Muscular Dystrophy,15,35,3,1,4
Jammu And Kashmir,Srinagar,Muscular Dystrophy,35,60,1,2,3
Andhra Pradesh,Srikakulam,Muscular Dystrophy,6,15,0,1,1
Andhra Pradesh,Srikakulam,Muscular Dystrophy,15,35,2,0,2
Andhra Pradesh,Srikakulam,Muscular Dystrophy,35,60,1,0,1
Punjab,Sri Muktsar Sahib,Muscular Dystrophy,6,15,4,0,4
Punjab,Sri Muktsar Sahib,Muscular Dystrophy,15,35,38,11,49
Punjab,Sri Muktsar Sahib,Muscular Dystrophy,35,60,45,31,76
Punjab,Sri Muktsar Sahib,Muscular Dystrophy,60,80,10,4,14
Andhra Pradesh,Spsr Nellore,Muscular Dystrophy,6,15,3,0,3
Andhra Pradesh,Spsr Nellore,Muscular Dystrophy,15,35,3,0,3
Andhra Pradesh,Spsr Nellore,Muscular Dystrophy,35,60,1,0,1
Meghalaya,South West Khasi Hills,Muscular Dystrophy,15,35,1,0,1
Delhi,South West,Muscular Dystrophy,0,6,1,0,1
Delhi,South West,Muscular Dystrophy,6,15,16,0,16
Delhi,South West,Muscular Dystrophy,15,35,16,4,20
Delhi,South West,Muscular Dystrophy,35,60,5,4,9
Assam,South Salmara Mancachar,Muscular Dystrophy,35,60,1,0,1
Goa,South Goa,Muscular Dystrophy,6,15,1,0,1
Goa,South Goa,Muscular Dystrophy,15,35,7,1,8
Goa,South Goa,Muscular Dystrophy,35,60,5,5,10
Goa,South Goa,Muscular Dystrophy,60,80,1,2,3
Delhi,South East,Muscular Dystrophy,6,15,1,0,1
Delhi,South East,Muscular Dystrophy,15,35,2,1,3
Delhi,South East,Muscular Dystrophy,60,80,1,0,1
Andaman And Nicobar Islands,South Andamans,Muscular Dystrophy,6,15,4,0,4
Andaman And Nicobar Islands,South Andamans,Muscular Dystrophy,15,35,17,9,26
Andaman And Nicobar Islands,South Andamans,Muscular Dystrophy,35,60,33,27,60
Andaman And Nicobar Islands,South Andamans,Muscular Dystrophy,60,80,11,5,16
Andaman And Nicobar Islands,South Andamans,Muscular Dystrophy,80,100,1,0,1
Delhi,South,Muscular Dystrophy,6,15,2,1,3
Delhi,South,Muscular Dystrophy,15,35,6,3,9
Delhi,South,Muscular Dystrophy,35,60,5,0,5
Delhi,South,Muscular Dystrophy,60,80,1,0,1
Assam,Sonitpur,Muscular Dystrophy,6,15,6,2,8
Assam,Sonitpur,Muscular Dystrophy,15,35,6,3,9
Assam,Sonitpur,Muscular Dystrophy,35,60,3,0,3
Haryana,Sonipat,Muscular Dystrophy,6,15,7,0,7
Haryana,Sonipat,Muscular Dystrophy,15,35,27,9,36
Haryana,Sonipat,Muscular Dystrophy,35,60,35,6,41
Haryana,Sonipat,Muscular Dystrophy,60,80,5,1,6
Odisha,Sonepur,Muscular Dystrophy,0,6,1,0,1
Odisha,Sonepur,Muscular Dystrophy,6,15,7,0,7
Odisha,Sonepur,Muscular Dystrophy,15,35,4,3,7
Odisha,Sonepur,Muscular Dystrophy,35,60,2,3,5
Uttar Pradesh,Sonbhadra,Muscular Dystrophy,6,15,3,0,3
Uttar Pradesh,Sonbhadra,Muscular Dystrophy,15,35,37,7,44
Uttar Pradesh,Sonbhadra,Muscular Dystrophy,35,60,28,10,38
Uttar Pradesh,Sonbhadra,Muscular Dystrophy,60,80,10,0,10
Uttar Pradesh,Sonbhadra,Muscular Dystrophy,80,100,0,1,1
Maharashtra,Solapur,Muscular Dystrophy,0,6,1,1,2
Maharashtra,Solapur,Muscular Dystrophy,6,15,43,3,46
Maharashtra,Solapur,Muscular Dystrophy,15,35,57,27,84
Maharashtra,Solapur,Muscular Dystrophy,35,60,62,33,95
Maharashtra,Solapur,Muscular Dystrophy,60,80,6,8,14
Maharashtra,Solapur,Muscular Dystrophy,80,100,1,0,1
Himachal Pradesh,Solan,Muscular Dystrophy,6,15,6,0,6
Himachal Pradesh,Solan,Muscular Dystrophy,15,35,7,1,8
Himachal Pradesh,Solan,Muscular Dystrophy,35,60,3,3,6
Himachal Pradesh,Solan,Muscular Dystrophy,60,80,3,1,4
Bihar,Siwan,Muscular Dystrophy,6,15,9,3,12
Bihar,Siwan,Muscular Dystrophy,15,35,14,10,24
Bihar,Siwan,Muscular Dystrophy,35,60,15,3,18
Bihar,Siwan,Muscular Dystrophy,60,80,1,0,1
Assam,Sivasagar,Muscular Dystrophy,6,15,2,1,3
Assam,Sivasagar,Muscular Dystrophy,15,35,2,0,2
Assam,Sivasagar,Muscular Dystrophy,35,60,1,1,2
Tamil Nadu,Sivaganga,Muscular Dystrophy,0,6,1,0,1
Tamil Nadu,Sivaganga,Muscular Dystrophy,6,15,27,9,36
Tamil Nadu,Sivaganga,Muscular Dystrophy,15,35,36,11,47
Tamil Nadu,Sivaganga,Muscular Dystrophy,35,60,15,5,20
Tamil Nadu,Sivaganga,Muscular Dystrophy,60,80,1,1,2
Tamil Nadu,Sivaganga,Muscular Dystrophy,80,100,1,0,1
Uttar Pradesh,Sitapur,Muscular Dystrophy,6,15,8,3,11
Uttar Pradesh,Sitapur,Muscular Dystrophy,15,35,92,26,118
Uttar Pradesh,Sitapur,Muscular Dystrophy,35,60,80,19,99
Uttar Pradesh,Sitapur,Muscular Dystrophy,60,80,8,0,8
Bihar,Sitamarhi,Muscular Dystrophy,6,15,11,4,15
Bihar,Sitamarhi,Muscular Dystrophy,15,35,18,7,25
Bihar,Sitamarhi,Muscular Dystrophy,35,60,17,2,19
Bihar,Sitamarhi,Muscular Dystrophy,60,80,5,0,5
Haryana,Sirsa,Muscular Dystrophy,6,15,7,0,7
Haryana,Sirsa,Muscular Dystrophy,15,35,13,0,13
Haryana,Sirsa,Muscular Dystrophy,35,60,4,1,5
Haryana,Sirsa,Muscular Dystrophy,60,80,0,1,1
Rajasthan,Sirohi,Muscular Dystrophy,0,6,2,4,6
Rajasthan,Sirohi,Muscular Dystrophy,6,15,8,6,14
Rajasthan,Sirohi,Muscular Dystrophy,15,35,17,15,32
Rajasthan,Sirohi,Muscular Dystrophy,35,60,29,10,39
Rajasthan,Sirohi,Muscular Dystrophy,60,80,5,0,5
Himachal Pradesh,Sirmaur,Muscular Dystrophy,0,6,1,0,1
Himachal Pradesh,Sirmaur,Muscular Dystrophy,6,15,2,0,2
Himachal Pradesh,Sirmaur,Muscular Dystrophy,15,35,5,1,6
Himachal Pradesh,Sirmaur,Muscular Dystrophy,35,60,8,0,8
Madhya Pradesh,Singrauli,Muscular Dystrophy,6,15,2,0,2
Madhya Pradesh,Singrauli,Muscular Dystrophy,15,35,5,1,6
Madhya Pradesh,Singrauli,Muscular Dystrophy,35,60,4,1,5
Madhya Pradesh,Singrauli,Muscular Dystrophy,60,80,0,1,1
Maharashtra,Sindhudurg,Muscular Dystrophy,6,15,1,2,3
Maharashtra,Sindhudurg,Muscular Dystrophy,15,35,9,5,14
Maharashtra,Sindhudurg,Muscular Dystrophy,35,60,29,8,37
Maharashtra,Sindhudurg,Muscular Dystrophy,60,80,14,4,18
Maharashtra,Sindhudurg,Muscular Dystrophy,80,100,2,0,2
Jharkhand,Simdega,Muscular Dystrophy,0,6,2,1,3
Jharkhand,Simdega,Muscular Dystrophy,6,15,18,8,26
Jharkhand,Simdega,Muscular Dystrophy,15,35,61,47,108
Jharkhand,Simdega,Muscular Dystrophy,35,60,141,61,202
Jharkhand,Simdega,Muscular Dystrophy,60,80,28,15,43
Jharkhand,Simdega,Muscular Dystrophy,80,100,2,1,3
Rajasthan,Sikar,Muscular Dystrophy,0,6,1,1,2
Rajasthan,Sikar,Muscular Dystrophy,6,15,16,0,16
Rajasthan,Sikar,Muscular Dystrophy,15,35,20,4,24
Rajasthan,Sikar,Muscular Dystrophy,35,60,10,3,13
Rajasthan,Sikar,Muscular Dystrophy,60,80,5,2,7
Madhya Pradesh,Sidhi,Muscular Dystrophy,0,6,2,0,2
Madhya Pradesh,Sidhi,Muscular Dystrophy,6,15,7,1,8
Madhya Pradesh,Sidhi,Muscular Dystrophy,15,35,39,16,55
Madhya Pradesh,Sidhi,Muscular Dystrophy,35,60,38,23,61
Madhya Pradesh,Sidhi,Muscular Dystrophy,60,80,11,4,15
Uttar Pradesh,Siddharth Nagar,Muscular Dystrophy,0,6,2,1,3
Uttar Pradesh,Siddharth Nagar,Muscular Dystrophy,6,15,12,5,17
Uttar Pradesh,Siddharth Nagar,Muscular Dystrophy,15,35,139,41,180
Uttar Pradesh,Siddharth Nagar,Muscular Dystrophy,35,60,169,34,203
Uttar Pradesh,Siddharth Nagar,Muscular Dystrophy,60,80,49,7,56
Uttar Pradesh,Siddharth Nagar,Muscular Dystrophy,80,100,3,0,3
Uttar Pradesh,Shravasti,Muscular Dystrophy,6,15,2,0,2
Uttar Pradesh,Shravasti,Muscular Dystrophy,15,35,15,3,18
Uttar Pradesh,Shravasti,Muscular Dystrophy,35,60,13,2,15
Uttar Pradesh,Shravasti,Muscular Dystrophy,60,80,7,4,11
Jammu And Kashmir,Shopian,Muscular Dystrophy,0,6,2,0,2
Jammu And Kashmir,Shopian,Muscular Dystrophy,6,15,7,1,8
Jammu And Kashmir,Shopian,Muscular Dystrophy,15,35,11,2,13
Jammu And Kashmir,Shopian,Muscular Dystrophy,35,60,8,3,11
Madhya Pradesh,Shivpuri,Muscular Dystrophy,6,15,18,13,31
Madhya Pradesh,Shivpuri,Muscular Dystrophy,15,35,92,40,132
Madhya Pradesh,Shivpuri,Muscular Dystrophy,35,60,147,58,205
Madhya Pradesh,Shivpuri,Muscular Dystrophy,60,80,26,9,35
Madhya Pradesh,Shivpuri,Muscular Dystrophy,80,100,1,1,2
Karnataka,Shivamogga,Muscular Dystrophy,0,6,2,1,3
Karnataka,Shivamogga,Muscular Dystrophy,6,15,12,2,14
Karnataka,Shivamogga,Muscular Dystrophy,15,35,22,8,30
Karnataka,Shivamogga,Muscular Dystrophy,35,60,27,3,30
Karnataka,Shivamogga,Muscular Dystrophy,60,80,8,2,10
Himachal Pradesh,Shimla,Muscular Dystrophy,0,6,1,0,1
Himachal Pradesh,Shimla,Muscular Dystrophy,6,15,4,0,4
Himachal Pradesh,Shimla,Muscular Dystrophy,15,35,2,0,2
Himachal Pradesh,Shimla,Muscular Dystrophy,35,60,3,0,3
Madhya Pradesh,Sheopur,Muscular Dystrophy,6,15,1,0,1
Madhya Pradesh,Sheopur,Muscular Dystrophy,15,35,1,0,1
Madhya Pradesh,Sheopur,Muscular Dystrophy,35,60,1,0,1
Bihar,Sheohar,Muscular Dystrophy,6,15,5,1,6
Bihar,Sheohar,Muscular Dystrophy,15,35,13,3,16
Bihar,Sheohar,Muscular Dystrophy,35,60,12,4,16
Bihar,Sheohar,Muscular Dystrophy,60,80,8,2,10
Bihar,Sheohar,Muscular Dystrophy,80,100,1,0,1
Bihar,Sheikhpura,Muscular Dystrophy,6,15,2,1,3
Bihar,Sheikhpura,Muscular Dystrophy,15,35,2,3,5
Bihar,Sheikhpura,Muscular Dystrophy,35,60,5,1,6
Bihar,Sheikhpura,Muscular Dystrophy,60,80,1,0,1
Uttar Pradesh,Shamli,Muscular Dystrophy,6,15,4,1,5
Uttar Pradesh,Shamli,Muscular Dystrophy,15,35,16,6,22
Uttar Pradesh,Shamli,Muscular Dystrophy,35,60,31,8,39
Uttar Pradesh,Shamli,Muscular Dystrophy,60,80,4,1,5
Madhya Pradesh,Shajapur,Muscular Dystrophy,6,15,1,0,1
Madhya Pradesh,Shajapur,Muscular Dystrophy,15,35,2,0,2
Uttar Pradesh,Shahjahanpur,Muscular Dystrophy,0,6,7,4,11
Uttar Pradesh,Shahjahanpur,Muscular Dystrophy,6,15,60,31,91
Uttar Pradesh,Shahjahanpur,Muscular Dystrophy,15,35,1341,465,1806
Uttar Pradesh,Shahjahanpur,Muscular Dystrophy,35,60,1248,389,1637
Uttar Pradesh,Shahjahanpur,Muscular Dystrophy,60,80,219,51,270
Uttar Pradesh,Shahjahanpur,Muscular Dystrophy,80,100,6,2,8
Punjab,Shahid Bhagat Singh Nagar,Muscular Dystrophy,6,15,10,2,12
Punjab,Shahid Bhagat Singh Nagar,Muscular Dystrophy,15,35,21,11,32
Punjab,Shahid Bhagat Singh Nagar,Muscular Dystrophy,35,60,38,19,57
Punjab,Shahid Bhagat Singh Nagar,Muscular Dystrophy,60,80,26,4,30
Madhya Pradesh,Shahdol,Muscular Dystrophy,0,6,0,1,1
Madhya Pradesh,Shahdol,Muscular Dystrophy,6,15,5,2,7
Madhya Pradesh,Shahdol,Muscular Dystrophy,15,35,17,6,23
Madhya Pradesh,Shahdol,Muscular Dystrophy,35,60,18,12,30
Madhya Pradesh,Shahdol,Muscular Dystrophy,60,80,2,0,2
Madhya Pradesh,Shahdol,Muscular Dystrophy,80,100,1,0,1
Delhi,Shahdara,Muscular Dystrophy,0,6,1,0,1
Delhi,Shahdara,Muscular Dystrophy,6,15,2,0,2
Delhi,Shahdara,Muscular Dystrophy,15,35,4,1,5
Delhi,Shahdara,Muscular Dystrophy,35,60,2,1,3
Mizoram,Serchhip,Muscular Dystrophy,15,35,1,0,1
Madhya Pradesh,Seoni,Muscular Dystrophy,6,15,4,2,6
Madhya Pradesh,Seoni,Muscular Dystrophy,15,35,25,10,35
Madhya Pradesh,Seoni,Muscular Dystrophy,35,60,47,16,63
Madhya Pradesh,Seoni,Muscular Dystrophy,60,80,13,3,16
Madhya Pradesh,Seoni,Muscular Dystrophy,80,100,2,0,2
Madhya Pradesh,Sehore,Muscular Dystrophy,6,15,4,0,4
Madhya Pradesh,Sehore,Muscular Dystrophy,15,35,5,0,5
Madhya Pradesh,Sehore,Muscular Dystrophy,35,60,2,0,2
Madhya Pradesh,Sehore,Muscular Dystrophy,60,80,1,1,2
Rajasthan,Sawai Madhopur,Muscular Dystrophy,0,6,4,1,5
Rajasthan,Sawai Madhopur,Muscular Dystrophy,6,15,12,4,16
Rajasthan,Sawai Madhopur,Muscular Dystrophy,15,35,19,7,26
Rajasthan,Sawai Madhopur,Muscular Dystrophy,35,60,12,1,13
Rajasthan,Sawai Madhopur,Muscular Dystrophy,60,80,0,1,1
Madhya Pradesh,Satna,Muscular Dystrophy,0,6,1,0,1
Madhya Pradesh,Satna,Muscular Dystrophy,6,15,7,1,8
Madhya Pradesh,Satna,Muscular Dystrophy,15,35,20,4,24
Madhya Pradesh,Satna,Muscular Dystrophy,35,60,7,0,7
Madhya Pradesh,Satna,Muscular Dystrophy,60,80,1,0,1
Maharashtra,Satara,Muscular Dystrophy,6,15,12,2,14
Maharashtra,Satara,Muscular Dystrophy,15,35,10,4,14
Maharashtra,Satara,Muscular Dystrophy,35,60,39,12,51
Maharashtra,Satara,Muscular Dystrophy,60,80,10,3,13
Bihar,Saran,Muscular Dystrophy,0,6,2,0,2
Bihar,Saran,Muscular Dystrophy,6,15,10,3,13
Bihar,Saran,Muscular Dystrophy,15,35,21,2,23
Bihar,Saran,Muscular Dystrophy,35,60,27,9,36
Bihar,Saran,Muscular Dystrophy,60,80,2,2,4
Jharkhand,Saraikela Kharsawan,Muscular Dystrophy,6,15,4,1,5
Jharkhand,Saraikela Kharsawan,Muscular Dystrophy,15,35,11,5,16
Jharkhand,Saraikela Kharsawan,Muscular Dystrophy,35,60,6,9,15
Jharkhand,Saraikela Kharsawan,Muscular Dystrophy,60,80,1,0,1
Uttar Pradesh,Sant Kabeer Nagar,Muscular Dystrophy,6,15,7,5,12
Uttar Pradesh,Sant Kabeer Nagar,Muscular Dystrophy,15,35,88,25,113
Uttar Pradesh,Sant Kabeer Nagar,Muscular Dystrophy,35,60,62,14,76
Uttar Pradesh,Sant Kabeer Nagar,Muscular Dystrophy,60,80,22,7,29
Punjab,Sangrur,Muscular Dystrophy,6,15,9,6,15
Punjab,Sangrur,Muscular Dystrophy,15,35,49,18,67
Punjab,Sangrur,Muscular Dystrophy,35,60,78,35,113
Punjab,Sangrur,Muscular Dystrophy,60,80,20,10,30
Punjab,Sangrur,Muscular Dystrophy,80,100,1,1,2
Maharashtra,Sangli,Muscular Dystrophy,0,6,2,0,2
Maharashtra,Sangli,Muscular Dystrophy,6,15,29,3,32
Maharashtra,Sangli,Muscular Dystrophy,15,35,36,11,47
Maharashtra,Sangli,Muscular Dystrophy,35,60,26,10,36
Maharashtra,Sangli,Muscular Dystrophy,60,80,4,2,6
Uttar Pradesh,Sambhal,Muscular Dystrophy,6,15,7,2,9
Uttar Pradesh,Sambhal,Muscular Dystrophy,15,35,17,5,22
Uttar Pradesh,Sambhal,Muscular Dystrophy,35,60,8,0,8
Odisha,Sambalpur,Muscular Dystrophy,0,6,1,1,2
Odisha,Sambalpur,Muscular Dystrophy,6,15,5,1,6
Odisha,Sambalpur,Muscular Dystrophy,15,35,5,2,7
Odisha,Sambalpur,Muscular Dystrophy,35,60,4,0,4
Odisha,Sambalpur,Muscular Dystrophy,60,80,3,0,3
Jammu And Kashmir,Samba,Muscular Dystrophy,6,15,2,1,3
Jammu And Kashmir,Samba,Muscular Dystrophy,15,35,5,1,6
Jammu And Kashmir,Samba,Muscular Dystrophy,35,60,6,2,8
Jammu And Kashmir,Samba,Muscular Dystrophy,60,80,1,0,1
Bihar,Samastipur,Muscular Dystrophy,0,6,1,1,2
Bihar,Samastipur,Muscular Dystrophy,6,15,25,5,30
Bihar,Samastipur,Muscular Dystrophy,15,35,72,32,104
Bihar,Samastipur,Muscular Dystrophy,35,60,67,36,103
Bihar,Samastipur,Muscular Dystrophy,60,80,13,9,22
Tamil Nadu,Salem,Muscular Dystrophy,0,6,2,0,2
Tamil Nadu,Salem,Muscular Dystrophy,6,15,62,11,73
Tamil Nadu,Salem,Muscular Dystrophy,15,35,56,10,66
Tamil Nadu,Salem,Muscular Dystrophy,35,60,16,9,25
Tamil Nadu,Salem,Muscular Dystrophy,60,80,3,1,4
Jharkhand,Sahebganj,Muscular Dystrophy,0,6,2,1,3
Jharkhand,Sahebganj,Muscular Dystrophy,6,15,18,14,32
Jharkhand,Sahebganj,Muscular Dystrophy,15,35,25,17,42
Jharkhand,Sahebganj,Muscular Dystrophy,35,60,37,14,51
Jharkhand,Sahebganj,Muscular Dystrophy,60,80,10,1,11
Bihar,Saharsa,Muscular Dystrophy,6,15,4,1,5
Bihar,Saharsa,Muscular Dystrophy,15,35,14,6,20
Bihar,Saharsa,Muscular Dystrophy,35,60,32,9,41
Bihar,Saharsa,Muscular Dystrophy,60,80,3,1,4
Uttar Pradesh,Saharanpur,Muscular Dystrophy,0,6,0,2,2
Uttar Pradesh,Saharanpur,Muscular Dystrophy,6,15,16,4,20
Uttar Pradesh,Saharanpur,Muscular Dystrophy,15,35,176,47,223
Uttar Pradesh,Saharanpur,Muscular Dystrophy,35,60,285,57,342
Uttar Pradesh,Saharanpur,Muscular Dystrophy,60,80,62,9,71
Uttar Pradesh,Saharanpur,Muscular Dystrophy,80,100,4,0,4
Madhya Pradesh,Sagar,Muscular Dystrophy,6,15,1,1,2
Madhya Pradesh,Sagar,Muscular Dystrophy,15,35,5,5,10
Madhya Pradesh,Sagar,Muscular Dystrophy,35,60,10,2,12
Madhya Pradesh,Sagar,Muscular Dystrophy,60,80,1,1,2
Gujarat,Sabar Kantha,Muscular Dystrophy,6,15,1,1,2
Gujarat,Sabar Kantha,Muscular Dystrophy,15,35,4,4,8
Gujarat,Sabar Kantha,Muscular Dystrophy,35,60,5,0,5
Gujarat,Sabar Kantha,Muscular Dystrophy,60,80,3,0,3
Punjab,S.A.S Nagar,Muscular Dystrophy,0,6,0,1,1
Punjab,S.A.S Nagar,Muscular Dystrophy,6,15,17,4,21
Punjab,S.A.S Nagar,Muscular Dystrophy,15,35,46,32,78
Punjab,S.A.S Nagar,Muscular Dystrophy,35,60,129,66,195
Punjab,S.A.S Nagar,Muscular Dystrophy,60,80,27,4,31
Punjab,S.A.S Nagar,Muscular Dystrophy,80,100,1,0,1
Punjab,Rupnagar,Muscular Dystrophy,0,6,1,0,1
Punjab,Rupnagar,Muscular Dystrophy,6,15,10,1,11
Punjab,Rupnagar,Muscular Dystrophy,15,35,28,7,35
Punjab,Rupnagar,Muscular Dystrophy,35,60,73,22,95
Punjab,Rupnagar,Muscular Dystrophy,60,80,22,11,33
Punjab,Rupnagar,Muscular Dystrophy,80,100,1,1,2
Uttarakhand,Rudra Prayag,Muscular Dystrophy,0,6,2,0,2
Uttarakhand,Rudra Prayag,Muscular Dystrophy,6,15,1,1,2
Uttarakhand,Rudra Prayag,Muscular Dystrophy,15,35,11,11,22
Uttarakhand,Rudra Prayag,Muscular Dystrophy,35,60,28,9,37
Uttarakhand,Rudra Prayag,Muscular Dystrophy,60,80,1,1,2
Bihar,Rohtas,Muscular Dystrophy,0,6,0,1,1
Bihar,Rohtas,Muscular Dystrophy,6,15,29,17,46
Bihar,Rohtas,Muscular Dystrophy,15,35,144,42,186
Bihar,Rohtas,Muscular Dystrophy,35,60,142,58,200
Bihar,Rohtas,Muscular Dystrophy,60,80,58,23,81
Bihar,Rohtas,Muscular Dystrophy,80,100,4,0,4
Haryana,Rohtak,Muscular Dystrophy,0,6,1,0,1
Haryana,Rohtak,Muscular Dystrophy,6,15,14,1,15
Haryana,Rohtak,Muscular Dystrophy,15,35,32,16,48
Haryana,Rohtak,Muscular Dystrophy,35,60,51,17,68
Haryana,Rohtak,Muscular Dystrophy,60,80,4,7,11
Meghalaya,Ri Bhoi,Muscular Dystrophy,6,15,3,0,3
Meghalaya,Ri Bhoi,Muscular Dystrophy,15,35,4,2,6
Meghalaya,Ri Bhoi,Muscular Dystrophy,35,60,2,0,2
Meghalaya,Ri Bhoi,Muscular Dystrophy,60,80,1,0,1
Haryana,Rewari,Muscular Dystrophy,6,15,6,0,6
Haryana,Rewari,Muscular Dystrophy,15,35,12,4,16
Haryana,Rewari,Muscular Dystrophy,35,60,6,4,10
Haryana,Rewari,Muscular Dystrophy,60,80,3,1,4
Madhya Pradesh,Rewa,Muscular Dystrophy,6,15,22,0,22
Madhya Pradesh,Rewa,Muscular Dystrophy,15,35,22,3,25
Madhya Pradesh,Rewa,Muscular Dystrophy,35,60,18,1,19
Madhya Pradesh,Rewa,Muscular Dystrophy,60,80,3,1,4
Jammu And Kashmir,Reasi,Muscular Dystrophy,6,15,9,1,10
Jammu And Kashmir,Reasi,Muscular Dystrophy,15,35,15,11,26
Jammu And Kashmir,Reasi,Muscular Dystrophy,35,60,19,14,33
Jammu And Kashmir,Reasi,Muscular Dystrophy,60,80,3,2,5
Odisha,Rayagada,Muscular Dystrophy,0,6,1,0,1
Odisha,Rayagada,Muscular Dystrophy,6,15,2,2,4
Odisha,Rayagada,Muscular Dystrophy,15,35,4,3,7
Odisha,Rayagada,Muscular Dystrophy,35,60,17,4,21
Maharashtra,Ratnagiri,Muscular Dystrophy,6,15,9,1,10
Maharashtra,Ratnagiri,Muscular Dystrophy,15,35,23,9,32
Maharashtra,Ratnagiri,Muscular Dystrophy,35,60,57,19,76
Maharashtra,Ratnagiri,Muscular Dystrophy,60,80,13,5,18
Madhya Pradesh,Ratlam,Muscular Dystrophy,6,15,16,2,18
Madhya Pradesh,Ratlam,Muscular Dystrophy,15,35,24,5,29
Madhya Pradesh,Ratlam,Muscular Dystrophy,35,60,13,8,21
Madhya Pradesh,Ratlam,Muscular Dystrophy,60,80,3,0,3
Tamil Nadu,Ranipet,Muscular Dystrophy,0,6,2,0,2
Tamil Nadu,Ranipet,Muscular Dystrophy,6,15,11,2,13
Tamil Nadu,Ranipet,Muscular Dystrophy,15,35,10,4,14
Tamil Nadu,Ranipet,Muscular Dystrophy,35,60,7,1,8
Tamil Nadu,Ranipet,Muscular Dystrophy,60,80,1,0,1
Jharkhand,Ranchi,Muscular Dystrophy,6,15,11,0,11
Jharkhand,Ranchi,Muscular Dystrophy,15,35,10,4,14
Jharkhand,Ranchi,Muscular Dystrophy,35,60,5,4,9
Uttar Pradesh,Rampur,Muscular Dystrophy,0,6,5,3,8
Uttar Pradesh,Rampur,Muscular Dystrophy,6,15,35,20,55
Uttar Pradesh,Rampur,Muscular Dystrophy,15,35,501,167,668
Uttar Pradesh,Rampur,Muscular Dystrophy,35,60,422,108,530
Uttar Pradesh,Rampur,Muscular Dystrophy,60,80,63,11,74
Uttar Pradesh,Rampur,Muscular Dystrophy,80,100,2,0,2
Jharkhand,Ramgarh,Muscular Dystrophy,0,6,6,5,11
Jharkhand,Ramgarh,Muscular Dystrophy,6,15,67,23,90
Jharkhand,Ramgarh,Muscular Dystrophy,15,35,310,174,484
Jharkhand,Ramgarh,Muscular Dystrophy,35,60,438,188,626
Jharkhand,Ramgarh,Muscular Dystrophy,60,80,61,21,82
Jharkhand,Ramgarh,Muscular Dystrophy,80,100,4,1,5
Jammu And Kashmir,Ramban,Muscular Dystrophy,0,6,1,0,1
Jammu And Kashmir,Ramban,Muscular Dystrophy,6,15,2,0,2
Jammu And Kashmir,Ramban,Muscular Dystrophy,15,35,6,5,11
Jammu And Kashmir,Ramban,Muscular Dystrophy,35,60,5,2,7
Jammu And Kashmir,Ramban,Muscular Dystrophy,60,80,5,0,5
Tamil Nadu,Ramanathapuram,Muscular Dystrophy,6,15,17,4,21
Tamil Nadu,Ramanathapuram,Muscular Dystrophy,15,35,20,6,26
Tamil Nadu,Ramanathapuram,Muscular Dystrophy,35,60,26,14,40
Tamil Nadu,Ramanathapuram,Muscular Dystrophy,60,80,1,2,3
Karnataka,Ramanagara,Muscular Dystrophy,0,6,1,0,1
Karnataka,Ramanagara,Muscular Dystrophy,6,15,5,2,7
Karnataka,Ramanagara,Muscular Dystrophy,15,35,19,3,22
Karnataka,Ramanagara,Muscular Dystrophy,35,60,28,11,39
Karnataka,Ramanagara,Muscular Dystrophy,60,80,5,4,9
Rajasthan,Rajsamand,Muscular Dystrophy,0,6,3,1,4
Rajasthan,Rajsamand,Muscular Dystrophy,6,15,10,2,12
Rajasthan,Rajsamand,Muscular Dystrophy,15,35,19,14,33
Rajasthan,Rajsamand,Muscular Dystrophy,35,60,22,7,29
Rajasthan,Rajsamand,Muscular Dystrophy,60,80,4,1,5
Jammu And Kashmir,Rajouri,Muscular Dystrophy,0,6,1,0,1
Jammu And Kashmir,Rajouri,Muscular Dystrophy,6,15,18,6,24
Jammu And Kashmir,Rajouri,Muscular Dystrophy,15,35,38,25,63
Jammu And Kashmir,Rajouri,Muscular Dystrophy,35,60,22,14,36
Jammu And Kashmir,Rajouri,Muscular Dystrophy,60,80,3,1,4
Jammu And Kashmir,Rajouri,Muscular Dystrophy,80,100,1,0,1
Chhattisgarh,Rajnandgaon,Muscular Dystrophy,6,15,25,9,34
Chhattisgarh,Rajnandgaon,Muscular Dystrophy,15,35,65,28,93
Chhattisgarh,Rajnandgaon,Muscular Dystrophy,35,60,47,18,65
Chhattisgarh,Rajnandgaon,Muscular Dystrophy,60,80,13,2,15
Gujarat,Rajkot,Muscular Dystrophy,6,15,1,1,2
Gujarat,Rajkot,Muscular Dystrophy,15,35,3,0,3
Gujarat,Rajkot,Muscular Dystrophy,60,80,1,0,1
Madhya Pradesh,Rajgarh,Muscular Dystrophy,6,15,4,4,8
Madhya Pradesh,Rajgarh,Muscular Dystrophy,15,35,22,7,29
Madhya Pradesh,Rajgarh,Muscular Dystrophy,35,60,28,6,34
Madhya Pradesh,Rajgarh,Muscular Dystrophy,60,80,2,2,4
Madhya Pradesh,Raisen,Muscular Dystrophy,0,6,0,1,1
Madhya Pradesh,Raisen,Muscular Dystrophy,6,15,7,2,9
Madhya Pradesh,Raisen,Muscular Dystrophy,15,35,15,6,21
Madhya Pradesh,Raisen,Muscular Dystrophy,35,60,33,2,35
Madhya Pradesh,Raisen,Muscular Dystrophy,60,80,11,4,15
Chhattisgarh,Raipur,Muscular Dystrophy,15,35,7,0,7
Chhattisgarh,Raipur,Muscular Dystrophy,35,60,4,4,8
Chhattisgarh,Raigarh,Muscular Dystrophy,6,15,10,1,11
Chhattisgarh,Raigarh,Muscular Dystrophy,15,35,16,4,20
Chhattisgarh,Raigarh,Muscular Dystrophy,35,60,10,3,13
Maharashtra,Raigad,Muscular Dystrophy,0,6,1,2,3
Maharashtra,Raigad,Muscular Dystrophy,6,15,22,1,23
Maharashtra,Raigad,Muscular Dystrophy,15,35,37,12,49
Maharashtra,Raigad,Muscular Dystrophy,35,60,49,19,68
Maharashtra,Raigad,Muscular Dystrophy,60,80,5,4,9
Karnataka,Raichur,Muscular Dystrophy,0,6,0,1,1
Karnataka,Raichur,Muscular Dystrophy,6,15,35,6,41
Karnataka,Raichur,Muscular Dystrophy,15,35,28,17,45
Karnataka,Raichur,Muscular Dystrophy,35,60,13,3,16
Uttar Pradesh,Rae Bareli,Muscular Dystrophy,6,15,9,0,9
Uttar Pradesh,Rae Bareli,Muscular Dystrophy,15,35,41,17,58
Uttar Pradesh,Rae Bareli,Muscular Dystrophy,35,60,59,17,76
Uttar Pradesh,Rae Bareli,Muscular Dystrophy,60,80,24,1,25
Uttar Pradesh,Rae Bareli,Muscular Dystrophy,80,100,1,0,1
Bihar,Purnia,Muscular Dystrophy,6,15,14,4,18
Bihar,Purnia,Muscular Dystrophy,15,35,38,16,54
Bihar,Purnia,Muscular Dystrophy,35,60,16,5,21
Bihar,Purnia,Muscular Dystrophy,60,80,6,3,9
Odisha,Puri,Muscular Dystrophy,6,15,5,4,9
Odisha,Puri,Muscular Dystrophy,15,35,13,7,20
Odisha,Puri,Muscular Dystrophy,35,60,36,5,41
Odisha,Puri,Muscular Dystrophy,60,80,13,4,17
Bihar,Purbi Champaran,Muscular Dystrophy,0,6,1,0,1
Bihar,Purbi Champaran,Muscular Dystrophy,6,15,12,9,21
Bihar,Purbi Champaran,Muscular Dystrophy,15,35,78,24,102
Bihar,Purbi Champaran,Muscular Dystrophy,35,60,68,28,96
Bihar,Purbi Champaran,Muscular Dystrophy,60,80,21,4,25
Maharashtra,Pune,Muscular Dystrophy,0,6,1,2,3
Maharashtra,Pune,Muscular Dystrophy,6,15,62,12,74
Maharashtra,Pune,Muscular Dystrophy,15,35,72,34,106
Maharashtra,Pune,Muscular Dystrophy,35,60,110,57,167
Maharashtra,Pune,Muscular Dystrophy,60,80,23,12,35
Maharashtra,Pune,Muscular Dystrophy,80,100,1,1,2
Jammu And Kashmir,Pulwama,Muscular Dystrophy,0,6,2,0,2
Jammu And Kashmir,Pulwama,Muscular Dystrophy,6,15,8,2,10
Jammu And Kashmir,Pulwama,Muscular Dystrophy,15,35,17,10,27
Jammu And Kashmir,Pulwama,Muscular Dystrophy,35,60,2,7,9
Jammu And Kashmir,Pulwama,Muscular Dystrophy,60,80,0,1,1
Tamil Nadu,Pudukkottai,Muscular Dystrophy,0,6,1,0,1
Tamil Nadu,Pudukkottai,Muscular Dystrophy,6,15,41,7,48
Tamil Nadu,Pudukkottai,Muscular Dystrophy,15,35,40,16,56
Tamil Nadu,Pudukkottai,Muscular Dystrophy,35,60,13,5,18
Tamil Nadu,Pudukkottai,Muscular Dystrophy,60,80,0,1,1
Uttar Pradesh,Prayagraj,Muscular Dystrophy,6,15,3,0,3
Uttar Pradesh,Prayagraj,Muscular Dystrophy,15,35,47,10,57
Uttar Pradesh,Prayagraj,Muscular Dystrophy,35,60,49,7,56
Uttar Pradesh,Prayagraj,Muscular Dystrophy,60,80,4,0,4
Rajasthan,Pratapgarh,Muscular Dystrophy,6,15,5,3,8
Rajasthan,Pratapgarh,Muscular Dystrophy,15,35,10,4,14
Rajasthan,Pratapgarh,Muscular Dystrophy,35,60,13,5,18
Rajasthan,Pratapgarh,Muscular Dystrophy,60,80,3,1,4
Rajasthan,Pratapgarh,Muscular Dystrophy,80,100,1,1,2
Uttar Pradesh,Pratapgarh,Muscular Dystrophy,6,15,6,2,8
Uttar Pradesh,Pratapgarh,Muscular Dystrophy,15,35,81,28,109
Uttar Pradesh,Pratapgarh,Muscular Dystrophy,35,60,109,31,140
Uttar Pradesh,Pratapgarh,Muscular Dystrophy,60,80,29,6,35
Uttar Pradesh,Pratapgarh,Muscular Dystrophy,80,100,1,0,1
Andhra Pradesh,Prakasam,Muscular Dystrophy,15,35,1,1,2
Andhra Pradesh,Prakasam,Muscular Dystrophy,35,60,2,0,2
Gujarat,Porbandar,Muscular Dystrophy,35,60,1,1,2
Jammu And Kashmir,Poonch,Muscular Dystrophy,0,6,9,3,12
Jammu And Kashmir,Poonch,Muscular Dystrophy,6,15,33,20,53
Jammu And Kashmir,Poonch,Muscular Dystrophy,15,35,112,82,194
Jammu And Kashmir,Poonch,Muscular Dystrophy,35,60,152,78,230
Jammu And Kashmir,Poonch,Muscular Dystrophy,60,80,25,6,31
Jammu And Kashmir,Poonch,Muscular Dystrophy,80,100,1,1,2
Puducherry,Pondicherry,Muscular Dystrophy,6,15,2,0,2
Puducherry,Pondicherry,Muscular Dystrophy,15,35,9,1,10
Puducherry,Pondicherry,Muscular Dystrophy,35,60,7,3,10
Puducherry,Pondicherry,Muscular Dystrophy,60,80,2,1,3
Uttarakhand,Pithoragarh,Muscular Dystrophy,0,6,4,2,6
Uttarakhand,Pithoragarh,Muscular Dystrophy,6,15,10,2,12
Uttarakhand,Pithoragarh,Muscular Dystrophy,15,35,18,11,29
Uttarakhand,Pithoragarh,Muscular Dystrophy,35,60,39,18,57
Uttarakhand,Pithoragarh,Muscular Dystrophy,60,80,7,3,10
Uttarakhand,Pithoragarh,Muscular Dystrophy,80,100,1,0,1
Uttar Pradesh,Pilibhit,Muscular Dystrophy,0,6,2,0,2
Uttar Pradesh,Pilibhit,Muscular Dystrophy,6,15,17,8,25
Uttar Pradesh,Pilibhit,Muscular Dystrophy,15,35,261,91,352
Uttar Pradesh,Pilibhit,Muscular Dystrophy,35,60,243,72,315
Uttar Pradesh,Pilibhit,Muscular Dystrophy,60,80,52,11,63
Uttar Pradesh,Pilibhit,Muscular Dystrophy,80,100,1,0,1
Nagaland,Phek,Muscular Dystrophy,15,35,2,1,3
Nagaland,Phek,Muscular Dystrophy,35,60,1,0,1
Nagaland,Phek,Muscular Dystrophy,60,80,3,3,6
Tamil Nadu,Perambalur,Muscular Dystrophy,0,6,2,0,2
Tamil Nadu,Perambalur,Muscular Dystrophy,6,15,13,0,13
Tamil Nadu,Perambalur,Muscular Dystrophy,15,35,18,4,22
Tamil Nadu,Perambalur,Muscular Dystrophy,35,60,10,1,11
Tamil Nadu,Perambalur,Muscular Dystrophy,60,80,1,0,1
Uttarakhand,Pauri Garhwal,Muscular Dystrophy,0,6,5,2,7
Uttarakhand,Pauri Garhwal,Muscular Dystrophy,6,15,11,6,17
Uttarakhand,Pauri Garhwal,Muscular Dystrophy,15,35,103,44,147
Uttarakhand,Pauri Garhwal,Muscular Dystrophy,35,60,230,71,301
Uttarakhand,Pauri Garhwal,Muscular Dystrophy,60,80,41,18,59
Uttarakhand,Pauri Garhwal,Muscular Dystrophy,80,100,4,1,5
Bihar,Patna,Muscular Dystrophy,0,6,3,1,4
Bihar,Patna,Muscular Dystrophy,6,15,18,3,21
Bihar,Patna,Muscular Dystrophy,15,35,48,11,59
Bihar,Patna,Muscular Dystrophy,35,60,30,15,45
Bihar,Patna,Muscular Dystrophy,60,80,4,0,4
Punjab,Patiala,Muscular Dystrophy,0,6,1,1,2
Punjab,Patiala,Muscular Dystrophy,6,15,38,22,60
Punjab,Patiala,Muscular Dystrophy,15,35,312,144,456
Punjab,Patiala,Muscular Dystrophy,35,60,684,315,999
Punjab,Patiala,Muscular Dystrophy,60,80,159,46,205
Punjab,Patiala,Muscular Dystrophy,80,100,12,3,15
Punjab,Pathankot,Muscular Dystrophy,0,6,2,2,4
Punjab,Pathankot,Muscular Dystrophy,6,15,15,10,25
Punjab,Pathankot,Muscular Dystrophy,15,35,88,35,123
Punjab,Pathankot,Muscular Dystrophy,35,60,152,59,211
Punjab,Pathankot,Muscular Dystrophy,60,80,43,8,51
Punjab,Pathankot,Muscular Dystrophy,80,100,1,2,3
Kerala,Pathanamthitta,Muscular Dystrophy,6,15,3,1,4
Kerala,Pathanamthitta,Muscular Dystrophy,15,35,12,3,15
Kerala,Pathanamthitta,Muscular Dystrophy,35,60,12,3,15
Kerala,Pathanamthitta,Muscular Dystrophy,60,80,2,1,3
Kerala,Pathanamthitta,Muscular Dystrophy,80,100,1,0,1
Gujarat,Patan,Muscular Dystrophy,6,15,1,0,1
Gujarat,Patan,Muscular Dystrophy,15,35,1,0,1
Gujarat,Patan,Muscular Dystrophy,35,60,0,1,1
Gujarat,Patan,Muscular Dystrophy,60,80,1,0,1
Bihar,Pashchim Champaran,Muscular Dystrophy,0,6,1,0,1
Bihar,Pashchim Champaran,Muscular Dystrophy,6,15,11,1,12
Bihar,Pashchim Champaran,Muscular Dystrophy,15,35,26,9,35
Bihar,Pashchim Champaran,Muscular Dystrophy,35,60,16,4,20
Bihar,Pashchim Champaran,Muscular Dystrophy,60,80,2,1,3
Maharashtra,Parbhani,Muscular Dystrophy,0,6,3,4,7
Maharashtra,Parbhani,Muscular Dystrophy,6,15,23,5,28
Maharashtra,Parbhani,Muscular Dystrophy,15,35,46,19,65
Maharashtra,Parbhani,Muscular Dystrophy,35,60,54,27,81
Maharashtra,Parbhani,Muscular Dystrophy,60,80,34,23,57
Maharashtra,Parbhani,Muscular Dystrophy,80,100,0,2,2
Arunachal Pradesh,Papum Pare,Muscular Dystrophy,6,15,2,0,2
Arunachal Pradesh,Papum Pare,Muscular Dystrophy,15,35,8,11,19
Arunachal Pradesh,Papum Pare,Muscular Dystrophy,35,60,15,3,18
Arunachal Pradesh,Papum Pare,Muscular Dystrophy,60,80,3,0,3
Madhya Pradesh,Panna,Muscular Dystrophy,6,15,0,1,1
Madhya Pradesh,Panna,Muscular Dystrophy,15,35,12,1,13
Madhya Pradesh,Panna,Muscular Dystrophy,35,60,17,6,23
Madhya Pradesh,Panna,Muscular Dystrophy,60,80,0,1,1
Haryana,Panipat,Muscular Dystrophy,6,15,6,0,6
Haryana,Panipat,Muscular Dystrophy,15,35,17,4,21
Haryana,Panipat,Muscular Dystrophy,35,60,20,6,26
Haryana,Panchkula,Muscular Dystrophy,0,6,1,0,1
Haryana,Panchkula,Muscular Dystrophy,6,15,1,1,2
Haryana,Panchkula,Muscular Dystrophy,15,35,15,5,20
Haryana,Panchkula,Muscular Dystrophy,35,60,12,8,20
Haryana,Panchkula,Muscular Dystrophy,60,80,3,0,3
Gujarat,Panch Mahals,Muscular Dystrophy,6,15,3,0,3
Gujarat,Panch Mahals,Muscular Dystrophy,15,35,0,1,1
Gujarat,Panch Mahals,Muscular Dystrophy,35,60,2,0,2
Haryana,Palwal,Muscular Dystrophy,6,15,1,0,1
Haryana,Palwal,Muscular Dystrophy,15,35,3,2,5
Haryana,Palwal,Muscular Dystrophy,35,60,8,0,8
Haryana,Palwal,Muscular Dystrophy,60,80,1,0,1
Rajasthan,Pali,Muscular Dystrophy,6,15,5,1,6
Rajasthan,Pali,Muscular Dystrophy,15,35,2,1,3
Rajasthan,Pali,Muscular Dystrophy,35,60,1,0,1
Maharashtra,Palghar,Muscular Dystrophy,6,15,2,4,6
Maharashtra,Palghar,Muscular Dystrophy,15,35,17,6,23
Maharashtra,Palghar,Muscular Dystrophy,35,60,24,5,29
Maharashtra,Palghar,Muscular Dystrophy,60,80,6,0,6
Jharkhand,Palamu,Muscular Dystrophy,0,6,0,2,2
Jharkhand,Palamu,Muscular Dystrophy,6,15,8,5,13
Jharkhand,Palamu,Muscular Dystrophy,15,35,67,30,97
Jharkhand,Palamu,Muscular Dystrophy,35,60,58,30,88
Jharkhand,Palamu,Muscular Dystrophy,60,80,12,10,22
Jharkhand,Palamu,Muscular Dystrophy,80,100,1,0,1
Kerala,Palakkad,Muscular Dystrophy,6,15,19,1,20
Kerala,Palakkad,Muscular Dystrophy,15,35,43,9,52
Kerala,Palakkad,Muscular Dystrophy,35,60,31,7,38
Kerala,Palakkad,Muscular Dystrophy,60,80,4,0,4
Jharkhand,Pakur,Muscular Dystrophy,6,15,1,0,1
Jharkhand,Pakur,Muscular Dystrophy,15,35,3,1,4
Jharkhand,Pakur,Muscular Dystrophy,35,60,1,1,2
Jharkhand,Pakur,Muscular Dystrophy,60,80,0,1,1
Maharashtra,Osmanabad,Muscular Dystrophy,0,6,0,2,2
Maharashtra,Osmanabad,Muscular Dystrophy,6,15,4,3,7
Maharashtra,Osmanabad,Muscular Dystrophy,15,35,21,10,31
Maharashtra,Osmanabad,Muscular Dystrophy,35,60,37,9,46
Maharashtra,Osmanabad,Muscular Dystrophy,60,80,13,5,18
Haryana,Nuh,Muscular Dystrophy,6,15,0,1,1
Haryana,Nuh,Muscular Dystrophy,15,35,6,5,11
Haryana,Nuh,Muscular Dystrophy,35,60,5,1,6
Haryana,Nuh,Muscular Dystrophy,60,80,1,0,1
Haryana,Nuh,Muscular Dystrophy,80,100,0,1,1
Odisha,Nuapada,Muscular Dystrophy,0,6,2,1,3
Odisha,Nuapada,Muscular Dystrophy,6,15,2,2,4
Odisha,Nuapada,Muscular Dystrophy,15,35,9,2,11
Odisha,Nuapada,Muscular Dystrophy,35,60,9,5,14
Odisha,Nuapada,Muscular Dystrophy,60,80,6,0,6
Odisha,Nuapada,Muscular Dystrophy,80,100,0,1,1
Delhi,North West,Muscular Dystrophy,6,15,18,2,20
Delhi,North West,Muscular Dystrophy,15,35,32,7,39
Delhi,North West,Muscular Dystrophy,35,60,15,8,23
Delhi,North West,Muscular Dystrophy,60,80,2,0,2
Goa,North Goa,Muscular Dystrophy,0,6,1,0,1
Goa,North Goa,Muscular Dystrophy,6,15,3,0,3
Goa,North Goa,Muscular Dystrophy,15,35,7,4,11
Goa,North Goa,Muscular Dystrophy,35,60,16,5,21
Goa,North Goa,Muscular Dystrophy,60,80,6,3,9
Meghalaya,North Garo Hills,Muscular Dystrophy,35,60,2,1,3
Meghalaya,North Garo Hills,Muscular Dystrophy,60,80,0,1,1
Delhi,North East,Muscular Dystrophy,6,15,6,2,8
Delhi,North East,Muscular Dystrophy,15,35,9,1,10
Delhi,North East,Muscular Dystrophy,35,60,2,0,2
Andaman And Nicobar Islands,North And Middle Andaman,Muscular Dystrophy,6,15,3,1,4
Andaman And Nicobar Islands,North And Middle Andaman,Muscular Dystrophy,15,35,18,7,25
Andaman And Nicobar Islands,North And Middle Andaman,Muscular Dystrophy,35,60,25,11,36
Andaman And Nicobar Islands,North And Middle Andaman,Muscular Dystrophy,60,80,2,1,3
Delhi,North,Muscular Dystrophy,6,15,1,2,3
Delhi,North,Muscular Dystrophy,15,35,5,1,6
Delhi,North,Muscular Dystrophy,35,60,4,1,5
Delhi,North,Muscular Dystrophy,60,80,1,0,1
Madhya Pradesh,Niwari,Muscular Dystrophy,15,35,9,2,11
Madhya Pradesh,Niwari,Muscular Dystrophy,35,60,6,0,6
Andaman And Nicobar Islands,Nicobars,Muscular Dystrophy,15,35,1,0,1
Andaman And Nicobar Islands,Nicobars,Muscular Dystrophy,35,60,2,0,2
Andaman And Nicobar Islands,Nicobars,Muscular Dystrophy,60,80,2,1,3
Delhi,New Delhi,Muscular Dystrophy,15,35,0,1,1
Delhi,New Delhi,Muscular Dystrophy,35,60,1,0,1
Madhya Pradesh,Neemuch,Muscular Dystrophy,15,35,2,1,3
Madhya Pradesh,Neemuch,Muscular Dystrophy,35,60,1,0,1
Odisha,Nayagarh,Muscular Dystrophy,6,15,1,1,2
Odisha,Nayagarh,Muscular Dystrophy,15,35,8,4,12
Odisha,Nayagarh,Muscular Dystrophy,35,60,27,19,46
Odisha,Nayagarh,Muscular Dystrophy,60,80,20,13,33
Odisha,Nayagarh,Muscular Dystrophy,80,100,2,0,2
Bihar,Nawada,Muscular Dystrophy,6,15,1,1,2
Bihar,Nawada,Muscular Dystrophy,15,35,8,5,13
Bihar,Nawada,Muscular Dystrophy,35,60,26,4,30
Bihar,Nawada,Muscular Dystrophy,60,80,5,1,6
Gujarat,Navsari,Muscular Dystrophy,15,35,1,0,1
Gujarat,Navsari,Muscular Dystrophy,35,60,1,0,1
Maharashtra,Nashik,Muscular Dystrophy,0,6,1,0,1
Maharashtra,Nashik,Muscular Dystrophy,6,15,26,7,33
Maharashtra,Nashik,Muscular Dystrophy,15,35,48,8,56
Maharashtra,Nashik,Muscular Dystrophy,35,60,41,16,57
Maharashtra,Nashik,Muscular Dystrophy,60,80,3,0,3
Madhya Pradesh,Narsinghpur,Muscular Dystrophy,0,6,3,0,3
Madhya Pradesh,Narsinghpur,Muscular Dystrophy,6,15,22,14,36
Madhya Pradesh,Narsinghpur,Muscular Dystrophy,15,35,97,52,149
Madhya Pradesh,Narsinghpur,Muscular Dystrophy,35,60,180,53,233
Madhya Pradesh,Narsinghpur,Muscular Dystrophy,60,80,49,10,59
Madhya Pradesh,Narsinghpur,Muscular Dystrophy,80,100,3,0,3
Madhya Pradesh,Narmadapuram,Muscular Dystrophy,6,15,5,0,5
Madhya Pradesh,Narmadapuram,Muscular Dystrophy,15,35,18,5,23
Madhya Pradesh,Narmadapuram,Muscular Dystrophy,35,60,22,4,26
Madhya Pradesh,Narmadapuram,Muscular Dystrophy,60,80,3,0,3
Maharashtra,Nandurbar,Muscular Dystrophy,6,15,8,0,8
Maharashtra,Nandurbar,Muscular Dystrophy,15,35,23,5,28
Maharashtra,Nandurbar,Muscular Dystrophy,35,60,44,11,55
Maharashtra,Nandurbar,Muscular Dystrophy,60,80,12,1,13
Maharashtra,Nanded,Muscular Dystrophy,0,6,0,1,1
Maharashtra,Nanded,Muscular Dystrophy,6,15,44,21,65
Maharashtra,Nanded,Muscular Dystrophy,15,35,107,42,149
Maharashtra,Nanded,Muscular Dystrophy,35,60,155,51,206
Maharashtra,Nanded,Muscular Dystrophy,60,80,41,4,45
Maharashtra,Nanded,Muscular Dystrophy,80,100,1,0,1
Arunachal Pradesh,Namsai,Muscular Dystrophy,15,35,0,1,1
Sikkim,Namchi,Muscular Dystrophy,15,35,0,1,1
Tamil Nadu,Namakkal,Muscular Dystrophy,0,6,1,0,1
Tamil Nadu,Namakkal,Muscular Dystrophy,6,15,35,3,38
Tamil Nadu,Namakkal,Muscular Dystrophy,15,35,27,14,41
Tamil Nadu,Namakkal,Muscular Dystrophy,35,60,18,5,23
Tamil Nadu,Namakkal,Muscular Dystrophy,60,80,4,0,4
Assam,Nalbari,Muscular Dystrophy,6,15,1,1,2
Assam,Nalbari,Muscular Dystrophy,15,35,4,1,5
Assam,Nalbari,Muscular Dystrophy,35,60,1,2,3
Bihar,Nalanda,Muscular Dystrophy,0,6,0,1,1
Bihar,Nalanda,Muscular Dystrophy,6,15,11,6,17
Bihar,Nalanda,Muscular Dystrophy,15,35,69,28,97
Bihar,Nalanda,Muscular Dystrophy,35,60,53,23,76
Bihar,Nalanda,Muscular Dystrophy,60,80,15,2,17
Bihar,Nalanda,Muscular Dystrophy,80,100,2,0,2
Uttarakhand,Nainital,Muscular Dystrophy,6,15,10,1,11
Uttarakhand,Nainital,Muscular Dystrophy,15,35,9,0,9
Uttarakhand,Nainital,Muscular Dystrophy,35,60,10,3,13
Uttarakhand,Nainital,Muscular Dystrophy,60,80,2,0,2
Maharashtra,Nagpur,Muscular Dystrophy,6,15,5,0,5
Maharashtra,Nagpur,Muscular Dystrophy,15,35,4,0,4
Maharashtra,Nagpur,Muscular Dystrophy,35,60,4,1,5
Maharashtra,Nagpur,Muscular Dystrophy,60,80,0,1,1
Rajasthan,Nagaur,Muscular Dystrophy,0,6,1,0,1
Rajasthan,Nagaur,Muscular Dystrophy,6,15,9,5,14
Rajasthan,Nagaur,Muscular Dystrophy,15,35,15,13,28
Rajasthan,Nagaur,Muscular Dystrophy,35,60,23,7,30
Rajasthan,Nagaur,Muscular Dystrophy,60,80,3,1,4
Tamil Nadu,Nagapattinam,Muscular Dystrophy,6,15,15,1,16
Tamil Nadu,Nagapattinam,Muscular Dystrophy,15,35,36,9,45
Tamil Nadu,Nagapattinam,Muscular Dystrophy,35,60,20,3,23
Tamil Nadu,Nagapattinam,Muscular Dystrophy,60,80,2,0,2
Assam,Nagaon,Muscular Dystrophy,6,15,2,1,3
Assam,Nagaon,Muscular Dystrophy,15,35,3,3,6
Assam,Nagaon,Muscular Dystrophy,35,60,6,3,9
Assam,Nagaon,Muscular Dystrophy,60,80,2,1,3
Odisha,Nabarangpur,Muscular Dystrophy,0,6,1,0,1
Odisha,Nabarangpur,Muscular Dystrophy,6,15,5,4,9
Odisha,Nabarangpur,Muscular Dystrophy,15,35,4,4,8
Odisha,Nabarangpur,Muscular Dystrophy,35,60,5,0,5
Odisha,Nabarangpur,Muscular Dystrophy,60,80,2,0,2
Karnataka,Mysuru,Muscular Dystrophy,0,6,3,0,3
Karnataka,Mysuru,Muscular Dystrophy,6,15,16,4,20
Karnataka,Mysuru,Muscular Dystrophy,15,35,30,8,38
Karnataka,Mysuru,Muscular Dystrophy,35,60,38,13,51
Karnataka,Mysuru,Muscular Dystrophy,60,80,15,3,18
Bihar,Muzaffarpur,Muscular Dystrophy,0,6,1,0,1
Bihar,Muzaffarpur,Muscular Dystrophy,6,15,40,4,44
Bihar,Muzaffarpur,Muscular Dystrophy,15,35,56,17,73
Bihar,Muzaffarpur,Muscular Dystrophy,35,60,41,10,51
Bihar,Muzaffarpur,Muscular Dystrophy,60,80,6,0,6
Uttar Pradesh,Muzaffarnagar,Muscular Dystrophy,6,15,4,0,4
Uttar Pradesh,Muzaffarnagar,Muscular Dystrophy,15,35,45,17,62
Uttar Pradesh,Muzaffarnagar,Muscular Dystrophy,35,60,58,17,75
Uttar Pradesh,Muzaffarnagar,Muscular Dystrophy,60,80,10,3,13
Uttar Pradesh,Muzaffarnagar,Muscular Dystrophy,80,100,1,0,1
Bihar,Munger,Muscular Dystrophy,6,15,7,4,11
Bihar,Munger,Muscular Dystrophy,15,35,21,12,33
Bihar,Munger,Muscular Dystrophy,35,60,38,4,42
Bihar,Munger,Muscular Dystrophy,60,80,7,1,8
Chhattisgarh,Mungeli,Muscular Dystrophy,15,35,1,0,1
Maharashtra,Mumbai Suburban,Muscular Dystrophy,0,6,0,1,1
Maharashtra,Mumbai Suburban,Muscular Dystrophy,6,15,18,5,23
Maharashtra,Mumbai Suburban,Muscular Dystrophy,15,35,11,1,12
Maharashtra,Mumbai Suburban,Muscular Dystrophy,35,60,4,2,6
Maharashtra,Mumbai Suburban,Muscular Dystrophy,60,80,1,0,1
Maharashtra,Mumbai,Muscular Dystrophy,6,15,16,1,17
Maharashtra,Mumbai,Muscular Dystrophy,15,35,30,12,42
Maharashtra,Mumbai,Muscular Dystrophy,35,60,44,19,63
Maharashtra,Mumbai,Muscular Dystrophy,60,80,18,7,25
Madhya Pradesh,Morena,Muscular Dystrophy,6,15,17,4,21
Madhya Pradesh,Morena,Muscular Dystrophy,15,35,25,6,31
Madhya Pradesh,Morena,Muscular Dystrophy,35,60,12,0,12
Madhya Pradesh,Morena,Muscular Dystrophy,60,80,1,0,1
Gujarat,Morbi,Muscular Dystrophy,35,60,1,0,1
Uttar Pradesh,Moradabad,Muscular Dystrophy,0,6,0,2,2
Uttar Pradesh,Moradabad,Muscular Dystrophy,6,15,12,2,14
Uttar Pradesh,Moradabad,Muscular Dystrophy,15,35,77,21,98
Uttar Pradesh,Moradabad,Muscular Dystrophy,35,60,71,19,90
Uttar Pradesh,Moradabad,Muscular Dystrophy,60,80,19,2,21
Nagaland,Mon,Muscular Dystrophy,6,15,3,2,5
Nagaland,Mon,Muscular Dystrophy,15,35,11,6,17
Nagaland,Mon,Muscular Dystrophy,35,60,14,2,16
Nagaland,Mon,Muscular Dystrophy,60,80,5,0,5
Nagaland,Mon,Muscular Dystrophy,80,100,1,1,2
Nagaland,Mokokchung,Muscular Dystrophy,6,15,1,0,1
Nagaland,Mokokchung,Muscular Dystrophy,15,35,1,1,2
Nagaland,Mokokchung,Muscular Dystrophy,35,60,0,3,3
Punjab,Moga,Muscular Dystrophy,0,6,1,0,1
Punjab,Moga,Muscular Dystrophy,6,15,6,0,6
Punjab,Moga,Muscular Dystrophy,15,35,31,7,38
Punjab,Moga,Muscular Dystrophy,35,60,36,20,56
Punjab,Moga,Muscular Dystrophy,60,80,10,2,12
Uttar Pradesh,Mirzapur,Muscular Dystrophy,0,6,1,0,1
Uttar Pradesh,Mirzapur,Muscular Dystrophy,6,15,1,0,1
Uttar Pradesh,Mirzapur,Muscular Dystrophy,15,35,94,28,122
Uttar Pradesh,Mirzapur,Muscular Dystrophy,35,60,114,28,142
Uttar Pradesh,Mirzapur,Muscular Dystrophy,60,80,28,2,30
Uttar Pradesh,Mirzapur,Muscular Dystrophy,80,100,1,1,2
Uttar Pradesh,Meerut,Muscular Dystrophy,6,15,11,1,12
Uttar Pradesh,Meerut,Muscular Dystrophy,15,35,61,17,78
Uttar Pradesh,Meerut,Muscular Dystrophy,35,60,61,8,69
Uttar Pradesh,Meerut,Muscular Dystrophy,60,80,8,0,8
Uttar Pradesh,Meerut,Muscular Dystrophy,80,100,1,0,1
Odisha,Mayurbhanj,Muscular Dystrophy,0,6,1,1,2
Odisha,Mayurbhanj,Muscular Dystrophy,6,15,12,2,14
Odisha,Mayurbhanj,Muscular Dystrophy,15,35,7,2,9
Odisha,Mayurbhanj,Muscular Dystrophy,35,60,4,1,5
Odisha,Mayurbhanj,Muscular Dystrophy,60,80,2,0,2
Tamil Nadu,Mayiladuthurai,Muscular Dystrophy,6,15,6,1,7
Tamil Nadu,Mayiladuthurai,Muscular Dystrophy,15,35,8,2,10
Tamil Nadu,Mayiladuthurai,Muscular Dystrophy,35,60,6,1,7
Uttar Pradesh,Mau,Muscular Dystrophy,6,15,7,7,14
Uttar Pradesh,Mau,Muscular Dystrophy,15,35,172,62,234
Uttar Pradesh,Mau,Muscular Dystrophy,35,60,213,42,255
Uttar Pradesh,Mau,Muscular Dystrophy,60,80,59,5,64
Uttar Pradesh,Mau,Muscular Dystrophy,80,100,2,0,2
Uttar Pradesh,Mathura,Muscular Dystrophy,0,6,2,0,2
Uttar Pradesh,Mathura,Muscular Dystrophy,6,15,9,2,11
Uttar Pradesh,Mathura,Muscular Dystrophy,15,35,10,1,11
Uttar Pradesh,Mathura,Muscular Dystrophy,35,60,14,2,16
Uttar Pradesh,Mathura,Muscular Dystrophy,60,80,4,1,5
Assam,Marigaon,Muscular Dystrophy,15,35,2,2,4
Assam,Marigaon,Muscular Dystrophy,35,60,3,1,4
Punjab,Mansa,Muscular Dystrophy,6,15,4,1,5
Punjab,Mansa,Muscular Dystrophy,15,35,28,15,43
Punjab,Mansa,Muscular Dystrophy,35,60,75,28,103
Punjab,Mansa,Muscular Dystrophy,60,80,23,3,26
Punjab,Mansa,Muscular Dystrophy,80,100,2,0,2
Karnataka,Mandya,Muscular Dystrophy,0,6,1,1,2
Karnataka,Mandya,Muscular Dystrophy,6,15,30,1,31
Karnataka,Mandya,Muscular Dystrophy,15,35,27,7,34
Karnataka,Mandya,Muscular Dystrophy,35,60,22,14,36
Karnataka,Mandya,Muscular Dystrophy,60,80,3,0,3
Madhya Pradesh,Mandsaur,Muscular Dystrophy,6,15,14,4,18
Madhya Pradesh,Mandsaur,Muscular Dystrophy,15,35,58,31,89
Madhya Pradesh,Mandsaur,Muscular Dystrophy,35,60,103,34,137
Madhya Pradesh,Mandsaur,Muscular Dystrophy,60,80,51,19,70
Madhya Pradesh,Mandsaur,Muscular Dystrophy,80,100,9,0,9
Madhya Pradesh,Mandla,Muscular Dystrophy,6,15,7,4,11
Madhya Pradesh,Mandla,Muscular Dystrophy,15,35,9,4,13
Madhya Pradesh,Mandla,Muscular Dystrophy,35,60,5,3,8
Madhya Pradesh,Mandla,Muscular Dystrophy,60,80,1,0,1
Himachal Pradesh,Mandi,Muscular Dystrophy,0,6,1,0,1
Himachal Pradesh,Mandi,Muscular Dystrophy,6,15,15,5,20
Himachal Pradesh,Mandi,Muscular Dystrophy,15,35,16,9,25
Himachal Pradesh,Mandi,Muscular Dystrophy,35,60,27,17,44
Himachal Pradesh,Mandi,Muscular Dystrophy,60,80,6,4,10
Himachal Pradesh,Mandi,Muscular Dystrophy,80,100,2,0,2
Odisha,Malkangiri,Muscular Dystrophy,0,6,0,1,1
Odisha,Malkangiri,Muscular Dystrophy,6,15,1,0,1
Odisha,Malkangiri,Muscular Dystrophy,35,60,4,1,5
Odisha,Malkangiri,Muscular Dystrophy,60,80,0,1,1
Punjab,Malerkotla,Muscular Dystrophy,6,15,2,0,2
Punjab,Malerkotla,Muscular Dystrophy,15,35,1,0,1
Punjab,Malerkotla,Muscular Dystrophy,35,60,1,1,2
Kerala,Malappuram,Muscular Dystrophy,0,6,3,0,3
Kerala,Malappuram,Muscular Dystrophy,6,15,30,3,33
Kerala,Malappuram,Muscular Dystrophy,15,35,33,17,50
Kerala,Malappuram,Muscular Dystrophy,35,60,61,35,96
Kerala,Malappuram,Muscular Dystrophy,60,80,19,6,25
Kerala,Malappuram,Muscular Dystrophy,80,100,1,1,2
Assam,Majuli,Muscular Dystrophy,15,35,3,1,4
Assam,Majuli,Muscular Dystrophy,35,60,1,2,3
Assam,Majuli,Muscular Dystrophy,60,80,0,1,1
Uttar Pradesh,Mainpuri,Muscular Dystrophy,6,15,13,9,22
Uttar Pradesh,Mainpuri,Muscular Dystrophy,15,35,122,38,160
Uttar Pradesh,Mainpuri,Muscular Dystrophy,35,60,82,19,101
Uttar Pradesh,Mainpuri,Muscular Dystrophy,60,80,27,6,33
Uttar Pradesh,Mainpuri,Muscular Dystrophy,80,100,1,1,2
Uttar Pradesh,Mahoba,Muscular Dystrophy,6,15,3,1,4
Uttar Pradesh,Mahoba,Muscular Dystrophy,15,35,58,13,71
Uttar Pradesh,Mahoba,Muscular Dystrophy,35,60,87,20,107
Uttar Pradesh,Mahoba,Muscular Dystrophy,60,80,21,9,30
Gujarat,Mahisagar,Muscular Dystrophy,6,15,1,0,1
Gujarat,Mahesana,Muscular Dystrophy,0,6,1,0,1
Gujarat,Mahesana,Muscular Dystrophy,6,15,3,2,5
Gujarat,Mahesana,Muscular Dystrophy,15,35,3,0,3
Haryana,Mahendragarh,Muscular Dystrophy,15,35,5,1,6
Haryana,Mahendragarh,Muscular Dystrophy,35,60,18,4,22
Haryana,Mahendragarh,Muscular Dystrophy,60,80,5,1,6
Puducherry,Mahe,Muscular Dystrophy,6,15,0,1,1
Puducherry,Mahe,Muscular Dystrophy,15,35,0,1,1
Puducherry,Mahe,Muscular Dystrophy,35,60,1,0,1
Chhattisgarh,Mahasamund,Muscular Dystrophy,6,15,1,0,1
Chhattisgarh,Mahasamund,Muscular Dystrophy,15,35,8,6,14
Chhattisgarh,Mahasamund,Muscular Dystrophy,35,60,2,0,2
Uttar Pradesh,Maharajganj,Muscular Dystrophy,6,15,7,0,7
Uttar Pradesh,Maharajganj,Muscular Dystrophy,15,35,24,11,35
Uttar Pradesh,Maharajganj,Muscular Dystrophy,35,60,20,4,24
Uttar Pradesh,Maharajganj,Muscular Dystrophy,60,80,2,0,2
Telangana,Mahabubabad,Muscular Dystrophy,15,35,2,0,2
Telangana,Mahabubabad,Muscular Dystrophy,35,60,0,1,1
Tamil Nadu,Madurai,Muscular Dystrophy,0,6,1,2,3
Tamil Nadu,Madurai,Muscular Dystrophy,6,15,30,11,41
Tamil Nadu,Madurai,Muscular Dystrophy,15,35,55,19,74
Tamil Nadu,Madurai,Muscular Dystrophy,35,60,33,21,54
Tamil Nadu,Madurai,Muscular Dystrophy,60,80,3,1,4
Bihar,Madhubani,Muscular Dystrophy,0,6,1,0,1
Bihar,Madhubani,Muscular Dystrophy,6,15,7,3,10
Bihar,Madhubani,Muscular Dystrophy,15,35,52,12,64
Bihar,Madhubani,Muscular Dystrophy,35,60,35,12,47
Bihar,Madhubani,Muscular Dystrophy,60,80,17,2,19
Bihar,Madhepura,Muscular Dystrophy,0,6,1,2,3
Bihar,Madhepura,Muscular Dystrophy,6,15,13,6,19
Bihar,Madhepura,Muscular Dystrophy,15,35,36,14,50
Bihar,Madhepura,Muscular Dystrophy,35,60,29,7,36
Bihar,Madhepura,Muscular Dystrophy,60,80,11,4,15
Punjab,Ludhiana,Muscular Dystrophy,0,6,2,3,5
Punjab,Ludhiana,Muscular Dystrophy,6,15,55,23,78
Punjab,Ludhiana,Muscular Dystrophy,15,35,354,205,559
Punjab,Ludhiana,Muscular Dystrophy,35,60,864,506,1370
Punjab,Ludhiana,Muscular Dystrophy,60,80,238,85,323
Punjab,Ludhiana,Muscular Dystrophy,80,100,16,7,23
Uttar Pradesh,Lucknow,Muscular Dystrophy,0,6,1,0,1
Uttar Pradesh,Lucknow,Muscular Dystrophy,6,15,20,9,29
Uttar Pradesh,Lucknow,Muscular Dystrophy,15,35,142,46,188
Uttar Pradesh,Lucknow,Muscular Dystrophy,35,60,270,70,340
Uttar Pradesh,Lucknow,Muscular Dystrophy,60,80,68,12,80
Arunachal Pradesh,Lower Subansiri,Muscular Dystrophy,15,35,4,0,4
Arunachal Pradesh,Lower Dibang Valley,Muscular Dystrophy,15,35,0,1,1
Arunachal Pradesh,Lower Dibang Valley,Muscular Dystrophy,35,60,1,1,2
Arunachal Pradesh,Longding,Muscular Dystrophy,15,35,2,0,2
Jharkhand,Lohardaga,Muscular Dystrophy,6,15,5,2,7
Jharkhand,Lohardaga,Muscular Dystrophy,15,35,9,6,15
Jharkhand,Lohardaga,Muscular Dystrophy,35,60,14,3,17
Jharkhand,Lohardaga,Muscular Dystrophy,60,80,2,2,4
Jharkhand,Lohardaga,Muscular Dystrophy,80,100,1,0,1
Ladakh,Leh Ladakh,Muscular Dystrophy,6,15,1,0,1
Ladakh,Leh Ladakh,Muscular Dystrophy,15,35,2,0,2
Ladakh,Leh Ladakh,Muscular Dystrophy,35,60,1,1,2
Maharashtra,Latur,Muscular Dystrophy,0,6,2,0,2
Maharashtra,Latur,Muscular Dystrophy,6,15,24,6,30
Maharashtra,Latur,Muscular Dystrophy,15,35,59,20,79
Maharashtra,Latur,Muscular Dystrophy,35,60,111,28,139
Maharashtra,Latur,Muscular Dystrophy,60,80,36,6,42
Maharashtra,Latur,Muscular Dystrophy,80,100,7,1,8
Jharkhand,Latehar,Muscular Dystrophy,6,15,4,0,4
Jharkhand,Latehar,Muscular Dystrophy,15,35,4,1,5
Jharkhand,Latehar,Muscular Dystrophy,35,60,4,0,4
Jharkhand,Latehar,Muscular Dystrophy,60,80,1,0,1
Uttar Pradesh,Lalitpur,Muscular Dystrophy,6,15,2,1,3
Uttar Pradesh,Lalitpur,Muscular Dystrophy,15,35,16,5,21
Uttar Pradesh,Lalitpur,Muscular Dystrophy,35,60,35,12,47
Uttar Pradesh,Lalitpur,Muscular Dystrophy,60,80,7,0,7
Bihar,Lakhisarai,Muscular Dystrophy,6,15,3,2,5
Bihar,Lakhisarai,Muscular Dystrophy,15,35,8,5,13
Bihar,Lakhisarai,Muscular Dystrophy,35,60,23,4,27
Bihar,Lakhisarai,Muscular Dystrophy,60,80,0,2,2
Assam,Lakhimpur,Muscular Dystrophy,0,6,1,0,1
Assam,Lakhimpur,Muscular Dystrophy,6,15,10,2,12
Assam,Lakhimpur,Muscular Dystrophy,15,35,8,2,10
Assam,Lakhimpur,Muscular Dystrophy,35,60,9,3,12
Assam,Lakhimpur,Muscular Dystrophy,60,80,1,0,1
Uttar Pradesh,Kushi Nagar,Muscular Dystrophy,6,15,1,3,4
Uttar Pradesh,Kushi Nagar,Muscular Dystrophy,15,35,40,10,50
Uttar Pradesh,Kushi Nagar,Muscular Dystrophy,35,60,40,8,48
Uttar Pradesh,Kushi Nagar,Muscular Dystrophy,60,80,6,2,8
Arunachal Pradesh,Kurung Kumey,Muscular Dystrophy,15,35,1,0,1
Haryana,Kurukshetra,Muscular Dystrophy,0,6,1,0,1
Haryana,Kurukshetra,Muscular Dystrophy,6,15,8,2,10
Haryana,Kurukshetra,Muscular Dystrophy,15,35,16,1,17
Haryana,Kurukshetra,Muscular Dystrophy,35,60,11,0,11
Haryana,Kurukshetra,Muscular Dystrophy,60,80,2,0,2
Andhra Pradesh,Kurnool,Muscular Dystrophy,15,35,3,0,3
Andhra Pradesh,Kurnool,Muscular Dystrophy,35,60,4,2,6
Andhra Pradesh,Kurnool,Muscular Dystrophy,60,80,1,0,1
Jammu And Kashmir,Kupwara,Muscular Dystrophy,0,6,1,1,2
Jammu And Kashmir,Kupwara,Muscular Dystrophy,6,15,16,3,19
Jammu And Kashmir,Kupwara,Muscular Dystrophy,15,35,18,10,28
Jammu And Kashmir,Kupwara,Muscular Dystrophy,35,60,25,9,34
Jammu And Kashmir,Kupwara,Muscular Dystrophy,60,80,4,0,4
Himachal Pradesh,Kullu,Muscular Dystrophy,0,6,1,0,1
Himachal Pradesh,Kullu,Muscular Dystrophy,15,35,1,2,3
Himachal Pradesh,Kullu,Muscular Dystrophy,35,60,1,0,1
Himachal Pradesh,Kullu,Muscular Dystrophy,60,80,0,1,1
Jammu And Kashmir,Kulgam,Muscular Dystrophy,0,6,1,1,2
Jammu And Kashmir,Kulgam,Muscular Dystrophy,6,15,6,0,6
Jammu And Kashmir,Kulgam,Muscular Dystrophy,15,35,3,3,6
Jammu And Kashmir,Kulgam,Muscular Dystrophy,35,60,2,0,2
Jammu And Kashmir,Kulgam,Muscular Dystrophy,60,80,1,0,1
Tamil Nadu,Krishnagiri,Muscular Dystrophy,0,6,5,0,5
Tamil Nadu,Krishnagiri,Muscular Dystrophy,6,15,39,14,53
Tamil Nadu,Krishnagiri,Muscular Dystrophy,15,35,56,23,79
Tamil Nadu,Krishnagiri,Muscular Dystrophy,35,60,17,10,27
Tamil Nadu,Krishnagiri,Muscular Dystrophy,60,80,8,1,9
Andhra Pradesh,Krishna,Muscular Dystrophy,15,35,1,0,1
Andhra Pradesh,Krishna,Muscular Dystrophy,35,60,2,0,2
Kerala,Kozhikode,Muscular Dystrophy,0,6,1,1,2
Kerala,Kozhikode,Muscular Dystrophy,6,15,20,3,23
Kerala,Kozhikode,Muscular Dystrophy,15,35,24,5,29
Kerala,Kozhikode,Muscular Dystrophy,35,60,55,18,73
Kerala,Kozhikode,Muscular Dystrophy,60,80,8,2,10
Kerala,Kottayam,Muscular Dystrophy,6,15,3,0,3
Kerala,Kottayam,Muscular Dystrophy,15,35,20,2,22
Kerala,Kottayam,Muscular Dystrophy,35,60,15,16,31
Kerala,Kottayam,Muscular Dystrophy,60,80,5,0,5
Rajasthan,Kota,Muscular Dystrophy,6,15,3,2,5
Rajasthan,Kota,Muscular Dystrophy,15,35,4,7,11
Rajasthan,Kota,Muscular Dystrophy,35,60,8,4,12
Rajasthan,Kota,Muscular Dystrophy,60,80,1,0,1
Rajasthan,Kota,Muscular Dystrophy,80,100,0,1,1
Chhattisgarh,Korea,Muscular Dystrophy,6,15,1,1,2
Chhattisgarh,Korea,Muscular Dystrophy,15,35,4,0,4
Chhattisgarh,Korea,Muscular Dystrophy,35,60,2,0,2
Chhattisgarh,Korea,Muscular Dystrophy,60,80,1,0,1
Chhattisgarh,Korea,Muscular Dystrophy,80,100,0,1,1
Chhattisgarh,Korba,Muscular Dystrophy,6,15,2,0,2
Chhattisgarh,Korba,Muscular Dystrophy,15,35,8,3,11
Chhattisgarh,Korba,Muscular Dystrophy,35,60,5,4,9
Chhattisgarh,Korba,Muscular Dystrophy,60,80,2,0,2
Odisha,Koraput,Muscular Dystrophy,0,6,2,0,2
Odisha,Koraput,Muscular Dystrophy,15,35,2,1,3
Odisha,Koraput,Muscular Dystrophy,35,60,2,3,5
Karnataka,Koppal,Muscular Dystrophy,6,15,3,0,3
Karnataka,Koppal,Muscular Dystrophy,15,35,11,4,15
Karnataka,Koppal,Muscular Dystrophy,35,60,10,2,12
Karnataka,Koppal,Muscular Dystrophy,60,80,3,1,4
Chhattisgarh,Kondagaon,Muscular Dystrophy,6,15,1,2,3
Chhattisgarh,Kondagaon,Muscular Dystrophy,15,35,8,2,10
Chhattisgarh,Kondagaon,Muscular Dystrophy,35,60,10,4,14
Chhattisgarh,Kondagaon,Muscular Dystrophy,60,80,3,2,5
Chhattisgarh,Kondagaon,Muscular Dystrophy,80,100,1,0,1
Kerala,Kollam,Muscular Dystrophy,6,15,7,0,7
Kerala,Kollam,Muscular Dystrophy,15,35,15,5,20
Kerala,Kollam,Muscular Dystrophy,35,60,19,14,33
Kerala,Kollam,Muscular Dystrophy,60,80,11,3,14
Kerala,Kollam,Muscular Dystrophy,80,100,1,1,2
Maharashtra,Kolhapur,Muscular Dystrophy,6,15,55,1,56
Maharashtra,Kolhapur,Muscular Dystrophy,15,35,58,23,81
Maharashtra,Kolhapur,Muscular Dystrophy,35,60,58,35,93
Maharashtra,Kolhapur,Muscular Dystrophy,60,80,16,6,22
Maharashtra,Kolhapur,Muscular Dystrophy,80,100,0,1,1
Mizoram,Kolasib,Muscular Dystrophy,6,15,0,1,1
Mizoram,Kolasib,Muscular Dystrophy,15,35,2,0,2
Mizoram,Kolasib,Muscular Dystrophy,35,60,4,3,7
Karnataka,Kolar,Muscular Dystrophy,6,15,14,4,18
Karnataka,Kolar,Muscular Dystrophy,15,35,24,19,43
Karnataka,Kolar,Muscular Dystrophy,35,60,29,16,45
Karnataka,Kolar,Muscular Dystrophy,60,80,17,3,20
Karnataka,Kolar,Muscular Dystrophy,80,100,1,0,1
Assam,Kokrajhar,Muscular Dystrophy,15,35,2,2,4
Assam,Kokrajhar,Muscular Dystrophy,35,60,1,1,2
Nagaland,Kohima,Muscular Dystrophy,15,35,1,0,1
Jharkhand,Koderma,Muscular Dystrophy,6,15,4,1,5
Jharkhand,Koderma,Muscular Dystrophy,15,35,6,3,9
Jharkhand,Koderma,Muscular Dystrophy,35,60,7,3,10
Jharkhand,Koderma,Muscular Dystrophy,60,80,1,1,2
Karnataka,Kodagu,Muscular Dystrophy,6,15,3,0,3
Karnataka,Kodagu,Muscular Dystrophy,15,35,7,0,7
Karnataka,Kodagu,Muscular Dystrophy,35,60,4,4,8
Karnataka,Kodagu,Muscular Dystrophy,60,80,1,0,1
Jammu And Kashmir,Kishtwar,Muscular Dystrophy,6,15,0,2,2
Jammu And Kashmir,Kishtwar,Muscular Dystrophy,15,35,0,6,6
Jammu And Kashmir,Kishtwar,Muscular Dystrophy,35,60,9,1,10
Jammu And Kashmir,Kishtwar,Muscular Dystrophy,60,80,2,0,2
Bihar,Kishanganj,Muscular Dystrophy,6,15,3,2,5
Bihar,Kishanganj,Muscular Dystrophy,15,35,16,9,25
Bihar,Kishanganj,Muscular Dystrophy,35,60,6,1,7
Himachal Pradesh,Kinnaur,Muscular Dystrophy,35,60,1,0,1
Jharkhand,Khunti,Muscular Dystrophy,6,15,5,7,12
Jharkhand,Khunti,Muscular Dystrophy,15,35,29,20,49
Jharkhand,Khunti,Muscular Dystrophy,35,60,40,13,53
Jharkhand,Khunti,Muscular Dystrophy,60,80,16,6,22
Jharkhand,Khunti,Muscular Dystrophy,80,100,1,0,1
Odisha,Khordha,Muscular Dystrophy,0,6,1,1,2
Odisha,Khordha,Muscular Dystrophy,6,15,3,5,8
Odisha,Khordha,Muscular Dystrophy,15,35,23,14,37
Odisha,Khordha,Muscular Dystrophy,35,60,47,19,66
Odisha,Khordha,Muscular Dystrophy,60,80,18,3,21
Uttar Pradesh,Kheri,Muscular Dystrophy,6,15,8,3,11
Uttar Pradesh,Kheri,Muscular Dystrophy,15,35,185,62,247
Uttar Pradesh,Kheri,Muscular Dystrophy,35,60,172,66,238
Uttar Pradesh,Kheri,Muscular Dystrophy,60,80,33,7,40
Uttar Pradesh,Kheri,Muscular Dystrophy,80,100,2,0,2
Gujarat,Kheda,Muscular Dystrophy,35,60,1,1,2
Madhya Pradesh,Khargone,Muscular Dystrophy,6,15,11,4,15
Madhya Pradesh,Khargone,Muscular Dystrophy,15,35,10,2,12
Madhya Pradesh,Khargone,Muscular Dystrophy,35,60,10,2,12
Bihar,Khagaria,Muscular Dystrophy,6,15,1,0,1
Bihar,Khagaria,Muscular Dystrophy,15,35,21,4,25
Bihar,Khagaria,Muscular Dystrophy,35,60,21,7,28
Bihar,Khagaria,Muscular Dystrophy,60,80,7,1,8
Odisha,Kendujhar,Muscular Dystrophy,6,15,18,3,21
Odisha,Kendujhar,Muscular Dystrophy,15,35,22,7,29
Odisha,Kendujhar,Muscular Dystrophy,35,60,18,2,20
Odisha,Kendujhar,Muscular Dystrophy,60,80,2,0,2
Odisha,Kendrapara,Muscular Dystrophy,6,15,1,1,2
Odisha,Kendrapara,Muscular Dystrophy,15,35,0,2,2
Odisha,Kendrapara,Muscular Dystrophy,35,60,3,5,8
Odisha,Kendrapara,Muscular Dystrophy,60,80,4,0,4
Uttar Pradesh,Kaushambi,Muscular Dystrophy,0,6,2,1,3
Uttar Pradesh,Kaushambi,Muscular Dystrophy,6,15,26,12,38
Uttar Pradesh,Kaushambi,Muscular Dystrophy,15,35,272,67,339
Uttar Pradesh,Kaushambi,Muscular Dystrophy,35,60,341,51,392
Uttar Pradesh,Kaushambi,Muscular Dystrophy,60,80,85,13,98
Uttar Pradesh,Kaushambi,Muscular Dystrophy,80,100,6,0,6
Madhya Pradesh,Katni,Muscular Dystrophy,6,15,3,0,3
Madhya Pradesh,Katni,Muscular Dystrophy,15,35,11,1,12
Madhya Pradesh,Katni,Muscular Dystrophy,35,60,2,1,3
Bihar,Katihar,Muscular Dystrophy,6,15,3,2,5
Bihar,Katihar,Muscular Dystrophy,15,35,19,7,26
Bihar,Katihar,Muscular Dystrophy,35,60,10,4,14
Bihar,Katihar,Muscular Dystrophy,60,80,5,0,5
Jammu And Kashmir,Kathua,Muscular Dystrophy,0,6,2,3,5
Jammu And Kashmir,Kathua,Muscular Dystrophy,6,15,15,10,25
Jammu And Kashmir,Kathua,Muscular Dystrophy,15,35,50,21,71
Jammu And Kashmir,Kathua,Muscular Dystrophy,35,60,84,40,124
Jammu And Kashmir,Kathua,Muscular Dystrophy,60,80,15,5,20
Jammu And Kashmir,Kathua,Muscular Dystrophy,80,100,0,2,2
Uttar Pradesh,Kasganj,Muscular Dystrophy,0,6,1,1,2
Uttar Pradesh,Kasganj,Muscular Dystrophy,6,15,5,1,6
Uttar Pradesh,Kasganj,Muscular Dystrophy,15,35,97,28,125
Uttar Pradesh,Kasganj,Muscular Dystrophy,35,60,124,21,145
Uttar Pradesh,Kasganj,Muscular Dystrophy,60,80,26,3,29
Uttar Pradesh,Kasganj,Muscular Dystrophy,80,100,1,0,1
Kerala,Kasaragod,Muscular Dystrophy,0,6,1,0,1
Kerala,Kasaragod,Muscular Dystrophy,6,15,7,0,7
Kerala,Kasaragod,Muscular Dystrophy,15,35,10,3,13
Kerala,Kasaragod,Muscular Dystrophy,35,60,16,6,22
Kerala,Kasaragod,Muscular Dystrophy,60,80,1,2,3
Tamil Nadu,Karur,Muscular Dystrophy,0,6,0,2,2
Tamil Nadu,Karur,Muscular Dystrophy,6,15,24,7,31
Tamil Nadu,Karur,Muscular Dystrophy,15,35,34,8,42
Tamil Nadu,Karur,Muscular Dystrophy,35,60,15,6,21
Tamil Nadu,Karur,Muscular Dystrophy,60,80,2,3,5
Haryana,Karnal,Muscular Dystrophy,0,6,1,1,2
Haryana,Karnal,Muscular Dystrophy,6,15,15,1,16
Haryana,Karnal,Muscular Dystrophy,15,35,25,1,26
Haryana,Karnal,Muscular Dystrophy,35,60,16,6,22
Haryana,Karnal,Muscular Dystrophy,60,80,2,2,4
Haryana,Karnal,Muscular Dystrophy,80,100,1,0,1
Assam,Karimganj,Muscular Dystrophy,6,15,0,1,1
Assam,Karimganj,Muscular Dystrophy,15,35,9,2,11
Assam,Karimganj,Muscular Dystrophy,35,60,2,1,3
Assam,Karimganj,Muscular Dystrophy,60,80,1,0,1
Assam,Karimganj,Muscular Dystrophy,80,100,1,0,1
Ladakh,Kargil,Muscular Dystrophy,6,15,1,0,1
Ladakh,Kargil,Muscular Dystrophy,35,60,1,1,2
Rajasthan,Karauli,Muscular Dystrophy,6,15,3,1,4
Rajasthan,Karauli,Muscular Dystrophy,15,35,4,4,8
Rajasthan,Karauli,Muscular Dystrophy,35,60,3,1,4
Rajasthan,Karauli,Muscular Dystrophy,60,80,2,0,2
Puducherry,Karaikal,Muscular Dystrophy,35,60,1,0,1
Punjab,Kapurthala,Muscular Dystrophy,6,15,5,1,6
Punjab,Kapurthala,Muscular Dystrophy,15,35,18,6,24
Punjab,Kapurthala,Muscular Dystrophy,35,60,26,17,43
Punjab,Kapurthala,Muscular Dystrophy,60,80,9,2,11
Uttar Pradesh,Kanpur Nagar,Muscular Dystrophy,6,15,4,1,5
Uttar Pradesh,Kanpur Nagar,Muscular Dystrophy,15,35,53,20,73
Uttar Pradesh,Kanpur Nagar,Muscular Dystrophy,35,60,132,30,162
Uttar Pradesh,Kanpur Nagar,Muscular Dystrophy,60,80,29,8,37
Uttar Pradesh,Kanpur Dehat,Muscular Dystrophy,0,6,5,0,5
Uttar Pradesh,Kanpur Dehat,Muscular Dystrophy,6,15,8,1,9
Uttar Pradesh,Kanpur Dehat,Muscular Dystrophy,15,35,30,7,37
Uttar Pradesh,Kanpur Dehat,Muscular Dystrophy,35,60,33,1,34
Uttar Pradesh,Kanpur Dehat,Muscular Dystrophy,60,80,4,0,4
Kerala,Kannur,Muscular Dystrophy,0,6,2,0,2
Kerala,Kannur,Muscular Dystrophy,6,15,10,1,11
Kerala,Kannur,Muscular Dystrophy,15,35,22,7,29
Kerala,Kannur,Muscular Dystrophy,35,60,32,15,47
Kerala,Kannur,Muscular Dystrophy,60,80,5,0,5
Tamil Nadu,Kanniyakumari,Muscular Dystrophy,0,6,1,0,1
Tamil Nadu,Kanniyakumari,Muscular Dystrophy,6,15,13,4,17
Tamil Nadu,Kanniyakumari,Muscular Dystrophy,15,35,20,5,25
Tamil Nadu,Kanniyakumari,Muscular Dystrophy,35,60,9,4,13
Uttar Pradesh,Kannauj,Muscular Dystrophy,6,15,3,0,3
Uttar Pradesh,Kannauj,Muscular Dystrophy,15,35,12,0,12
Uttar Pradesh,Kannauj,Muscular Dystrophy,35,60,10,2,12
Uttar Pradesh,Kannauj,Muscular Dystrophy,60,80,2,2,4
Chhattisgarh,Kanker,Muscular Dystrophy,6,15,15,7,22
Chhattisgarh,Kanker,Muscular Dystrophy,15,35,41,21,62
Chhattisgarh,Kanker,Muscular Dystrophy,35,60,44,12,56
Chhattisgarh,Kanker,Muscular Dystrophy,60,80,13,6,19
Himachal Pradesh,Kangra,Muscular Dystrophy,0,6,1,0,1
Himachal Pradesh,Kangra,Muscular Dystrophy,6,15,25,3,28
Himachal Pradesh,Kangra,Muscular Dystrophy,15,35,20,12,32
Himachal Pradesh,Kangra,Muscular Dystrophy,35,60,43,11,54
Himachal Pradesh,Kangra,Muscular Dystrophy,60,80,9,2,11
Himachal Pradesh,Kangra,Muscular Dystrophy,80,100,1,0,1
Manipur,Kangpokpi,Muscular Dystrophy,15,35,1,0,1
Odisha,Kandhamal,Muscular Dystrophy,6,15,2,2,4
Odisha,Kandhamal,Muscular Dystrophy,15,35,1,1,2
Odisha,Kandhamal,Muscular Dystrophy,35,60,1,3,4
Tamil Nadu,Kanchipuram,Muscular Dystrophy,6,15,18,3,21
Tamil Nadu,Kanchipuram,Muscular Dystrophy,15,35,18,6,24
Tamil Nadu,Kanchipuram,Muscular Dystrophy,35,60,11,5,16
Tamil Nadu,Kanchipuram,Muscular Dystrophy,60,80,3,0,3
Assam,Kamrup Metro,Muscular Dystrophy,15,35,0,1,1
Assam,Kamrup Metro,Muscular Dystrophy,35,60,2,0,2
Assam,Kamrup,Muscular Dystrophy,15,35,0,1,1
Assam,Kamrup,Muscular Dystrophy,35,60,1,0,1
Arunachal Pradesh,Kamle,Muscular Dystrophy,15,35,1,0,1
Manipur,Kamjong,Muscular Dystrophy,15,35,1,0,1
Tamil Nadu,Kallakurichi,Muscular Dystrophy,0,6,1,0,1
Tamil Nadu,Kallakurichi,Muscular Dystrophy,6,15,13,3,16
Tamil Nadu,Kallakurichi,Muscular Dystrophy,15,35,10,4,14
Tamil Nadu,Kallakurichi,Muscular Dystrophy,35,60,7,3,10
Tamil Nadu,Kallakurichi,Muscular Dystrophy,60,80,1,1,2
Odisha,Kalahandi,Muscular Dystrophy,15,35,2,0,2
Odisha,Kalahandi,Muscular Dystrophy,35,60,4,1,5
Odisha,Kalahandi,Muscular Dystrophy,60,80,1,0,1
Karnataka,Kalaburagi,Muscular Dystrophy,0,6,1,2,3
Karnataka,Kalaburagi,Muscular Dystrophy,6,15,15,1,16
Karnataka,Kalaburagi,Muscular Dystrophy,15,35,20,7,27
Karnataka,Kalaburagi,Muscular Dystrophy,35,60,26,6,32
Karnataka,Kalaburagi,Muscular Dystrophy,60,80,10,1,11
Karnataka,Kalaburagi,Muscular Dystrophy,80,100,1,0,1
Manipur,Kakching,Muscular Dystrophy,15,35,1,0,1
Haryana,Kaithal,Muscular Dystrophy,6,15,1,1,2
Haryana,Kaithal,Muscular Dystrophy,15,35,4,0,4
Haryana,Kaithal,Muscular Dystrophy,35,60,14,1,15
Haryana,Kaithal,Muscular Dystrophy,60,80,3,1,4
Bihar,Kaimur (Bhabua),Muscular Dystrophy,0,6,3,3,6
Bihar,Kaimur (Bhabua),Muscular Dystrophy,6,15,17,10,27
Bihar,Kaimur (Bhabua),Muscular Dystrophy,15,35,63,30,93
Bihar,Kaimur (Bhabua),Muscular Dystrophy,35,60,54,20,74
Bihar,Kaimur (Bhabua),Muscular Dystrophy,60,80,12,1,13
Bihar,Kaimur (Bhabua),Muscular Dystrophy,80,100,2,0,2
Gujarat,Kachchh,Muscular Dystrophy,0,6,1,0,1
Gujarat,Kachchh,Muscular Dystrophy,6,15,4,0,4
Gujarat,Kachchh,Muscular Dystrophy,15,35,5,1,6
Gujarat,Kachchh,Muscular Dystrophy,35,60,2,1,3
Gujarat,Kachchh,Muscular Dystrophy,60,80,0,1,1
Gujarat,Junagadh,Muscular Dystrophy,0,6,1,1,2
Gujarat,Junagadh,Muscular Dystrophy,6,15,2,2,4
Gujarat,Junagadh,Muscular Dystrophy,15,35,4,8,12
Gujarat,Junagadh,Muscular Dystrophy,35,60,18,4,22
Gujarat,Junagadh,Muscular Dystrophy,60,80,4,2,6
Assam,Jorhat,Muscular Dystrophy,6,15,1,1,2
Assam,Jorhat,Muscular Dystrophy,15,35,10,1,11
Assam,Jorhat,Muscular Dystrophy,35,60,4,0,4
Assam,Jorhat,Muscular Dystrophy,60,80,1,0,1
Rajasthan,Jodhpur,Muscular Dystrophy,6,15,8,8,16
Rajasthan,Jodhpur,Muscular Dystrophy,15,35,32,11,43
Rajasthan,Jodhpur,Muscular Dystrophy,35,60,37,14,51
Rajasthan,Jodhpur,Muscular Dystrophy,60,80,8,2,10
Haryana,Jind,Muscular Dystrophy,6,15,2,0,2
Haryana,Jind,Muscular Dystrophy,15,35,4,2,6
Haryana,Jind,Muscular Dystrophy,35,60,6,2,8
Haryana,Jind,Muscular Dystrophy,60,80,1,0,1
Rajasthan,Jhunjhunu,Muscular Dystrophy,0,6,1,0,1
Rajasthan,Jhunjhunu,Muscular Dystrophy,6,15,6,2,8
Rajasthan,Jhunjhunu,Muscular Dystrophy,15,35,23,7,30
Rajasthan,Jhunjhunu,Muscular Dystrophy,35,60,15,6,21
Rajasthan,Jhunjhunu,Muscular Dystrophy,60,80,6,2,8
Odisha,Jharsuguda,Muscular Dystrophy,0,6,1,0,1
Odisha,Jharsuguda,Muscular Dystrophy,6,15,4,0,4
Odisha,Jharsuguda,Muscular Dystrophy,15,35,8,2,10
Odisha,Jharsuguda,Muscular Dystrophy,35,60,6,5,11
Odisha,Jharsuguda,Muscular Dystrophy,60,80,1,0,1
Uttar Pradesh,Jhansi,Muscular Dystrophy,0,6,0,1,1
Uttar Pradesh,Jhansi,Muscular Dystrophy,6,15,11,1,12
Uttar Pradesh,Jhansi,Muscular Dystrophy,15,35,38,12,50
Uttar Pradesh,Jhansi,Muscular Dystrophy,35,60,63,16,79
Uttar Pradesh,Jhansi,Muscular Dystrophy,60,80,17,1,18
Uttar Pradesh,Jhansi,Muscular Dystrophy,80,100,1,0,1
Rajasthan,Jhalawar,Muscular Dystrophy,0,6,0,1,1
Rajasthan,Jhalawar,Muscular Dystrophy,6,15,6,2,8
Rajasthan,Jhalawar,Muscular Dystrophy,15,35,12,7,19
Rajasthan,Jhalawar,Muscular Dystrophy,35,60,10,6,16
Rajasthan,Jhalawar,Muscular Dystrophy,60,80,3,1,4
Haryana,Jhajjar,Muscular Dystrophy,0,6,1,0,1
Haryana,Jhajjar,Muscular Dystrophy,6,15,12,1,13
Haryana,Jhajjar,Muscular Dystrophy,15,35,15,6,21
Haryana,Jhajjar,Muscular Dystrophy,35,60,14,5,19
Haryana,Jhajjar,Muscular Dystrophy,60,80,1,1,2
Madhya Pradesh,Jhabua,Muscular Dystrophy,15,35,1,2,3
Madhya Pradesh,Jhabua,Muscular Dystrophy,35,60,8,0,8
Madhya Pradesh,Jhabua,Muscular Dystrophy,60,80,3,0,3
Bihar,Jehanabad,Muscular Dystrophy,15,35,9,4,13
Bihar,Jehanabad,Muscular Dystrophy,35,60,5,2,7
Bihar,Jehanabad,Muscular Dystrophy,60,80,3,0,3
Bihar,Jehanabad,Muscular Dystrophy,80,100,1,0,1
Uttar Pradesh,Jaunpur,Muscular Dystrophy,0,6,1,2,3
Uttar Pradesh,Jaunpur,Muscular Dystrophy,6,15,19,4,23
Uttar Pradesh,Jaunpur,Muscular Dystrophy,15,35,104,24,128
Uttar Pradesh,Jaunpur,Muscular Dystrophy,35,60,104,24,128
Uttar Pradesh,Jaunpur,Muscular Dystrophy,60,80,18,4,22
Uttar Pradesh,Jaunpur,Muscular Dystrophy,80,100,1,0,1
Chhattisgarh,Jashpur,Muscular Dystrophy,15,35,6,0,6
Chhattisgarh,Jashpur,Muscular Dystrophy,35,60,5,0,5
Chhattisgarh,Janjgir-Champa,Muscular Dystrophy,6,15,6,0,6
Chhattisgarh,Janjgir-Champa,Muscular Dystrophy,15,35,25,14,39
Chhattisgarh,Janjgir-Champa,Muscular Dystrophy,35,60,12,6,18
Chhattisgarh,Janjgir-Champa,Muscular Dystrophy,60,80,2,0,2
Bihar,Jamui,Muscular Dystrophy,0,6,0,1,1
Bihar,Jamui,Muscular Dystrophy,6,15,6,3,9
Bihar,Jamui,Muscular Dystrophy,15,35,27,13,40
Bihar,Jamui,Muscular Dystrophy,35,60,28,3,31
Bihar,Jamui,Muscular Dystrophy,60,80,7,1,8
Bihar,Jamui,Muscular Dystrophy,80,100,1,0,1
Jharkhand,Jamtara,Muscular Dystrophy,6,15,1,1,2
Jharkhand,Jamtara,Muscular Dystrophy,15,35,13,5,18
Jharkhand,Jamtara,Muscular Dystrophy,35,60,13,3,16
Jharkhand,Jamtara,Muscular Dystrophy,60,80,2,1,3
Jharkhand,Jamtara,Muscular Dystrophy,80,100,1,0,1
Gujarat,Jamnagar,Muscular Dystrophy,0,6,1,0,1
Gujarat,Jamnagar,Muscular Dystrophy,6,15,5,2,7
Gujarat,Jamnagar,Muscular Dystrophy,15,35,4,0,4
Gujarat,Jamnagar,Muscular Dystrophy,35,60,1,0,1
Gujarat,Jamnagar,Muscular Dystrophy,60,80,0,1,1
Jammu And Kashmir,Jammu,Muscular Dystrophy,0,6,1,0,1
Jammu And Kashmir,Jammu,Muscular Dystrophy,6,15,18,4,22
Jammu And Kashmir,Jammu,Muscular Dystrophy,15,35,37,18,55
Jammu And Kashmir,Jammu,Muscular Dystrophy,35,60,89,39,128
Jammu And Kashmir,Jammu,Muscular Dystrophy,60,80,22,5,27
Jammu And Kashmir,Jammu,Muscular Dystrophy,80,100,1,0,1
Rajasthan,Jalore,Muscular Dystrophy,6,15,11,11,22
Rajasthan,Jalore,Muscular Dystrophy,15,35,33,21,54
Rajasthan,Jalore,Muscular Dystrophy,35,60,47,22,69
Rajasthan,Jalore,Muscular Dystrophy,60,80,15,7,22
Maharashtra,Jalna,Muscular Dystrophy,6,15,3,3,6
Maharashtra,Jalna,Muscular Dystrophy,15,35,20,6,26
Maharashtra,Jalna,Muscular Dystrophy,35,60,66,12,78
Maharashtra,Jalna,Muscular Dystrophy,60,80,13,4,17
Maharashtra,Jalna,Muscular Dystrophy,80,100,1,0,1
Maharashtra,Jalgaon,Muscular Dystrophy,0,6,1,0,1
Maharashtra,Jalgaon,Muscular Dystrophy,6,15,22,3,25
Maharashtra,Jalgaon,Muscular Dystrophy,15,35,37,8,45
Maharashtra,Jalgaon,Muscular Dystrophy,35,60,46,12,58
Maharashtra,Jalgaon,Muscular Dystrophy,60,80,20,0,20
Maharashtra,Jalgaon,Muscular Dystrophy,80,100,1,0,1
Uttar Pradesh,Jalaun,Muscular Dystrophy,6,15,1,1,2
Uttar Pradesh,Jalaun,Muscular Dystrophy,15,35,100,28,128
Uttar Pradesh,Jalaun,Muscular Dystrophy,35,60,158,46,204
Uttar Pradesh,Jalaun,Muscular Dystrophy,60,80,22,9,31
Uttar Pradesh,Jalaun,Muscular Dystrophy,80,100,1,0,1
Punjab,Jalandhar,Muscular Dystrophy,0,6,2,1,3
Punjab,Jalandhar,Muscular Dystrophy,6,15,10,4,14
Punjab,Jalandhar,Muscular Dystrophy,15,35,86,21,107
Punjab,Jalandhar,Muscular Dystrophy,35,60,168,58,226
Punjab,Jalandhar,Muscular Dystrophy,60,80,30,12,42
Punjab,Jalandhar,Muscular Dystrophy,80,100,0,2,2
Odisha,Jajapur,Muscular Dystrophy,6,15,4,0,4
Odisha,Jajapur,Muscular Dystrophy,15,35,5,2,7
Odisha,Jajapur,Muscular Dystrophy,35,60,6,6,12
Odisha,Jajapur,Muscular Dystrophy,60,80,1,2,3
Rajasthan,Jaisalmer,Muscular Dystrophy,6,15,5,1,6
Rajasthan,Jaisalmer,Muscular Dystrophy,15,35,14,7,21
Rajasthan,Jaisalmer,Muscular Dystrophy,35,60,10,5,15
Rajasthan,Jaisalmer,Muscular Dystrophy,60,80,1,1,2
Rajasthan,Jaipur,Muscular Dystrophy,0,6,2,1,3
Rajasthan,Jaipur,Muscular Dystrophy,6,15,22,8,30
Rajasthan,Jaipur,Muscular Dystrophy,15,35,61,21,82
Rajasthan,Jaipur,Muscular Dystrophy,35,60,40,24,64
Rajasthan,Jaipur,Muscular Dystrophy,60,80,10,4,14
Odisha,Jagatsinghapur,Muscular Dystrophy,6,15,1,0,1
Odisha,Jagatsinghapur,Muscular Dystrophy,15,35,2,2,4
Odisha,Jagatsinghapur,Muscular Dystrophy,35,60,7,3,10
Odisha,Jagatsinghapur,Muscular Dystrophy,60,80,3,3,6
Madhya Pradesh,Jabalpur,Muscular Dystrophy,0,6,0,1,1
Madhya Pradesh,Jabalpur,Muscular Dystrophy,6,15,10,1,11
Madhya Pradesh,Jabalpur,Muscular Dystrophy,15,35,31,10,41
Madhya Pradesh,Jabalpur,Muscular Dystrophy,35,60,38,18,56
Madhya Pradesh,Jabalpur,Muscular Dystrophy,60,80,7,5,12
Madhya Pradesh,Indore,Muscular Dystrophy,6,15,10,1,11
Madhya Pradesh,Indore,Muscular Dystrophy,15,35,23,10,33
Madhya Pradesh,Indore,Muscular Dystrophy,35,60,19,10,29
Madhya Pradesh,Indore,Muscular Dystrophy,60,80,2,0,2
Manipur,Imphal West,Muscular Dystrophy,6,15,2,0,2
Manipur,Imphal West,Muscular Dystrophy,15,35,2,0,2
Manipur,Imphal West,Muscular Dystrophy,60,80,0,1,1
Manipur,Imphal East,Muscular Dystrophy,15,35,2,1,3
Kerala,Idukki,Muscular Dystrophy,6,15,8,0,8
Kerala,Idukki,Muscular Dystrophy,15,35,8,0,8
Kerala,Idukki,Muscular Dystrophy,35,60,6,5,11
Kerala,Idukki,Muscular Dystrophy,60,80,3,0,3
Punjab,Hoshiarpur,Muscular Dystrophy,0,6,3,1,4
Punjab,Hoshiarpur,Muscular Dystrophy,6,15,25,5,30
Punjab,Hoshiarpur,Muscular Dystrophy,15,35,173,69,242
Punjab,Hoshiarpur,Muscular Dystrophy,35,60,448,198,646
Punjab,Hoshiarpur,Muscular Dystrophy,60,80,140,28,168
Punjab,Hoshiarpur,Muscular Dystrophy,80,100,9,4,13
Assam,Hojai,Muscular Dystrophy,15,35,1,1,2
Assam,Hojai,Muscular Dystrophy,35,60,3,0,3
Mizoram,Hnahthial,Muscular Dystrophy,15,35,1,0,1
Haryana,Hisar,Muscular Dystrophy,6,15,5,2,7
Haryana,Hisar,Muscular Dystrophy,15,35,21,15,36
Haryana,Hisar,Muscular Dystrophy,35,60,28,5,33
Haryana,Hisar,Muscular Dystrophy,60,80,1,1,2
Maharashtra,Hingoli,Muscular Dystrophy,6,15,2,0,2
Maharashtra,Hingoli,Muscular Dystrophy,15,35,6,1,7
Maharashtra,Hingoli,Muscular Dystrophy,35,60,3,3,6
Maharashtra,Hingoli,Muscular Dystrophy,60,80,2,0,2
Jharkhand,Hazaribagh,Muscular Dystrophy,0,6,1,0,1
Jharkhand,Hazaribagh,Muscular Dystrophy,6,15,5,2,7
Jharkhand,Hazaribagh,Muscular Dystrophy,15,35,36,14,50
Jharkhand,Hazaribagh,Muscular Dystrophy,35,60,34,14,48
Jharkhand,Hazaribagh,Muscular Dystrophy,60,80,3,4,7
Jharkhand,Hazaribagh,Muscular Dystrophy,80,100,1,0,1
Karnataka,Haveri,Muscular Dystrophy,6,15,4,2,6
Karnataka,Haveri,Muscular Dystrophy,15,35,14,11,25
Karnataka,Haveri,Muscular Dystrophy,35,60,24,8,32
Karnataka,Haveri,Muscular Dystrophy,60,80,4,3,7
Karnataka,Haveri,Muscular Dystrophy,80,100,1,0,1
Uttar Pradesh,Hathras,Muscular Dystrophy,6,15,6,1,7
Uttar Pradesh,Hathras,Muscular Dystrophy,15,35,73,12,85
Uttar Pradesh,Hathras,Muscular Dystrophy,35,60,96,19,115
Uttar Pradesh,Hathras,Muscular Dystrophy,60,80,36,4,40
Uttar Pradesh,Hathras,Muscular Dystrophy,80,100,1,0,1
Karnataka,Hassan,Muscular Dystrophy,0,6,0,1,1
Karnataka,Hassan,Muscular Dystrophy,6,15,15,1,16
Karnataka,Hassan,Muscular Dystrophy,15,35,19,7,26
Karnataka,Hassan,Muscular Dystrophy,35,60,39,13,52
Karnataka,Hassan,Muscular Dystrophy,60,80,16,2,18
Karnataka,Hassan,Muscular Dystrophy,80,100,0,1,1
Uttarakhand,Haridwar,Muscular Dystrophy,6,15,9,3,12
Uttarakhand,Haridwar,Muscular Dystrophy,15,35,42,23,65
Uttarakhand,Haridwar,Muscular Dystrophy,35,60,51,11,62
Uttarakhand,Haridwar,Muscular Dystrophy,60,80,6,0,6
Uttar Pradesh,Hardoi,Muscular Dystrophy,6,15,19,5,24
Uttar Pradesh,Hardoi,Muscular Dystrophy,15,35,290,60,350
Uttar Pradesh,Hardoi,Muscular Dystrophy,35,60,396,99,495
Uttar Pradesh,Hardoi,Muscular Dystrophy,60,80,113,11,124
Uttar Pradesh,Hardoi,Muscular Dystrophy,80,100,8,2,10
Madhya Pradesh,Harda,Muscular Dystrophy,15,35,4,1,5
Madhya Pradesh,Harda,Muscular Dystrophy,35,60,1,0,1
Uttar Pradesh,Hapur,Muscular Dystrophy,6,15,5,1,6
Uttar Pradesh,Hapur,Muscular Dystrophy,15,35,26,3,29
Uttar Pradesh,Hapur,Muscular Dystrophy,35,60,23,9,32
Uttar Pradesh,Hapur,Muscular Dystrophy,60,80,5,0,5
Rajasthan,Hanumangarh,Muscular Dystrophy,0,6,1,0,1
Rajasthan,Hanumangarh,Muscular Dystrophy,6,15,6,1,7
Rajasthan,Hanumangarh,Muscular Dystrophy,15,35,13,6,19
Rajasthan,Hanumangarh,Muscular Dystrophy,35,60,8,14,22
Rajasthan,Hanumangarh,Muscular Dystrophy,60,80,2,0,2
Himachal Pradesh,Hamirpur,Muscular Dystrophy,0,6,2,0,2
Himachal Pradesh,Hamirpur,Muscular Dystrophy,6,15,7,1,8
Himachal Pradesh,Hamirpur,Muscular Dystrophy,15,35,1,1,2
Himachal Pradesh,Hamirpur,Muscular Dystrophy,35,60,9,4,13
Himachal Pradesh,Hamirpur,Muscular Dystrophy,60,80,0,1,1
Himachal Pradesh,Hamirpur,Muscular Dystrophy,80,100,0,1,1
Uttar Pradesh,Hamirpur,Muscular Dystrophy,0,6,0,1,1
Uttar Pradesh,Hamirpur,Muscular Dystrophy,6,15,5,6,11
Uttar Pradesh,Hamirpur,Muscular Dystrophy,15,35,103,31,134
Uttar Pradesh,Hamirpur,Muscular Dystrophy,35,60,209,71,280
Uttar Pradesh,Hamirpur,Muscular Dystrophy,60,80,52,15,67
Uttar Pradesh,Hamirpur,Muscular Dystrophy,80,100,3,1,4
Assam,Hailakandi,Muscular Dystrophy,6,15,1,0,1
Assam,Hailakandi,Muscular Dystrophy,15,35,1,0,1
Assam,Hailakandi,Muscular Dystrophy,35,60,2,1,3
Assam,Hailakandi,Muscular Dystrophy,60,80,1,0,1
Sikkim,Gyalshing,Muscular Dystrophy,15,35,1,0,1
Madhya Pradesh,Gwalior,Muscular Dystrophy,6,15,4,1,5
Madhya Pradesh,Gwalior,Muscular Dystrophy,15,35,11,2,13
Madhya Pradesh,Gwalior,Muscular Dystrophy,35,60,10,3,13
Madhya Pradesh,Gwalior,Muscular Dystrophy,60,80,2,0,2
Madhya Pradesh,Gwalior,Muscular Dystrophy,80,100,1,0,1
Haryana,Gurugram,Muscular Dystrophy,6,15,4,2,6
Haryana,Gurugram,Muscular Dystrophy,15,35,8,2,10
Haryana,Gurugram,Muscular Dystrophy,35,60,1,1,2
Haryana,Gurugram,Muscular Dystrophy,60,80,0,1,1
Punjab,Gurdaspur,Muscular Dystrophy,0,6,1,1,2
Punjab,Gurdaspur,Muscular Dystrophy,6,15,6,2,8
Punjab,Gurdaspur,Muscular Dystrophy,15,35,52,30,82
Punjab,Gurdaspur,Muscular Dystrophy,35,60,108,40,148
Punjab,Gurdaspur,Muscular Dystrophy,60,80,44,10,54
Punjab,Gurdaspur,Muscular Dystrophy,80,100,1,2,3
Andhra Pradesh,Guntur,Muscular Dystrophy,15,35,8,1,9
Andhra Pradesh,Guntur,Muscular Dystrophy,35,60,1,0,1
Andhra Pradesh,Guntur,Muscular Dystrophy,60,80,0,1,1
Madhya Pradesh,Guna,Muscular Dystrophy,0,6,1,0,1
Madhya Pradesh,Guna,Muscular Dystrophy,6,15,16,0,16
Madhya Pradesh,Guna,Muscular Dystrophy,15,35,5,2,7
Madhya Pradesh,Guna,Muscular Dystrophy,35,60,5,0,5
Madhya Pradesh,Guna,Muscular Dystrophy,60,80,1,0,1
Jharkhand,Gumla,Muscular Dystrophy,0,6,2,2,4
Jharkhand,Gumla,Muscular Dystrophy,6,15,49,26,75
Jharkhand,Gumla,Muscular Dystrophy,15,35,188,113,301
Jharkhand,Gumla,Muscular Dystrophy,35,60,277,147,424
Jharkhand,Gumla,Muscular Dystrophy,60,80,75,38,113
Jharkhand,Gumla,Muscular Dystrophy,80,100,4,0,4
Uttar Pradesh,Gorakhpur,Muscular Dystrophy,0,6,2,1,3
Uttar Pradesh,Gorakhpur,Muscular Dystrophy,6,15,19,7,26
Uttar Pradesh,Gorakhpur,Muscular Dystrophy,15,35,140,46,186
Uttar Pradesh,Gorakhpur,Muscular Dystrophy,35,60,206,46,252
Uttar Pradesh,Gorakhpur,Muscular Dystrophy,60,80,59,3,62
Uttar Pradesh,Gorakhpur,Muscular Dystrophy,80,100,2,0,2
Bihar,Gopalganj,Muscular Dystrophy,0,6,2,0,2
Bihar,Gopalganj,Muscular Dystrophy,6,15,23,3,26
Bihar,Gopalganj,Muscular Dystrophy,15,35,14,1,15
Bihar,Gopalganj,Muscular Dystrophy,35,60,7,2,9
Bihar,Gopalganj,Muscular Dystrophy,60,80,1,0,1
Maharashtra,Gondia,Muscular Dystrophy,6,15,12,2,14
Maharashtra,Gondia,Muscular Dystrophy,15,35,10,8,18
Maharashtra,Gondia,Muscular Dystrophy,35,60,13,9,22
Maharashtra,Gondia,Muscular Dystrophy,60,80,2,0,2
Uttar Pradesh,Gonda,Muscular Dystrophy,0,6,1,0,1
Uttar Pradesh,Gonda,Muscular Dystrophy,6,15,11,2,13
Uttar Pradesh,Gonda,Muscular Dystrophy,15,35,117,21,138
Uttar Pradesh,Gonda,Muscular Dystrophy,35,60,133,25,158
Uttar Pradesh,Gonda,Muscular Dystrophy,60,80,20,3,23
Uttar Pradesh,Gonda,Muscular Dystrophy,80,100,1,0,1
Assam,Golaghat,Muscular Dystrophy,6,15,1,2,3
Assam,Golaghat,Muscular Dystrophy,15,35,12,4,16
Assam,Golaghat,Muscular Dystrophy,35,60,13,3,16
Assam,Golaghat,Muscular Dystrophy,60,80,1,0,1
Jharkhand,Godda,Muscular Dystrophy,6,15,4,2,6
Jharkhand,Godda,Muscular Dystrophy,15,35,32,16,48
Jharkhand,Godda,Muscular Dystrophy,35,60,31,15,46
Jharkhand,Godda,Muscular Dystrophy,60,80,7,4,11
Jharkhand,Godda,Muscular Dystrophy,80,100,2,2,4
Assam,Goalpara,Muscular Dystrophy,15,35,7,2,9
Assam,Goalpara,Muscular Dystrophy,35,60,4,2,6
Assam,Goalpara,Muscular Dystrophy,60,80,0,1,1
Jharkhand,Giridih,Muscular Dystrophy,0,6,0,1,1
Jharkhand,Giridih,Muscular Dystrophy,6,15,13,5,18
Jharkhand,Giridih,Muscular Dystrophy,15,35,30,23,53
Jharkhand,Giridih,Muscular Dystrophy,35,60,48,24,72
Jharkhand,Giridih,Muscular Dystrophy,60,80,6,1,7
Gujarat,Gir Somnath,Muscular Dystrophy,6,15,5,2,7
Gujarat,Gir Somnath,Muscular Dystrophy,15,35,13,4,17
Gujarat,Gir Somnath,Muscular Dystrophy,35,60,6,2,8
Gujarat,Gir Somnath,Muscular Dystrophy,60,80,1,0,1
Uttar Pradesh,Ghazipur,Muscular Dystrophy,0,6,1,0,1
Uttar Pradesh,Ghazipur,Muscular Dystrophy,6,15,14,3,17
Uttar Pradesh,Ghazipur,Muscular Dystrophy,15,35,39,16,55
Uttar Pradesh,Ghazipur,Muscular Dystrophy,35,60,42,9,51
Uttar Pradesh,Ghazipur,Muscular Dystrophy,60,80,3,1,4
Uttar Pradesh,Ghaziabad,Muscular Dystrophy,6,15,12,1,13
Uttar Pradesh,Ghaziabad,Muscular Dystrophy,15,35,37,3,40
Uttar Pradesh,Ghaziabad,Muscular Dystrophy,35,60,42,7,49
Uttar Pradesh,Ghaziabad,Muscular Dystrophy,60,80,11,0,11
Bihar,Gaya,Muscular Dystrophy,0,6,1,1,2
Bihar,Gaya,Muscular Dystrophy,6,15,18,4,22
Bihar,Gaya,Muscular Dystrophy,15,35,39,9,48
Bihar,Gaya,Muscular Dystrophy,35,60,25,2,27
Bihar,Gaya,Muscular Dystrophy,60,80,4,0,4
Uttar Pradesh,Gautam Buddha Nagar,Muscular Dystrophy,0,6,3,0,3
Uttar Pradesh,Gautam Buddha Nagar,Muscular Dystrophy,6,15,4,2,6
Uttar Pradesh,Gautam Buddha Nagar,Muscular Dystrophy,15,35,20,6,26
Uttar Pradesh,Gautam Buddha Nagar,Muscular Dystrophy,35,60,21,6,27
Uttar Pradesh,Gautam Buddha Nagar,Muscular Dystrophy,60,80,4,0,4
Uttar Pradesh,Gautam Buddha Nagar,Muscular Dystrophy,80,100,1,0,1
Chhattisgarh,Gaurella Pendra Marwahi,Muscular Dystrophy,15,35,1,0,1
Chhattisgarh,Gaurella Pendra Marwahi,Muscular Dystrophy,35,60,1,0,1
Chhattisgarh,Gariyaband,Muscular Dystrophy,6,15,4,5,9
Chhattisgarh,Gariyaband,Muscular Dystrophy,15,35,31,24,55
Chhattisgarh,Gariyaband,Muscular Dystrophy,35,60,56,13,69
Chhattisgarh,Gariyaband,Muscular Dystrophy,60,80,14,3,17
Jharkhand,Garhwa,Muscular Dystrophy,0,6,2,0,2
Jharkhand,Garhwa,Muscular Dystrophy,6,15,6,1,7
Jharkhand,Garhwa,Muscular Dystrophy,15,35,33,11,44
Jharkhand,Garhwa,Muscular Dystrophy,35,60,27,6,33
Jharkhand,Garhwa,Muscular Dystrophy,60,80,3,1,4
Odisha,Ganjam,Muscular Dystrophy,15,35,0,1,1
Odisha,Ganjam,Muscular Dystrophy,35,60,1,0,1
Sikkim,Gangtok,Muscular Dystrophy,6,15,3,0,3
Sikkim,Gangtok,Muscular Dystrophy,15,35,2,2,4
Sikkim,Gangtok,Muscular Dystrophy,35,60,2,0,2
Rajasthan,Ganganagar,Muscular Dystrophy,0,6,1,0,1
Rajasthan,Ganganagar,Muscular Dystrophy,6,15,7,3,10
Rajasthan,Ganganagar,Muscular Dystrophy,15,35,28,10,38
Rajasthan,Ganganagar,Muscular Dystrophy,35,60,25,9,34
Rajasthan,Ganganagar,Muscular Dystrophy,60,80,4,5,9
Rajasthan,Ganganagar,Muscular Dystrophy,80,100,3,0,3
Gujarat,Gandhinagar,Muscular Dystrophy,6,15,8,3,11
Gujarat,Gandhinagar,Muscular Dystrophy,15,35,15,1,16
Gujarat,Gandhinagar,Muscular Dystrophy,35,60,5,3,8
Gujarat,Gandhinagar,Muscular Dystrophy,60,80,2,0,2
Jammu And Kashmir,Ganderbal,Muscular Dystrophy,0,6,2,1,3
Jammu And Kashmir,Ganderbal,Muscular Dystrophy,6,15,10,7,17
Jammu And Kashmir,Ganderbal,Muscular Dystrophy,15,35,11,12,23
Jammu And Kashmir,Ganderbal,Muscular Dystrophy,35,60,19,18,37
Jammu And Kashmir,Ganderbal,Muscular Dystrophy,60,80,4,4,8
Jammu And Kashmir,Ganderbal,Muscular Dystrophy,80,100,0,1,1
Odisha,Gajapati,Muscular Dystrophy,6,15,0,1,1
Odisha,Gajapati,Muscular Dystrophy,15,35,2,0,2
Odisha,Gajapati,Muscular Dystrophy,35,60,0,1,1
Odisha,Gajapati,Muscular Dystrophy,60,80,1,0,1
Maharashtra,Gadchiroli,Muscular Dystrophy,0,6,2,2,4
Maharashtra,Gadchiroli,Muscular Dystrophy,6,15,4,3,7
Maharashtra,Gadchiroli,Muscular Dystrophy,15,35,28,10,38
Maharashtra,Gadchiroli,Muscular Dystrophy,35,60,73,14,87
Maharashtra,Gadchiroli,Muscular Dystrophy,60,80,15,9,24
Maharashtra,Gadchiroli,Muscular Dystrophy,80,100,1,0,1
Karnataka,Gadag,Muscular Dystrophy,6,15,2,2,4
Karnataka,Gadag,Muscular Dystrophy,15,35,5,4,9
Karnataka,Gadag,Muscular Dystrophy,35,60,21,9,30
Karnataka,Gadag,Muscular Dystrophy,60,80,6,3,9
Karnataka,Gadag,Muscular Dystrophy,80,100,1,0,1
Uttar Pradesh,Firozabad,Muscular Dystrophy,6,15,13,0,13
Uttar Pradesh,Firozabad,Muscular Dystrophy,15,35,34,13,47
Uttar Pradesh,Firozabad,Muscular Dystrophy,35,60,30,14,44
Uttar Pradesh,Firozabad,Muscular Dystrophy,60,80,8,1,9
Punjab,Ferozepur,Muscular Dystrophy,0,6,1,0,1
Punjab,Ferozepur,Muscular Dystrophy,6,15,5,2,7
Punjab,Ferozepur,Muscular Dystrophy,15,35,30,12,42
Punjab,Ferozepur,Muscular Dystrophy,35,60,43,12,55
Punjab,Ferozepur,Muscular Dystrophy,60,80,6,3,9
Punjab,Fazilka,Muscular Dystrophy,6,15,8,3,11
Punjab,Fazilka,Muscular Dystrophy,15,35,33,12,45
Punjab,Fazilka,Muscular Dystrophy,35,60,21,7,28
Punjab,Fazilka,Muscular Dystrophy,60,80,3,0,3
Uttar Pradesh,Fatehpur,Muscular Dystrophy,0,6,1,0,1
Uttar Pradesh,Fatehpur,Muscular Dystrophy,6,15,5,3,8
Uttar Pradesh,Fatehpur,Muscular Dystrophy,15,35,130,45,175
Uttar Pradesh,Fatehpur,Muscular Dystrophy,35,60,184,42,226
Uttar Pradesh,Fatehpur,Muscular Dystrophy,60,80,68,19,87
Uttar Pradesh,Fatehpur,Muscular Dystrophy,80,100,3,0,3
Punjab,Fatehgarh Sahib,Muscular Dystrophy,6,15,7,4,11
Punjab,Fatehgarh Sahib,Muscular Dystrophy,15,35,53,17,70
Punjab,Fatehgarh Sahib,Muscular Dystrophy,35,60,81,54,135
Punjab,Fatehgarh Sahib,Muscular Dystrophy,60,80,29,9,38
Punjab,Fatehgarh Sahib,Muscular Dystrophy,80,100,3,2,5
Haryana,Fatehabad,Muscular Dystrophy,6,15,2,2,4
Haryana,Fatehabad,Muscular Dystrophy,15,35,12,9,21
Haryana,Fatehabad,Muscular Dystrophy,35,60,16,5,21
Haryana,Fatehabad,Muscular Dystrophy,60,80,1,0,1
Uttar Pradesh,Farrukhabad,Muscular Dystrophy,6,15,4,4,8
Uttar Pradesh,Farrukhabad,Muscular Dystrophy,15,35,115,26,141
Uttar Pradesh,Farrukhabad,Muscular Dystrophy,35,60,150,33,183
Uttar Pradesh,Farrukhabad,Muscular Dystrophy,60,80,42,6,48
Uttar Pradesh,Farrukhabad,Muscular Dystrophy,80,100,1,0,1
Punjab,Faridkot,Muscular Dystrophy,6,15,1,0,1
Punjab,Faridkot,Muscular Dystrophy,15,35,7,4,11
Punjab,Faridkot,Muscular Dystrophy,35,60,7,0,7
Haryana,Faridabad,Muscular Dystrophy,6,15,3,1,4
Haryana,Faridabad,Muscular Dystrophy,15,35,7,3,10
Haryana,Faridabad,Muscular Dystrophy,35,60,2,1,3
Haryana,Faridabad,Muscular Dystrophy,60,80,1,0,1
Uttar Pradesh,Etawah,Muscular Dystrophy,6,15,3,0,3
Uttar Pradesh,Etawah,Muscular Dystrophy,15,35,54,16,70
Uttar Pradesh,Etawah,Muscular Dystrophy,35,60,103,27,130
Uttar Pradesh,Etawah,Muscular Dystrophy,60,80,25,5,30
Uttar Pradesh,Etawah,Muscular Dystrophy,80,100,2,0,2
Uttar Pradesh,Etah,Muscular Dystrophy,6,15,7,3,10
Uttar Pradesh,Etah,Muscular Dystrophy,15,35,163,44,207
Uttar Pradesh,Etah,Muscular Dystrophy,35,60,189,51,240
Uttar Pradesh,Etah,Muscular Dystrophy,60,80,49,5,54
Uttar Pradesh,Etah,Muscular Dystrophy,80,100,3,0,3
Tamil Nadu,Erode,Muscular Dystrophy,0,6,2,1,3
Tamil Nadu,Erode,Muscular Dystrophy,6,15,33,0,33
Tamil Nadu,Erode,Muscular Dystrophy,15,35,62,19,81
Tamil Nadu,Erode,Muscular Dystrophy,35,60,29,14,43
Tamil Nadu,Erode,Muscular Dystrophy,60,80,3,1,4
Kerala,Ernakulam,Muscular Dystrophy,6,15,8,1,9
Kerala,Ernakulam,Muscular Dystrophy,15,35,23,4,27
Kerala,Ernakulam,Muscular Dystrophy,35,60,15,19,34
Kerala,Ernakulam,Muscular Dystrophy,60,80,6,4,10
Jharkhand,East Singhbum,Muscular Dystrophy,6,15,6,0,6
Jharkhand,East Singhbum,Muscular Dystrophy,15,35,67,46,113
Jharkhand,East Singhbum,Muscular Dystrophy,35,60,97,45,142
Jharkhand,East Singhbum,Muscular Dystrophy,60,80,25,6,31
Arunachal Pradesh,East Siang,Muscular Dystrophy,6,15,1,0,1
Madhya Pradesh,East Nimar,Muscular Dystrophy,0,6,1,0,1
Madhya Pradesh,East Nimar,Muscular Dystrophy,6,15,3,1,4
Madhya Pradesh,East Nimar,Muscular Dystrophy,15,35,46,31,77
Madhya Pradesh,East Nimar,Muscular Dystrophy,35,60,80,21,101
Madhya Pradesh,East Nimar,Muscular Dystrophy,60,80,24,6,30
Madhya Pradesh,East Nimar,Muscular Dystrophy,80,100,2,0,2
Meghalaya,East Khasi Hills,Muscular Dystrophy,15,35,6,0,6
Meghalaya,East Khasi Hills,Muscular Dystrophy,35,60,2,0,2
Arunachal Pradesh,East Kameng,Muscular Dystrophy,15,35,2,1,3
Arunachal Pradesh,East Kameng,Muscular Dystrophy,60,80,1,0,1
Andhra Pradesh,East Godavari,Muscular Dystrophy,35,60,1,0,1
Meghalaya,East Garo Hills,Muscular Dystrophy,6,15,0,1,1
Meghalaya,East Garo Hills,Muscular Dystrophy,15,35,1,2,3
Delhi,East,Muscular Dystrophy,6,15,9,1,10
Delhi,East,Muscular Dystrophy,15,35,5,3,8
Delhi,East,Muscular Dystrophy,35,60,6,1,7
Delhi,East,Muscular Dystrophy,60,80,1,0,1
Chhattisgarh,Durg,Muscular Dystrophy,6,15,14,5,19
Chhattisgarh,Durg,Muscular Dystrophy,15,35,57,35,92
Chhattisgarh,Durg,Muscular Dystrophy,35,60,107,49,156
Chhattisgarh,Durg,Muscular Dystrophy,60,80,24,3,27
Chhattisgarh,Durg,Muscular Dystrophy,80,100,3,0,3
Rajasthan,Dungarpur,Muscular Dystrophy,6,15,1,0,1
Rajasthan,Dungarpur,Muscular Dystrophy,15,35,7,2,9
Rajasthan,Dungarpur,Muscular Dystrophy,35,60,4,5,9
Rajasthan,Dungarpur,Muscular Dystrophy,60,80,2,0,2
Jharkhand,Dumka,Muscular Dystrophy,0,6,2,1,3
Jharkhand,Dumka,Muscular Dystrophy,6,15,6,6,12
Jharkhand,Dumka,Muscular Dystrophy,15,35,32,30,62
Jharkhand,Dumka,Muscular Dystrophy,35,60,36,15,51
Jharkhand,Dumka,Muscular Dystrophy,60,80,6,5,11
Gujarat,Dohad,Muscular Dystrophy,6,15,2,0,2
Gujarat,Dohad,Muscular Dystrophy,15,35,5,0,5
Gujarat,Dohad,Muscular Dystrophy,35,60,1,2,3
Jammu And Kashmir,Doda,Muscular Dystrophy,6,15,4,4,8
Jammu And Kashmir,Doda,Muscular Dystrophy,15,35,18,6,24
Jammu And Kashmir,Doda,Muscular Dystrophy,35,60,7,5,12
Jammu And Kashmir,Doda,Muscular Dystrophy,60,80,1,0,1
Madhya Pradesh,Dindori,Muscular Dystrophy,6,15,4,6,10
Madhya Pradesh,Dindori,Muscular Dystrophy,15,35,15,5,20
Madhya Pradesh,Dindori,Muscular Dystrophy,35,60,16,5,21
Madhya Pradesh,Dindori,Muscular Dystrophy,60,80,1,3,4
Madhya Pradesh,Dindori,Muscular Dystrophy,80,100,1,0,1
Tamil Nadu,Dindigul,Muscular Dystrophy,0,6,1,0,1
Tamil Nadu,Dindigul,Muscular Dystrophy,6,15,25,5,30
Tamil Nadu,Dindigul,Muscular Dystrophy,15,35,69,11,80
Tamil Nadu,Dindigul,Muscular Dystrophy,35,60,29,17,46
Tamil Nadu,Dindigul,Muscular Dystrophy,60,80,4,3,7
Nagaland,Dimapur,Muscular Dystrophy,6,15,0,1,1
Nagaland,Dimapur,Muscular Dystrophy,15,35,1,0,1
Nagaland,Dimapur,Muscular Dystrophy,35,60,1,0,1
Assam,Dima Hasao,Muscular Dystrophy,6,15,0,1,1
Assam,Dima Hasao,Muscular Dystrophy,15,35,2,0,2
Assam,Dima Hasao,Muscular Dystrophy,35,60,1,1,2
Assam,Dibrugarh,Muscular Dystrophy,6,15,2,1,3
Assam,Dibrugarh,Muscular Dystrophy,15,35,2,1,3
Assam,Dibrugarh,Muscular Dystrophy,35,60,6,1,7
Assam,Dibrugarh,Muscular Dystrophy,60,80,0,1,1
Maharashtra,Dhule,Muscular Dystrophy,6,15,5,3,8
Maharashtra,Dhule,Muscular Dystrophy,15,35,56,15,71
Maharashtra,Dhule,Muscular Dystrophy,35,60,148,41,189
Maharashtra,Dhule,Muscular Dystrophy,60,80,28,4,32
Maharashtra,Dhule,Muscular Dystrophy,80,100,1,0,1
Assam,Dhubri,Muscular Dystrophy,6,15,0,1,1
Assam,Dhubri,Muscular Dystrophy,15,35,0,1,1
Assam,Dhubri,Muscular Dystrophy,35,60,5,0,5
Odisha,Dhenkanal,Muscular Dystrophy,0,6,1,0,1
Odisha,Dhenkanal,Muscular Dystrophy,6,15,9,3,12
Odisha,Dhenkanal,Muscular Dystrophy,15,35,16,11,27
Odisha,Dhenkanal,Muscular Dystrophy,35,60,36,10,46
Odisha,Dhenkanal,Muscular Dystrophy,60,80,10,1,11
Odisha,Dhenkanal,Muscular Dystrophy,80,100,1,0,1
Assam,Dhemaji,Muscular Dystrophy,6,15,1,1,2
Assam,Dhemaji,Muscular Dystrophy,15,35,4,2,6
Assam,Dhemaji,Muscular Dystrophy,35,60,5,2,7
Assam,Dhemaji,Muscular Dystrophy,60,80,2,0,2
Karnataka,Dharwad,Muscular Dystrophy,6,15,6,1,7
Karnataka,Dharwad,Muscular Dystrophy,15,35,4,3,7
Karnataka,Dharwad,Muscular Dystrophy,35,60,15,5,20
Karnataka,Dharwad,Muscular Dystrophy,60,80,5,0,5
Tamil Nadu,Dharmapuri,Muscular Dystrophy,0,6,1,0,1
Tamil Nadu,Dharmapuri,Muscular Dystrophy,6,15,21,4,25
Tamil Nadu,Dharmapuri,Muscular Dystrophy,15,35,33,13,46
Tamil Nadu,Dharmapuri,Muscular Dystrophy,35,60,15,6,21
Tamil Nadu,Dharmapuri,Muscular Dystrophy,60,80,5,0,5
Madhya Pradesh,Dhar,Muscular Dystrophy,0,6,1,1,2
Madhya Pradesh,Dhar,Muscular Dystrophy,6,15,4,5,9
Madhya Pradesh,Dhar,Muscular Dystrophy,15,35,27,9,36
Madhya Pradesh,Dhar,Muscular Dystrophy,35,60,24,15,39
Madhya Pradesh,Dhar,Muscular Dystrophy,60,80,7,0,7
Madhya Pradesh,Dhar,Muscular Dystrophy,80,100,1,1,2
Jharkhand,Dhanbad,Muscular Dystrophy,0,6,1,1,2
Jharkhand,Dhanbad,Muscular Dystrophy,6,15,7,3,10
Jharkhand,Dhanbad,Muscular Dystrophy,15,35,34,18,52
Jharkhand,Dhanbad,Muscular Dystrophy,35,60,39,19,58
Jharkhand,Dhanbad,Muscular Dystrophy,60,80,6,2,8
Chhattisgarh,Dhamtari,Muscular Dystrophy,6,15,1,1,2
Chhattisgarh,Dhamtari,Muscular Dystrophy,15,35,2,0,2
Chhattisgarh,Dhamtari,Muscular Dystrophy,35,60,4,0,4
Madhya Pradesh,Dewas,Muscular Dystrophy,6,15,9,4,13
Madhya Pradesh,Dewas,Muscular Dystrophy,15,35,33,21,54
Madhya Pradesh,Dewas,Muscular Dystrophy,35,60,50,17,67
Madhya Pradesh,Dewas,Muscular Dystrophy,60,80,9,3,12
Madhya Pradesh,Dewas,Muscular Dystrophy,80,100,1,0,1
Gujarat,Devbhumi Dwarka,Muscular Dystrophy,15,35,1,0,1
Gujarat,Devbhumi Dwarka,Muscular Dystrophy,35,60,4,0,4
Gujarat,Devbhumi Dwarka,Muscular Dystrophy,60,80,1,0,1
Uttar Pradesh,Deoria,Muscular Dystrophy,6,15,12,2,14
Uttar Pradesh,Deoria,Muscular Dystrophy,15,35,142,31,173
Uttar Pradesh,Deoria,Muscular Dystrophy,35,60,121,41,162
Uttar Pradesh,Deoria,Muscular Dystrophy,60,80,49,13,62
Uttar Pradesh,Deoria,Muscular Dystrophy,80,100,2,1,3
Jharkhand,Deoghar,Muscular Dystrophy,6,15,6,3,9
Jharkhand,Deoghar,Muscular Dystrophy,15,35,29,16,45
Jharkhand,Deoghar,Muscular Dystrophy,35,60,35,18,53
Jharkhand,Deoghar,Muscular Dystrophy,60,80,7,3,10
Odisha,Deogarh,Muscular Dystrophy,6,15,1,0,1
Odisha,Deogarh,Muscular Dystrophy,15,35,3,0,3
Odisha,Deogarh,Muscular Dystrophy,35,60,2,0,2
Odisha,Deogarh,Muscular Dystrophy,60,80,0,1,1
Uttarakhand,Dehradun,Muscular Dystrophy,6,15,15,5,20
Uttarakhand,Dehradun,Muscular Dystrophy,15,35,14,7,21
Uttarakhand,Dehradun,Muscular Dystrophy,35,60,27,4,31
Uttarakhand,Dehradun,Muscular Dystrophy,60,80,5,3,8
Karnataka,Davangere,Muscular Dystrophy,0,6,1,0,1
Karnataka,Davangere,Muscular Dystrophy,6,15,14,3,17
Karnataka,Davangere,Muscular Dystrophy,15,35,43,12,55
Karnataka,Davangere,Muscular Dystrophy,35,60,22,8,30
Karnataka,Davangere,Muscular Dystrophy,60,80,4,1,5
Rajasthan,Dausa,Muscular Dystrophy,0,6,1,0,1
Rajasthan,Dausa,Muscular Dystrophy,6,15,5,5,10
Rajasthan,Dausa,Muscular Dystrophy,15,35,29,17,46
Rajasthan,Dausa,Muscular Dystrophy,35,60,19,8,27
Rajasthan,Dausa,Muscular Dystrophy,60,80,3,1,4
Madhya Pradesh,Datia,Muscular Dystrophy,6,15,3,0,3
Madhya Pradesh,Datia,Muscular Dystrophy,15,35,9,0,9
Madhya Pradesh,Datia,Muscular Dystrophy,35,60,1,2,3
Assam,Darrang,Muscular Dystrophy,6,15,1,0,1
Assam,Darrang,Muscular Dystrophy,15,35,1,2,3
Assam,Darrang,Muscular Dystrophy,35,60,6,1,7
Assam,Darrang,Muscular Dystrophy,60,80,2,0,2
Bihar,Darbhanga,Muscular Dystrophy,0,6,1,0,1
Bihar,Darbhanga,Muscular Dystrophy,6,15,4,3,7
Bihar,Darbhanga,Muscular Dystrophy,15,35,23,13,36
Bihar,Darbhanga,Muscular Dystrophy,35,60,20,6,26
Bihar,Darbhanga,Muscular Dystrophy,60,80,3,1,4
Gujarat,Dang,Muscular Dystrophy,6,15,1,0,1
Madhya Pradesh,Damoh,Muscular Dystrophy,6,15,3,1,4
Madhya Pradesh,Damoh,Muscular Dystrophy,15,35,31,8,39
Madhya Pradesh,Damoh,Muscular Dystrophy,35,60,31,16,47
Madhya Pradesh,Damoh,Muscular Dystrophy,60,80,17,2,19
Dadra Nagar Haveli And Daman And Diu,Daman,Muscular Dystrophy,6,15,2,0,2
Dadra Nagar Haveli And Daman And Diu,Daman,Muscular Dystrophy,15,35,7,1,8
Dadra Nagar Haveli And Daman And Diu,Daman,Muscular Dystrophy,35,60,3,1,4
Karnataka,Dakshina Kannada,Muscular Dystrophy,6,15,15,0,15
Karnataka,Dakshina Kannada,Muscular Dystrophy,15,35,11,8,19
Karnataka,Dakshina Kannada,Muscular Dystrophy,35,60,15,6,21
Karnataka,Dakshina Kannada,Muscular Dystrophy,60,80,6,1,7
Odisha,Cuttack,Muscular Dystrophy,0,6,1,4,5
Odisha,Cuttack,Muscular Dystrophy,6,15,26,6,32
Odisha,Cuttack,Muscular Dystrophy,15,35,37,21,58
Odisha,Cuttack,Muscular Dystrophy,35,60,71,31,102
Odisha,Cuttack,Muscular Dystrophy,60,80,27,5,32
Tamil Nadu,Cuddalore,Muscular Dystrophy,0,6,1,0,1
Tamil Nadu,Cuddalore,Muscular Dystrophy,6,15,30,7,37
Tamil Nadu,Cuddalore,Muscular Dystrophy,15,35,39,10,49
Tamil Nadu,Cuddalore,Muscular Dystrophy,35,60,24,3,27
Tamil Nadu,Cuddalore,Muscular Dystrophy,60,80,2,0,2
Tamil Nadu,Coimbatore,Muscular Dystrophy,0,6,0,1,1
Tamil Nadu,Coimbatore,Muscular Dystrophy,6,15,50,3,53
Tamil Nadu,Coimbatore,Muscular Dystrophy,15,35,47,13,60
Tamil Nadu,Coimbatore,Muscular Dystrophy,35,60,12,6,18
Tamil Nadu,Coimbatore,Muscular Dystrophy,60,80,2,3,5
Rajasthan,Churu,Muscular Dystrophy,6,15,2,0,2
Rajasthan,Churu,Muscular Dystrophy,15,35,7,0,7
Rajasthan,Churu,Muscular Dystrophy,35,60,8,1,9
Rajasthan,Churu,Muscular Dystrophy,60,80,1,0,1
Manipur,Churachandpur,Muscular Dystrophy,15,35,2,0,2
Manipur,Churachandpur,Muscular Dystrophy,60,80,0,1,1
Rajasthan,Chittorgarh,Muscular Dystrophy,0,6,0,1,1
Rajasthan,Chittorgarh,Muscular Dystrophy,6,15,11,0,11
Rajasthan,Chittorgarh,Muscular Dystrophy,15,35,16,10,26
Rajasthan,Chittorgarh,Muscular Dystrophy,35,60,18,11,29
Rajasthan,Chittorgarh,Muscular Dystrophy,60,80,3,1,4
Andhra Pradesh,Chittoor,Muscular Dystrophy,15,35,1,0,1
Andhra Pradesh,Chittoor,Muscular Dystrophy,35,60,1,0,1
Uttar Pradesh,Chitrakoot,Muscular Dystrophy,0,6,0,1,1
Uttar Pradesh,Chitrakoot,Muscular Dystrophy,6,15,8,4,12
Uttar Pradesh,Chitrakoot,Muscular Dystrophy,15,35,51,13,64
Uttar Pradesh,Chitrakoot,Muscular Dystrophy,35,60,60,24,84
Uttar Pradesh,Chitrakoot,Muscular Dystrophy,60,80,15,2,17
Uttar Pradesh,Chitrakoot,Muscular Dystrophy,80,100,2,0,2
Karnataka,Chitradurga,Muscular Dystrophy,6,15,15,5,20
Karnataka,Chitradurga,Muscular Dystrophy,15,35,20,13,33
Karnataka,Chitradurga,Muscular Dystrophy,35,60,36,13,49
Karnataka,Chitradurga,Muscular Dystrophy,60,80,5,4,9
Assam,Chirang,Muscular Dystrophy,35,60,0,1,1
Karnataka,Chikkamagaluru,Muscular Dystrophy,6,15,3,1,4
Karnataka,Chikkamagaluru,Muscular Dystrophy,15,35,17,12,29
Karnataka,Chikkamagaluru,Muscular Dystrophy,35,60,21,16,37
Karnataka,Chikkamagaluru,Muscular Dystrophy,60,80,12,6,18
Karnataka,Chikkamagaluru,Muscular Dystrophy,80,100,1,0,1
Karnataka,Chikkaballapura,Muscular Dystrophy,6,15,4,1,5
Karnataka,Chikkaballapura,Muscular Dystrophy,15,35,5,2,7
Karnataka,Chikkaballapura,Muscular Dystrophy,35,60,11,4,15
Karnataka,Chikkaballapura,Muscular Dystrophy,60,80,5,2,7
Madhya Pradesh,Chhindwara,Muscular Dystrophy,0,6,0,2,2
Madhya Pradesh,Chhindwara,Muscular Dystrophy,6,15,24,13,37
Madhya Pradesh,Chhindwara,Muscular Dystrophy,15,35,50,28,78
Madhya Pradesh,Chhindwara,Muscular Dystrophy,35,60,53,32,85
Madhya Pradesh,Chhindwara,Muscular Dystrophy,60,80,19,9,28
Madhya Pradesh,Chhindwara,Muscular Dystrophy,80,100,2,0,2
Madhya Pradesh,Chhatarpur,Muscular Dystrophy,6,15,7,1,8
Madhya Pradesh,Chhatarpur,Muscular Dystrophy,15,35,18,5,23
Madhya Pradesh,Chhatarpur,Muscular Dystrophy,35,60,18,7,25
Madhya Pradesh,Chhatarpur,Muscular Dystrophy,60,80,4,0,4
Tamil Nadu,Chennai,Muscular Dystrophy,0,6,1,0,1
Tamil Nadu,Chennai,Muscular Dystrophy,6,15,47,9,56
Tamil Nadu,Chennai,Muscular Dystrophy,15,35,55,16,71
Tamil Nadu,Chennai,Muscular Dystrophy,35,60,51,18,69
Tamil Nadu,Chennai,Muscular Dystrophy,60,80,8,4,12
Tamil Nadu,Chengalpattu,Muscular Dystrophy,0,6,2,0,2
Tamil Nadu,Chengalpattu,Muscular Dystrophy,6,15,11,4,15
Tamil Nadu,Chengalpattu,Muscular Dystrophy,15,35,25,6,31
Tamil Nadu,Chengalpattu,Muscular Dystrophy,35,60,8,5,13
Jharkhand,Chatra,Muscular Dystrophy,6,15,2,1,3
Jharkhand,Chatra,Muscular Dystrophy,15,35,2,0,2
Jharkhand,Chatra,Muscular Dystrophy,35,60,3,1,4
Jharkhand,Chatra,Muscular Dystrophy,60,80,1,0,1
Haryana,Charki Dadri,Muscular Dystrophy,6,15,2,2,4
Haryana,Charki Dadri,Muscular Dystrophy,15,35,3,1,4
Haryana,Charki Dadri,Muscular Dystrophy,35,60,4,3,7
Haryana,Charki Dadri,Muscular Dystrophy,60,80,0,1,1
Assam,Charaideo,Muscular Dystrophy,6,15,1,1,2
Assam,Charaideo,Muscular Dystrophy,15,35,1,1,2
Assam,Charaideo,Muscular Dystrophy,35,60,2,3,5
Maharashtra,Chandrapur,Muscular Dystrophy,6,15,19,1,20
Maharashtra,Chandrapur,Muscular Dystrophy,15,35,14,1,15
Maharashtra,Chandrapur,Muscular Dystrophy,35,60,1,0,1
Chandigarh,Chandigarh,Muscular Dystrophy,6,15,13,5,18
Chandigarh,Chandigarh,Muscular Dystrophy,15,35,33,17,50
Chandigarh,Chandigarh,Muscular Dystrophy,35,60,56,20,76
Chandigarh,Chandigarh,Muscular Dystrophy,60,80,12,3,15
Chandigarh,Chandigarh,Muscular Dystrophy,80,100,0,1,1
Manipur,Chandel,Muscular Dystrophy,0,6,0,1,1
Manipur,Chandel,Muscular Dystrophy,15,35,2,1,3
Manipur,Chandel,Muscular Dystrophy,35,60,1,0,1
Manipur,Chandel,Muscular Dystrophy,80,100,0,1,1
Uttar Pradesh,Chandauli,Muscular Dystrophy,6,15,7,2,9
Uttar Pradesh,Chandauli,Muscular Dystrophy,15,35,10,2,12
Uttar Pradesh,Chandauli,Muscular Dystrophy,35,60,4,1,5
Uttar Pradesh,Chandauli,Muscular Dystrophy,60,80,2,1,3
Mizoram,Champhai,Muscular Dystrophy,6,15,1,0,1
Mizoram,Champhai,Muscular Dystrophy,35,60,4,0,4
Mizoram,Champhai,Muscular Dystrophy,60,80,1,0,1
Uttarakhand,Champawat,Muscular Dystrophy,0,6,2,1,3
Uttarakhand,Champawat,Muscular Dystrophy,6,15,2,0,2
Uttarakhand,Champawat,Muscular Dystrophy,15,35,10,3,13
Uttarakhand,Champawat,Muscular Dystrophy,35,60,10,3,13
Uttarakhand,Champawat,Muscular Dystrophy,60,80,4,0,4
Uttarakhand,Chamoli,Muscular Dystrophy,6,15,0,2,2
Uttarakhand,Chamoli,Muscular Dystrophy,15,35,13,4,17
Uttarakhand,Chamoli,Muscular Dystrophy,35,60,19,10,29
Uttarakhand,Chamoli,Muscular Dystrophy,60,80,2,1,3
Himachal Pradesh,Chamba,Muscular Dystrophy,0,6,2,0,2
Himachal Pradesh,Chamba,Muscular Dystrophy,6,15,0,2,2
Himachal Pradesh,Chamba,Muscular Dystrophy,15,35,7,3,10
Himachal Pradesh,Chamba,Muscular Dystrophy,35,60,4,2,6
Karnataka,Chamarajanagara,Muscular Dystrophy,6,15,1,0,1
Karnataka,Chamarajanagara,Muscular Dystrophy,15,35,4,3,7
Karnataka,Chamarajanagara,Muscular Dystrophy,35,60,3,2,5
Karnataka,Chamarajanagara,Muscular Dystrophy,60,80,2,0,2
Delhi,Central,Muscular Dystrophy,15,35,2,0,2
Delhi,Central,Muscular Dystrophy,35,60,2,0,2
Assam,Cachar,Muscular Dystrophy,0,6,1,0,1
Assam,Cachar,Muscular Dystrophy,6,15,4,0,4
Assam,Cachar,Muscular Dystrophy,15,35,14,6,20
Assam,Cachar,Muscular Dystrophy,35,60,14,10,24
Assam,Cachar,Muscular Dystrophy,60,80,3,0,3
Bihar,Buxar,Muscular Dystrophy,0,6,1,0,1
Bihar,Buxar,Muscular Dystrophy,6,15,7,2,9
Bihar,Buxar,Muscular Dystrophy,15,35,49,9,58
Bihar,Buxar,Muscular Dystrophy,35,60,56,12,68
Bihar,Buxar,Muscular Dystrophy,60,80,17,1,18
Madhya Pradesh,Burhanpur,Muscular Dystrophy,0,6,0,1,1
Madhya Pradesh,Burhanpur,Muscular Dystrophy,6,15,9,3,12
Madhya Pradesh,Burhanpur,Muscular Dystrophy,15,35,42,21,63
Madhya Pradesh,Burhanpur,Muscular Dystrophy,35,60,43,16,59
Madhya Pradesh,Burhanpur,Muscular Dystrophy,60,80,8,1,9
Rajasthan,Bundi,Muscular Dystrophy,6,15,2,1,3
Rajasthan,Bundi,Muscular Dystrophy,15,35,12,5,17
Rajasthan,Bundi,Muscular Dystrophy,35,60,17,4,21
Maharashtra,Buldhana,Muscular Dystrophy,6,15,8,0,8
Maharashtra,Buldhana,Muscular Dystrophy,15,35,11,4,15
Maharashtra,Buldhana,Muscular Dystrophy,35,60,4,2,6
Maharashtra,Buldhana,Muscular Dystrophy,60,80,1,1,2
Uttar Pradesh,Bulandshahr,Muscular Dystrophy,0,6,1,0,1
Uttar Pradesh,Bulandshahr,Muscular Dystrophy,6,15,12,5,17
Uttar Pradesh,Bulandshahr,Muscular Dystrophy,15,35,105,37,142
Uttar Pradesh,Bulandshahr,Muscular Dystrophy,35,60,122,23,145
Uttar Pradesh,Bulandshahr,Muscular Dystrophy,60,80,36,6,42
Uttar Pradesh,Bulandshahr,Muscular Dystrophy,80,100,1,0,1
Jammu And Kashmir,Budgam,Muscular Dystrophy,0,6,3,1,4
Jammu And Kashmir,Budgam,Muscular Dystrophy,6,15,9,2,11
Jammu And Kashmir,Budgam,Muscular Dystrophy,15,35,20,9,29
Jammu And Kashmir,Budgam,Muscular Dystrophy,35,60,15,8,23
Jammu And Kashmir,Budgam,Muscular Dystrophy,60,80,4,1,5
Uttar Pradesh,Budaun,Muscular Dystrophy,6,15,2,0,2
Uttar Pradesh,Budaun,Muscular Dystrophy,15,35,52,22,74
Uttar Pradesh,Budaun,Muscular Dystrophy,35,60,48,9,57
Uttar Pradesh,Budaun,Muscular Dystrophy,60,80,12,1,13
Uttar Pradesh,Budaun,Muscular Dystrophy,80,100,1,0,1
Odisha,Boudh,Muscular Dystrophy,0,6,0,1,1
Odisha,Boudh,Muscular Dystrophy,6,15,3,1,4
Odisha,Boudh,Muscular Dystrophy,15,35,7,4,11
Odisha,Boudh,Muscular Dystrophy,35,60,9,7,16
Odisha,Boudh,Muscular Dystrophy,60,80,2,1,3
Gujarat,Botad,Muscular Dystrophy,6,15,4,0,4
Gujarat,Botad,Muscular Dystrophy,15,35,1,0,1
Assam,Bongaigaon,Muscular Dystrophy,15,35,4,0,4
Assam,Bongaigaon,Muscular Dystrophy,35,60,1,1,2
Assam,Bongaigaon,Muscular Dystrophy,60,80,1,0,1
Jharkhand,Bokaro,Muscular Dystrophy,0,6,1,5,6
Jharkhand,Bokaro,Muscular Dystrophy,6,15,63,35,98
Jharkhand,Bokaro,Muscular Dystrophy,15,35,662,366,1028
Jharkhand,Bokaro,Muscular Dystrophy,35,60,744,297,1041
Jharkhand,Bokaro,Muscular Dystrophy,60,80,158,54,212
Jharkhand,Bokaro,Muscular Dystrophy,80,100,6,1,7
Assam,Biswanath,Muscular Dystrophy,15,35,1,0,1
Assam,Biswanath,Muscular Dystrophy,35,60,2,1,3
Assam,Biswanath,Muscular Dystrophy,60,80,1,0,1
Manipur,Bishnupur,Muscular Dystrophy,6,15,1,0,1
Manipur,Bishnupur,Muscular Dystrophy,15,35,2,1,3
Manipur,Bishnupur,Muscular Dystrophy,35,60,0,1,1
Manipur,Bishnupur,Muscular Dystrophy,60,80,2,0,2
Manipur,Bishnupur,Muscular Dystrophy,80,100,1,0,1
Chhattisgarh,Bilaspur,Muscular Dystrophy,6,15,8,0,8
Chhattisgarh,Bilaspur,Muscular Dystrophy,15,35,9,1,10
Chhattisgarh,Bilaspur,Muscular Dystrophy,35,60,8,4,12
Chhattisgarh,Bilaspur,Muscular Dystrophy,60,80,0,1,1
Himachal Pradesh,Bilaspur,Muscular Dystrophy,6,15,1,0,1
Himachal Pradesh,Bilaspur,Muscular Dystrophy,15,35,2,1,3
Himachal Pradesh,Bilaspur,Muscular Dystrophy,35,60,3,2,5
Himachal Pradesh,Bilaspur,Muscular Dystrophy,60,80,1,1,2
Rajasthan,Bikaner,Muscular Dystrophy,6,15,7,4,11
Rajasthan,Bikaner,Muscular Dystrophy,15,35,16,3,19
Rajasthan,Bikaner,Muscular Dystrophy,35,60,7,7,14
Rajasthan,Bikaner,Muscular Dystrophy,60,80,2,2,4
Uttar Pradesh,Bijnor,Muscular Dystrophy,0,6,0,1,1
Uttar Pradesh,Bijnor,Muscular Dystrophy,6,15,4,5,9
Uttar Pradesh,Bijnor,Muscular Dystrophy,15,35,203,71,274
Uttar Pradesh,Bijnor,Muscular Dystrophy,35,60,216,68,284
Uttar Pradesh,Bijnor,Muscular Dystrophy,60,80,64,6,70
Uttar Pradesh,Bijnor,Muscular Dystrophy,80,100,5,0,5
Chhattisgarh,Bijapur,Muscular Dystrophy,0,6,0,1,1
Chhattisgarh,Bijapur,Muscular Dystrophy,6,15,7,4,11
Chhattisgarh,Bijapur,Muscular Dystrophy,15,35,7,6,13
Chhattisgarh,Bijapur,Muscular Dystrophy,35,60,3,2,5
Karnataka,Bidar,Muscular Dystrophy,0,6,1,1,2
Karnataka,Bidar,Muscular Dystrophy,6,15,13,5,18
Karnataka,Bidar,Muscular Dystrophy,15,35,32,16,48
Karnataka,Bidar,Muscular Dystrophy,35,60,51,11,62
Karnataka,Bidar,Muscular Dystrophy,60,80,16,1,17
Karnataka,Bidar,Muscular Dystrophy,80,100,2,0,2
Madhya Pradesh,Bhopal,Muscular Dystrophy,0,6,1,0,1
Madhya Pradesh,Bhopal,Muscular Dystrophy,6,15,12,10,22
Madhya Pradesh,Bhopal,Muscular Dystrophy,15,35,68,38,106
Madhya Pradesh,Bhopal,Muscular Dystrophy,35,60,117,49,166
Madhya Pradesh,Bhopal,Muscular Dystrophy,60,80,27,10,37
Madhya Pradesh,Bhopal,Muscular Dystrophy,80,100,1,0,1
Bihar,Bhojpur,Muscular Dystrophy,6,15,7,0,7
Bihar,Bhojpur,Muscular Dystrophy,15,35,40,19,59
Bihar,Bhojpur,Muscular Dystrophy,35,60,36,11,47
Bihar,Bhojpur,Muscular Dystrophy,60,80,6,4,10
Haryana,Bhiwani,Muscular Dystrophy,0,6,1,0,1
Haryana,Bhiwani,Muscular Dystrophy,6,15,14,3,17
Haryana,Bhiwani,Muscular Dystrophy,15,35,38,5,43
Haryana,Bhiwani,Muscular Dystrophy,35,60,41,8,49
Haryana,Bhiwani,Muscular Dystrophy,60,80,5,6,11
Madhya Pradesh,Bhind,Muscular Dystrophy,6,15,5,0,5
Madhya Pradesh,Bhind,Muscular Dystrophy,15,35,40,3,43
Madhya Pradesh,Bhind,Muscular Dystrophy,35,60,50,9,59
Madhya Pradesh,Bhind,Muscular Dystrophy,60,80,4,0,4
Rajasthan,Bhilwara,Muscular Dystrophy,6,15,8,1,9
Rajasthan,Bhilwara,Muscular Dystrophy,15,35,34,13,47
Rajasthan,Bhilwara,Muscular Dystrophy,35,60,39,21,60
Rajasthan,Bhilwara,Muscular Dystrophy,60,80,12,11,23
Rajasthan,Bhilwara,Muscular Dystrophy,80,100,1,1,2
Gujarat,Bhavnagar,Muscular Dystrophy,0,6,1,0,1
Gujarat,Bhavnagar,Muscular Dystrophy,6,15,25,0,25
Gujarat,Bhavnagar,Muscular Dystrophy,15,35,15,3,18
Gujarat,Bhavnagar,Muscular Dystrophy,35,60,1,1,2
Gujarat,Bhavnagar,Muscular Dystrophy,60,80,1,0,1
Gujarat,Bharuch,Muscular Dystrophy,0,6,1,0,1
Gujarat,Bharuch,Muscular Dystrophy,6,15,7,1,8
Gujarat,Bharuch,Muscular Dystrophy,15,35,7,5,12
Gujarat,Bharuch,Muscular Dystrophy,35,60,5,3,8
Rajasthan,Bharatpur,Muscular Dystrophy,6,15,0,4,4
Rajasthan,Bharatpur,Muscular Dystrophy,15,35,4,2,6
Rajasthan,Bharatpur,Muscular Dystrophy,35,60,7,2,9
Maharashtra,Bhandara,Muscular Dystrophy,0,6,3,1,4
Maharashtra,Bhandara,Muscular Dystrophy,6,15,28,2,30
Maharashtra,Bhandara,Muscular Dystrophy,15,35,20,5,25
Maharashtra,Bhandara,Muscular Dystrophy,35,60,17,3,20
Maharashtra,Bhandara,Muscular Dystrophy,60,80,3,2,5
Bihar,Bhagalpur,Muscular Dystrophy,0,6,2,0,2
Bihar,Bhagalpur,Muscular Dystrophy,6,15,22,3,25
Bihar,Bhagalpur,Muscular Dystrophy,15,35,26,10,36
Bihar,Bhagalpur,Muscular Dystrophy,35,60,19,5,24
Bihar,Bhagalpur,Muscular Dystrophy,60,80,3,1,4
Odisha,Bhadrak,Muscular Dystrophy,0,6,1,0,1
Odisha,Bhadrak,Muscular Dystrophy,6,15,11,1,12
Odisha,Bhadrak,Muscular Dystrophy,15,35,8,3,11
Odisha,Bhadrak,Muscular Dystrophy,35,60,9,4,13
Odisha,Bhadrak,Muscular Dystrophy,60,80,6,1,7
Uttar Pradesh,Bhadohi,Muscular Dystrophy,6,15,15,2,17
Uttar Pradesh,Bhadohi,Muscular Dystrophy,15,35,19,3,22
Uttar Pradesh,Bhadohi,Muscular Dystrophy,35,60,8,2,10
Uttar Pradesh,Bhadohi,Muscular Dystrophy,60,80,2,0,2
Madhya Pradesh,Betul,Muscular Dystrophy,6,15,10,4,14
Madhya Pradesh,Betul,Muscular Dystrophy,15,35,26,13,39
Madhya Pradesh,Betul,Muscular Dystrophy,35,60,27,8,35
Madhya Pradesh,Betul,Muscular Dystrophy,60,80,3,1,4
Karnataka,Bengaluru Urban,Muscular Dystrophy,0,6,4,0,4
Karnataka,Bengaluru Urban,Muscular Dystrophy,6,15,17,3,20
Karnataka,Bengaluru Urban,Muscular Dystrophy,15,35,54,16,70
Karnataka,Bengaluru Urban,Muscular Dystrophy,35,60,47,15,62
Karnataka,Bengaluru Urban,Muscular Dystrophy,60,80,11,2,13
Karnataka,Bengaluru Rural,Muscular Dystrophy,6,15,3,1,4
Karnataka,Bengaluru Rural,Muscular Dystrophy,15,35,11,3,14
Karnataka,Bengaluru Rural,Muscular Dystrophy,35,60,12,6,18
Karnataka,Bengaluru Rural,Muscular Dystrophy,60,80,3,0,3
Chhattisgarh,Bemetara,Muscular Dystrophy,6,15,5,1,6
Chhattisgarh,Bemetara,Muscular Dystrophy,15,35,80,44,124
Chhattisgarh,Bemetara,Muscular Dystrophy,35,60,114,43,157
Chhattisgarh,Bemetara,Muscular Dystrophy,60,80,10,4,14
Karnataka,Belagavi,Muscular Dystrophy,0,6,2,0,2
Karnataka,Belagavi,Muscular Dystrophy,6,15,12,10,22
Karnataka,Belagavi,Muscular Dystrophy,15,35,62,27,89
Karnataka,Belagavi,Muscular Dystrophy,35,60,124,45,169
Karnataka,Belagavi,Muscular Dystrophy,60,80,26,6,32
Karnataka,Belagavi,Muscular Dystrophy,80,100,3,0,3
Bihar,Begusarai,Muscular Dystrophy,0,6,2,2,4
Bihar,Begusarai,Muscular Dystrophy,6,15,10,3,13
Bihar,Begusarai,Muscular Dystrophy,15,35,24,11,35
Bihar,Begusarai,Muscular Dystrophy,35,60,15,1,16
Bihar,Begusarai,Muscular Dystrophy,60,80,2,0,2
Maharashtra,Beed,Muscular Dystrophy,0,6,1,0,1
Maharashtra,Beed,Muscular Dystrophy,6,15,43,9,52
Maharashtra,Beed,Muscular Dystrophy,15,35,106,45,151
Maharashtra,Beed,Muscular Dystrophy,35,60,234,83,317
Maharashtra,Beed,Muscular Dystrophy,60,80,57,5,62
Maharashtra,Beed,Muscular Dystrophy,80,100,2,2,4
Punjab,Bathinda,Muscular Dystrophy,6,15,14,1,15
Punjab,Bathinda,Muscular Dystrophy,15,35,20,5,25
Punjab,Bathinda,Muscular Dystrophy,35,60,25,9,34
Punjab,Bathinda,Muscular Dystrophy,60,80,5,3,8
Uttar Pradesh,Basti,Muscular Dystrophy,6,15,4,2,6
Uttar Pradesh,Basti,Muscular Dystrophy,15,35,81,26,107
Uttar Pradesh,Basti,Muscular Dystrophy,35,60,97,6,103
Uttar Pradesh,Basti,Muscular Dystrophy,60,80,33,6,39
Chhattisgarh,Bastar,Muscular Dystrophy,6,15,3,1,4
Chhattisgarh,Bastar,Muscular Dystrophy,15,35,3,2,5
Chhattisgarh,Bastar,Muscular Dystrophy,35,60,0,1,1
Madhya Pradesh,Barwani,Muscular Dystrophy,15,35,6,3,9
Madhya Pradesh,Barwani,Muscular Dystrophy,35,60,15,9,24
Madhya Pradesh,Barwani,Muscular Dystrophy,60,80,0,1,1
Assam,Barpeta,Muscular Dystrophy,6,15,4,1,5
Assam,Barpeta,Muscular Dystrophy,15,35,8,6,14
Assam,Barpeta,Muscular Dystrophy,35,60,9,5,14
Assam,Barpeta,Muscular Dystrophy,60,80,4,3,7
Assam,Barpeta,Muscular Dystrophy,80,100,1,0,1
Punjab,Barnala,Muscular Dystrophy,0,6,4,5,9
Punjab,Barnala,Muscular Dystrophy,6,15,47,16,63
Punjab,Barnala,Muscular Dystrophy,15,35,224,85,309
Punjab,Barnala,Muscular Dystrophy,35,60,537,251,788
Punjab,Barnala,Muscular Dystrophy,60,80,183,51,234
Punjab,Barnala,Muscular Dystrophy,80,100,8,0,8
Rajasthan,Barmer,Muscular Dystrophy,0,6,3,3,6
Rajasthan,Barmer,Muscular Dystrophy,6,15,30,11,41
Rajasthan,Barmer,Muscular Dystrophy,15,35,55,16,71
Rajasthan,Barmer,Muscular Dystrophy,35,60,51,23,74
Rajasthan,Barmer,Muscular Dystrophy,60,80,11,1,12
Odisha,Bargarh,Muscular Dystrophy,6,15,2,0,2
Odisha,Bargarh,Muscular Dystrophy,15,35,2,1,3
Odisha,Bargarh,Muscular Dystrophy,35,60,7,3,10
Odisha,Bargarh,Muscular Dystrophy,60,80,2,2,4
Uttar Pradesh,Bareilly,Muscular Dystrophy,6,15,13,3,16
Uttar Pradesh,Bareilly,Muscular Dystrophy,15,35,162,37,199
Uttar Pradesh,Bareilly,Muscular Dystrophy,35,60,174,29,203
Uttar Pradesh,Bareilly,Muscular Dystrophy,60,80,26,4,30
Rajasthan,Baran,Muscular Dystrophy,0,6,2,1,3
Rajasthan,Baran,Muscular Dystrophy,6,15,4,4,8
Rajasthan,Baran,Muscular Dystrophy,15,35,20,4,24
Rajasthan,Baran,Muscular Dystrophy,35,60,23,7,30
Rajasthan,Baran,Muscular Dystrophy,60,80,2,2,4
Rajasthan,Baran,Muscular Dystrophy,80,100,1,0,1
Jammu And Kashmir,Baramulla,Muscular Dystrophy,0,6,7,0,7
Jammu And Kashmir,Baramulla,Muscular Dystrophy,6,15,19,14,33
Jammu And Kashmir,Baramulla,Muscular Dystrophy,15,35,56,30,86
Jammu And Kashmir,Baramulla,Muscular Dystrophy,35,60,64,36,100
Jammu And Kashmir,Baramulla,Muscular Dystrophy,60,80,13,5,18
Jammu And Kashmir,Baramulla,Muscular Dystrophy,80,100,3,0,3
Uttar Pradesh,Barabanki,Muscular Dystrophy,0,6,0,1,1
Uttar Pradesh,Barabanki,Muscular Dystrophy,6,15,29,13,42
Uttar Pradesh,Barabanki,Muscular Dystrophy,15,35,184,68,252
Uttar Pradesh,Barabanki,Muscular Dystrophy,35,60,229,52,281
Uttar Pradesh,Barabanki,Muscular Dystrophy,60,80,49,7,56
Uttar Pradesh,Barabanki,Muscular Dystrophy,80,100,1,0,1
Rajasthan,Banswara,Muscular Dystrophy,0,6,1,0,1
Rajasthan,Banswara,Muscular Dystrophy,6,15,5,6,11
Rajasthan,Banswara,Muscular Dystrophy,15,35,15,9,24
Rajasthan,Banswara,Muscular Dystrophy,35,60,8,9,17
Bihar,Banka,Muscular Dystrophy,0,6,1,0,1
Bihar,Banka,Muscular Dystrophy,6,15,8,2,10
Bihar,Banka,Muscular Dystrophy,15,35,26,9,35
Bihar,Banka,Muscular Dystrophy,35,60,20,9,29
Bihar,Banka,Muscular Dystrophy,60,80,8,2,10
Jammu And Kashmir,Bandipora,Muscular Dystrophy,0,6,1,2,3
Jammu And Kashmir,Bandipora,Muscular Dystrophy,6,15,9,13,22
Jammu And Kashmir,Bandipora,Muscular Dystrophy,15,35,56,35,91
Jammu And Kashmir,Bandipora,Muscular Dystrophy,35,60,63,53,116
Jammu And Kashmir,Bandipora,Muscular Dystrophy,60,80,9,7,16
Uttar Pradesh,Banda,Muscular Dystrophy,6,15,3,0,3
Uttar Pradesh,Banda,Muscular Dystrophy,15,35,33,4,37
Uttar Pradesh,Banda,Muscular Dystrophy,35,60,61,15,76
Uttar Pradesh,Banda,Muscular Dystrophy,60,80,34,2,36
Uttar Pradesh,Banda,Muscular Dystrophy,80,100,1,0,1
Gujarat,Banas Kantha,Muscular Dystrophy,0,6,1,0,1
Gujarat,Banas Kantha,Muscular Dystrophy,6,15,1,1,2
Gujarat,Banas Kantha,Muscular Dystrophy,35,60,1,0,1
Chhattisgarh,Balrampur,Muscular Dystrophy,6,15,1,0,1
Chhattisgarh,Balrampur,Muscular Dystrophy,15,35,3,2,5
Chhattisgarh,Balrampur,Muscular Dystrophy,35,60,2,0,2
Chhattisgarh,Balrampur,Muscular Dystrophy,60,80,1,0,1
Uttar Pradesh,Balrampur,Muscular Dystrophy,0,6,2,0,2
Uttar Pradesh,Balrampur,Muscular Dystrophy,6,15,15,3,18
Uttar Pradesh,Balrampur,Muscular Dystrophy,15,35,73,12,85
Uttar Pradesh,Balrampur,Muscular Dystrophy,35,60,41,3,44
Uttar Pradesh,Balrampur,Muscular Dystrophy,60,80,5,0,5
Uttar Pradesh,Balrampur,Muscular Dystrophy,80,100,1,0,1
Chhattisgarh,Baloda Bazar,Muscular Dystrophy,6,15,20,6,26
Chhattisgarh,Baloda Bazar,Muscular Dystrophy,15,35,97,72,169
Chhattisgarh,Baloda Bazar,Muscular Dystrophy,35,60,142,52,194
Chhattisgarh,Baloda Bazar,Muscular Dystrophy,60,80,45,10,55
Chhattisgarh,Baloda Bazar,Muscular Dystrophy,80,100,3,0,3
Chhattisgarh,Balod,Muscular Dystrophy,15,35,1,2,3
Chhattisgarh,Balod,Muscular Dystrophy,35,60,6,3,9
Chhattisgarh,Balod,Muscular Dystrophy,60,80,0,1,1
Uttar Pradesh,Ballia,Muscular Dystrophy,6,15,3,5,8
Uttar Pradesh,Ballia,Muscular Dystrophy,15,35,139,39,178
Uttar Pradesh,Ballia,Muscular Dystrophy,35,60,180,61,241
Uttar Pradesh,Ballia,Muscular Dystrophy,60,80,55,10,65
Uttar Pradesh,Ballia,Muscular Dystrophy,80,100,1,0,1
Karnataka,Ballari,Muscular Dystrophy,0,6,2,1,3
Karnataka,Ballari,Muscular Dystrophy,6,15,7,6,13
Karnataka,Ballari,Muscular Dystrophy,15,35,23,11,34
Karnataka,Ballari,Muscular Dystrophy,35,60,21,19,40
Karnataka,Ballari,Muscular Dystrophy,60,80,1,1,2
Odisha,Baleshwar,Muscular Dystrophy,0,6,6,4,10
Odisha,Baleshwar,Muscular Dystrophy,6,15,17,8,25
Odisha,Baleshwar,Muscular Dystrophy,15,35,46,17,63
Odisha,Baleshwar,Muscular Dystrophy,35,60,97,47,144
Odisha,Baleshwar,Muscular Dystrophy,60,80,28,10,38
Odisha,Baleshwar,Muscular Dystrophy,80,100,1,0,1
Odisha,Balangir,Muscular Dystrophy,0,6,2,1,3
Odisha,Balangir,Muscular Dystrophy,6,15,13,7,20
Odisha,Balangir,Muscular Dystrophy,15,35,20,19,39
Odisha,Balangir,Muscular Dystrophy,35,60,42,20,62
Odisha,Balangir,Muscular Dystrophy,60,80,9,7,16
Madhya Pradesh,Balaghat,Muscular Dystrophy,6,15,8,6,14
Madhya Pradesh,Balaghat,Muscular Dystrophy,15,35,10,10,20
Madhya Pradesh,Balaghat,Muscular Dystrophy,35,60,13,3,16
Madhya Pradesh,Balaghat,Muscular Dystrophy,60,80,2,0,2
Assam,Baksa,Muscular Dystrophy,15,35,1,0,1
Assam,Bajali,Muscular Dystrophy,35,60,1,0,1
Uttar Pradesh,Bahraich,Muscular Dystrophy,6,15,20,4,24
Uttar Pradesh,Bahraich,Muscular Dystrophy,15,35,86,22,108
Uttar Pradesh,Bahraich,Muscular Dystrophy,35,60,91,19,110
Uttar Pradesh,Bahraich,Muscular Dystrophy,60,80,20,3,23
Uttar Pradesh,Bahraich,Muscular Dystrophy,80,100,1,1,2
Uttar Pradesh,Baghpat,Muscular Dystrophy,6,15,2,1,3
Uttar Pradesh,Baghpat,Muscular Dystrophy,15,35,35,17,52
Uttar Pradesh,Baghpat,Muscular Dystrophy,35,60,50,16,66
Uttar Pradesh,Baghpat,Muscular Dystrophy,60,80,11,4,15
Uttarakhand,Bageshwar,Muscular Dystrophy,0,6,1,0,1
Uttarakhand,Bageshwar,Muscular Dystrophy,6,15,6,2,8
Uttarakhand,Bageshwar,Muscular Dystrophy,15,35,30,13,43
Uttarakhand,Bageshwar,Muscular Dystrophy,35,60,94,33,127
Uttarakhand,Bageshwar,Muscular Dystrophy,60,80,16,7,23
Uttarakhand,Bageshwar,Muscular Dystrophy,80,100,1,0,1
Karnataka,Bagalkote,Muscular Dystrophy,6,15,12,6,18
Karnataka,Bagalkote,Muscular Dystrophy,15,35,36,13,49
Karnataka,Bagalkote,Muscular Dystrophy,35,60,24,6,30
Karnataka,Bagalkote,Muscular Dystrophy,60,80,2,1,3
Uttar Pradesh,Azamgarh,Muscular Dystrophy,0,6,2,1,3
Uttar Pradesh,Azamgarh,Muscular Dystrophy,6,15,29,14,43
Uttar Pradesh,Azamgarh,Muscular Dystrophy,15,35,15,1,16
Uttar Pradesh,Azamgarh,Muscular Dystrophy,35,60,12,2,14
Uttar Pradesh,Ayodhya,Muscular Dystrophy,6,15,4,0,4
Uttar Pradesh,Ayodhya,Muscular Dystrophy,15,35,32,9,41
Uttar Pradesh,Ayodhya,Muscular Dystrophy,35,60,45,7,52
Uttar Pradesh,Ayodhya,Muscular Dystrophy,60,80,9,2,11
Uttar Pradesh,Ayodhya,Muscular Dystrophy,80,100,1,0,1
Bihar,Aurangabad,Muscular Dystrophy,0,6,0,2,2
Bihar,Aurangabad,Muscular Dystrophy,6,15,3,1,4
Bihar,Aurangabad,Muscular Dystrophy,15,35,30,9,39
Bihar,Aurangabad,Muscular Dystrophy,35,60,26,6,32
Bihar,Aurangabad,Muscular Dystrophy,60,80,3,1,4
Maharashtra,Aurangabad,Muscular Dystrophy,0,6,1,0,1
Maharashtra,Aurangabad,Muscular Dystrophy,6,15,11,4,15
Maharashtra,Aurangabad,Muscular Dystrophy,15,35,23,9,32
Maharashtra,Aurangabad,Muscular Dystrophy,35,60,20,6,26
Maharashtra,Aurangabad,Muscular Dystrophy,60,80,6,0,6
Uttar Pradesh,Auraiya,Muscular Dystrophy,0,6,1,1,2
Uttar Pradesh,Auraiya,Muscular Dystrophy,6,15,4,0,4
Uttar Pradesh,Auraiya,Muscular Dystrophy,15,35,19,12,31
Uttar Pradesh,Auraiya,Muscular Dystrophy,35,60,25,7,32
Uttar Pradesh,Auraiya,Muscular Dystrophy,60,80,13,0,13
Uttar Pradesh,Auraiya,Muscular Dystrophy,80,100,1,0,1
Madhya Pradesh,Ashoknagar,Muscular Dystrophy,6,15,1,0,1
Bihar,Arwal,Muscular Dystrophy,6,15,4,6,10
Bihar,Arwal,Muscular Dystrophy,15,35,29,14,43
Bihar,Arwal,Muscular Dystrophy,35,60,45,24,69
Bihar,Arwal,Muscular Dystrophy,60,80,14,8,22
Bihar,Arwal,Muscular Dystrophy,80,100,0,1,1
Gujarat,Arvalli,Muscular Dystrophy,6,15,0,1,1
Gujarat,Arvalli,Muscular Dystrophy,15,35,1,1,2
Gujarat,Arvalli,Muscular Dystrophy,35,60,2,0,2
Gujarat,Arvalli,Muscular Dystrophy,60,80,1,0,1
Tamil Nadu,Ariyalur,Muscular Dystrophy,0,6,1,1,2
Tamil Nadu,Ariyalur,Muscular Dystrophy,6,15,23,3,26
Tamil Nadu,Ariyalur,Muscular Dystrophy,15,35,39,11,50
Tamil Nadu,Ariyalur,Muscular Dystrophy,35,60,5,5,10
Tamil Nadu,Ariyalur,Muscular Dystrophy,60,80,2,0,2
Bihar,Araria,Muscular Dystrophy,0,6,3,0,3
Bihar,Araria,Muscular Dystrophy,6,15,4,4,8
Bihar,Araria,Muscular Dystrophy,15,35,11,3,14
Bihar,Araria,Muscular Dystrophy,35,60,7,2,9
Bihar,Araria,Muscular Dystrophy,60,80,1,2,3
Madhya Pradesh,Anuppur,Muscular Dystrophy,6,15,1,2,3
Madhya Pradesh,Anuppur,Muscular Dystrophy,15,35,1,1,2
Madhya Pradesh,Anuppur,Muscular Dystrophy,35,60,4,1,5
Odisha,Anugul,Muscular Dystrophy,0,6,1,1,2
Odisha,Anugul,Muscular Dystrophy,6,15,10,1,11
Odisha,Anugul,Muscular Dystrophy,15,35,16,8,24
Odisha,Anugul,Muscular Dystrophy,35,60,24,17,41
Odisha,Anugul,Muscular Dystrophy,60,80,10,2,12
Jammu And Kashmir,Anantnag,Muscular Dystrophy,0,6,3,1,4
Jammu And Kashmir,Anantnag,Muscular Dystrophy,6,15,18,7,25
Jammu And Kashmir,Anantnag,Muscular Dystrophy,15,35,33,9,42
Jammu And Kashmir,Anantnag,Muscular Dystrophy,35,60,13,9,22
Jammu And Kashmir,Anantnag,Muscular Dystrophy,60,80,0,3,3
Jammu And Kashmir,Anantnag,Muscular Dystrophy,80,100,1,0,1
Andhra Pradesh,Anantapur,Muscular Dystrophy,6,15,0,1,1
Andhra Pradesh,Anantapur,Muscular Dystrophy,15,35,1,0,1
Andhra Pradesh,Anantapur,Muscular Dystrophy,35,60,1,1,2
Gujarat,Anand,Muscular Dystrophy,6,15,17,1,18
Gujarat,Anand,Muscular Dystrophy,15,35,9,3,12
Gujarat,Anand,Muscular Dystrophy,35,60,2,0,2
Gujarat,Anand,Muscular Dystrophy,60,80,1,0,1
Uttar Pradesh,Amroha,Muscular Dystrophy,6,15,1,2,3
Uttar Pradesh,Amroha,Muscular Dystrophy,15,35,69,18,87
Uttar Pradesh,Amroha,Muscular Dystrophy,35,60,92,25,117
Uttar Pradesh,Amroha,Muscular Dystrophy,60,80,16,1,17
Punjab,Amritsar,Muscular Dystrophy,6,15,11,0,11
Punjab,Amritsar,Muscular Dystrophy,15,35,54,15,69
Punjab,Amritsar,Muscular Dystrophy,35,60,67,20,87
Punjab,Amritsar,Muscular Dystrophy,60,80,10,4,14
Gujarat,Amreli,Muscular Dystrophy,6,15,3,1,4
Gujarat,Amreli,Muscular Dystrophy,15,35,4,6,10
Gujarat,Amreli,Muscular Dystrophy,35,60,2,0,2
Maharashtra,Amravati,Muscular Dystrophy,0,6,1,0,1
Maharashtra,Amravati,Muscular Dystrophy,6,15,10,0,10
Maharashtra,Amravati,Muscular Dystrophy,15,35,18,6,24
Maharashtra,Amravati,Muscular Dystrophy,35,60,34,12,46
Maharashtra,Amravati,Muscular Dystrophy,60,80,8,1,9
Uttar Pradesh,Amethi,Muscular Dystrophy,6,15,1,1,2
Uttar Pradesh,Amethi,Muscular Dystrophy,15,35,31,11,42
Uttar Pradesh,Amethi,Muscular Dystrophy,35,60,49,6,55
Uttar Pradesh,Amethi,Muscular Dystrophy,60,80,13,2,15
Uttar Pradesh,Ambedkar Nagar,Muscular Dystrophy,6,15,5,3,8
Uttar Pradesh,Ambedkar Nagar,Muscular Dystrophy,15,35,83,30,113
Uttar Pradesh,Ambedkar Nagar,Muscular Dystrophy,35,60,109,24,133
Uttar Pradesh,Ambedkar Nagar,Muscular Dystrophy,60,80,27,6,33
Uttar Pradesh,Ambedkar Nagar,Muscular Dystrophy,80,100,1,1,2
Haryana,Ambala,Muscular Dystrophy,0,6,1,0,1
Haryana,Ambala,Muscular Dystrophy,6,15,8,1,9
Haryana,Ambala,Muscular Dystrophy,15,35,19,9,28
Haryana,Ambala,Muscular Dystrophy,35,60,40,16,56
Haryana,Ambala,Muscular Dystrophy,60,80,8,3,11
Rajasthan,Alwar,Muscular Dystrophy,0,6,1,1,2
Rajasthan,Alwar,Muscular Dystrophy,6,15,22,5,27
Rajasthan,Alwar,Muscular Dystrophy,15,35,77,32,109
Rajasthan,Alwar,Muscular Dystrophy,35,60,82,44,126
Rajasthan,Alwar,Muscular Dystrophy,60,80,14,16,30
Rajasthan,Alwar,Muscular Dystrophy,80,100,3,0,3
Uttarakhand,Almora,Muscular Dystrophy,6,15,0,1,1
Uttarakhand,Almora,Muscular Dystrophy,15,35,17,5,22
Uttarakhand,Almora,Muscular Dystrophy,35,60,7,1,8
Uttarakhand,Almora,Muscular Dystrophy,60,80,1,1,2
Madhya Pradesh,Alirajpur,Muscular Dystrophy,6,15,0,3,3
Madhya Pradesh,Alirajpur,Muscular Dystrophy,15,35,11,3,14
Madhya Pradesh,Alirajpur,Muscular Dystrophy,35,60,4,0,4
Madhya Pradesh,Alirajpur,Muscular Dystrophy,60,80,2,0,2
Uttar Pradesh,Aligarh,Muscular Dystrophy,0,6,1,0,1
Uttar Pradesh,Aligarh,Muscular Dystrophy,6,15,9,7,16
Uttar Pradesh,Aligarh,Muscular Dystrophy,15,35,125,32,157
Uttar Pradesh,Aligarh,Muscular Dystrophy,35,60,165,42,207
Uttar Pradesh,Aligarh,Muscular Dystrophy,60,80,62,2,64
Uttar Pradesh,Aligarh,Muscular Dystrophy,80,100,1,0,1
Kerala,Alappuzha,Muscular Dystrophy,6,15,9,0,9
Kerala,Alappuzha,Muscular Dystrophy,15,35,9,7,16
Kerala,Alappuzha,Muscular Dystrophy,35,60,11,9,20
Kerala,Alappuzha,Muscular Dystrophy,60,80,3,2,5
Maharashtra,Akola,Muscular Dystrophy,0,6,1,1,2
Maharashtra,Akola,Muscular Dystrophy,6,15,17,1,18
Maharashtra,Akola,Muscular Dystrophy,15,35,25,6,31
Maharashtra,Akola,Muscular Dystrophy,35,60,21,8,29
Maharashtra,Akola,Muscular Dystrophy,60,80,3,0,3
Rajasthan,Ajmer,Muscular Dystrophy,0,6,0,1,1
Rajasthan,Ajmer,Muscular Dystrophy,6,15,12,1,13
Rajasthan,Ajmer,Muscular Dystrophy,15,35,21,7,28
Rajasthan,Ajmer,Muscular Dystrophy,35,60,4,2,6
Rajasthan,Ajmer,Muscular Dystrophy,60,80,3,1,4
Mizoram,Aizawl,Muscular Dystrophy,0,6,0,1,1
Mizoram,Aizawl,Muscular Dystrophy,6,15,1,0,1
Mizoram,Aizawl,Muscular Dystrophy,15,35,4,4,8
Mizoram,Aizawl,Muscular Dystrophy,35,60,2,0,2
Mizoram,Aizawl,Muscular Dystrophy,80,100,1,0,1
Maharashtra,Ahmednagar,Muscular Dystrophy,0,6,1,0,1
Maharashtra,Ahmednagar,Muscular Dystrophy,6,15,6,1,7
Maharashtra,Ahmednagar,Muscular Dystrophy,15,35,22,9,31
Maharashtra,Ahmednagar,Muscular Dystrophy,35,60,39,9,48
Maharashtra,Ahmednagar,Muscular Dystrophy,60,80,2,2,4
Maharashtra,Ahmednagar,Muscular Dystrophy,80,100,1,0,1
Gujarat,Ahmadabad,Muscular Dystrophy,0,6,1,0,1
Gujarat,Ahmadabad,Muscular Dystrophy,6,15,10,0,10
Gujarat,Ahmadabad,Muscular Dystrophy,15,35,27,8,35
Gujarat,Ahmadabad,Muscular Dystrophy,35,60,33,16,49
Gujarat,Ahmadabad,Muscular Dystrophy,60,80,8,2,10
Uttar Pradesh,Agra,Muscular Dystrophy,0,6,0,1,1
Uttar Pradesh,Agra,Muscular Dystrophy,6,15,16,2,18
Uttar Pradesh,Agra,Muscular Dystrophy,15,35,39,3,42
Uttar Pradesh,Agra,Muscular Dystrophy,35,60,25,3,28
Uttar Pradesh,Agra,Muscular Dystrophy,60,80,4,0,4
Madhya Pradesh,Agar Malwa,Muscular Dystrophy,6,15,2,1,3
Madhya Pradesh,Agar Malwa,Muscular Dystrophy,35,60,2,0,2
West Bengal,24 Paraganas South,Muscular Dystrophy,35,60,2,1,3
Haryana,Yamunanagar,Parkinson'S Disease,15,35,1,0,1
Haryana,Yamunanagar,Parkinson'S Disease,35,60,4,1,5
Haryana,Yamunanagar,Parkinson'S Disease,60,80,1,0,1
Karnataka,Yadgir,Parkinson'S Disease,35,60,0,1,1
Jharkhand,West Singhbhum,Parkinson'S Disease,6,15,3,4,7
Jharkhand,West Singhbhum,Parkinson'S Disease,15,35,3,5,8
Jharkhand,West Singhbhum,Parkinson'S Disease,35,60,10,2,12
Jharkhand,West Singhbhum,Parkinson'S Disease,60,80,1,0,1
Delhi,West,Parkinson'S Disease,35,60,4,0,4
Delhi,West,Parkinson'S Disease,60,80,3,0,3
Kerala,Wayanad,Parkinson'S Disease,35,60,2,1,3
Kerala,Wayanad,Parkinson'S Disease,60,80,3,0,3
Maharashtra,Washim,Parkinson'S Disease,35,60,1,0,1
Maharashtra,Wardha,Parkinson'S Disease,35,60,3,0,3
Maharashtra,Wardha,Parkinson'S Disease,80,100,1,0,1
Andhra Pradesh,Visakhapatanam,Parkinson'S Disease,35,60,1,0,1
Tamil Nadu,Virudhunagar,Parkinson'S Disease,6,15,0,1,1
Tamil Nadu,Virudhunagar,Parkinson'S Disease,35,60,4,1,5
Tamil Nadu,Virudhunagar,Parkinson'S Disease,60,80,5,0,5
Tamil Nadu,Villupuram,Parkinson'S Disease,15,35,2,1,3
Tamil Nadu,Villupuram,Parkinson'S Disease,35,60,5,1,6
Tamil Nadu,Villupuram,Parkinson'S Disease,60,80,5,1,6
Karnataka,Vijayapura,Parkinson'S Disease,6,15,1,0,1
Karnataka,Vijayapura,Parkinson'S Disease,15,35,1,3,4
Karnataka,Vijayapura,Parkinson'S Disease,35,60,13,2,15
Karnataka,Vijayapura,Parkinson'S Disease,60,80,0,1,1
Madhya Pradesh,Vidisha,Parkinson'S Disease,6,15,4,0,4
Madhya Pradesh,Vidisha,Parkinson'S Disease,15,35,19,3,22
Madhya Pradesh,Vidisha,Parkinson'S Disease,35,60,24,10,34
Madhya Pradesh,Vidisha,Parkinson'S Disease,60,80,10,1,11
Madhya Pradesh,Vidisha,Parkinson'S Disease,80,100,1,0,1
Tamil Nadu,Vellore,Parkinson'S Disease,6,15,1,0,1
Tamil Nadu,Vellore,Parkinson'S Disease,35,60,6,4,10
Tamil Nadu,Vellore,Parkinson'S Disease,60,80,1,1,2
Uttar Pradesh,Varanasi,Parkinson'S Disease,35,60,6,1,7
Uttar Pradesh,Varanasi,Parkinson'S Disease,60,80,3,2,5
Gujarat,Valsad,Parkinson'S Disease,15,35,1,0,1
Gujarat,Valsad,Parkinson'S Disease,35,60,2,0,2
Bihar,Vaishali,Parkinson'S Disease,6,15,1,3,4
Bihar,Vaishali,Parkinson'S Disease,15,35,18,1,19
Bihar,Vaishali,Parkinson'S Disease,35,60,15,1,16
Bihar,Vaishali,Parkinson'S Disease,60,80,5,0,5
Gujarat,Vadodara,Parkinson'S Disease,35,60,4,1,5
Gujarat,Vadodara,Parkinson'S Disease,60,80,1,1,2
Karnataka,Uttara Kannada,Parkinson'S Disease,35,60,3,1,4
Karnataka,Uttara Kannada,Parkinson'S Disease,60,80,4,3,7
Uttarakhand,Uttar Kashi,Parkinson'S Disease,15,35,1,0,1
Uttarakhand,Uttar Kashi,Parkinson'S Disease,35,60,1,0,1
Uttar Pradesh,Unnao,Parkinson'S Disease,15,35,1,0,1
Uttar Pradesh,Unnao,Parkinson'S Disease,35,60,3,1,4
Himachal Pradesh,Una,Parkinson'S Disease,6,15,2,0,2
Himachal Pradesh,Una,Parkinson'S Disease,35,60,1,0,1
Himachal Pradesh,Una,Parkinson'S Disease,60,80,2,0,2
Madhya Pradesh,Umaria,Parkinson'S Disease,35,60,0,2,2
Manipur,Ukhrul,Parkinson'S Disease,35,60,1,0,1
Madhya Pradesh,Ujjain,Parkinson'S Disease,6,15,1,0,1
Madhya Pradesh,Ujjain,Parkinson'S Disease,15,35,1,1,2
Madhya Pradesh,Ujjain,Parkinson'S Disease,35,60,2,2,4
Madhya Pradesh,Ujjain,Parkinson'S Disease,60,80,1,1,2
Karnataka,Udupi,Parkinson'S Disease,15,35,1,0,1
Karnataka,Udupi,Parkinson'S Disease,35,60,3,1,4
Karnataka,Udupi,Parkinson'S Disease,60,80,11,0,11
Jammu And Kashmir,Udhampur,Parkinson'S Disease,15,35,0,1,1
Jammu And Kashmir,Udhampur,Parkinson'S Disease,35,60,3,0,3
Uttarakhand,Udam Singh Nagar,Parkinson'S Disease,15,35,4,4,8
Uttarakhand,Udam Singh Nagar,Parkinson'S Disease,35,60,5,3,8
Uttarakhand,Udam Singh Nagar,Parkinson'S Disease,60,80,1,0,1
Assam,Udalguri,Parkinson'S Disease,15,35,1,0,1
Rajasthan,Udaipur,Parkinson'S Disease,6,15,0,1,1
Rajasthan,Udaipur,Parkinson'S Disease,15,35,2,0,2
Rajasthan,Udaipur,Parkinson'S Disease,60,80,1,0,1
Karnataka,Tumakuru,Parkinson'S Disease,15,35,4,1,5
Karnataka,Tumakuru,Parkinson'S Disease,35,60,14,8,22
Karnataka,Tumakuru,Parkinson'S Disease,60,80,3,0,3
Karnataka,Tumakuru,Parkinson'S Disease,80,100,1,0,1
Rajasthan,Tonk,Parkinson'S Disease,15,35,1,0,1
Rajasthan,Tonk,Parkinson'S Disease,35,60,0,1,1
Tamil Nadu,Tiruvannamalai,Parkinson'S Disease,35,60,2,4,6
Tamil Nadu,Tiruvannamalai,Parkinson'S Disease,60,80,3,2,5
Tamil Nadu,Tiruvannamalai,Parkinson'S Disease,80,100,0,1,1
Tamil Nadu,Tiruppur,Parkinson'S Disease,35,60,0,1,1
Tamil Nadu,Tirupathur,Parkinson'S Disease,35,60,2,1,3
Tamil Nadu,Tirupathur,Parkinson'S Disease,60,80,1,0,1
Tamil Nadu,Tirunelveli,Parkinson'S Disease,35,60,3,0,3
Tamil Nadu,Tirunelveli,Parkinson'S Disease,80,100,1,0,1
Tamil Nadu,Tiruchirappalli,Parkinson'S Disease,35,60,13,2,15
Tamil Nadu,Tiruchirappalli,Parkinson'S Disease,60,80,11,3,14
Madhya Pradesh,Tikamgarh,Parkinson'S Disease,15,35,1,0,1
Madhya Pradesh,Tikamgarh,Parkinson'S Disease,35,60,1,0,1
Madhya Pradesh,Tikamgarh,Parkinson'S Disease,60,80,2,0,2
Kerala,Thrissur,Parkinson'S Disease,15,35,0,1,1
Kerala,Thrissur,Parkinson'S Disease,35,60,11,2,13
Kerala,Thrissur,Parkinson'S Disease,60,80,6,3,9
Tamil Nadu,Thiruvarur,Parkinson'S Disease,35,60,2,0,2
Tamil Nadu,Thiruvarur,Parkinson'S Disease,60,80,1,0,1
Kerala,Thiruvananthapuram,Parkinson'S Disease,15,35,0,1,1
Kerala,Thiruvananthapuram,Parkinson'S Disease,35,60,12,4,16
Kerala,Thiruvananthapuram,Parkinson'S Disease,60,80,16,3,19
Kerala,Thiruvananthapuram,Parkinson'S Disease,80,100,0,1,1
Tamil Nadu,Thiruvallur,Parkinson'S Disease,15,35,1,0,1
Tamil Nadu,Thiruvallur,Parkinson'S Disease,35,60,9,3,12
Tamil Nadu,Thiruvallur,Parkinson'S Disease,60,80,2,0,2
Tamil Nadu,Theni,Parkinson'S Disease,35,60,2,1,3
Tamil Nadu,Theni,Parkinson'S Disease,60,80,5,0,5
Tamil Nadu,Thanjavur,Parkinson'S Disease,35,60,2,2,4
Tamil Nadu,Thanjavur,Parkinson'S Disease,60,80,0,1,1
Maharashtra,Thane,Parkinson'S Disease,15,35,2,0,2
Maharashtra,Thane,Parkinson'S Disease,35,60,15,5,20
Maharashtra,Thane,Parkinson'S Disease,60,80,16,5,21
Tamil Nadu,Tenkasi,Parkinson'S Disease,60,80,0,1,1
Uttarakhand,Tehri Garhwal,Parkinson'S Disease,35,60,1,2,3
Uttarakhand,Tehri Garhwal,Parkinson'S Disease,60,80,1,0,1
Punjab,Tarn Taran,Parkinson'S Disease,15,35,3,1,4
Punjab,Tarn Taran,Parkinson'S Disease,35,60,1,0,1
Gujarat,Tapi,Parkinson'S Disease,60,80,1,0,1
Manipur,Tamenglong,Parkinson'S Disease,80,100,0,1,1
Chhattisgarh,Surguja,Parkinson'S Disease,6,15,1,0,1
Chhattisgarh,Surguja,Parkinson'S Disease,15,35,18,6,24
Chhattisgarh,Surguja,Parkinson'S Disease,35,60,81,28,109
Chhattisgarh,Surguja,Parkinson'S Disease,60,80,45,10,55
Chhattisgarh,Surguja,Parkinson'S Disease,80,100,2,0,2
Gujarat,Surendranagar,Parkinson'S Disease,35,60,1,0,1
Gujarat,Surendranagar,Parkinson'S Disease,60,80,2,0,2
Gujarat,Surat,Parkinson'S Disease,35,60,1,0,1
Chhattisgarh,Surajpur,Parkinson'S Disease,6,15,0,1,1
Chhattisgarh,Surajpur,Parkinson'S Disease,15,35,5,1,6
Chhattisgarh,Surajpur,Parkinson'S Disease,35,60,24,1,25
Chhattisgarh,Surajpur,Parkinson'S Disease,60,80,4,2,6
Chhattisgarh,Surajpur,Parkinson'S Disease,80,100,1,0,1
Bihar,Supaul,Parkinson'S Disease,35,60,0,1,1
Odisha,Sundargarh,Parkinson'S Disease,6,15,5,0,5
Odisha,Sundargarh,Parkinson'S Disease,15,35,3,3,6
Odisha,Sundargarh,Parkinson'S Disease,35,60,13,6,19
Odisha,Sundargarh,Parkinson'S Disease,60,80,4,1,5
Uttar Pradesh,Sultanpur,Parkinson'S Disease,15,35,4,3,7
Uttar Pradesh,Sultanpur,Parkinson'S Disease,35,60,4,1,5
Uttar Pradesh,Sultanpur,Parkinson'S Disease,60,80,3,0,3
Chhattisgarh,Sukma,Parkinson'S Disease,35,60,0,1,1
Jammu And Kashmir,Srinagar,Parkinson'S Disease,35,60,1,2,3
Jammu And Kashmir,Srinagar,Parkinson'S Disease,60,80,0,1,1
Punjab,Sri Muktsar Sahib,Parkinson'S Disease,15,35,0,4,4
Punjab,Sri Muktsar Sahib,Parkinson'S Disease,35,60,3,3,6
Delhi,South West,Parkinson'S Disease,35,60,4,0,4
Goa,South Goa,Parkinson'S Disease,60,80,0,1,1
Delhi,South East,Parkinson'S Disease,35,60,1,0,1
Andaman And Nicobar Islands,South Andamans,Parkinson'S Disease,15,35,1,0,1
Andaman And Nicobar Islands,South Andamans,Parkinson'S Disease,35,60,1,1,2
Delhi,South,Parkinson'S Disease,60,80,1,1,2
Assam,Sonitpur,Parkinson'S Disease,35,60,2,0,2
Haryana,Sonipat,Parkinson'S Disease,35,60,1,0,1
Odisha,Sonepur,Parkinson'S Disease,35,60,3,0,3
Odisha,Sonepur,Parkinson'S Disease,60,80,0,1,1
Uttar Pradesh,Sonbhadra,Parkinson'S Disease,15,35,1,0,1
Uttar Pradesh,Sonbhadra,Parkinson'S Disease,35,60,1,2,3
Uttar Pradesh,Sonbhadra,Parkinson'S Disease,60,80,2,1,3
Maharashtra,Solapur,Parkinson'S Disease,35,60,2,1,3
Himachal Pradesh,Solan,Parkinson'S Disease,35,60,1,1,2
Himachal Pradesh,Solan,Parkinson'S Disease,60,80,0,1,1
Bihar,Siwan,Parkinson'S Disease,15,35,0,1,1
Bihar,Siwan,Parkinson'S Disease,35,60,1,0,1
Bihar,Siwan,Parkinson'S Disease,60,80,1,0,1
Assam,Sivasagar,Parkinson'S Disease,15,35,1,0,1
Tamil Nadu,Sivaganga,Parkinson'S Disease,15,35,0,1,1
Tamil Nadu,Sivaganga,Parkinson'S Disease,35,60,9,4,13
Tamil Nadu,Sivaganga,Parkinson'S Disease,60,80,6,6,12
Tamil Nadu,Sivaganga,Parkinson'S Disease,80,100,1,0,1
Uttar Pradesh,Sitapur,Parkinson'S Disease,6,15,1,0,1
Uttar Pradesh,Sitapur,Parkinson'S Disease,15,35,3,1,4
Uttar Pradesh,Sitapur,Parkinson'S Disease,35,60,2,0,2
Uttar Pradesh,Sitapur,Parkinson'S Disease,60,80,0,2,2
Bihar,Sitamarhi,Parkinson'S Disease,6,15,1,0,1
Bihar,Sitamarhi,Parkinson'S Disease,15,35,1,0,1
Bihar,Sitamarhi,Parkinson'S Disease,35,60,4,0,4
Rajasthan,Sirohi,Parkinson'S Disease,15,35,1,0,1
Rajasthan,Sirohi,Parkinson'S Disease,35,60,1,0,1
Himachal Pradesh,Sirmaur,Parkinson'S Disease,15,35,1,0,1
Himachal Pradesh,Sirmaur,Parkinson'S Disease,35,60,2,1,3
Himachal Pradesh,Sirmaur,Parkinson'S Disease,60,80,1,0,1
Madhya Pradesh,Singrauli,Parkinson'S Disease,35,60,1,0,1
Maharashtra,Sindhudurg,Parkinson'S Disease,35,60,1,0,1
Jharkhand,Simdega,Parkinson'S Disease,35,60,3,1,4
Rajasthan,Sikar,Parkinson'S Disease,35,60,1,0,1
Madhya Pradesh,Sidhi,Parkinson'S Disease,15,35,5,5,10
Madhya Pradesh,Sidhi,Parkinson'S Disease,35,60,5,5,10
Madhya Pradesh,Sidhi,Parkinson'S Disease,60,80,1,0,1
Uttar Pradesh,Siddharth Nagar,Parkinson'S Disease,6,15,1,0,1
Uttar Pradesh,Siddharth Nagar,Parkinson'S Disease,15,35,4,4,8
Uttar Pradesh,Siddharth Nagar,Parkinson'S Disease,35,60,9,2,11
Uttar Pradesh,Siddharth Nagar,Parkinson'S Disease,60,80,1,2,3
Uttar Pradesh,Shravasti,Parkinson'S Disease,6,15,1,0,1
Jammu And Kashmir,Shopian,Parkinson'S Disease,60,80,1,0,1
Madhya Pradesh,Shivpuri,Parkinson'S Disease,15,35,1,2,3
Madhya Pradesh,Shivpuri,Parkinson'S Disease,35,60,0,1,1
Karnataka,Shivamogga,Parkinson'S Disease,15,35,5,2,7
Karnataka,Shivamogga,Parkinson'S Disease,35,60,13,10,23
Karnataka,Shivamogga,Parkinson'S Disease,60,80,16,1,17
Himachal Pradesh,Shimla,Parkinson'S Disease,35,60,0,1,1
Himachal Pradesh,Shimla,Parkinson'S Disease,60,80,0,1,1
Madhya Pradesh,Sheopur,Parkinson'S Disease,60,80,2,0,2
Bihar,Sheohar,Parkinson'S Disease,6,15,1,0,1
Bihar,Sheohar,Parkinson'S Disease,15,35,1,2,3
Bihar,Sheohar,Parkinson'S Disease,35,60,1,1,2
Bihar,Sheohar,Parkinson'S Disease,60,80,2,0,2
Bihar,Sheikhpura,Parkinson'S Disease,35,60,0,1,1
Uttar Pradesh,Shamli,Parkinson'S Disease,6,15,1,0,1
Uttar Pradesh,Shamli,Parkinson'S Disease,15,35,2,1,3
Uttar Pradesh,Shamli,Parkinson'S Disease,35,60,7,0,7
Uttar Pradesh,Shamli,Parkinson'S Disease,60,80,1,0,1
Uttar Pradesh,Shahjahanpur,Parkinson'S Disease,6,15,2,0,2
Uttar Pradesh,Shahjahanpur,Parkinson'S Disease,15,35,3,0,3
Uttar Pradesh,Shahjahanpur,Parkinson'S Disease,35,60,6,3,9
Uttar Pradesh,Shahjahanpur,Parkinson'S Disease,60,80,1,0,1
Punjab,Shahid Bhagat Singh Nagar,Parkinson'S Disease,6,15,1,0,1
Punjab,Shahid Bhagat Singh Nagar,Parkinson'S Disease,35,60,9,2,11
Punjab,Shahid Bhagat Singh Nagar,Parkinson'S Disease,60,80,1,0,1
Punjab,Shahid Bhagat Singh Nagar,Parkinson'S Disease,80,100,0,1,1
Madhya Pradesh,Shahdol,Parkinson'S Disease,15,35,2,0,2
Madhya Pradesh,Shahdol,Parkinson'S Disease,35,60,2,4,6
Delhi,Shahdara,Parkinson'S Disease,35,60,1,0,1
Madhya Pradesh,Seoni,Parkinson'S Disease,6,15,0,1,1
Madhya Pradesh,Seoni,Parkinson'S Disease,15,35,2,0,2
Madhya Pradesh,Seoni,Parkinson'S Disease,35,60,7,0,7
Madhya Pradesh,Seoni,Parkinson'S Disease,60,80,1,0,1
Madhya Pradesh,Seoni,Parkinson'S Disease,80,100,1,1,2
Madhya Pradesh,Sehore,Parkinson'S Disease,6,15,1,0,1
Madhya Pradesh,Satna,Parkinson'S Disease,35,60,6,1,7
Madhya Pradesh,Satna,Parkinson'S Disease,60,80,4,2,6
Maharashtra,Satara,Parkinson'S Disease,15,35,2,0,2
Maharashtra,Satara,Parkinson'S Disease,35,60,4,1,5
Maharashtra,Satara,Parkinson'S Disease,60,80,1,0,1
Bihar,Saran,Parkinson'S Disease,15,35,2,1,3
Bihar,Saran,Parkinson'S Disease,35,60,8,2,10
Bihar,Saran,Parkinson'S Disease,60,80,1,1,2
Jharkhand,Saraikela Kharsawan,Parkinson'S Disease,35,60,1,0,1
Uttar Pradesh,Sant Kabeer Nagar,Parkinson'S Disease,15,35,1,0,1
Uttar Pradesh,Sant Kabeer Nagar,Parkinson'S Disease,35,60,2,1,3
Uttar Pradesh,Sant Kabeer Nagar,Parkinson'S Disease,60,80,1,0,1
Punjab,Sangrur,Parkinson'S Disease,15,35,0,1,1
Punjab,Sangrur,Parkinson'S Disease,35,60,1,3,4
Punjab,Sangrur,Parkinson'S Disease,60,80,2,0,2
Maharashtra,Sangli,Parkinson'S Disease,6,15,0,1,1
Maharashtra,Sangli,Parkinson'S Disease,15,35,1,0,1
Maharashtra,Sangli,Parkinson'S Disease,35,60,5,0,5
Maharashtra,Sangli,Parkinson'S Disease,60,80,1,0,1
Odisha,Sambalpur,Parkinson'S Disease,15,35,0,1,1
Odisha,Sambalpur,Parkinson'S Disease,35,60,3,0,3
Odisha,Sambalpur,Parkinson'S Disease,60,80,0,1,1
Jammu And Kashmir,Samba,Parkinson'S Disease,35,60,2,0,2
Jammu And Kashmir,Samba,Parkinson'S Disease,60,80,2,0,2
Bihar,Samastipur,Parkinson'S Disease,0,6,1,0,1
Bihar,Samastipur,Parkinson'S Disease,6,15,6,6,12
Bihar,Samastipur,Parkinson'S Disease,15,35,33,16,49
Bihar,Samastipur,Parkinson'S Disease,35,60,29,24,53
Bihar,Samastipur,Parkinson'S Disease,60,80,9,3,12
Tamil Nadu,Salem,Parkinson'S Disease,35,60,3,0,3
Jharkhand,Sahebganj,Parkinson'S Disease,15,35,1,0,1
Jharkhand,Sahebganj,Parkinson'S Disease,35,60,3,0,3
Bihar,Saharsa,Parkinson'S Disease,15,35,5,1,6
Bihar,Saharsa,Parkinson'S Disease,35,60,4,1,5
Bihar,Saharsa,Parkinson'S Disease,60,80,2,0,2
Uttar Pradesh,Saharanpur,Parkinson'S Disease,6,15,2,2,4
Uttar Pradesh,Saharanpur,Parkinson'S Disease,15,35,18,2,20
Uttar Pradesh,Saharanpur,Parkinson'S Disease,35,60,14,7,21
Uttar Pradesh,Saharanpur,Parkinson'S Disease,60,80,4,2,6
Madhya Pradesh,Sagar,Parkinson'S Disease,15,35,1,0,1
Madhya Pradesh,Sagar,Parkinson'S Disease,35,60,5,0,5
Madhya Pradesh,Sagar,Parkinson'S Disease,60,80,1,0,1
Gujarat,Sabar Kantha,Parkinson'S Disease,35,60,2,0,2
Gujarat,Sabar Kantha,Parkinson'S Disease,60,80,1,0,1
Punjab,S.A.S Nagar,Parkinson'S Disease,15,35,1,1,2
Punjab,S.A.S Nagar,Parkinson'S Disease,35,60,3,4,7
Punjab,S.A.S Nagar,Parkinson'S Disease,60,80,1,1,2
Punjab,Rupnagar,Parkinson'S Disease,6,15,1,0,1
Punjab,Rupnagar,Parkinson'S Disease,15,35,1,0,1
Punjab,Rupnagar,Parkinson'S Disease,35,60,1,1,2
Punjab,Rupnagar,Parkinson'S Disease,60,80,0,2,2
Uttarakhand,Rudra Prayag,Parkinson'S Disease,6,15,1,0,1
Uttarakhand,Rudra Prayag,Parkinson'S Disease,35,60,4,0,4
Bihar,Rohtas,Parkinson'S Disease,6,15,2,0,2
Bihar,Rohtas,Parkinson'S Disease,15,35,2,1,3
Bihar,Rohtas,Parkinson'S Disease,35,60,4,1,5
Bihar,Rohtas,Parkinson'S Disease,60,80,0,1,1
Haryana,Rohtak,Parkinson'S Disease,15,35,1,0,1
Haryana,Rohtak,Parkinson'S Disease,35,60,2,0,2
Haryana,Rewari,Parkinson'S Disease,15,35,1,0,1
Haryana,Rewari,Parkinson'S Disease,60,80,0,1,1
Madhya Pradesh,Rewa,Parkinson'S Disease,15,35,1,0,1
Madhya Pradesh,Rewa,Parkinson'S Disease,35,60,3,1,4
Madhya Pradesh,Rewa,Parkinson'S Disease,60,80,1,0,1
Odisha,Rayagada,Parkinson'S Disease,15,35,3,3,6
Odisha,Rayagada,Parkinson'S Disease,35,60,2,2,4
Odisha,Rayagada,Parkinson'S Disease,60,80,0,1,1
Maharashtra,Ratnagiri,Parkinson'S Disease,35,60,1,0,1
Maharashtra,Ratnagiri,Parkinson'S Disease,60,80,3,0,3
Madhya Pradesh,Ratlam,Parkinson'S Disease,15,35,1,0,1
Madhya Pradesh,Ratlam,Parkinson'S Disease,35,60,1,0,1
Madhya Pradesh,Ratlam,Parkinson'S Disease,60,80,1,0,1
Tamil Nadu,Ranipet,Parkinson'S Disease,35,60,1,1,2
Tamil Nadu,Ranipet,Parkinson'S Disease,60,80,1,0,1
Jharkhand,Ranchi,Parkinson'S Disease,35,60,1,1,2
Uttar Pradesh,Rampur,Parkinson'S Disease,15,35,4,1,5
Uttar Pradesh,Rampur,Parkinson'S Disease,35,60,1,0,1
Jharkhand,Ramgarh,Parkinson'S Disease,6,15,5,4,9
Jharkhand,Ramgarh,Parkinson'S Disease,15,35,9,8,17
Jharkhand,Ramgarh,Parkinson'S Disease,35,60,27,12,39
Jharkhand,Ramgarh,Parkinson'S Disease,60,80,2,4,6
Jharkhand,Ramgarh,Parkinson'S Disease,80,100,2,0,2
Jammu And Kashmir,Ramban,Parkinson'S Disease,60,80,0,1,1
Tamil Nadu,Ramanathapuram,Parkinson'S Disease,35,60,3,0,3
Tamil Nadu,Ramanathapuram,Parkinson'S Disease,60,80,1,1,2
Karnataka,Ramanagara,Parkinson'S Disease,15,35,1,0,1
Karnataka,Ramanagara,Parkinson'S Disease,35,60,7,3,10
Karnataka,Ramanagara,Parkinson'S Disease,60,80,3,0,3
Rajasthan,Rajsamand,Parkinson'S Disease,6,15,1,0,1
Rajasthan,Rajsamand,Parkinson'S Disease,15,35,3,0,3
Rajasthan,Rajsamand,Parkinson'S Disease,60,80,0,1,1
Jammu And Kashmir,Rajouri,Parkinson'S Disease,35,60,3,4,7
Jammu And Kashmir,Rajouri,Parkinson'S Disease,60,80,4,0,4
Jammu And Kashmir,Rajouri,Parkinson'S Disease,80,100,1,0,1
Chhattisgarh,Rajnandgaon,Parkinson'S Disease,15,35,0,1,1
Chhattisgarh,Rajnandgaon,Parkinson'S Disease,35,60,2,2,4
Chhattisgarh,Rajnandgaon,Parkinson'S Disease,60,80,0,2,2
Gujarat,Rajkot,Parkinson'S Disease,35,60,1,0,1
Madhya Pradesh,Rajgarh,Parkinson'S Disease,15,35,2,1,3
Madhya Pradesh,Rajgarh,Parkinson'S Disease,35,60,6,1,7
Madhya Pradesh,Raisen,Parkinson'S Disease,15,35,0,1,1
Madhya Pradesh,Raisen,Parkinson'S Disease,60,80,1,0,1
Chhattisgarh,Raipur,Parkinson'S Disease,35,60,1,0,1
Chhattisgarh,Raigarh,Parkinson'S Disease,35,60,1,0,1
Chhattisgarh,Raigarh,Parkinson'S Disease,60,80,2,0,2
Maharashtra,Raigad,Parkinson'S Disease,15,35,1,1,2
Maharashtra,Raigad,Parkinson'S Disease,35,60,1,0,1
Maharashtra,Raigad,Parkinson'S Disease,60,80,3,0,3
Karnataka,Raichur,Parkinson'S Disease,15,35,2,2,4
Karnataka,Raichur,Parkinson'S Disease,35,60,6,4,10
Karnataka,Raichur,Parkinson'S Disease,60,80,9,1,10
Uttar Pradesh,Rae Bareli,Parkinson'S Disease,35,60,1,1,2
Uttar Pradesh,Rae Bareli,Parkinson'S Disease,60,80,1,0,1
Bihar,Purnia,Parkinson'S Disease,15,35,2,2,4
Bihar,Purnia,Parkinson'S Disease,35,60,3,0,3
Odisha,Puri,Parkinson'S Disease,15,35,2,0,2
Odisha,Puri,Parkinson'S Disease,35,60,1,1,2
Odisha,Puri,Parkinson'S Disease,60,80,6,0,6
Bihar,Purbi Champaran,Parkinson'S Disease,6,15,5,0,5
Bihar,Purbi Champaran,Parkinson'S Disease,15,35,18,5,23
Bihar,Purbi Champaran,Parkinson'S Disease,35,60,19,4,23
Bihar,Purbi Champaran,Parkinson'S Disease,60,80,3,2,5
Maharashtra,Pune,Parkinson'S Disease,15,35,1,1,2
Maharashtra,Pune,Parkinson'S Disease,35,60,11,4,15
Maharashtra,Pune,Parkinson'S Disease,60,80,13,0,13
Jammu And Kashmir,Pulwama,Parkinson'S Disease,15,35,1,0,1
Jammu And Kashmir,Pulwama,Parkinson'S Disease,35,60,9,6,15
Jammu And Kashmir,Pulwama,Parkinson'S Disease,60,80,3,0,3
Tamil Nadu,Pudukkottai,Parkinson'S Disease,35,60,4,0,4
Tamil Nadu,Pudukkottai,Parkinson'S Disease,60,80,3,0,3
Uttar Pradesh,Prayagraj,Parkinson'S Disease,15,35,1,2,3
Uttar Pradesh,Prayagraj,Parkinson'S Disease,35,60,3,0,3
Rajasthan,Pratapgarh,Parkinson'S Disease,35,60,2,0,2
Rajasthan,Pratapgarh,Parkinson'S Disease,60,80,0,2,2
Uttar Pradesh,Pratapgarh,Parkinson'S Disease,6,15,0,1,1
Uttar Pradesh,Pratapgarh,Parkinson'S Disease,15,35,1,5,6
Uttar Pradesh,Pratapgarh,Parkinson'S Disease,35,60,5,1,6
Uttar Pradesh,Pratapgarh,Parkinson'S Disease,60,80,2,0,2
Jammu And Kashmir,Poonch,Parkinson'S Disease,6,15,0,2,2
Jammu And Kashmir,Poonch,Parkinson'S Disease,15,35,5,6,11
Jammu And Kashmir,Poonch,Parkinson'S Disease,35,60,1,4,5
Jammu And Kashmir,Poonch,Parkinson'S Disease,60,80,1,1,2
Puducherry,Pondicherry,Parkinson'S Disease,35,60,2,0,2
Puducherry,Pondicherry,Parkinson'S Disease,60,80,1,0,1
Uttar Pradesh,Pilibhit,Parkinson'S Disease,15,35,6,1,7
Uttar Pradesh,Pilibhit,Parkinson'S Disease,35,60,1,0,1
Uttar Pradesh,Pilibhit,Parkinson'S Disease,60,80,2,0,2
Tamil Nadu,Perambalur,Parkinson'S Disease,35,60,1,1,2
Tamil Nadu,Perambalur,Parkinson'S Disease,60,80,1,1,2
Uttarakhand,Pauri Garhwal,Parkinson'S Disease,6,15,0,1,1
Uttarakhand,Pauri Garhwal,Parkinson'S Disease,15,35,0,1,1
Uttarakhand,Pauri Garhwal,Parkinson'S Disease,35,60,2,0,2
Uttarakhand,Pauri Garhwal,Parkinson'S Disease,60,80,1,0,1
Bihar,Patna,Parkinson'S Disease,0,6,1,0,1
Bihar,Patna,Parkinson'S Disease,6,15,3,0,3
Bihar,Patna,Parkinson'S Disease,15,35,4,1,5
Bihar,Patna,Parkinson'S Disease,35,60,8,3,11
Bihar,Patna,Parkinson'S Disease,60,80,1,0,1
Punjab,Patiala,Parkinson'S Disease,15,35,1,3,4
Punjab,Patiala,Parkinson'S Disease,35,60,4,1,5
Punjab,Patiala,Parkinson'S Disease,60,80,2,0,2
Punjab,Pathankot,Parkinson'S Disease,6,15,1,0,1
Punjab,Pathankot,Parkinson'S Disease,15,35,1,0,1
Punjab,Pathankot,Parkinson'S Disease,35,60,0,4,4
Punjab,Pathankot,Parkinson'S Disease,60,80,1,0,1
Kerala,Pathanamthitta,Parkinson'S Disease,15,35,1,0,1
Kerala,Pathanamthitta,Parkinson'S Disease,35,60,2,0,2
Kerala,Pathanamthitta,Parkinson'S Disease,60,80,1,0,1
Gujarat,Patan,Parkinson'S Disease,35,60,0,1,1
Gujarat,Patan,Parkinson'S Disease,60,80,1,0,1
Bihar,Pashchim Champaran,Parkinson'S Disease,6,15,0,1,1
Bihar,Pashchim Champaran,Parkinson'S Disease,15,35,2,0,2
Bihar,Pashchim Champaran,Parkinson'S Disease,35,60,6,0,6
Maharashtra,Parbhani,Parkinson'S Disease,15,35,1,0,1
Maharashtra,Parbhani,Parkinson'S Disease,35,60,2,1,3
Maharashtra,Parbhani,Parkinson'S Disease,60,80,3,0,3
Arunachal Pradesh,Papum Pare,Parkinson'S Disease,35,60,2,0,2
Madhya Pradesh,Panna,Parkinson'S Disease,15,35,4,2,6
Madhya Pradesh,Panna,Parkinson'S Disease,35,60,7,5,12
Madhya Pradesh,Panna,Parkinson'S Disease,60,80,1,0,1
Haryana,Panipat,Parkinson'S Disease,15,35,0,1,1
Haryana,Panchkula,Parkinson'S Disease,35,60,1,0,1
Haryana,Panchkula,Parkinson'S Disease,60,80,1,2,3
Gujarat,Panch Mahals,Parkinson'S Disease,35,60,2,0,2
Haryana,Palwal,Parkinson'S Disease,15,35,1,0,1
Rajasthan,Pali,Parkinson'S Disease,15,35,1,1,2
Rajasthan,Pali,Parkinson'S Disease,35,60,0,1,1
Maharashtra,Palghar,Parkinson'S Disease,15,35,1,0,1
Maharashtra,Palghar,Parkinson'S Disease,35,60,9,0,9
Maharashtra,Palghar,Parkinson'S Disease,60,80,6,1,7
Jharkhand,Palamu,Parkinson'S Disease,6,15,1,0,1
Jharkhand,Palamu,Parkinson'S Disease,15,35,2,2,4
Jharkhand,Palamu,Parkinson'S Disease,35,60,1,2,3
Jharkhand,Palamu,Parkinson'S Disease,60,80,1,1,2
Kerala,Palakkad,Parkinson'S Disease,35,60,5,0,5
Kerala,Palakkad,Parkinson'S Disease,60,80,4,1,5
Jharkhand,Pakur,Parkinson'S Disease,15,35,1,0,1
Jharkhand,Pakur,Parkinson'S Disease,35,60,1,0,1
Maharashtra,Osmanabad,Parkinson'S Disease,35,60,1,0,1
Maharashtra,Osmanabad,Parkinson'S Disease,60,80,1,0,1
Haryana,Nuh,Parkinson'S Disease,15,35,0,1,1
Haryana,Nuh,Parkinson'S Disease,35,60,1,0,1
Odisha,Nuapada,Parkinson'S Disease,15,35,2,0,2
Odisha,Nuapada,Parkinson'S Disease,35,60,1,0,1
Delhi,North West,Parkinson'S Disease,15,35,1,0,1
Delhi,North West,Parkinson'S Disease,35,60,1,2,3
Delhi,North West,Parkinson'S Disease,60,80,1,0,1
Goa,North Goa,Parkinson'S Disease,35,60,4,0,4
Goa,North Goa,Parkinson'S Disease,60,80,1,1,2
Delhi,North East,Parkinson'S Disease,15,35,2,0,2
Delhi,North East,Parkinson'S Disease,35,60,3,0,3
Andaman And Nicobar Islands,North And Middle Andaman,Parkinson'S Disease,35,60,1,0,1
Delhi,North,Parkinson'S Disease,60,80,1,0,1
Delhi,North,Parkinson'S Disease,80,100,1,0,1
Madhya Pradesh,Niwari,Parkinson'S Disease,15,35,0,1,1
Madhya Pradesh,Niwari,Parkinson'S Disease,60,80,1,0,1
Madhya Pradesh,Neemuch,Parkinson'S Disease,35,60,1,1,2
Odisha,Nayagarh,Parkinson'S Disease,15,35,2,1,3
Odisha,Nayagarh,Parkinson'S Disease,35,60,8,4,12
Odisha,Nayagarh,Parkinson'S Disease,60,80,5,1,6
Bihar,Nawada,Parkinson'S Disease,15,35,1,1,2
Bihar,Nawada,Parkinson'S Disease,35,60,1,0,1
Bihar,Nawada,Parkinson'S Disease,60,80,1,0,1
Gujarat,Navsari,Parkinson'S Disease,35,60,2,0,2
Gujarat,Navsari,Parkinson'S Disease,60,80,1,0,1
Maharashtra,Nashik,Parkinson'S Disease,35,60,3,1,4
Maharashtra,Nashik,Parkinson'S Disease,60,80,1,1,2
Madhya Pradesh,Narsinghpur,Parkinson'S Disease,6,15,1,1,2
Madhya Pradesh,Narsinghpur,Parkinson'S Disease,15,35,6,4,10
Madhya Pradesh,Narsinghpur,Parkinson'S Disease,35,60,10,2,12
Madhya Pradesh,Narsinghpur,Parkinson'S Disease,60,80,1,0,1
Madhya Pradesh,Narmadapuram,Parkinson'S Disease,15,35,1,0,1
Madhya Pradesh,Narmadapuram,Parkinson'S Disease,35,60,3,2,5
Madhya Pradesh,Narmadapuram,Parkinson'S Disease,60,80,1,0,1
Gujarat,Narmada,Parkinson'S Disease,35,60,0,1,1
Chhattisgarh,Narayanpur,Parkinson'S Disease,6,15,1,0,1
Chhattisgarh,Narayanpur,Parkinson'S Disease,15,35,1,0,1
Maharashtra,Nandurbar,Parkinson'S Disease,6,15,0,1,1
Maharashtra,Nandurbar,Parkinson'S Disease,60,80,1,1,2
Maharashtra,Nanded,Parkinson'S Disease,35,60,4,0,4
Maharashtra,Nanded,Parkinson'S Disease,60,80,1,0,1
Maharashtra,Nanded,Parkinson'S Disease,80,100,0,1,1
Tamil Nadu,Namakkal,Parkinson'S Disease,35,60,2,0,2
Tamil Nadu,Namakkal,Parkinson'S Disease,60,80,1,0,1
Assam,Nalbari,Parkinson'S Disease,35,60,7,1,8
Assam,Nalbari,Parkinson'S Disease,60,80,2,0,2
Bihar,Nalanda,Parkinson'S Disease,6,15,0,1,1
Bihar,Nalanda,Parkinson'S Disease,15,35,0,3,3
Bihar,Nalanda,Parkinson'S Disease,35,60,1,1,2
Maharashtra,Nagpur,Parkinson'S Disease,35,60,1,0,1
Maharashtra,Nagpur,Parkinson'S Disease,60,80,1,0,1
Rajasthan,Nagaur,Parkinson'S Disease,35,60,1,0,1
Tamil Nadu,Nagapattinam,Parkinson'S Disease,6,15,1,0,1
Tamil Nadu,Nagapattinam,Parkinson'S Disease,35,60,1,0,1
Assam,Nagaon,Parkinson'S Disease,15,35,1,0,1
Assam,Nagaon,Parkinson'S Disease,35,60,1,0,1
Odisha,Nabarangpur,Parkinson'S Disease,35,60,1,0,1
Odisha,Nabarangpur,Parkinson'S Disease,60,80,0,1,1
Karnataka,Mysuru,Parkinson'S Disease,15,35,3,0,3
Karnataka,Mysuru,Parkinson'S Disease,35,60,5,6,11
Karnataka,Mysuru,Parkinson'S Disease,60,80,5,0,5
Bihar,Muzaffarpur,Parkinson'S Disease,0,6,1,0,1
Bihar,Muzaffarpur,Parkinson'S Disease,6,15,3,2,5
Bihar,Muzaffarpur,Parkinson'S Disease,15,35,9,2,11
Bihar,Muzaffarpur,Parkinson'S Disease,35,60,5,2,7
Bihar,Muzaffarpur,Parkinson'S Disease,60,80,2,1,3
Uttar Pradesh,Muzaffarnagar,Parkinson'S Disease,15,35,3,4,7
Uttar Pradesh,Muzaffarnagar,Parkinson'S Disease,35,60,4,1,5
Bihar,Munger,Parkinson'S Disease,15,35,3,3,6
Bihar,Munger,Parkinson'S Disease,35,60,3,0,3
Bihar,Munger,Parkinson'S Disease,60,80,0,1,1
Maharashtra,Mumbai Suburban,Parkinson'S Disease,35,60,1,1,2
Maharashtra,Mumbai Suburban,Parkinson'S Disease,60,80,4,0,4
Maharashtra,Mumbai Suburban,Parkinson'S Disease,80,100,1,0,1
Maharashtra,Mumbai,Parkinson'S Disease,15,35,2,0,2
Maharashtra,Mumbai,Parkinson'S Disease,35,60,6,0,6
Maharashtra,Mumbai,Parkinson'S Disease,60,80,14,2,16
Madhya Pradesh,Morena,Parkinson'S Disease,35,60,1,0,1
Madhya Pradesh,Morena,Parkinson'S Disease,60,80,3,0,3
Nagaland,Mokokchung,Parkinson'S Disease,60,80,0,2,2
Punjab,Moga,Parkinson'S Disease,15,35,1,0,1
Punjab,Moga,Parkinson'S Disease,35,60,1,0,1
Uttar Pradesh,Mirzapur,Parkinson'S Disease,6,15,1,0,1
Uttar Pradesh,Mirzapur,Parkinson'S Disease,15,35,2,1,3
Uttar Pradesh,Mirzapur,Parkinson'S Disease,35,60,1,0,1
Uttar Pradesh,Mirzapur,Parkinson'S Disease,60,80,0,1,1
Uttar Pradesh,Meerut,Parkinson'S Disease,15,35,2,1,3
Uttar Pradesh,Meerut,Parkinson'S Disease,35,60,4,0,4
Uttar Pradesh,Meerut,Parkinson'S Disease,60,80,5,0,5
Odisha,Mayurbhanj,Parkinson'S Disease,35,60,2,7,9
Odisha,Mayurbhanj,Parkinson'S Disease,60,80,6,5,11
Odisha,Mayurbhanj,Parkinson'S Disease,80,100,0,1,1
Uttar Pradesh,Mau,Parkinson'S Disease,15,35,0,1,1
Uttar Pradesh,Mau,Parkinson'S Disease,60,80,1,1,2
Assam,Marigaon,Parkinson'S Disease,35,60,1,1,2
Punjab,Mansa,Parkinson'S Disease,35,60,0,2,2
Karnataka,Mandya,Parkinson'S Disease,15,35,1,0,1
Karnataka,Mandya,Parkinson'S Disease,35,60,7,3,10
Karnataka,Mandya,Parkinson'S Disease,60,80,2,1,3
Madhya Pradesh,Mandsaur,Parkinson'S Disease,35,60,1,0,1
Madhya Pradesh,Mandla,Parkinson'S Disease,15,35,1,1,2
Madhya Pradesh,Mandla,Parkinson'S Disease,35,60,2,1,3
Himachal Pradesh,Mandi,Parkinson'S Disease,35,60,4,2,6
Himachal Pradesh,Mandi,Parkinson'S Disease,60,80,2,0,2
Himachal Pradesh,Mandi,Parkinson'S Disease,80,100,0,1,1
Odisha,Malkangiri,Parkinson'S Disease,6,15,1,0,1
Odisha,Malkangiri,Parkinson'S Disease,35,60,1,1,2
Punjab,Malerkotla,Parkinson'S Disease,35,60,0,1,1
Kerala,Malappuram,Parkinson'S Disease,15,35,1,1,2
Kerala,Malappuram,Parkinson'S Disease,35,60,15,2,17
Kerala,Malappuram,Parkinson'S Disease,60,80,6,1,7
Uttar Pradesh,Mainpuri,Parkinson'S Disease,35,60,4,0,4
Uttar Pradesh,Mainpuri,Parkinson'S Disease,60,80,2,1,3
Uttar Pradesh,Mahoba,Parkinson'S Disease,35,60,1,0,1
Uttar Pradesh,Mahoba,Parkinson'S Disease,60,80,1,0,1
Haryana,Mahendragarh,Parkinson'S Disease,35,60,0,2,2
Chhattisgarh,Mahasamund,Parkinson'S Disease,6,15,1,0,1
Chhattisgarh,Mahasamund,Parkinson'S Disease,35,60,1,0,1
Uttar Pradesh,Maharajganj,Parkinson'S Disease,35,60,1,0,1
Uttar Pradesh,Maharajganj,Parkinson'S Disease,60,80,1,0,1
Telangana,Mahabubabad,Parkinson'S Disease,35,60,1,0,1
Tamil Nadu,Madurai,Parkinson'S Disease,6,15,1,0,1
Tamil Nadu,Madurai,Parkinson'S Disease,15,35,0,1,1
Tamil Nadu,Madurai,Parkinson'S Disease,35,60,1,2,3
Tamil Nadu,Madurai,Parkinson'S Disease,60,80,1,0,1
Bihar,Madhubani,Parkinson'S Disease,15,35,4,0,4
Bihar,Madhubani,Parkinson'S Disease,35,60,4,0,4
Bihar,Madhubani,Parkinson'S Disease,60,80,2,0,2
Bihar,Madhepura,Parkinson'S Disease,6,15,1,0,1
Bihar,Madhepura,Parkinson'S Disease,15,35,11,5,16
Bihar,Madhepura,Parkinson'S Disease,35,60,14,3,17
Bihar,Madhepura,Parkinson'S Disease,60,80,2,1,3
Bihar,Madhepura,Parkinson'S Disease,80,100,1,0,1
Punjab,Ludhiana,Parkinson'S Disease,15,35,1,1,2
Punjab,Ludhiana,Parkinson'S Disease,35,60,2,2,4
Punjab,Ludhiana,Parkinson'S Disease,60,80,4,1,5
Uttar Pradesh,Lucknow,Parkinson'S Disease,15,35,1,0,1
Uttar Pradesh,Lucknow,Parkinson'S Disease,35,60,14,0,14
Uttar Pradesh,Lucknow,Parkinson'S Disease,60,80,3,0,3
Jharkhand,Lohardaga,Parkinson'S Disease,6,15,1,0,1
Jharkhand,Lohardaga,Parkinson'S Disease,15,35,1,1,2
Jharkhand,Lohardaga,Parkinson'S Disease,35,60,2,1,3
Maharashtra,Latur,Parkinson'S Disease,35,60,6,4,10
Maharashtra,Latur,Parkinson'S Disease,60,80,1,1,2
Uttar Pradesh,Lalitpur,Parkinson'S Disease,6,15,1,0,1
Uttar Pradesh,Lalitpur,Parkinson'S Disease,15,35,2,0,2
Uttar Pradesh,Lalitpur,Parkinson'S Disease,35,60,1,0,1
Uttar Pradesh,Lalitpur,Parkinson'S Disease,60,80,1,0,1
Bihar,Lakhisarai,Parkinson'S Disease,6,15,1,0,1
Bihar,Lakhisarai,Parkinson'S Disease,15,35,1,0,1
Bihar,Lakhisarai,Parkinson'S Disease,60,80,1,0,1
Assam,Lakhimpur,Parkinson'S Disease,35,60,2,0,2
Uttar Pradesh,Kushi Nagar,Parkinson'S Disease,6,15,1,0,1
Uttar Pradesh,Kushi Nagar,Parkinson'S Disease,15,35,1,2,3
Uttar Pradesh,Kushi Nagar,Parkinson'S Disease,35,60,7,0,7
Uttar Pradesh,Kushi Nagar,Parkinson'S Disease,60,80,1,0,1
Haryana,Kurukshetra,Parkinson'S Disease,35,60,3,0,3
Jammu And Kashmir,Kupwara,Parkinson'S Disease,6,15,2,0,2
Jammu And Kashmir,Kupwara,Parkinson'S Disease,15,35,1,0,1
Jammu And Kashmir,Kupwara,Parkinson'S Disease,35,60,7,4,11
Jammu And Kashmir,Kupwara,Parkinson'S Disease,60,80,10,1,11
Jammu And Kashmir,Kulgam,Parkinson'S Disease,35,60,5,1,6
Jammu And Kashmir,Kulgam,Parkinson'S Disease,60,80,1,0,1
Tamil Nadu,Krishnagiri,Parkinson'S Disease,15,35,1,2,3
Tamil Nadu,Krishnagiri,Parkinson'S Disease,35,60,5,2,7
Tamil Nadu,Krishnagiri,Parkinson'S Disease,60,80,4,0,4
Tamil Nadu,Krishnagiri,Parkinson'S Disease,80,100,1,0,1
Andhra Pradesh,Krishna,Parkinson'S Disease,35,60,1,0,1
Kerala,Kozhikode,Parkinson'S Disease,35,60,24,3,27
Kerala,Kozhikode,Parkinson'S Disease,60,80,16,7,23
Kerala,Kozhikode,Parkinson'S Disease,80,100,1,0,1
Kerala,Kottayam,Parkinson'S Disease,35,60,2,1,3
Kerala,Kottayam,Parkinson'S Disease,60,80,10,4,14
Chhattisgarh,Korea,Parkinson'S Disease,15,35,1,0,1
Chhattisgarh,Korea,Parkinson'S Disease,35,60,1,1,2
Chhattisgarh,Korea,Parkinson'S Disease,60,80,1,0,1
Chhattisgarh,Korba,Parkinson'S Disease,35,60,1,0,1
Odisha,Koraput,Parkinson'S Disease,15,35,0,1,1
Odisha,Koraput,Parkinson'S Disease,35,60,3,0,3
Karnataka,Koppal,Parkinson'S Disease,15,35,3,1,4
Karnataka,Koppal,Parkinson'S Disease,35,60,3,0,3
Karnataka,Koppal,Parkinson'S Disease,60,80,2,0,2
Chhattisgarh,Kondagaon,Parkinson'S Disease,6,15,0,1,1
Chhattisgarh,Kondagaon,Parkinson'S Disease,15,35,5,2,7
Chhattisgarh,Kondagaon,Parkinson'S Disease,35,60,7,6,13
Chhattisgarh,Kondagaon,Parkinson'S Disease,60,80,3,2,5
Kerala,Kollam,Parkinson'S Disease,15,35,1,0,1
Kerala,Kollam,Parkinson'S Disease,35,60,5,6,11
Kerala,Kollam,Parkinson'S Disease,60,80,10,3,13
Maharashtra,Kolhapur,Parkinson'S Disease,35,60,0,1,1
Maharashtra,Kolhapur,Parkinson'S Disease,60,80,3,0,3
Karnataka,Kolar,Parkinson'S Disease,6,15,2,0,2
Karnataka,Kolar,Parkinson'S Disease,15,35,1,2,3
Karnataka,Kolar,Parkinson'S Disease,35,60,12,4,16
Karnataka,Kolar,Parkinson'S Disease,60,80,5,1,6
Karnataka,Kolar,Parkinson'S Disease,80,100,2,0,2
Jharkhand,Koderma,Parkinson'S Disease,6,15,2,0,2
Jharkhand,Koderma,Parkinson'S Disease,15,35,0,1,1
Jharkhand,Koderma,Parkinson'S Disease,35,60,1,0,1
Jharkhand,Koderma,Parkinson'S Disease,60,80,1,0,1
Karnataka,Kodagu,Parkinson'S Disease,35,60,3,2,5
Karnataka,Kodagu,Parkinson'S Disease,60,80,1,2,3
Jammu And Kashmir,Kishtwar,Parkinson'S Disease,35,60,1,0,1
Bihar,Kishanganj,Parkinson'S Disease,15,35,4,1,5
Bihar,Kishanganj,Parkinson'S Disease,35,60,2,0,2
Bihar,Kishanganj,Parkinson'S Disease,60,80,3,0,3
Jharkhand,Khunti,Parkinson'S Disease,15,35,1,1,2
Jharkhand,Khunti,Parkinson'S Disease,35,60,1,3,4
Odisha,Khordha,Parkinson'S Disease,35,60,4,3,7
Odisha,Khordha,Parkinson'S Disease,60,80,5,0,5
Uttar Pradesh,Kheri,Parkinson'S Disease,15,35,3,1,4
Uttar Pradesh,Kheri,Parkinson'S Disease,35,60,6,0,6
Uttar Pradesh,Kheri,Parkinson'S Disease,60,80,1,0,1
Gujarat,Kheda,Parkinson'S Disease,35,60,1,0,1
Madhya Pradesh,Khargone,Parkinson'S Disease,15,35,1,1,2
Madhya Pradesh,Khargone,Parkinson'S Disease,35,60,2,0,2
Madhya Pradesh,Khargone,Parkinson'S Disease,60,80,1,0,1
Bihar,Khagaria,Parkinson'S Disease,15,35,0,1,1
Bihar,Khagaria,Parkinson'S Disease,35,60,2,0,2
Odisha,Kendujhar,Parkinson'S Disease,35,60,6,1,7
Odisha,Kendujhar,Parkinson'S Disease,60,80,2,0,2
Odisha,Kendrapara,Parkinson'S Disease,35,60,1,1,2
Odisha,Kendrapara,Parkinson'S Disease,60,80,1,1,2
Uttar Pradesh,Kaushambi,Parkinson'S Disease,15,35,1,0,1
Uttar Pradesh,Kaushambi,Parkinson'S Disease,35,60,2,1,3
Madhya Pradesh,Katni,Parkinson'S Disease,6,15,1,0,1
Madhya Pradesh,Katni,Parkinson'S Disease,35,60,1,0,1
Bihar,Katihar,Parkinson'S Disease,6,15,2,0,2
Bihar,Katihar,Parkinson'S Disease,15,35,3,0,3
Bihar,Katihar,Parkinson'S Disease,35,60,1,2,3
Bihar,Katihar,Parkinson'S Disease,60,80,1,0,1
Jammu And Kashmir,Kathua,Parkinson'S Disease,6,15,0,2,2
Jammu And Kashmir,Kathua,Parkinson'S Disease,15,35,1,2,3
Jammu And Kashmir,Kathua,Parkinson'S Disease,35,60,6,3,9
Jammu And Kashmir,Kathua,Parkinson'S Disease,60,80,0,1,1
Uttar Pradesh,Kasganj,Parkinson'S Disease,15,35,2,0,2
Uttar Pradesh,Kasganj,Parkinson'S Disease,35,60,1,0,1
Uttar Pradesh,Kasganj,Parkinson'S Disease,60,80,2,0,2
Kerala,Kasaragod,Parkinson'S Disease,6,15,1,0,1
Kerala,Kasaragod,Parkinson'S Disease,35,60,9,6,15
Kerala,Kasaragod,Parkinson'S Disease,60,80,5,0,5
Kerala,Kasaragod,Parkinson'S Disease,80,100,1,0,1
Tamil Nadu,Karur,Parkinson'S Disease,35,60,2,1,3
Tamil Nadu,Karur,Parkinson'S Disease,60,80,2,1,3
Haryana,Karnal,Parkinson'S Disease,15,35,1,0,1
Haryana,Karnal,Parkinson'S Disease,35,60,6,1,7
Haryana,Karnal,Parkinson'S Disease,60,80,4,0,4
Assam,Karimganj,Parkinson'S Disease,15,35,1,0,1
Assam,Karimganj,Parkinson'S Disease,35,60,3,1,4
Assam,Karimganj,Parkinson'S Disease,60,80,1,0,1
Ladakh,Kargil,Parkinson'S Disease,35,60,0,1,1
Rajasthan,Karauli,Parkinson'S Disease,80,100,0,1,1
Punjab,Kapurthala,Parkinson'S Disease,35,60,1,0,1
Uttar Pradesh,Kanpur Nagar,Parkinson'S Disease,15,35,1,0,1
Uttar Pradesh,Kanpur Nagar,Parkinson'S Disease,35,60,3,1,4
Uttar Pradesh,Kanpur Dehat,Parkinson'S Disease,15,35,2,0,2
Uttar Pradesh,Kanpur Dehat,Parkinson'S Disease,35,60,0,1,1
Kerala,Kannur,Parkinson'S Disease,35,60,5,0,5
Kerala,Kannur,Parkinson'S Disease,60,80,1,1,2
Tamil Nadu,Kanniyakumari,Parkinson'S Disease,35,60,2,2,4
Tamil Nadu,Kanniyakumari,Parkinson'S Disease,60,80,0,3,3
Chhattisgarh,Kanker,Parkinson'S Disease,6,15,2,3,5
Chhattisgarh,Kanker,Parkinson'S Disease,15,35,7,10,17
Chhattisgarh,Kanker,Parkinson'S Disease,35,60,18,8,26
Chhattisgarh,Kanker,Parkinson'S Disease,60,80,4,1,5
Himachal Pradesh,Kangra,Parkinson'S Disease,15,35,3,0,3
Himachal Pradesh,Kangra,Parkinson'S Disease,35,60,2,1,3
Himachal Pradesh,Kangra,Parkinson'S Disease,60,80,3,2,5
Odisha,Kandhamal,Parkinson'S Disease,15,35,6,3,9
Odisha,Kandhamal,Parkinson'S Disease,35,60,7,5,12
Odisha,Kandhamal,Parkinson'S Disease,60,80,5,1,6
Tamil Nadu,Kanchipuram,Parkinson'S Disease,35,60,3,0,3
Tamil Nadu,Kanchipuram,Parkinson'S Disease,60,80,1,0,1
Tamil Nadu,Kallakurichi,Parkinson'S Disease,35,60,0,1,1
Tamil Nadu,Kallakurichi,Parkinson'S Disease,80,100,0,1,1
Odisha,Kalahandi,Parkinson'S Disease,35,60,5,3,8
Odisha,Kalahandi,Parkinson'S Disease,60,80,2,1,3
Odisha,Kalahandi,Parkinson'S Disease,80,100,1,0,1
Karnataka,Kalaburagi,Parkinson'S Disease,6,15,0,1,1
Karnataka,Kalaburagi,Parkinson'S Disease,15,35,2,2,4
Karnataka,Kalaburagi,Parkinson'S Disease,35,60,15,1,16
Karnataka,Kalaburagi,Parkinson'S Disease,60,80,7,1,8
Karnataka,Kalaburagi,Parkinson'S Disease,80,100,1,0,1
Haryana,Kaithal,Parkinson'S Disease,35,60,1,1,2
Bihar,Kaimur (Bhabua),Parkinson'S Disease,6,15,4,2,6
Bihar,Kaimur (Bhabua),Parkinson'S Disease,15,35,4,3,7
Bihar,Kaimur (Bhabua),Parkinson'S Disease,35,60,5,2,7
Bihar,Kaimur (Bhabua),Parkinson'S Disease,60,80,1,1,2
Gujarat,Junagadh,Parkinson'S Disease,15,35,1,0,1
Gujarat,Junagadh,Parkinson'S Disease,35,60,1,0,1
Assam,Jorhat,Parkinson'S Disease,35,60,3,0,3
Assam,Jorhat,Parkinson'S Disease,60,80,0,1,1
Rajasthan,Jodhpur,Parkinson'S Disease,15,35,0,2,2
Rajasthan,Jodhpur,Parkinson'S Disease,35,60,3,0,3
Haryana,Jind,Parkinson'S Disease,35,60,2,1,3
Rajasthan,Jhunjhunu,Parkinson'S Disease,6,15,3,4,7
Rajasthan,Jhunjhunu,Parkinson'S Disease,15,35,2,2,4
Rajasthan,Jhunjhunu,Parkinson'S Disease,35,60,2,2,4
Rajasthan,Jhunjhunu,Parkinson'S Disease,60,80,1,0,1
Odisha,Jharsuguda,Parkinson'S Disease,60,80,1,0,1
Uttar Pradesh,Jhansi,Parkinson'S Disease,15,35,4,0,4
Uttar Pradesh,Jhansi,Parkinson'S Disease,35,60,3,0,3
Uttar Pradesh,Jhansi,Parkinson'S Disease,60,80,1,0,1
Rajasthan,Jhalawar,Parkinson'S Disease,15,35,1,0,1
Haryana,Jhajjar,Parkinson'S Disease,35,60,1,0,1
Madhya Pradesh,Jhabua,Parkinson'S Disease,35,60,1,1,2
Bihar,Jehanabad,Parkinson'S Disease,15,35,1,0,1
Bihar,Jehanabad,Parkinson'S Disease,60,80,2,0,2
Uttar Pradesh,Jaunpur,Parkinson'S Disease,15,35,7,1,8
Uttar Pradesh,Jaunpur,Parkinson'S Disease,35,60,8,2,10
Uttar Pradesh,Jaunpur,Parkinson'S Disease,60,80,1,0,1
Chhattisgarh,Jashpur,Parkinson'S Disease,15,35,1,3,4
Chhattisgarh,Jashpur,Parkinson'S Disease,35,60,2,0,2
Chhattisgarh,Jashpur,Parkinson'S Disease,60,80,0,1,1
Chhattisgarh,Janjgir-Champa,Parkinson'S Disease,15,35,3,1,4
Chhattisgarh,Janjgir-Champa,Parkinson'S Disease,35,60,4,1,5
Chhattisgarh,Janjgir-Champa,Parkinson'S Disease,60,80,0,2,2
Bihar,Jamui,Parkinson'S Disease,6,15,0,2,2
Bihar,Jamui,Parkinson'S Disease,15,35,3,1,4
Bihar,Jamui,Parkinson'S Disease,35,60,6,1,7
Bihar,Jamui,Parkinson'S Disease,60,80,3,1,4
Jharkhand,Jamtara,Parkinson'S Disease,6,15,1,1,2
Jharkhand,Jamtara,Parkinson'S Disease,15,35,1,1,2
Jharkhand,Jamtara,Parkinson'S Disease,35,60,0,1,1
Jharkhand,Jamtara,Parkinson'S Disease,60,80,1,0,1
Jammu And Kashmir,Jammu,Parkinson'S Disease,15,35,1,1,2
Jammu And Kashmir,Jammu,Parkinson'S Disease,35,60,7,1,8
Jammu And Kashmir,Jammu,Parkinson'S Disease,60,80,1,1,2
Rajasthan,Jalore,Parkinson'S Disease,6,15,1,0,1
Rajasthan,Jalore,Parkinson'S Disease,60,80,1,0,1
Maharashtra,Jalgaon,Parkinson'S Disease,15,35,1,0,1
Maharashtra,Jalgaon,Parkinson'S Disease,35,60,2,0,2
Maharashtra,Jalgaon,Parkinson'S Disease,60,80,1,1,2
Uttar Pradesh,Jalaun,Parkinson'S Disease,15,35,3,0,3
Uttar Pradesh,Jalaun,Parkinson'S Disease,35,60,2,1,3
Uttar Pradesh,Jalaun,Parkinson'S Disease,60,80,2,0,2
Punjab,Jalandhar,Parkinson'S Disease,6,15,1,0,1
Punjab,Jalandhar,Parkinson'S Disease,15,35,1,1,2
Punjab,Jalandhar,Parkinson'S Disease,35,60,6,0,6
Punjab,Jalandhar,Parkinson'S Disease,60,80,2,0,2
Odisha,Jajapur,Parkinson'S Disease,35,60,12,1,13
Odisha,Jajapur,Parkinson'S Disease,60,80,6,0,6
Odisha,Jajapur,Parkinson'S Disease,80,100,1,0,1
Rajasthan,Jaisalmer,Parkinson'S Disease,60,80,1,0,1
Rajasthan,Jaipur,Parkinson'S Disease,15,35,0,1,1
Rajasthan,Jaipur,Parkinson'S Disease,35,60,6,3,9
Rajasthan,Jaipur,Parkinson'S Disease,60,80,5,3,8
Madhya Pradesh,Jabalpur,Parkinson'S Disease,15,35,5,5,10
Madhya Pradesh,Jabalpur,Parkinson'S Disease,35,60,8,1,9
Madhya Pradesh,Jabalpur,Parkinson'S Disease,60,80,0,2,2
Madhya Pradesh,Indore,Parkinson'S Disease,15,35,1,0,1
Madhya Pradesh,Indore,Parkinson'S Disease,35,60,4,1,5
Madhya Pradesh,Indore,Parkinson'S Disease,60,80,0,1,1
Manipur,Imphal East,Parkinson'S Disease,35,60,1,0,1
Kerala,Idukki,Parkinson'S Disease,15,35,1,0,1
Kerala,Idukki,Parkinson'S Disease,35,60,2,4,6
Kerala,Idukki,Parkinson'S Disease,60,80,5,3,8
Kerala,Idukki,Parkinson'S Disease,80,100,1,0,1
Punjab,Hoshiarpur,Parkinson'S Disease,6,15,1,0,1
Punjab,Hoshiarpur,Parkinson'S Disease,35,60,6,1,7
Punjab,Hoshiarpur,Parkinson'S Disease,60,80,5,1,6
Assam,Hojai,Parkinson'S Disease,15,35,1,0,1
Assam,Hojai,Parkinson'S Disease,35,60,1,0,1
Haryana,Hisar,Parkinson'S Disease,15,35,2,1,3
Haryana,Hisar,Parkinson'S Disease,35,60,3,1,4
Haryana,Hisar,Parkinson'S Disease,60,80,1,0,1
Maharashtra,Hingoli,Parkinson'S Disease,6,15,1,0,1
Maharashtra,Hingoli,Parkinson'S Disease,15,35,1,0,1
Maharashtra,Hingoli,Parkinson'S Disease,35,60,1,0,1
Maharashtra,Hingoli,Parkinson'S Disease,60,80,2,0,2
Jharkhand,Hazaribagh,Parkinson'S Disease,35,60,1,0,1
Karnataka,Haveri,Parkinson'S Disease,6,15,1,0,1
Karnataka,Haveri,Parkinson'S Disease,15,35,1,1,2
Karnataka,Haveri,Parkinson'S Disease,35,60,8,2,10
Karnataka,Haveri,Parkinson'S Disease,60,80,2,1,3
Uttar Pradesh,Hathras,Parkinson'S Disease,6,15,1,0,1
Uttar Pradesh,Hathras,Parkinson'S Disease,15,35,0,1,1
Uttar Pradesh,Hathras,Parkinson'S Disease,35,60,2,1,3
Uttar Pradesh,Hathras,Parkinson'S Disease,60,80,3,0,3
Karnataka,Hassan,Parkinson'S Disease,0,6,1,0,1
Karnataka,Hassan,Parkinson'S Disease,15,35,2,1,3
Karnataka,Hassan,Parkinson'S Disease,35,60,16,6,22
Karnataka,Hassan,Parkinson'S Disease,60,80,4,2,6
Uttarakhand,Haridwar,Parkinson'S Disease,15,35,3,1,4
Uttar Pradesh,Hardoi,Parkinson'S Disease,15,35,5,1,6
Uttar Pradesh,Hardoi,Parkinson'S Disease,35,60,3,1,4
Uttar Pradesh,Hardoi,Parkinson'S Disease,60,80,4,0,4
Uttar Pradesh,Hardoi,Parkinson'S Disease,80,100,0,1,1
Madhya Pradesh,Harda,Parkinson'S Disease,35,60,0,1,1
Madhya Pradesh,Harda,Parkinson'S Disease,60,80,2,0,2
Uttar Pradesh,Hapur,Parkinson'S Disease,15,35,1,0,1
Uttar Pradesh,Hapur,Parkinson'S Disease,35,60,2,0,2
Rajasthan,Hanumangarh,Parkinson'S Disease,35,60,2,1,3
Himachal Pradesh,Hamirpur,Parkinson'S Disease,35,60,3,0,3
Uttar Pradesh,Hamirpur,Parkinson'S Disease,0,6,1,0,1
Uttar Pradesh,Hamirpur,Parkinson'S Disease,6,15,4,0,4
Uttar Pradesh,Hamirpur,Parkinson'S Disease,15,35,2,0,2
Uttar Pradesh,Hamirpur,Parkinson'S Disease,35,60,12,1,13
Uttar Pradesh,Hamirpur,Parkinson'S Disease,60,80,5,0,5
Madhya Pradesh,Gwalior,Parkinson'S Disease,6,15,1,0,1
Haryana,Gurugram,Parkinson'S Disease,35,60,1,0,1
Punjab,Gurdaspur,Parkinson'S Disease,15,35,1,0,1
Punjab,Gurdaspur,Parkinson'S Disease,35,60,2,2,4
Punjab,Gurdaspur,Parkinson'S Disease,60,80,1,0,1
Madhya Pradesh,Guna,Parkinson'S Disease,35,60,1,0,1
Jharkhand,Gumla,Parkinson'S Disease,0,6,1,0,1
Jharkhand,Gumla,Parkinson'S Disease,6,15,0,1,1
Jharkhand,Gumla,Parkinson'S Disease,15,35,13,8,21
Jharkhand,Gumla,Parkinson'S Disease,35,60,22,10,32
Jharkhand,Gumla,Parkinson'S Disease,60,80,8,8,16
Uttar Pradesh,Gorakhpur,Parkinson'S Disease,6,15,0,1,1
Uttar Pradesh,Gorakhpur,Parkinson'S Disease,15,35,8,2,10
Uttar Pradesh,Gorakhpur,Parkinson'S Disease,35,60,12,4,16
Uttar Pradesh,Gorakhpur,Parkinson'S Disease,60,80,4,1,5
Bihar,Gopalganj,Parkinson'S Disease,35,60,7,0,7
Bihar,Gopalganj,Parkinson'S Disease,60,80,1,0,1
Uttar Pradesh,Gonda,Parkinson'S Disease,15,35,2,0,2
Uttar Pradesh,Gonda,Parkinson'S Disease,35,60,2,1,3
Uttar Pradesh,Gonda,Parkinson'S Disease,60,80,0,1,1
Assam,Golaghat,Parkinson'S Disease,6,15,1,0,1
Assam,Golaghat,Parkinson'S Disease,15,35,1,0,1
Assam,Golaghat,Parkinson'S Disease,35,60,3,2,5
Jharkhand,Godda,Parkinson'S Disease,6,15,0,1,1
Jharkhand,Godda,Parkinson'S Disease,15,35,15,4,19
Jharkhand,Godda,Parkinson'S Disease,35,60,18,4,22
Jharkhand,Godda,Parkinson'S Disease,60,80,9,1,10
Jharkhand,Godda,Parkinson'S Disease,80,100,1,1,2
Assam,Goalpara,Parkinson'S Disease,6,15,0,2,2
Assam,Goalpara,Parkinson'S Disease,15,35,1,1,2
Assam,Goalpara,Parkinson'S Disease,35,60,0,1,1
Jharkhand,Giridih,Parkinson'S Disease,15,35,2,3,5
Jharkhand,Giridih,Parkinson'S Disease,35,60,7,0,7
Gujarat,Gir Somnath,Parkinson'S Disease,15,35,1,0,1
Gujarat,Gir Somnath,Parkinson'S Disease,35,60,0,2,2
Uttar Pradesh,Ghazipur,Parkinson'S Disease,15,35,1,0,1
Uttar Pradesh,Ghazipur,Parkinson'S Disease,35,60,1,0,1
Uttar Pradesh,Ghazipur,Parkinson'S Disease,60,80,1,0,1
Uttar Pradesh,Ghaziabad,Parkinson'S Disease,60,80,5,0,5
Bihar,Gaya,Parkinson'S Disease,35,60,2,0,2
Bihar,Gaya,Parkinson'S Disease,60,80,2,1,3
Uttar Pradesh,Gautam Buddha Nagar,Parkinson'S Disease,6,15,1,0,1
Uttar Pradesh,Gautam Buddha Nagar,Parkinson'S Disease,35,60,0,1,1
Uttar Pradesh,Gautam Buddha Nagar,Parkinson'S Disease,60,80,1,1,2
Uttar Pradesh,Gautam Buddha Nagar,Parkinson'S Disease,80,100,2,0,2
Chhattisgarh,Gaurella Pendra Marwahi,Parkinson'S Disease,60,80,0,1,1
Chhattisgarh,Gariyaband,Parkinson'S Disease,15,35,1,0,1
Chhattisgarh,Gariyaband,Parkinson'S Disease,35,60,1,0,1
Jharkhand,Garhwa,Parkinson'S Disease,15,35,5,1,6
Jharkhand,Garhwa,Parkinson'S Disease,35,60,4,0,4
Odisha,Ganjam,Parkinson'S Disease,35,60,2,0,2
Odisha,Ganjam,Parkinson'S Disease,60,80,2,0,2
Sikkim,Gangtok,Parkinson'S Disease,35,60,1,0,1
Gujarat,Gandhinagar,Parkinson'S Disease,35,60,0,1,1
Jammu And Kashmir,Ganderbal,Parkinson'S Disease,0,6,1,0,1
Jammu And Kashmir,Ganderbal,Parkinson'S Disease,15,35,2,0,2
Jammu And Kashmir,Ganderbal,Parkinson'S Disease,35,60,1,1,2
Odisha,Gajapati,Parkinson'S Disease,35,60,0,2,2
Odisha,Gajapati,Parkinson'S Disease,60,80,1,2,3
Maharashtra,Gadchiroli,Parkinson'S Disease,15,35,1,0,1
Karnataka,Gadag,Parkinson'S Disease,15,35,1,0,1
Karnataka,Gadag,Parkinson'S Disease,35,60,2,2,4
Karnataka,Gadag,Parkinson'S Disease,60,80,0,1,1
Uttar Pradesh,Firozabad,Parkinson'S Disease,35,60,0,1,1
Punjab,Ferozepur,Parkinson'S Disease,15,35,1,0,1
Punjab,Ferozepur,Parkinson'S Disease,35,60,1,0,1
Punjab,Fazilka,Parkinson'S Disease,15,35,1,0,1
Punjab,Fazilka,Parkinson'S Disease,35,60,1,0,1
Punjab,Fazilka,Parkinson'S Disease,80,100,1,0,1
Uttar Pradesh,Fatehpur,Parkinson'S Disease,15,35,6,2,8
Uttar Pradesh,Fatehpur,Parkinson'S Disease,35,60,6,0,6
Uttar Pradesh,Fatehpur,Parkinson'S Disease,60,80,5,0,5
Punjab,Fatehgarh Sahib,Parkinson'S Disease,15,35,0,1,1
Punjab,Fatehgarh Sahib,Parkinson'S Disease,35,60,3,4,7
Punjab,Fatehgarh Sahib,Parkinson'S Disease,60,80,1,1,2
Haryana,Fatehabad,Parkinson'S Disease,15,35,5,0,5
Haryana,Fatehabad,Parkinson'S Disease,35,60,0,2,2
Uttar Pradesh,Farrukhabad,Parkinson'S Disease,15,35,5,0,5
Uttar Pradesh,Farrukhabad,Parkinson'S Disease,35,60,4,2,6
Uttar Pradesh,Farrukhabad,Parkinson'S Disease,60,80,2,0,2
Punjab,Faridkot,Parkinson'S Disease,35,60,3,1,4
Punjab,Faridkot,Parkinson'S Disease,60,80,1,0,1
Haryana,Faridabad,Parkinson'S Disease,35,60,1,1,2
Uttar Pradesh,Etawah,Parkinson'S Disease,6,15,0,1,1
Uttar Pradesh,Etawah,Parkinson'S Disease,15,35,3,1,4
Uttar Pradesh,Etawah,Parkinson'S Disease,35,60,11,4,15
Uttar Pradesh,Etah,Parkinson'S Disease,15,35,0,1,1
Uttar Pradesh,Etah,Parkinson'S Disease,35,60,3,0,3
Tamil Nadu,Erode,Parkinson'S Disease,15,35,0,1,1
Tamil Nadu,Erode,Parkinson'S Disease,35,60,2,0,2
Tamil Nadu,Erode,Parkinson'S Disease,60,80,0,3,3
Kerala,Ernakulam,Parkinson'S Disease,15,35,0,1,1
Kerala,Ernakulam,Parkinson'S Disease,35,60,5,1,6
Kerala,Ernakulam,Parkinson'S Disease,60,80,5,0,5
Jharkhand,East Singhbum,Parkinson'S Disease,15,35,1,3,4
Jharkhand,East Singhbum,Parkinson'S Disease,35,60,6,3,9
Jharkhand,East Singhbum,Parkinson'S Disease,60,80,2,0,2
Madhya Pradesh,East Nimar,Parkinson'S Disease,35,60,1,0,1
Meghalaya,East Khasi Hills,Parkinson'S Disease,60,80,0,1,1
Delhi,East,Parkinson'S Disease,35,60,2,0,2
Delhi,East,Parkinson'S Disease,60,80,1,0,1
Chhattisgarh,Durg,Parkinson'S Disease,35,60,1,0,1
Chhattisgarh,Durg,Parkinson'S Disease,60,80,1,0,1
Jharkhand,Dumka,Parkinson'S Disease,0,6,1,0,1
Jharkhand,Dumka,Parkinson'S Disease,6,15,0,2,2
Jharkhand,Dumka,Parkinson'S Disease,15,35,1,1,2
Jharkhand,Dumka,Parkinson'S Disease,35,60,3,1,4
Jharkhand,Dumka,Parkinson'S Disease,60,80,1,0,1
Madhya Pradesh,Dindori,Parkinson'S Disease,6,15,2,0,2
Madhya Pradesh,Dindori,Parkinson'S Disease,15,35,0,2,2
Madhya Pradesh,Dindori,Parkinson'S Disease,35,60,3,0,3
Tamil Nadu,Dindigul,Parkinson'S Disease,15,35,1,0,1
Tamil Nadu,Dindigul,Parkinson'S Disease,35,60,4,2,6
Tamil Nadu,Dindigul,Parkinson'S Disease,60,80,6,1,7
Tamil Nadu,Dindigul,Parkinson'S Disease,80,100,1,0,1
Maharashtra,Dhule,Parkinson'S Disease,35,60,3,0,3
Maharashtra,Dhule,Parkinson'S Disease,60,80,2,0,2
Assam,Dhubri,Parkinson'S Disease,6,15,0,1,1
Assam,Dhubri,Parkinson'S Disease,15,35,0,1,1
Rajasthan,Dholpur,Parkinson'S Disease,35,60,1,0,1
Odisha,Dhenkanal,Parkinson'S Disease,15,35,1,1,2
Odisha,Dhenkanal,Parkinson'S Disease,35,60,4,4,8
Odisha,Dhenkanal,Parkinson'S Disease,60,80,4,3,7
Odisha,Dhenkanal,Parkinson'S Disease,80,100,1,0,1
Assam,Dhemaji,Parkinson'S Disease,6,15,1,0,1
Assam,Dhemaji,Parkinson'S Disease,35,60,1,0,1
Karnataka,Dharwad,Parkinson'S Disease,35,60,2,0,2
Tamil Nadu,Dharmapuri,Parkinson'S Disease,35,60,2,0,2
Tamil Nadu,Dharmapuri,Parkinson'S Disease,60,80,2,0,2
Madhya Pradesh,Dhar,Parkinson'S Disease,35,60,2,1,3
Madhya Pradesh,Dhar,Parkinson'S Disease,60,80,2,0,2
Jharkhand,Dhanbad,Parkinson'S Disease,6,15,1,0,1
Jharkhand,Dhanbad,Parkinson'S Disease,15,35,7,5,12
Jharkhand,Dhanbad,Parkinson'S Disease,35,60,8,2,10
Jharkhand,Dhanbad,Parkinson'S Disease,60,80,3,0,3
Chhattisgarh,Dhamtari,Parkinson'S Disease,35,60,2,0,2
Tripura,Dhalai,Parkinson'S Disease,35,60,1,1,2
Madhya Pradesh,Dewas,Parkinson'S Disease,15,35,2,1,3
Madhya Pradesh,Dewas,Parkinson'S Disease,35,60,6,1,7
Madhya Pradesh,Dewas,Parkinson'S Disease,60,80,1,0,1
Uttar Pradesh,Deoria,Parkinson'S Disease,15,35,10,1,11
Uttar Pradesh,Deoria,Parkinson'S Disease,35,60,7,2,9
Uttar Pradesh,Deoria,Parkinson'S Disease,60,80,4,0,4
Jharkhand,Deoghar,Parkinson'S Disease,15,35,2,1,3
Jharkhand,Deoghar,Parkinson'S Disease,35,60,4,1,5
Odisha,Deogarh,Parkinson'S Disease,15,35,1,0,1
Odisha,Deogarh,Parkinson'S Disease,35,60,3,0,3
Odisha,Deogarh,Parkinson'S Disease,60,80,1,0,1
Uttarakhand,Dehradun,Parkinson'S Disease,15,35,1,2,3
Uttarakhand,Dehradun,Parkinson'S Disease,35,60,2,1,3
Karnataka,Davangere,Parkinson'S Disease,15,35,2,1,3
Karnataka,Davangere,Parkinson'S Disease,35,60,12,2,14
Karnataka,Davangere,Parkinson'S Disease,60,80,4,2,6
Rajasthan,Dausa,Parkinson'S Disease,6,15,0,1,1
Rajasthan,Dausa,Parkinson'S Disease,15,35,1,1,2
Rajasthan,Dausa,Parkinson'S Disease,35,60,1,1,2
Rajasthan,Dausa,Parkinson'S Disease,60,80,1,0,1
Madhya Pradesh,Datia,Parkinson'S Disease,6,15,1,0,1
Madhya Pradesh,Datia,Parkinson'S Disease,15,35,1,1,2
Madhya Pradesh,Datia,Parkinson'S Disease,35,60,2,0,2
Madhya Pradesh,Datia,Parkinson'S Disease,60,80,2,0,2
Assam,Darrang,Parkinson'S Disease,35,60,1,1,2
Assam,Darrang,Parkinson'S Disease,60,80,0,1,1
Bihar,Darbhanga,Parkinson'S Disease,15,35,4,1,5
Bihar,Darbhanga,Parkinson'S Disease,35,60,2,0,2
Bihar,Darbhanga,Parkinson'S Disease,60,80,1,0,1
Madhya Pradesh,Damoh,Parkinson'S Disease,15,35,4,3,7
Madhya Pradesh,Damoh,Parkinson'S Disease,35,60,13,5,18
Madhya Pradesh,Damoh,Parkinson'S Disease,60,80,2,0,2
Madhya Pradesh,Damoh,Parkinson'S Disease,80,100,2,0,2
Dadra Nagar Haveli And Daman And Diu,Daman,Parkinson'S Disease,80,100,1,0,1
Karnataka,Dakshina Kannada,Parkinson'S Disease,35,60,11,6,17
Karnataka,Dakshina Kannada,Parkinson'S Disease,60,80,11,2,13
Karnataka,Dakshina Kannada,Parkinson'S Disease,80,100,0,1,1
Odisha,Cuttack,Parkinson'S Disease,15,35,1,1,2
Odisha,Cuttack,Parkinson'S Disease,35,60,3,2,5
Odisha,Cuttack,Parkinson'S Disease,60,80,2,0,2
Tamil Nadu,Cuddalore,Parkinson'S Disease,6,15,0,1,1
Tamil Nadu,Cuddalore,Parkinson'S Disease,60,80,1,0,1
Tamil Nadu,Coimbatore,Parkinson'S Disease,35,60,1,1,2
Tamil Nadu,Coimbatore,Parkinson'S Disease,60,80,1,0,1
Rajasthan,Chittorgarh,Parkinson'S Disease,35,60,1,0,1
Rajasthan,Chittorgarh,Parkinson'S Disease,60,80,1,0,1
Uttar Pradesh,Chitrakoot,Parkinson'S Disease,6,15,1,1,2
Uttar Pradesh,Chitrakoot,Parkinson'S Disease,15,35,5,3,8
Uttar Pradesh,Chitrakoot,Parkinson'S Disease,35,60,3,0,3
Uttar Pradesh,Chitrakoot,Parkinson'S Disease,60,80,1,0,1
Karnataka,Chitradurga,Parkinson'S Disease,15,35,3,0,3
Karnataka,Chitradurga,Parkinson'S Disease,35,60,8,4,12
Karnataka,Chitradurga,Parkinson'S Disease,60,80,2,1,3
Karnataka,Chikkamagaluru,Parkinson'S Disease,15,35,1,1,2
Karnataka,Chikkamagaluru,Parkinson'S Disease,35,60,9,7,16
Karnataka,Chikkamagaluru,Parkinson'S Disease,60,80,5,1,6
Karnataka,Chikkaballapura,Parkinson'S Disease,35,60,1,4,5
Karnataka,Chikkaballapura,Parkinson'S Disease,60,80,1,1,2
Madhya Pradesh,Chhindwara,Parkinson'S Disease,35,60,2,2,4
Madhya Pradesh,Chhindwara,Parkinson'S Disease,60,80,1,1,2
Madhya Pradesh,Chhatarpur,Parkinson'S Disease,15,35,4,0,4
Madhya Pradesh,Chhatarpur,Parkinson'S Disease,35,60,4,1,5
Madhya Pradesh,Chhatarpur,Parkinson'S Disease,60,80,1,0,1
Tamil Nadu,Chennai,Parkinson'S Disease,35,60,2,0,2
Tamil Nadu,Chengalpattu,Parkinson'S Disease,35,60,5,6,11
Tamil Nadu,Chengalpattu,Parkinson'S Disease,60,80,7,1,8
Haryana,Charki Dadri,Parkinson'S Disease,60,80,1,0,1
Assam,Charaideo,Parkinson'S Disease,35,60,1,1,2
Assam,Charaideo,Parkinson'S Disease,60,80,1,0,1
Maharashtra,Chandrapur,Parkinson'S Disease,35,60,2,1,3
Chandigarh,Chandigarh,Parkinson'S Disease,35,60,3,1,4
Chandigarh,Chandigarh,Parkinson'S Disease,60,80,4,3,7
Chandigarh,Chandigarh,Parkinson'S Disease,80,100,1,0,1
Uttar Pradesh,Chandauli,Parkinson'S Disease,15,35,1,0,1
Uttar Pradesh,Chandauli,Parkinson'S Disease,35,60,2,0,2
Uttarakhand,Champawat,Parkinson'S Disease,15,35,4,1,5
Uttarakhand,Champawat,Parkinson'S Disease,35,60,3,2,5
Uttarakhand,Chamoli,Parkinson'S Disease,6,15,0,1,1
Uttarakhand,Chamoli,Parkinson'S Disease,15,35,4,0,4
Uttarakhand,Chamoli,Parkinson'S Disease,35,60,5,2,7
Karnataka,Chamarajanagara,Parkinson'S Disease,35,60,5,0,5
Assam,Cachar,Parkinson'S Disease,15,35,2,0,2
Assam,Cachar,Parkinson'S Disease,35,60,2,0,2
Bihar,Buxar,Parkinson'S Disease,6,15,2,1,3
Bihar,Buxar,Parkinson'S Disease,15,35,4,2,6
Bihar,Buxar,Parkinson'S Disease,35,60,6,0,6
Bihar,Buxar,Parkinson'S Disease,60,80,1,1,2
Madhya Pradesh,Burhanpur,Parkinson'S Disease,0,6,0,1,1
Madhya Pradesh,Burhanpur,Parkinson'S Disease,6,15,1,0,1
Madhya Pradesh,Burhanpur,Parkinson'S Disease,15,35,2,0,2
Madhya Pradesh,Burhanpur,Parkinson'S Disease,60,80,2,0,2
Rajasthan,Bundi,Parkinson'S Disease,35,60,2,0,2
Maharashtra,Buldhana,Parkinson'S Disease,35,60,3,0,3
Maharashtra,Buldhana,Parkinson'S Disease,60,80,3,0,3
Uttar Pradesh,Bulandshahr,Parkinson'S Disease,15,35,4,1,5
Uttar Pradesh,Bulandshahr,Parkinson'S Disease,35,60,4,0,4
Uttar Pradesh,Bulandshahr,Parkinson'S Disease,60,80,2,0,2
Uttar Pradesh,Bulandshahr,Parkinson'S Disease,80,100,1,1,2
Jammu And Kashmir,Budgam,Parkinson'S Disease,6,15,1,0,1
Jammu And Kashmir,Budgam,Parkinson'S Disease,15,35,2,0,2
Jammu And Kashmir,Budgam,Parkinson'S Disease,35,60,6,0,6
Uttar Pradesh,Budaun,Parkinson'S Disease,15,35,2,0,2
Uttar Pradesh,Budaun,Parkinson'S Disease,35,60,2,0,2
Odisha,Boudh,Parkinson'S Disease,15,35,0,1,1
Odisha,Boudh,Parkinson'S Disease,35,60,0,2,2
Odisha,Boudh,Parkinson'S Disease,60,80,1,1,2
Assam,Bongaigaon,Parkinson'S Disease,35,60,0,1,1
Assam,Bongaigaon,Parkinson'S Disease,60,80,1,0,1
Jharkhand,Bokaro,Parkinson'S Disease,6,15,0,2,2
Jharkhand,Bokaro,Parkinson'S Disease,15,35,8,8,16
Jharkhand,Bokaro,Parkinson'S Disease,35,60,11,3,14
Jharkhand,Bokaro,Parkinson'S Disease,60,80,3,1,4
Chhattisgarh,Bilaspur,Parkinson'S Disease,15,35,0,1,1
Chhattisgarh,Bilaspur,Parkinson'S Disease,35,60,1,0,1
Chhattisgarh,Bilaspur,Parkinson'S Disease,60,80,1,1,2
Himachal Pradesh,Bilaspur,Parkinson'S Disease,15,35,1,0,1
Himachal Pradesh,Bilaspur,Parkinson'S Disease,35,60,0,1,1
Himachal Pradesh,Bilaspur,Parkinson'S Disease,60,80,0,1,1
Rajasthan,Bikaner,Parkinson'S Disease,35,60,1,2,3
Rajasthan,Bikaner,Parkinson'S Disease,60,80,3,1,4
Uttar Pradesh,Bijnor,Parkinson'S Disease,15,35,1,1,2
Uttar Pradesh,Bijnor,Parkinson'S Disease,35,60,7,1,8
Uttar Pradesh,Bijnor,Parkinson'S Disease,60,80,2,1,3
Chhattisgarh,Bijapur,Parkinson'S Disease,6,15,0,1,1
Chhattisgarh,Bijapur,Parkinson'S Disease,15,35,1,0,1
Karnataka,Bidar,Parkinson'S Disease,15,35,2,1,3
Karnataka,Bidar,Parkinson'S Disease,35,60,3,2,5
Karnataka,Bidar,Parkinson'S Disease,60,80,1,0,1
Madhya Pradesh,Bhopal,Parkinson'S Disease,6,15,0,1,1
Madhya Pradesh,Bhopal,Parkinson'S Disease,15,35,15,6,21
Madhya Pradesh,Bhopal,Parkinson'S Disease,35,60,21,3,24
Madhya Pradesh,Bhopal,Parkinson'S Disease,60,80,5,0,5
Madhya Pradesh,Bhopal,Parkinson'S Disease,80,100,1,0,1
Bihar,Bhojpur,Parkinson'S Disease,6,15,3,1,4
Bihar,Bhojpur,Parkinson'S Disease,15,35,10,2,12
Bihar,Bhojpur,Parkinson'S Disease,35,60,12,2,14
Bihar,Bhojpur,Parkinson'S Disease,60,80,5,1,6
Haryana,Bhiwani,Parkinson'S Disease,15,35,1,0,1
Haryana,Bhiwani,Parkinson'S Disease,35,60,3,1,4
Haryana,Bhiwani,Parkinson'S Disease,60,80,1,1,2
Madhya Pradesh,Bhind,Parkinson'S Disease,15,35,3,0,3
Madhya Pradesh,Bhind,Parkinson'S Disease,35,60,6,4,10
Madhya Pradesh,Bhind,Parkinson'S Disease,60,80,2,0,2
Madhya Pradesh,Bhind,Parkinson'S Disease,80,100,0,1,1
Rajasthan,Bhilwara,Parkinson'S Disease,15,35,3,1,4
Rajasthan,Bhilwara,Parkinson'S Disease,35,60,2,3,5
Rajasthan,Bhilwara,Parkinson'S Disease,60,80,2,1,3
Gujarat,Bhavnagar,Parkinson'S Disease,60,80,1,0,1
Gujarat,Bharuch,Parkinson'S Disease,35,60,1,0,1
Gujarat,Bharuch,Parkinson'S Disease,60,80,2,1,3
Maharashtra,Bhandara,Parkinson'S Disease,35,60,2,0,2
Maharashtra,Bhandara,Parkinson'S Disease,60,80,1,1,2
Bihar,Bhagalpur,Parkinson'S Disease,15,35,2,2,4
Bihar,Bhagalpur,Parkinson'S Disease,35,60,4,2,6
Bihar,Bhagalpur,Parkinson'S Disease,60,80,3,0,3
Odisha,Bhadrak,Parkinson'S Disease,35,60,9,3,12
Odisha,Bhadrak,Parkinson'S Disease,60,80,3,1,4
Uttar Pradesh,Bhadohi,Parkinson'S Disease,15,35,2,0,2
Uttar Pradesh,Bhadohi,Parkinson'S Disease,35,60,1,0,1
Madhya Pradesh,Betul,Parkinson'S Disease,15,35,0,1,1
Madhya Pradesh,Betul,Parkinson'S Disease,35,60,3,0,3
Madhya Pradesh,Betul,Parkinson'S Disease,60,80,1,0,1
Karnataka,Bengaluru Urban,Parkinson'S Disease,15,35,0,2,2
Karnataka,Bengaluru Urban,Parkinson'S Disease,35,60,5,2,7
Karnataka,Bengaluru Urban,Parkinson'S Disease,60,80,2,2,4
Karnataka,Bengaluru Rural,Parkinson'S Disease,15,35,1,1,2
Karnataka,Bengaluru Rural,Parkinson'S Disease,35,60,6,1,7
Karnataka,Bengaluru Rural,Parkinson'S Disease,60,80,0,2,2
Karnataka,Bengaluru Rural,Parkinson'S Disease,80,100,0,1,1
Chhattisgarh,Bemetara,Parkinson'S Disease,6,15,2,3,5
Chhattisgarh,Bemetara,Parkinson'S Disease,15,35,1,0,1
Chhattisgarh,Bemetara,Parkinson'S Disease,35,60,11,0,11
Chhattisgarh,Bemetara,Parkinson'S Disease,60,80,3,0,3
Karnataka,Belagavi,Parkinson'S Disease,6,15,0,1,1
Karnataka,Belagavi,Parkinson'S Disease,15,35,4,2,6
Karnataka,Belagavi,Parkinson'S Disease,35,60,10,4,14
Karnataka,Belagavi,Parkinson'S Disease,60,80,4,1,5
Bihar,Begusarai,Parkinson'S Disease,6,15,0,1,1
Bihar,Begusarai,Parkinson'S Disease,15,35,9,0,9
Bihar,Begusarai,Parkinson'S Disease,35,60,8,0,8
Bihar,Begusarai,Parkinson'S Disease,60,80,1,0,1
Maharashtra,Beed,Parkinson'S Disease,15,35,1,1,2
Maharashtra,Beed,Parkinson'S Disease,35,60,4,0,4
Maharashtra,Beed,Parkinson'S Disease,60,80,1,1,2
Punjab,Bathinda,Parkinson'S Disease,15,35,2,0,2
Punjab,Bathinda,Parkinson'S Disease,35,60,16,1,17
Punjab,Bathinda,Parkinson'S Disease,60,80,3,0,3
Uttar Pradesh,Basti,Parkinson'S Disease,15,35,0,1,1
Uttar Pradesh,Basti,Parkinson'S Disease,35,60,5,0,5
Uttar Pradesh,Basti,Parkinson'S Disease,80,100,0,1,1
Chhattisgarh,Bastar,Parkinson'S Disease,6,15,0,1,1
Madhya Pradesh,Barwani,Parkinson'S Disease,15,35,6,1,7
Madhya Pradesh,Barwani,Parkinson'S Disease,35,60,2,1,3
Assam,Barpeta,Parkinson'S Disease,15,35,0,1,1
Assam,Barpeta,Parkinson'S Disease,35,60,2,0,2
Punjab,Barnala,Parkinson'S Disease,15,35,1,1,2
Punjab,Barnala,Parkinson'S Disease,35,60,1,0,1
Punjab,Barnala,Parkinson'S Disease,60,80,3,0,3
Rajasthan,Barmer,Parkinson'S Disease,6,15,0,1,1
Rajasthan,Barmer,Parkinson'S Disease,15,35,1,0,1
Rajasthan,Barmer,Parkinson'S Disease,35,60,2,1,3
Odisha,Bargarh,Parkinson'S Disease,15,35,1,0,1
Odisha,Bargarh,Parkinson'S Disease,35,60,1,1,2
Odisha,Bargarh,Parkinson'S Disease,60,80,1,0,1
Uttar Pradesh,Bareilly,Parkinson'S Disease,15,35,11,2,13
Uttar Pradesh,Bareilly,Parkinson'S Disease,35,60,8,2,10
Uttar Pradesh,Bareilly,Parkinson'S Disease,60,80,5,2,7
Jammu And Kashmir,Baramulla,Parkinson'S Disease,0,6,0,1,1
Jammu And Kashmir,Baramulla,Parkinson'S Disease,6,15,1,0,1
Jammu And Kashmir,Baramulla,Parkinson'S Disease,15,35,1,0,1
Jammu And Kashmir,Baramulla,Parkinson'S Disease,35,60,2,1,3
Jammu And Kashmir,Baramulla,Parkinson'S Disease,60,80,3,0,3
Jammu And Kashmir,Baramulla,Parkinson'S Disease,80,100,1,0,1
Uttar Pradesh,Barabanki,Parkinson'S Disease,15,35,4,1,5
Uttar Pradesh,Barabanki,Parkinson'S Disease,35,60,3,0,3
Rajasthan,Banswara,Parkinson'S Disease,15,35,1,0,1
Rajasthan,Banswara,Parkinson'S Disease,35,60,1,0,1
Bihar,Banka,Parkinson'S Disease,6,15,1,1,2
Bihar,Banka,Parkinson'S Disease,15,35,4,0,4
Bihar,Banka,Parkinson'S Disease,35,60,3,2,5
Jammu And Kashmir,Bandipora,Parkinson'S Disease,6,15,1,0,1
Jammu And Kashmir,Bandipora,Parkinson'S Disease,15,35,0,9,9
Jammu And Kashmir,Bandipora,Parkinson'S Disease,35,60,5,5,10
Jammu And Kashmir,Bandipora,Parkinson'S Disease,60,80,1,0,1
Jammu And Kashmir,Bandipora,Parkinson'S Disease,80,100,1,0,1
Uttar Pradesh,Banda,Parkinson'S Disease,15,35,1,0,1
Uttar Pradesh,Banda,Parkinson'S Disease,35,60,1,0,1
Chhattisgarh,Balrampur,Parkinson'S Disease,15,35,1,0,1
Chhattisgarh,Balrampur,Parkinson'S Disease,35,60,6,1,7
Chhattisgarh,Balrampur,Parkinson'S Disease,60,80,2,1,3
Uttar Pradesh,Balrampur,Parkinson'S Disease,6,15,1,0,1
Uttar Pradesh,Balrampur,Parkinson'S Disease,15,35,2,0,2
Uttar Pradesh,Balrampur,Parkinson'S Disease,35,60,2,1,3
Chhattisgarh,Baloda Bazar,Parkinson'S Disease,15,35,1,0,1
Chhattisgarh,Baloda Bazar,Parkinson'S Disease,35,60,3,0,3
Uttar Pradesh,Ballia,Parkinson'S Disease,6,15,0,1,1
Uttar Pradesh,Ballia,Parkinson'S Disease,15,35,5,0,5
Uttar Pradesh,Ballia,Parkinson'S Disease,35,60,6,5,11
Uttar Pradesh,Ballia,Parkinson'S Disease,60,80,3,0,3
Karnataka,Ballari,Parkinson'S Disease,6,15,0,1,1
Karnataka,Ballari,Parkinson'S Disease,15,35,6,2,8
Karnataka,Ballari,Parkinson'S Disease,35,60,23,4,27
Karnataka,Ballari,Parkinson'S Disease,60,80,4,2,6
Odisha,Baleshwar,Parkinson'S Disease,6,15,0,1,1
Odisha,Baleshwar,Parkinson'S Disease,15,35,5,0,5
Odisha,Baleshwar,Parkinson'S Disease,35,60,13,2,15
Odisha,Baleshwar,Parkinson'S Disease,60,80,11,2,13
Odisha,Baleshwar,Parkinson'S Disease,80,100,0,1,1
Odisha,Balangir,Parkinson'S Disease,6,15,1,0,1
Odisha,Balangir,Parkinson'S Disease,35,60,8,3,11
Odisha,Balangir,Parkinson'S Disease,60,80,2,2,4
Madhya Pradesh,Balaghat,Parkinson'S Disease,6,15,1,0,1
Madhya Pradesh,Balaghat,Parkinson'S Disease,15,35,2,1,3
Madhya Pradesh,Balaghat,Parkinson'S Disease,35,60,4,2,6
Assam,Baksa,Parkinson'S Disease,6,15,1,0,1
Uttar Pradesh,Bahraich,Parkinson'S Disease,6,15,1,0,1
Uttar Pradesh,Bahraich,Parkinson'S Disease,15,35,1,0,1
Uttar Pradesh,Bahraich,Parkinson'S Disease,35,60,1,0,1
Uttar Pradesh,Bahraich,Parkinson'S Disease,60,80,3,0,3
Uttar Pradesh,Baghpat,Parkinson'S Disease,15,35,1,0,1
Uttarakhand,Bageshwar,Parkinson'S Disease,15,35,0,1,1
Uttarakhand,Bageshwar,Parkinson'S Disease,35,60,1,1,2
Uttarakhand,Bageshwar,Parkinson'S Disease,60,80,0,1,1
Karnataka,Bagalkote,Parkinson'S Disease,15,35,1,0,1
Karnataka,Bagalkote,Parkinson'S Disease,35,60,4,0,4
Uttar Pradesh,Azamgarh,Parkinson'S Disease,35,60,1,0,1
Uttar Pradesh,Azamgarh,Parkinson'S Disease,80,100,1,0,1
Uttar Pradesh,Ayodhya,Parkinson'S Disease,35,60,3,0,3
Uttar Pradesh,Ayodhya,Parkinson'S Disease,60,80,1,0,1
Bihar,Aurangabad,Parkinson'S Disease,6,15,2,2,4
Bihar,Aurangabad,Parkinson'S Disease,15,35,8,4,12
Bihar,Aurangabad,Parkinson'S Disease,35,60,13,2,15
Bihar,Aurangabad,Parkinson'S Disease,60,80,4,0,4
Maharashtra,Aurangabad,Parkinson'S Disease,35,60,2,1,3
Maharashtra,Aurangabad,Parkinson'S Disease,60,80,1,0,1
Uttar Pradesh,Auraiya,Parkinson'S Disease,15,35,2,0,2
Uttar Pradesh,Auraiya,Parkinson'S Disease,60,80,1,1,2
Tamil Nadu,Ariyalur,Parkinson'S Disease,60,80,2,0,2
Bihar,Araria,Parkinson'S Disease,35,60,3,0,3
Madhya Pradesh,Anuppur,Parkinson'S Disease,6,15,1,0,1
Odisha,Anugul,Parkinson'S Disease,35,60,3,3,6
Odisha,Anugul,Parkinson'S Disease,60,80,2,0,2
Jammu And Kashmir,Anantnag,Parkinson'S Disease,15,35,0,1,1
Jammu And Kashmir,Anantnag,Parkinson'S Disease,35,60,4,3,7
Jammu And Kashmir,Anantnag,Parkinson'S Disease,60,80,3,2,5
Gujarat,Anand,Parkinson'S Disease,35,60,1,0,1
Gujarat,Anand,Parkinson'S Disease,60,80,1,0,1
Uttar Pradesh,Amroha,Parkinson'S Disease,15,35,2,0,2
Uttar Pradesh,Amroha,Parkinson'S Disease,35,60,1,1,2
Uttar Pradesh,Amroha,Parkinson'S Disease,60,80,2,0,2
Punjab,Amritsar,Parkinson'S Disease,35,60,3,0,3
Punjab,Amritsar,Parkinson'S Disease,60,80,2,0,2
Maharashtra,Amravati,Parkinson'S Disease,35,60,2,0,2
Uttar Pradesh,Ambedkar Nagar,Parkinson'S Disease,15,35,1,0,1
Uttar Pradesh,Ambedkar Nagar,Parkinson'S Disease,35,60,3,1,4
Uttar Pradesh,Ambedkar Nagar,Parkinson'S Disease,60,80,1,0,1
Haryana,Ambala,Parkinson'S Disease,35,60,2,0,2
Haryana,Ambala,Parkinson'S Disease,60,80,1,1,2
Haryana,Ambala,Parkinson'S Disease,80,100,0,1,1
Rajasthan,Alwar,Parkinson'S Disease,6,15,1,1,2
Rajasthan,Alwar,Parkinson'S Disease,35,60,2,2,4
Rajasthan,Alwar,Parkinson'S Disease,60,80,2,0,2
Uttarakhand,Almora,Parkinson'S Disease,35,60,0,1,1
Madhya Pradesh,Alirajpur,Parkinson'S Disease,15,35,1,0,1
Uttar Pradesh,Aligarh,Parkinson'S Disease,15,35,5,0,5
Uttar Pradesh,Aligarh,Parkinson'S Disease,60,80,1,0,1
Kerala,Alappuzha,Parkinson'S Disease,35,60,5,1,6
Kerala,Alappuzha,Parkinson'S Disease,60,80,5,2,7
Maharashtra,Akola,Parkinson'S Disease,15,35,1,0,1
Maharashtra,Akola,Parkinson'S Disease,35,60,6,0,6
Maharashtra,Akola,Parkinson'S Disease,60,80,1,0,1
Rajasthan,Ajmer,Parkinson'S Disease,15,35,1,0,1
Mizoram,Aizawl,Parkinson'S Disease,35,60,0,2,2
Mizoram,Aizawl,Parkinson'S Disease,80,100,1,1,2
Maharashtra,Ahmednagar,Parkinson'S Disease,35,60,1,4,5
Gujarat,Ahmadabad,Parkinson'S Disease,60,80,1,0,1
Uttar Pradesh,Agra,Parkinson'S Disease,35,60,1,0,1
Uttar Pradesh,Agra,Parkinson'S Disease,60,80,1,1,2
Maharashtra,Yavatmal,Short Stature/Dwarfism,15,35,15,32,47
Maharashtra,Yavatmal,Short Stature/Dwarfism,35,60,15,14,29
Maharashtra,Yavatmal,Short Stature/Dwarfism,60,80,2,0,2
Puducherry,Yanam,Short Stature/Dwarfism,6,15,1,0,1
Puducherry,Yanam,Short Stature/Dwarfism,15,35,8,5,13
Puducherry,Yanam,Short Stature/Dwarfism,35,60,13,12,25
Puducherry,Yanam,Short Stature/Dwarfism,60,80,2,2,4
Haryana,Yamunanagar,Short Stature/Dwarfism,6,15,3,4,7
Haryana,Yamunanagar,Short Stature/Dwarfism,15,35,4,1,5
Haryana,Yamunanagar,Short Stature/Dwarfism,35,60,1,3,4
Karnataka,Yadgir,Short Stature/Dwarfism,6,15,2,5,7
Karnataka,Yadgir,Short Stature/Dwarfism,15,35,14,20,34
Karnataka,Yadgir,Short Stature/Dwarfism,35,60,9,2,11
Karnataka,Yadgir,Short Stature/Dwarfism,60,80,1,3,4
Nagaland,Wokha,Short Stature/Dwarfism,15,35,1,0,1
Nagaland,Wokha,Short Stature/Dwarfism,35,60,0,1,1
Tripura,West Tripura,Short Stature/Dwarfism,15,35,1,0,1
Jharkhand,West Singhbhum,Short Stature/Dwarfism,6,15,0,1,1
Jharkhand,West Singhbhum,Short Stature/Dwarfism,15,35,1,1,2
Jharkhand,West Singhbhum,Short Stature/Dwarfism,35,60,0,1,1
Meghalaya,West Jaintia Hills,Short Stature/Dwarfism,15,35,2,2,4
Meghalaya,West Jaintia Hills,Short Stature/Dwarfism,35,60,1,2,3
Meghalaya,West Garo Hills,Short Stature/Dwarfism,15,35,0,2,2
Meghalaya,West Garo Hills,Short Stature/Dwarfism,35,60,0,1,1
Delhi,West,Short Stature/Dwarfism,6,15,1,2,3
Delhi,West,Short Stature/Dwarfism,15,35,10,13,23
Delhi,West,Short Stature/Dwarfism,35,60,0,3,3
Kerala,Wayanad,Short Stature/Dwarfism,6,15,0,2,2
Kerala,Wayanad,Short Stature/Dwarfism,15,35,4,8,12
Kerala,Wayanad,Short Stature/Dwarfism,35,60,4,13,17
Kerala,Wayanad,Short Stature/Dwarfism,60,80,1,1,2
Maharashtra,Washim,Short Stature/Dwarfism,15,35,3,4,7
Maharashtra,Washim,Short Stature/Dwarfism,35,60,2,3,5
Maharashtra,Washim,Short Stature/Dwarfism,60,80,0,2,2
Maharashtra,Wardha,Short Stature/Dwarfism,15,35,2,2,4
Maharashtra,Wardha,Short Stature/Dwarfism,35,60,1,2,3
Andhra Pradesh,Vizianagaram,Short Stature/Dwarfism,15,35,1,0,1
Andhra Pradesh,Visakhapatanam,Short Stature/Dwarfism,15,35,1,0,1
Tamil Nadu,Virudhunagar,Short Stature/Dwarfism,6,15,1,5,6
Tamil Nadu,Virudhunagar,Short Stature/Dwarfism,15,35,2,5,7
Tamil Nadu,Virudhunagar,Short Stature/Dwarfism,35,60,1,2,3
Tamil Nadu,Villupuram,Short Stature/Dwarfism,0,6,2,0,2
Tamil Nadu,Villupuram,Short Stature/Dwarfism,6,15,3,3,6
Tamil Nadu,Villupuram,Short Stature/Dwarfism,15,35,15,29,44
Tamil Nadu,Villupuram,Short Stature/Dwarfism,35,60,17,25,42
Tamil Nadu,Villupuram,Short Stature/Dwarfism,60,80,1,1,2
Karnataka,Vijayapura,Short Stature/Dwarfism,0,6,1,0,1
Karnataka,Vijayapura,Short Stature/Dwarfism,6,15,6,14,20
Karnataka,Vijayapura,Short Stature/Dwarfism,15,35,20,49,69
Karnataka,Vijayapura,Short Stature/Dwarfism,35,60,18,6,24
Karnataka,Vijayapura,Short Stature/Dwarfism,60,80,1,1,2
Madhya Pradesh,Vidisha,Short Stature/Dwarfism,6,15,3,3,6
Madhya Pradesh,Vidisha,Short Stature/Dwarfism,15,35,20,14,34
Madhya Pradesh,Vidisha,Short Stature/Dwarfism,35,60,18,11,29
Madhya Pradesh,Vidisha,Short Stature/Dwarfism,60,80,12,6,18
Madhya Pradesh,Vidisha,Short Stature/Dwarfism,80,100,3,0,3
Tamil Nadu,Vellore,Short Stature/Dwarfism,6,15,0,1,1
Tamil Nadu,Vellore,Short Stature/Dwarfism,15,35,3,6,9
Tamil Nadu,Vellore,Short Stature/Dwarfism,35,60,2,3,5
Uttar Pradesh,Varanasi,Short Stature/Dwarfism,6,15,0,1,1
Uttar Pradesh,Varanasi,Short Stature/Dwarfism,15,35,17,22,39
Uttar Pradesh,Varanasi,Short Stature/Dwarfism,35,60,7,5,12
Gujarat,Valsad,Short Stature/Dwarfism,15,35,1,1,2
Bihar,Vaishali,Short Stature/Dwarfism,6,15,1,1,2
Bihar,Vaishali,Short Stature/Dwarfism,15,35,6,5,11
Bihar,Vaishali,Short Stature/Dwarfism,35,60,2,1,3
Gujarat,Vadodara,Short Stature/Dwarfism,15,35,1,0,1
Gujarat,Vadodara,Short Stature/Dwarfism,35,60,0,1,1
Karnataka,Uttara Kannada,Short Stature/Dwarfism,6,15,4,1,5
Karnataka,Uttara Kannada,Short Stature/Dwarfism,15,35,12,23,35
Karnataka,Uttara Kannada,Short Stature/Dwarfism,35,60,13,29,42
Karnataka,Uttara Kannada,Short Stature/Dwarfism,60,80,1,3,4
Uttarakhand,Uttar Kashi,Short Stature/Dwarfism,15,35,3,1,4
Uttarakhand,Uttar Kashi,Short Stature/Dwarfism,35,60,1,0,1
Arunachal Pradesh,Upper Subansiri,Short Stature/Dwarfism,15,35,0,1,1
Uttar Pradesh,Unnao,Short Stature/Dwarfism,6,15,2,0,2
Uttar Pradesh,Unnao,Short Stature/Dwarfism,15,35,6,10,16
Uttar Pradesh,Unnao,Short Stature/Dwarfism,35,60,6,5,11
Uttar Pradesh,Unnao,Short Stature/Dwarfism,60,80,1,1,2
Tripura,Unakoti,Short Stature/Dwarfism,15,35,1,0,1
Himachal Pradesh,Una,Short Stature/Dwarfism,35,60,2,0,2
Madhya Pradesh,Ujjain,Short Stature/Dwarfism,6,15,2,1,3
Madhya Pradesh,Ujjain,Short Stature/Dwarfism,15,35,5,14,19
Madhya Pradesh,Ujjain,Short Stature/Dwarfism,35,60,2,1,3
Madhya Pradesh,Ujjain,Short Stature/Dwarfism,60,80,1,0,1
Karnataka,Udupi,Short Stature/Dwarfism,6,15,2,2,4
Karnataka,Udupi,Short Stature/Dwarfism,15,35,3,14,17
Karnataka,Udupi,Short Stature/Dwarfism,35,60,4,15,19
Karnataka,Udupi,Short Stature/Dwarfism,60,80,1,0,1
Jammu And Kashmir,Udhampur,Short Stature/Dwarfism,6,15,0,1,1
Jammu And Kashmir,Udhampur,Short Stature/Dwarfism,15,35,6,8,14
Jammu And Kashmir,Udhampur,Short Stature/Dwarfism,35,60,3,1,4
Jammu And Kashmir,Udhampur,Short Stature/Dwarfism,60,80,0,1,1
Uttarakhand,Udam Singh Nagar,Short Stature/Dwarfism,6,15,1,2,3
Uttarakhand,Udam Singh Nagar,Short Stature/Dwarfism,15,35,4,3,7
Uttarakhand,Udam Singh Nagar,Short Stature/Dwarfism,35,60,6,3,9
Assam,Udalguri,Short Stature/Dwarfism,6,15,0,1,1
Assam,Udalguri,Short Stature/Dwarfism,15,35,3,1,4
Assam,Udalguri,Short Stature/Dwarfism,35,60,1,4,5
Rajasthan,Udaipur,Short Stature/Dwarfism,6,15,5,1,6
Rajasthan,Udaipur,Short Stature/Dwarfism,15,35,11,28,39
Rajasthan,Udaipur,Short Stature/Dwarfism,35,60,10,25,35
Rajasthan,Udaipur,Short Stature/Dwarfism,60,80,0,1,1
Tamil Nadu,Tuticorin,Short Stature/Dwarfism,0,6,0,1,1
Tamil Nadu,Tuticorin,Short Stature/Dwarfism,6,15,3,4,7
Tamil Nadu,Tuticorin,Short Stature/Dwarfism,15,35,5,9,14
Tamil Nadu,Tuticorin,Short Stature/Dwarfism,35,60,4,5,9
Tamil Nadu,Tuticorin,Short Stature/Dwarfism,60,80,0,1,1
Karnataka,Tumakuru,Short Stature/Dwarfism,0,6,1,2,3
Karnataka,Tumakuru,Short Stature/Dwarfism,6,15,11,11,22
Karnataka,Tumakuru,Short Stature/Dwarfism,15,35,18,53,71
Karnataka,Tumakuru,Short Stature/Dwarfism,35,60,22,35,57
Karnataka,Tumakuru,Short Stature/Dwarfism,60,80,7,3,10
Karnataka,Tumakuru,Short Stature/Dwarfism,80,100,0,1,1
Rajasthan,Tonk,Short Stature/Dwarfism,6,15,3,0,3
Rajasthan,Tonk,Short Stature/Dwarfism,15,35,6,22,28
Rajasthan,Tonk,Short Stature/Dwarfism,35,60,3,7,10
Rajasthan,Tonk,Short Stature/Dwarfism,60,80,1,0,1
Tamil Nadu,Tiruvannamalai,Short Stature/Dwarfism,6,15,3,1,4
Tamil Nadu,Tiruvannamalai,Short Stature/Dwarfism,15,35,6,12,18
Tamil Nadu,Tiruvannamalai,Short Stature/Dwarfism,35,60,4,4,8
Tamil Nadu,Tiruvannamalai,Short Stature/Dwarfism,60,80,2,1,3
Tamil Nadu,Tiruppur,Short Stature/Dwarfism,0,6,0,3,3
Tamil Nadu,Tiruppur,Short Stature/Dwarfism,6,15,1,2,3
Tamil Nadu,Tiruppur,Short Stature/Dwarfism,15,35,2,3,5
Tamil Nadu,Tiruppur,Short Stature/Dwarfism,35,60,5,3,8
Tamil Nadu,Tiruppur,Short Stature/Dwarfism,60,80,1,0,1
Tamil Nadu,Tirupathur,Short Stature/Dwarfism,0,6,1,1,2
Tamil Nadu,Tirupathur,Short Stature/Dwarfism,6,15,0,1,1
Tamil Nadu,Tirupathur,Short Stature/Dwarfism,15,35,4,3,7
Tamil Nadu,Tirupathur,Short Stature/Dwarfism,35,60,2,3,5
Tamil Nadu,Tirunelveli,Short Stature/Dwarfism,6,15,2,2,4
Tamil Nadu,Tirunelveli,Short Stature/Dwarfism,15,35,23,21,44
Tamil Nadu,Tirunelveli,Short Stature/Dwarfism,35,60,21,21,42
Tamil Nadu,Tirunelveli,Short Stature/Dwarfism,60,80,2,2,4
Tamil Nadu,Tiruchirappalli,Short Stature/Dwarfism,0,6,4,2,6
Tamil Nadu,Tiruchirappalli,Short Stature/Dwarfism,6,15,5,10,15
Tamil Nadu,Tiruchirappalli,Short Stature/Dwarfism,15,35,21,36,57
Tamil Nadu,Tiruchirappalli,Short Stature/Dwarfism,35,60,17,37,54
Tamil Nadu,Tiruchirappalli,Short Stature/Dwarfism,60,80,6,4,10
Assam,Tinsukia,Short Stature/Dwarfism,15,35,1,1,2
Assam,Tinsukia,Short Stature/Dwarfism,35,60,1,1,2
Madhya Pradesh,Tikamgarh,Short Stature/Dwarfism,6,15,0,1,1
Madhya Pradesh,Tikamgarh,Short Stature/Dwarfism,15,35,1,2,3
Madhya Pradesh,Tikamgarh,Short Stature/Dwarfism,35,60,1,0,1
Madhya Pradesh,Tikamgarh,Short Stature/Dwarfism,60,80,4,0,4
Kerala,Thrissur,Short Stature/Dwarfism,6,15,3,5,8
Kerala,Thrissur,Short Stature/Dwarfism,15,35,18,29,47
Kerala,Thrissur,Short Stature/Dwarfism,35,60,35,30,65
Kerala,Thrissur,Short Stature/Dwarfism,60,80,4,8,12
Kerala,Thrissur,Short Stature/Dwarfism,80,100,1,0,1
Manipur,Thoubal,Short Stature/Dwarfism,15,35,1,2,3
Manipur,Thoubal,Short Stature/Dwarfism,35,60,0,1,1
Tamil Nadu,Thiruvarur,Short Stature/Dwarfism,6,15,4,6,10
Tamil Nadu,Thiruvarur,Short Stature/Dwarfism,15,35,13,18,31
Tamil Nadu,Thiruvarur,Short Stature/Dwarfism,35,60,10,10,20
Tamil Nadu,Thiruvarur,Short Stature/Dwarfism,60,80,2,1,3
Kerala,Thiruvananthapuram,Short Stature/Dwarfism,6,15,3,1,4
Kerala,Thiruvananthapuram,Short Stature/Dwarfism,15,35,6,10,16
Kerala,Thiruvananthapuram,Short Stature/Dwarfism,35,60,12,13,25
Kerala,Thiruvananthapuram,Short Stature/Dwarfism,60,80,1,1,2
Tamil Nadu,Thiruvallur,Short Stature/Dwarfism,6,15,2,4,6
Tamil Nadu,Thiruvallur,Short Stature/Dwarfism,15,35,13,19,32
Tamil Nadu,Thiruvallur,Short Stature/Dwarfism,35,60,10,18,28
Tamil Nadu,Thiruvallur,Short Stature/Dwarfism,60,80,1,3,4
Tamil Nadu,Theni,Short Stature/Dwarfism,6,15,2,5,7
Tamil Nadu,Theni,Short Stature/Dwarfism,15,35,8,11,19
Tamil Nadu,Theni,Short Stature/Dwarfism,35,60,4,13,17
Tamil Nadu,Theni,Short Stature/Dwarfism,60,80,0,1,1
Tamil Nadu,Theni,Short Stature/Dwarfism,80,100,0,1,1
Tamil Nadu,The Nilgiris,Short Stature/Dwarfism,6,15,0,2,2
Tamil Nadu,The Nilgiris,Short Stature/Dwarfism,15,35,2,4,6
Tamil Nadu,The Nilgiris,Short Stature/Dwarfism,35,60,1,2,3
Tamil Nadu,Thanjavur,Short Stature/Dwarfism,0,6,1,2,3
Tamil Nadu,Thanjavur,Short Stature/Dwarfism,6,15,9,11,20
Tamil Nadu,Thanjavur,Short Stature/Dwarfism,15,35,39,52,91
Tamil Nadu,Thanjavur,Short Stature/Dwarfism,35,60,19,50,69
Tamil Nadu,Thanjavur,Short Stature/Dwarfism,60,80,6,6,12
Maharashtra,Thane,Short Stature/Dwarfism,6,15,2,11,13
Maharashtra,Thane,Short Stature/Dwarfism,15,35,31,23,54
Maharashtra,Thane,Short Stature/Dwarfism,35,60,16,9,25
Maharashtra,Thane,Short Stature/Dwarfism,60,80,0,1,1
Tamil Nadu,Tenkasi,Short Stature/Dwarfism,15,35,4,5,9
Tamil Nadu,Tenkasi,Short Stature/Dwarfism,35,60,1,3,4
Tamil Nadu,Tenkasi,Short Stature/Dwarfism,60,80,1,0,1
Manipur,Tengnoupal,Short Stature/Dwarfism,15,35,0,2,2
Uttarakhand,Tehri Garhwal,Short Stature/Dwarfism,15,35,1,3,4
Uttarakhand,Tehri Garhwal,Short Stature/Dwarfism,60,80,1,0,1
Punjab,Tarn Taran,Short Stature/Dwarfism,6,15,1,0,1
Punjab,Tarn Taran,Short Stature/Dwarfism,15,35,16,5,21
Punjab,Tarn Taran,Short Stature/Dwarfism,35,60,3,4,7
Gujarat,Tapi,Short Stature/Dwarfism,6,15,1,2,3
Gujarat,Tapi,Short Stature/Dwarfism,15,35,7,3,10
Gujarat,Tapi,Short Stature/Dwarfism,35,60,1,3,4
Gujarat,Tapi,Short Stature/Dwarfism,60,80,0,1,1
Manipur,Tamenglong,Short Stature/Dwarfism,6,15,0,1,1
Manipur,Tamenglong,Short Stature/Dwarfism,35,60,1,1,2
Manipur,Tamenglong,Short Stature/Dwarfism,80,100,0,1,1
Chhattisgarh,Surguja,Short Stature/Dwarfism,6,15,1,3,4
Chhattisgarh,Surguja,Short Stature/Dwarfism,15,35,3,10,13
Chhattisgarh,Surguja,Short Stature/Dwarfism,35,60,1,0,1
Gujarat,Surendranagar,Short Stature/Dwarfism,15,35,4,1,5
Gujarat,Surendranagar,Short Stature/Dwarfism,35,60,1,0,1
Gujarat,Surat,Short Stature/Dwarfism,15,35,3,1,4
Gujarat,Surat,Short Stature/Dwarfism,35,60,1,0,1
Chhattisgarh,Surajpur,Short Stature/Dwarfism,6,15,0,2,2
Chhattisgarh,Surajpur,Short Stature/Dwarfism,15,35,6,7,13
Chhattisgarh,Surajpur,Short Stature/Dwarfism,35,60,2,3,5
Chhattisgarh,Surajpur,Short Stature/Dwarfism,60,80,1,0,1
Bihar,Supaul,Short Stature/Dwarfism,6,15,1,4,5
Bihar,Supaul,Short Stature/Dwarfism,15,35,4,1,5
Bihar,Supaul,Short Stature/Dwarfism,35,60,1,0,1
Bihar,Supaul,Short Stature/Dwarfism,60,80,1,0,1
Odisha,Sundargarh,Short Stature/Dwarfism,0,6,2,1,3
Odisha,Sundargarh,Short Stature/Dwarfism,6,15,5,8,13
Odisha,Sundargarh,Short Stature/Dwarfism,15,35,9,16,25
Odisha,Sundargarh,Short Stature/Dwarfism,35,60,7,13,20
Odisha,Sundargarh,Short Stature/Dwarfism,60,80,1,0,1
Uttar Pradesh,Sultanpur,Short Stature/Dwarfism,15,35,9,6,15
Uttar Pradesh,Sultanpur,Short Stature/Dwarfism,35,60,5,1,6
Uttar Pradesh,Sultanpur,Short Stature/Dwarfism,60,80,3,0,3
Chhattisgarh,Sukma,Short Stature/Dwarfism,6,15,3,0,3
Chhattisgarh,Sukma,Short Stature/Dwarfism,15,35,3,6,9
Jammu And Kashmir,Srinagar,Short Stature/Dwarfism,6,15,0,1,1
Jammu And Kashmir,Srinagar,Short Stature/Dwarfism,15,35,0,4,4
Andhra Pradesh,Srikakulam,Short Stature/Dwarfism,15,35,1,1,2
Andhra Pradesh,Srikakulam,Short Stature/Dwarfism,35,60,1,1,2
Punjab,Sri Muktsar Sahib,Short Stature/Dwarfism,15,35,1,3,4
Punjab,Sri Muktsar Sahib,Short Stature/Dwarfism,35,60,3,3,6
Andhra Pradesh,Spsr Nellore,Short Stature/Dwarfism,15,35,1,0,1
Meghalaya,South West Khasi Hills,Short Stature/Dwarfism,6,15,2,0,2
Meghalaya,South West Khasi Hills,Short Stature/Dwarfism,15,35,2,0,2
Meghalaya,South West Garo Hills,Short Stature/Dwarfism,15,35,0,1,1
Delhi,South West,Short Stature/Dwarfism,6,15,0,1,1
Delhi,South West,Short Stature/Dwarfism,15,35,5,6,11
Delhi,South West,Short Stature/Dwarfism,35,60,1,1,2
Assam,South Salmara Mancachar,Short Stature/Dwarfism,6,15,1,0,1
Goa,South Goa,Short Stature/Dwarfism,0,6,1,0,1
Goa,South Goa,Short Stature/Dwarfism,6,15,1,0,1
Goa,South Goa,Short Stature/Dwarfism,15,35,1,1,2
Goa,South Goa,Short Stature/Dwarfism,35,60,0,1,1
Delhi,South East,Short Stature/Dwarfism,6,15,1,0,1
Andaman And Nicobar Islands,South Andamans,Short Stature/Dwarfism,15,35,6,5,11
Andaman And Nicobar Islands,South Andamans,Short Stature/Dwarfism,35,60,5,3,8
Andaman And Nicobar Islands,South Andamans,Short Stature/Dwarfism,60,80,0,1,1
Delhi,South,Short Stature/Dwarfism,15,35,1,1,2
Delhi,South,Short Stature/Dwarfism,35,60,1,0,1
Assam,Sonitpur,Short Stature/Dwarfism,6,15,1,0,1
Assam,Sonitpur,Short Stature/Dwarfism,15,35,5,5,10
Assam,Sonitpur,Short Stature/Dwarfism,35,60,3,2,5
Assam,Sonitpur,Short Stature/Dwarfism,60,80,1,0,1
Haryana,Sonipat,Short Stature/Dwarfism,0,6,1,0,1
Haryana,Sonipat,Short Stature/Dwarfism,6,15,0,2,2
Haryana,Sonipat,Short Stature/Dwarfism,15,35,2,8,10
Haryana,Sonipat,Short Stature/Dwarfism,35,60,2,2,4
Odisha,Sonepur,Short Stature/Dwarfism,6,15,0,2,2
Odisha,Sonepur,Short Stature/Dwarfism,15,35,4,8,12
Odisha,Sonepur,Short Stature/Dwarfism,35,60,0,6,6
Uttar Pradesh,Sonbhadra,Short Stature/Dwarfism,15,35,2,8,10
Uttar Pradesh,Sonbhadra,Short Stature/Dwarfism,35,60,2,1,3
Uttar Pradesh,Sonbhadra,Short Stature/Dwarfism,60,80,1,0,1
Maharashtra,Solapur,Short Stature/Dwarfism,0,6,1,0,1
Maharashtra,Solapur,Short Stature/Dwarfism,6,15,7,6,13
Maharashtra,Solapur,Short Stature/Dwarfism,15,35,25,40,65
Maharashtra,Solapur,Short Stature/Dwarfism,35,60,18,23,41
Maharashtra,Solapur,Short Stature/Dwarfism,60,80,2,2,4
Himachal Pradesh,Solan,Short Stature/Dwarfism,15,35,2,1,3
Bihar,Siwan,Short Stature/Dwarfism,15,35,4,0,4
Bihar,Siwan,Short Stature/Dwarfism,35,60,1,0,1
Assam,Sivasagar,Short Stature/Dwarfism,6,15,0,1,1
Assam,Sivasagar,Short Stature/Dwarfism,15,35,1,0,1
Assam,Sivasagar,Short Stature/Dwarfism,35,60,0,2,2
Tamil Nadu,Sivaganga,Short Stature/Dwarfism,0,6,1,0,1
Tamil Nadu,Sivaganga,Short Stature/Dwarfism,6,15,2,2,4
Tamil Nadu,Sivaganga,Short Stature/Dwarfism,15,35,11,13,24
Tamil Nadu,Sivaganga,Short Stature/Dwarfism,35,60,10,17,27
Tamil Nadu,Sivaganga,Short Stature/Dwarfism,60,80,3,2,5
Uttar Pradesh,Sitapur,Short Stature/Dwarfism,6,15,2,3,5
Uttar Pradesh,Sitapur,Short Stature/Dwarfism,15,35,12,9,21
Uttar Pradesh,Sitapur,Short Stature/Dwarfism,35,60,5,2,7
Uttar Pradesh,Sitapur,Short Stature/Dwarfism,60,80,2,0,2
Bihar,Sitamarhi,Short Stature/Dwarfism,6,15,6,1,7
Bihar,Sitamarhi,Short Stature/Dwarfism,15,35,4,8,12
Bihar,Sitamarhi,Short Stature/Dwarfism,35,60,2,2,4
Haryana,Sirsa,Short Stature/Dwarfism,15,35,2,2,4
Haryana,Sirsa,Short Stature/Dwarfism,35,60,3,2,5
Rajasthan,Sirohi,Short Stature/Dwarfism,6,15,2,0,2
Rajasthan,Sirohi,Short Stature/Dwarfism,15,35,18,32,50
Rajasthan,Sirohi,Short Stature/Dwarfism,35,60,2,16,18
Rajasthan,Sirohi,Short Stature/Dwarfism,60,80,1,1,2
Himachal Pradesh,Sirmaur,Short Stature/Dwarfism,6,15,0,2,2
Himachal Pradesh,Sirmaur,Short Stature/Dwarfism,15,35,1,7,8
Himachal Pradesh,Sirmaur,Short Stature/Dwarfism,35,60,1,0,1
Madhya Pradesh,Singrauli,Short Stature/Dwarfism,6,15,1,3,4
Madhya Pradesh,Singrauli,Short Stature/Dwarfism,15,35,8,10,18
Madhya Pradesh,Singrauli,Short Stature/Dwarfism,35,60,1,1,2
Maharashtra,Sindhudurg,Short Stature/Dwarfism,6,15,0,1,1
Maharashtra,Sindhudurg,Short Stature/Dwarfism,15,35,4,5,9
Maharashtra,Sindhudurg,Short Stature/Dwarfism,35,60,2,5,7
Jharkhand,Simdega,Short Stature/Dwarfism,0,6,1,0,1
Jharkhand,Simdega,Short Stature/Dwarfism,6,15,1,0,1
Jharkhand,Simdega,Short Stature/Dwarfism,15,35,2,3,5
Jharkhand,Simdega,Short Stature/Dwarfism,35,60,1,2,3
Rajasthan,Sikar,Short Stature/Dwarfism,6,15,3,0,3
Rajasthan,Sikar,Short Stature/Dwarfism,15,35,13,8,21
Rajasthan,Sikar,Short Stature/Dwarfism,35,60,3,5,8
Madhya Pradesh,Sidhi,Short Stature/Dwarfism,6,15,2,1,3
Madhya Pradesh,Sidhi,Short Stature/Dwarfism,15,35,10,18,28
Madhya Pradesh,Sidhi,Short Stature/Dwarfism,35,60,10,0,10
Uttar Pradesh,Siddharth Nagar,Short Stature/Dwarfism,6,15,3,1,4
Uttar Pradesh,Siddharth Nagar,Short Stature/Dwarfism,15,35,9,4,13
Uttar Pradesh,Siddharth Nagar,Short Stature/Dwarfism,35,60,4,3,7
Uttar Pradesh,Siddharth Nagar,Short Stature/Dwarfism,60,80,5,0,5
Uttar Pradesh,Shravasti,Short Stature/Dwarfism,6,15,2,1,3
Uttar Pradesh,Shravasti,Short Stature/Dwarfism,15,35,6,9,15
Uttar Pradesh,Shravasti,Short Stature/Dwarfism,35,60,9,5,14
Uttar Pradesh,Shravasti,Short Stature/Dwarfism,60,80,1,0,1
Jammu And Kashmir,Shopian,Short Stature/Dwarfism,6,15,1,1,2
Jammu And Kashmir,Shopian,Short Stature/Dwarfism,15,35,2,6,8
Jammu And Kashmir,Shopian,Short Stature/Dwarfism,35,60,1,4,5
Madhya Pradesh,Shivpuri,Short Stature/Dwarfism,6,15,0,1,1
Madhya Pradesh,Shivpuri,Short Stature/Dwarfism,15,35,8,4,12
Madhya Pradesh,Shivpuri,Short Stature/Dwarfism,35,60,5,3,8
Madhya Pradesh,Shivpuri,Short Stature/Dwarfism,60,80,1,0,1
Karnataka,Shivamogga,Short Stature/Dwarfism,6,15,1,0,1
Karnataka,Shivamogga,Short Stature/Dwarfism,15,35,5,9,14
Karnataka,Shivamogga,Short Stature/Dwarfism,35,60,12,12,24
Karnataka,Shivamogga,Short Stature/Dwarfism,60,80,1,3,4
Himachal Pradesh,Shimla,Short Stature/Dwarfism,6,15,1,1,2
Himachal Pradesh,Shimla,Short Stature/Dwarfism,15,35,3,3,6
Himachal Pradesh,Shimla,Short Stature/Dwarfism,35,60,1,0,1
Madhya Pradesh,Sheopur,Short Stature/Dwarfism,6,15,1,2,3
Madhya Pradesh,Sheopur,Short Stature/Dwarfism,15,35,0,1,1
Bihar,Sheohar,Short Stature/Dwarfism,6,15,3,7,10
Bihar,Sheohar,Short Stature/Dwarfism,15,35,2,2,4
Bihar,Sheohar,Short Stature/Dwarfism,35,60,2,0,2
Bihar,Sheohar,Short Stature/Dwarfism,60,80,2,0,2
Uttar Pradesh,Shamli,Short Stature/Dwarfism,6,15,1,0,1
Uttar Pradesh,Shamli,Short Stature/Dwarfism,15,35,6,3,9
Uttar Pradesh,Shamli,Short Stature/Dwarfism,35,60,2,2,4
Madhya Pradesh,Shajapur,Short Stature/Dwarfism,6,15,0,1,1
Madhya Pradesh,Shajapur,Short Stature/Dwarfism,15,35,3,4,7
Madhya Pradesh,Shajapur,Short Stature/Dwarfism,35,60,2,0,2
Uttar Pradesh,Shahjahanpur,Short Stature/Dwarfism,6,15,4,5,9
Uttar Pradesh,Shahjahanpur,Short Stature/Dwarfism,15,35,59,21,80
Uttar Pradesh,Shahjahanpur,Short Stature/Dwarfism,35,60,28,16,44
Uttar Pradesh,Shahjahanpur,Short Stature/Dwarfism,60,80,7,1,8
Punjab,Shahid Bhagat Singh Nagar,Short Stature/Dwarfism,15,35,3,0,3
Punjab,Shahid Bhagat Singh Nagar,Short Stature/Dwarfism,35,60,2,1,3
Punjab,Shahid Bhagat Singh Nagar,Short Stature/Dwarfism,60,80,1,0,1
Madhya Pradesh,Shahdol,Short Stature/Dwarfism,15,35,1,2,3
Delhi,Shahdara,Short Stature/Dwarfism,6,15,0,1,1
Delhi,Shahdara,Short Stature/Dwarfism,15,35,2,3,5
Delhi,Shahdara,Short Stature/Dwarfism,35,60,0,2,2
Mizoram,Serchhip,Short Stature/Dwarfism,15,35,1,0,1
Mizoram,Serchhip,Short Stature/Dwarfism,60,80,0,1,1
Madhya Pradesh,Seoni,Short Stature/Dwarfism,6,15,1,1,2
Madhya Pradesh,Seoni,Short Stature/Dwarfism,15,35,5,9,14
Madhya Pradesh,Seoni,Short Stature/Dwarfism,35,60,7,1,8
Madhya Pradesh,Seoni,Short Stature/Dwarfism,60,80,2,0,2
Manipur,Senapati,Short Stature/Dwarfism,6,15,1,0,1
Manipur,Senapati,Short Stature/Dwarfism,15,35,0,1,1
Manipur,Senapati,Short Stature/Dwarfism,35,60,0,1,1
Madhya Pradesh,Sehore,Short Stature/Dwarfism,6,15,1,0,1
Madhya Pradesh,Sehore,Short Stature/Dwarfism,15,35,1,0,1
Madhya Pradesh,Sehore,Short Stature/Dwarfism,35,60,0,1,1
Rajasthan,Sawai Madhopur,Short Stature/Dwarfism,6,15,1,0,1
Rajasthan,Sawai Madhopur,Short Stature/Dwarfism,15,35,2,2,4
Rajasthan,Sawai Madhopur,Short Stature/Dwarfism,35,60,3,1,4
Madhya Pradesh,Satna,Short Stature/Dwarfism,6,15,3,1,4
Madhya Pradesh,Satna,Short Stature/Dwarfism,15,35,2,3,5
Madhya Pradesh,Satna,Short Stature/Dwarfism,35,60,2,1,3
Maharashtra,Satara,Short Stature/Dwarfism,6,15,2,1,3
Maharashtra,Satara,Short Stature/Dwarfism,15,35,7,6,13
Maharashtra,Satara,Short Stature/Dwarfism,35,60,4,2,6
Bihar,Saran,Short Stature/Dwarfism,0,6,1,0,1
Bihar,Saran,Short Stature/Dwarfism,6,15,0,3,3
Bihar,Saran,Short Stature/Dwarfism,15,35,6,3,9
Bihar,Saran,Short Stature/Dwarfism,35,60,5,1,6
Bihar,Saran,Short Stature/Dwarfism,60,80,1,0,1
Jharkhand,Saraikela Kharsawan,Short Stature/Dwarfism,15,35,1,1,2
Uttar Pradesh,Sant Kabeer Nagar,Short Stature/Dwarfism,15,35,3,1,4
Uttar Pradesh,Sant Kabeer Nagar,Short Stature/Dwarfism,35,60,4,0,4
Punjab,Sangrur,Short Stature/Dwarfism,6,15,1,2,3
Punjab,Sangrur,Short Stature/Dwarfism,15,35,6,4,10
Punjab,Sangrur,Short Stature/Dwarfism,35,60,3,2,5
Punjab,Sangrur,Short Stature/Dwarfism,60,80,2,0,2
Maharashtra,Sangli,Short Stature/Dwarfism,6,15,1,2,3
Maharashtra,Sangli,Short Stature/Dwarfism,15,35,16,21,37
Maharashtra,Sangli,Short Stature/Dwarfism,35,60,11,9,20
Maharashtra,Sangli,Short Stature/Dwarfism,60,80,3,0,3
Uttar Pradesh,Sambhal,Short Stature/Dwarfism,6,15,1,0,1
Uttar Pradesh,Sambhal,Short Stature/Dwarfism,15,35,0,1,1
Odisha,Sambalpur,Short Stature/Dwarfism,6,15,1,0,1
Odisha,Sambalpur,Short Stature/Dwarfism,15,35,3,4,7
Odisha,Sambalpur,Short Stature/Dwarfism,35,60,3,2,5
Jammu And Kashmir,Samba,Short Stature/Dwarfism,0,6,0,1,1
Jammu And Kashmir,Samba,Short Stature/Dwarfism,15,35,1,1,2
Jammu And Kashmir,Samba,Short Stature/Dwarfism,35,60,3,1,4
Bihar,Samastipur,Short Stature/Dwarfism,0,6,1,0,1
Bihar,Samastipur,Short Stature/Dwarfism,6,15,2,1,3
Bihar,Samastipur,Short Stature/Dwarfism,15,35,16,6,22
Bihar,Samastipur,Short Stature/Dwarfism,35,60,7,3,10
Bihar,Samastipur,Short Stature/Dwarfism,60,80,1,0,1
Tamil Nadu,Salem,Short Stature/Dwarfism,0,6,0,1,1
Tamil Nadu,Salem,Short Stature/Dwarfism,6,15,12,15,27
Tamil Nadu,Salem,Short Stature/Dwarfism,15,35,19,28,47
Tamil Nadu,Salem,Short Stature/Dwarfism,35,60,13,23,36
Tamil Nadu,Salem,Short Stature/Dwarfism,60,80,1,2,3
Mizoram,Saiha,Short Stature/Dwarfism,15,35,1,0,1
Jharkhand,Sahebganj,Short Stature/Dwarfism,0,6,2,0,2
Jharkhand,Sahebganj,Short Stature/Dwarfism,6,15,7,5,12
Jharkhand,Sahebganj,Short Stature/Dwarfism,15,35,5,16,21
Jharkhand,Sahebganj,Short Stature/Dwarfism,35,60,1,5,6
Jharkhand,Sahebganj,Short Stature/Dwarfism,60,80,1,1,2
Bihar,Saharsa,Short Stature/Dwarfism,6,15,0,1,1
Bihar,Saharsa,Short Stature/Dwarfism,15,35,5,6,11
Bihar,Saharsa,Short Stature/Dwarfism,35,60,3,0,3
Bihar,Saharsa,Short Stature/Dwarfism,60,80,1,0,1
Uttar Pradesh,Saharanpur,Short Stature/Dwarfism,6,15,1,0,1
Uttar Pradesh,Saharanpur,Short Stature/Dwarfism,15,35,4,3,7
Uttar Pradesh,Saharanpur,Short Stature/Dwarfism,35,60,9,2,11
Uttar Pradesh,Saharanpur,Short Stature/Dwarfism,60,80,1,0,1
Madhya Pradesh,Sagar,Short Stature/Dwarfism,6,15,0,2,2
Madhya Pradesh,Sagar,Short Stature/Dwarfism,15,35,6,2,8
Madhya Pradesh,Sagar,Short Stature/Dwarfism,35,60,7,4,11
Madhya Pradesh,Sagar,Short Stature/Dwarfism,60,80,2,0,2
Gujarat,Sabar Kantha,Short Stature/Dwarfism,15,35,0,2,2
Punjab,S.A.S Nagar,Short Stature/Dwarfism,15,35,3,2,5
Punjab,S.A.S Nagar,Short Stature/Dwarfism,35,60,4,3,7
Punjab,Rupnagar,Short Stature/Dwarfism,15,35,2,3,5
Punjab,Rupnagar,Short Stature/Dwarfism,35,60,2,4,6
Punjab,Rupnagar,Short Stature/Dwarfism,60,80,1,0,1
Uttarakhand,Rudra Prayag,Short Stature/Dwarfism,15,35,0,1,1
Uttarakhand,Rudra Prayag,Short Stature/Dwarfism,35,60,1,2,3
Bihar,Rohtas,Short Stature/Dwarfism,6,15,2,3,5
Bihar,Rohtas,Short Stature/Dwarfism,15,35,10,8,18
Bihar,Rohtas,Short Stature/Dwarfism,35,60,1,1,2
Bihar,Rohtas,Short Stature/Dwarfism,60,80,1,0,1
Haryana,Rohtak,Short Stature/Dwarfism,6,15,1,2,3
Haryana,Rohtak,Short Stature/Dwarfism,15,35,2,8,10
Haryana,Rohtak,Short Stature/Dwarfism,35,60,3,2,5
Haryana,Rohtak,Short Stature/Dwarfism,60,80,0,1,1
Haryana,Rewari,Short Stature/Dwarfism,6,15,1,0,1
Haryana,Rewari,Short Stature/Dwarfism,15,35,1,0,1
Haryana,Rewari,Short Stature/Dwarfism,35,60,2,2,4
Haryana,Rewari,Short Stature/Dwarfism,60,80,1,0,1
Madhya Pradesh,Rewa,Short Stature/Dwarfism,6,15,1,1,2
Madhya Pradesh,Rewa,Short Stature/Dwarfism,15,35,4,9,13
Madhya Pradesh,Rewa,Short Stature/Dwarfism,35,60,3,1,4
Jammu And Kashmir,Reasi,Short Stature/Dwarfism,15,35,4,3,7
Jammu And Kashmir,Reasi,Short Stature/Dwarfism,35,60,2,2,4
Odisha,Rayagada,Short Stature/Dwarfism,6,15,3,0,3
Odisha,Rayagada,Short Stature/Dwarfism,15,35,9,12,21
Odisha,Rayagada,Short Stature/Dwarfism,35,60,2,4,6
Maharashtra,Ratnagiri,Short Stature/Dwarfism,6,15,2,1,3
Maharashtra,Ratnagiri,Short Stature/Dwarfism,15,35,13,16,29
Maharashtra,Ratnagiri,Short Stature/Dwarfism,35,60,9,23,32
Maharashtra,Ratnagiri,Short Stature/Dwarfism,60,80,1,1,2
Madhya Pradesh,Ratlam,Short Stature/Dwarfism,6,15,1,0,1
Madhya Pradesh,Ratlam,Short Stature/Dwarfism,15,35,7,10,17
Madhya Pradesh,Ratlam,Short Stature/Dwarfism,35,60,4,7,11
Tamil Nadu,Ranipet,Short Stature/Dwarfism,6,15,1,0,1
Tamil Nadu,Ranipet,Short Stature/Dwarfism,15,35,0,1,1
Tamil Nadu,Ranipet,Short Stature/Dwarfism,35,60,1,0,1
Jharkhand,Ranchi,Short Stature/Dwarfism,6,15,1,6,7
Jharkhand,Ranchi,Short Stature/Dwarfism,15,35,12,29,41
Jharkhand,Ranchi,Short Stature/Dwarfism,35,60,6,7,13
Uttar Pradesh,Rampur,Short Stature/Dwarfism,6,15,0,1,1
Uttar Pradesh,Rampur,Short Stature/Dwarfism,15,35,3,3,6
Uttar Pradesh,Rampur,Short Stature/Dwarfism,35,60,4,2,6
Jharkhand,Ramgarh,Short Stature/Dwarfism,0,6,1,0,1
Jharkhand,Ramgarh,Short Stature/Dwarfism,6,15,3,1,4
Jharkhand,Ramgarh,Short Stature/Dwarfism,15,35,2,5,7
Jharkhand,Ramgarh,Short Stature/Dwarfism,35,60,3,2,5
Jharkhand,Ramgarh,Short Stature/Dwarfism,60,80,1,1,2
Tamil Nadu,Ramanathapuram,Short Stature/Dwarfism,6,15,1,0,1
Tamil Nadu,Ramanathapuram,Short Stature/Dwarfism,15,35,2,6,8
Tamil Nadu,Ramanathapuram,Short Stature/Dwarfism,35,60,2,1,3
Karnataka,Ramanagara,Short Stature/Dwarfism,6,15,1,0,1
Karnataka,Ramanagara,Short Stature/Dwarfism,15,35,7,14,21
Karnataka,Ramanagara,Short Stature/Dwarfism,35,60,8,10,18
Karnataka,Ramanagara,Short Stature/Dwarfism,60,80,0,1,1
Rajasthan,Rajsamand,Short Stature/Dwarfism,15,35,9,8,17
Rajasthan,Rajsamand,Short Stature/Dwarfism,35,60,3,4,7
Jammu And Kashmir,Rajouri,Short Stature/Dwarfism,6,15,2,2,4
Jammu And Kashmir,Rajouri,Short Stature/Dwarfism,15,35,7,7,14
Jammu And Kashmir,Rajouri,Short Stature/Dwarfism,35,60,4,6,10
Jammu And Kashmir,Rajouri,Short Stature/Dwarfism,60,80,1,1,2
Chhattisgarh,Rajnandgaon,Short Stature/Dwarfism,6,15,9,11,20
Chhattisgarh,Rajnandgaon,Short Stature/Dwarfism,15,35,37,49,86
Chhattisgarh,Rajnandgaon,Short Stature/Dwarfism,35,60,21,25,46
Chhattisgarh,Rajnandgaon,Short Stature/Dwarfism,60,80,5,3,8
Chhattisgarh,Rajnandgaon,Short Stature/Dwarfism,80,100,1,0,1
Gujarat,Rajkot,Short Stature/Dwarfism,35,60,1,0,1
Madhya Pradesh,Rajgarh,Short Stature/Dwarfism,15,35,0,3,3
Madhya Pradesh,Rajgarh,Short Stature/Dwarfism,35,60,1,0,1
Madhya Pradesh,Rajgarh,Short Stature/Dwarfism,60,80,1,0,1
Madhya Pradesh,Raisen,Short Stature/Dwarfism,6,15,4,4,8
Madhya Pradesh,Raisen,Short Stature/Dwarfism,15,35,14,5,19
Madhya Pradesh,Raisen,Short Stature/Dwarfism,35,60,8,5,13
Madhya Pradesh,Raisen,Short Stature/Dwarfism,60,80,3,1,4
Chhattisgarh,Raipur,Short Stature/Dwarfism,15,35,6,5,11
Chhattisgarh,Raipur,Short Stature/Dwarfism,35,60,1,2,3
Chhattisgarh,Raigarh,Short Stature/Dwarfism,6,15,1,0,1
Chhattisgarh,Raigarh,Short Stature/Dwarfism,15,35,16,37,53
Chhattisgarh,Raigarh,Short Stature/Dwarfism,35,60,7,7,14
Chhattisgarh,Raigarh,Short Stature/Dwarfism,60,80,1,0,1
Maharashtra,Raigad,Short Stature/Dwarfism,0,6,0,2,2
Maharashtra,Raigad,Short Stature/Dwarfism,6,15,2,4,6
Maharashtra,Raigad,Short Stature/Dwarfism,15,35,24,18,42
Maharashtra,Raigad,Short Stature/Dwarfism,35,60,12,11,23
Maharashtra,Raigad,Short Stature/Dwarfism,60,80,1,2,3
Karnataka,Raichur,Short Stature/Dwarfism,0,6,1,2,3
Karnataka,Raichur,Short Stature/Dwarfism,6,15,16,19,35
Karnataka,Raichur,Short Stature/Dwarfism,15,35,42,66,108
Karnataka,Raichur,Short Stature/Dwarfism,35,60,17,17,34
Karnataka,Raichur,Short Stature/Dwarfism,60,80,0,1,1
Uttar Pradesh,Rae Bareli,Short Stature/Dwarfism,6,15,2,3,5
Uttar Pradesh,Rae Bareli,Short Stature/Dwarfism,15,35,12,15,27
Uttar Pradesh,Rae Bareli,Short Stature/Dwarfism,35,60,4,3,7
Bihar,Purnia,Short Stature/Dwarfism,0,6,1,0,1
Bihar,Purnia,Short Stature/Dwarfism,6,15,2,2,4
Bihar,Purnia,Short Stature/Dwarfism,15,35,11,7,18
Bihar,Purnia,Short Stature/Dwarfism,35,60,2,0,2
Odisha,Puri,Short Stature/Dwarfism,6,15,4,1,5
Odisha,Puri,Short Stature/Dwarfism,15,35,9,11,20
Odisha,Puri,Short Stature/Dwarfism,35,60,3,9,12
Odisha,Puri,Short Stature/Dwarfism,60,80,1,0,1
Bihar,Purbi Champaran,Short Stature/Dwarfism,0,6,1,0,1
Bihar,Purbi Champaran,Short Stature/Dwarfism,6,15,4,3,7
Bihar,Purbi Champaran,Short Stature/Dwarfism,15,35,16,10,26
Bihar,Purbi Champaran,Short Stature/Dwarfism,35,60,7,2,9
Bihar,Purbi Champaran,Short Stature/Dwarfism,60,80,2,0,2
Maharashtra,Pune,Short Stature/Dwarfism,0,6,3,1,4
Maharashtra,Pune,Short Stature/Dwarfism,6,15,6,6,12
Maharashtra,Pune,Short Stature/Dwarfism,15,35,36,36,72
Maharashtra,Pune,Short Stature/Dwarfism,35,60,18,28,46
Maharashtra,Pune,Short Stature/Dwarfism,60,80,3,3,6
Jammu And Kashmir,Pulwama,Short Stature/Dwarfism,6,15,0,2,2
Jammu And Kashmir,Pulwama,Short Stature/Dwarfism,15,35,8,12,20
Jammu And Kashmir,Pulwama,Short Stature/Dwarfism,35,60,8,19,27
Jammu And Kashmir,Pulwama,Short Stature/Dwarfism,60,80,3,5,8
Jammu And Kashmir,Pulwama,Short Stature/Dwarfism,80,100,1,0,1
Tamil Nadu,Pudukkottai,Short Stature/Dwarfism,0,6,2,0,2
Tamil Nadu,Pudukkottai,Short Stature/Dwarfism,6,15,4,17,21
Tamil Nadu,Pudukkottai,Short Stature/Dwarfism,15,35,18,25,43
Tamil Nadu,Pudukkottai,Short Stature/Dwarfism,35,60,10,29,39
Tamil Nadu,Pudukkottai,Short Stature/Dwarfism,60,80,3,2,5
Uttar Pradesh,Prayagraj,Short Stature/Dwarfism,15,35,4,6,10
Uttar Pradesh,Prayagraj,Short Stature/Dwarfism,35,60,1,1,2
Rajasthan,Pratapgarh,Short Stature/Dwarfism,0,6,1,0,1
Rajasthan,Pratapgarh,Short Stature/Dwarfism,6,15,1,1,2
Rajasthan,Pratapgarh,Short Stature/Dwarfism,15,35,12,29,41
Rajasthan,Pratapgarh,Short Stature/Dwarfism,35,60,6,18,24
Rajasthan,Pratapgarh,Short Stature/Dwarfism,60,80,2,0,2
Uttar Pradesh,Pratapgarh,Short Stature/Dwarfism,15,35,6,4,10
Uttar Pradesh,Pratapgarh,Short Stature/Dwarfism,35,60,9,1,10
Andhra Pradesh,Prakasam,Short Stature/Dwarfism,15,35,0,1,1
Jammu And Kashmir,Poonch,Short Stature/Dwarfism,0,6,0,1,1
Jammu And Kashmir,Poonch,Short Stature/Dwarfism,6,15,6,7,13
Jammu And Kashmir,Poonch,Short Stature/Dwarfism,15,35,16,18,34
Jammu And Kashmir,Poonch,Short Stature/Dwarfism,35,60,10,6,16
Jammu And Kashmir,Poonch,Short Stature/Dwarfism,60,80,1,0,1
Puducherry,Pondicherry,Short Stature/Dwarfism,6,15,0,1,1
Puducherry,Pondicherry,Short Stature/Dwarfism,15,35,10,12,22
Puducherry,Pondicherry,Short Stature/Dwarfism,35,60,12,21,33
Puducherry,Pondicherry,Short Stature/Dwarfism,60,80,0,3,3
Uttarakhand,Pithoragarh,Short Stature/Dwarfism,15,35,3,4,7
Uttarakhand,Pithoragarh,Short Stature/Dwarfism,35,60,0,1,1
Uttar Pradesh,Pilibhit,Short Stature/Dwarfism,6,15,2,0,2
Uttar Pradesh,Pilibhit,Short Stature/Dwarfism,15,35,11,11,22
Uttar Pradesh,Pilibhit,Short Stature/Dwarfism,35,60,6,1,7
Nagaland,Phek,Short Stature/Dwarfism,35,60,0,1,1
Tamil Nadu,Perambalur,Short Stature/Dwarfism,6,15,1,4,5
Tamil Nadu,Perambalur,Short Stature/Dwarfism,15,35,2,6,8
Tamil Nadu,Perambalur,Short Stature/Dwarfism,35,60,3,1,4
Uttarakhand,Pauri Garhwal,Short Stature/Dwarfism,0,6,0,1,1
Uttarakhand,Pauri Garhwal,Short Stature/Dwarfism,6,15,0,1,1
Uttarakhand,Pauri Garhwal,Short Stature/Dwarfism,15,35,0,3,3
Uttarakhand,Pauri Garhwal,Short Stature/Dwarfism,35,60,0,2,2
Uttarakhand,Pauri Garhwal,Short Stature/Dwarfism,60,80,0,1,1
Uttarakhand,Pauri Garhwal,Short Stature/Dwarfism,80,100,0,1,1
Bihar,Patna,Short Stature/Dwarfism,6,15,1,3,4
Bihar,Patna,Short Stature/Dwarfism,15,35,13,3,16
Bihar,Patna,Short Stature/Dwarfism,35,60,3,5,8
Bihar,Patna,Short Stature/Dwarfism,60,80,1,0,1
Punjab,Patiala,Short Stature/Dwarfism,6,15,1,3,4
Punjab,Patiala,Short Stature/Dwarfism,15,35,6,8,14
Punjab,Patiala,Short Stature/Dwarfism,35,60,5,7,12
Punjab,Pathankot,Short Stature/Dwarfism,6,15,1,2,3
Punjab,Pathankot,Short Stature/Dwarfism,15,35,7,2,9
Punjab,Pathankot,Short Stature/Dwarfism,35,60,4,6,10
Kerala,Pathanamthitta,Short Stature/Dwarfism,6,15,0,3,3
Kerala,Pathanamthitta,Short Stature/Dwarfism,15,35,1,7,8
Kerala,Pathanamthitta,Short Stature/Dwarfism,35,60,6,5,11
Gujarat,Patan,Short Stature/Dwarfism,6,15,1,0,1
Gujarat,Patan,Short Stature/Dwarfism,15,35,0,2,2
Gujarat,Patan,Short Stature/Dwarfism,35,60,2,0,2
Gujarat,Patan,Short Stature/Dwarfism,60,80,1,0,1
Bihar,Pashchim Champaran,Short Stature/Dwarfism,6,15,2,2,4
Bihar,Pashchim Champaran,Short Stature/Dwarfism,15,35,7,7,14
Bihar,Pashchim Champaran,Short Stature/Dwarfism,35,60,9,4,13
Bihar,Pashchim Champaran,Short Stature/Dwarfism,60,80,0,1,1
Maharashtra,Parbhani,Short Stature/Dwarfism,6,15,1,1,2
Maharashtra,Parbhani,Short Stature/Dwarfism,15,35,14,24,38
Maharashtra,Parbhani,Short Stature/Dwarfism,35,60,13,6,19
Maharashtra,Parbhani,Short Stature/Dwarfism,60,80,0,3,3
Arunachal Pradesh,Papum Pare,Short Stature/Dwarfism,15,35,4,1,5
Arunachal Pradesh,Papum Pare,Short Stature/Dwarfism,35,60,0,1,1
Madhya Pradesh,Panna,Short Stature/Dwarfism,6,15,0,1,1
Madhya Pradesh,Panna,Short Stature/Dwarfism,15,35,6,5,11
Madhya Pradesh,Panna,Short Stature/Dwarfism,35,60,3,1,4
Madhya Pradesh,Panna,Short Stature/Dwarfism,60,80,0,1,1
Haryana,Panipat,Short Stature/Dwarfism,15,35,3,5,8
Haryana,Panipat,Short Stature/Dwarfism,35,60,2,0,2
Haryana,Panchkula,Short Stature/Dwarfism,15,35,2,1,3
Haryana,Panchkula,Short Stature/Dwarfism,35,60,1,0,1
Gujarat,Panch Mahals,Short Stature/Dwarfism,6,15,0,1,1
Haryana,Palwal,Short Stature/Dwarfism,15,35,5,0,5
Haryana,Palwal,Short Stature/Dwarfism,35,60,1,1,2
Rajasthan,Pali,Short Stature/Dwarfism,15,35,6,13,19
Rajasthan,Pali,Short Stature/Dwarfism,35,60,3,2,5
Maharashtra,Palghar,Short Stature/Dwarfism,6,15,3,3,6
Maharashtra,Palghar,Short Stature/Dwarfism,15,35,2,4,6
Maharashtra,Palghar,Short Stature/Dwarfism,35,60,0,3,3
Jharkhand,Palamu,Short Stature/Dwarfism,6,15,2,1,3
Jharkhand,Palamu,Short Stature/Dwarfism,15,35,5,5,10
Jharkhand,Palamu,Short Stature/Dwarfism,35,60,8,4,12
Jharkhand,Palamu,Short Stature/Dwarfism,60,80,2,0,2
Kerala,Palakkad,Short Stature/Dwarfism,6,15,1,2,3
Kerala,Palakkad,Short Stature/Dwarfism,15,35,11,19,30
Kerala,Palakkad,Short Stature/Dwarfism,35,60,20,29,49
Kerala,Palakkad,Short Stature/Dwarfism,60,80,4,7,11
Jharkhand,Pakur,Short Stature/Dwarfism,15,35,1,1,2
Maharashtra,Osmanabad,Short Stature/Dwarfism,6,15,2,2,4
Maharashtra,Osmanabad,Short Stature/Dwarfism,15,35,6,4,10
Maharashtra,Osmanabad,Short Stature/Dwarfism,35,60,3,3,6
Maharashtra,Osmanabad,Short Stature/Dwarfism,60,80,1,0,1
Haryana,Nuh,Short Stature/Dwarfism,15,35,1,0,1
Odisha,Nuapada,Short Stature/Dwarfism,6,15,4,6,10
Odisha,Nuapada,Short Stature/Dwarfism,15,35,6,12,18
Odisha,Nuapada,Short Stature/Dwarfism,35,60,2,3,5
Delhi,North West,Short Stature/Dwarfism,6,15,0,2,2
Delhi,North West,Short Stature/Dwarfism,15,35,4,8,12
Delhi,North West,Short Stature/Dwarfism,35,60,4,2,6
Tripura,North Tripura,Short Stature/Dwarfism,6,15,0,1,1
Tripura,North Tripura,Short Stature/Dwarfism,35,60,0,1,1
Goa,North Goa,Short Stature/Dwarfism,15,35,0,1,1
Goa,North Goa,Short Stature/Dwarfism,35,60,0,3,3
Goa,North Goa,Short Stature/Dwarfism,60,80,1,1,2
Meghalaya,North Garo Hills,Short Stature/Dwarfism,6,15,0,1,1
Delhi,North East,Short Stature/Dwarfism,15,35,4,7,11
Delhi,North East,Short Stature/Dwarfism,35,60,0,1,1
Andaman And Nicobar Islands,North And Middle Andaman,Short Stature/Dwarfism,15,35,3,1,4
Andaman And Nicobar Islands,North And Middle Andaman,Short Stature/Dwarfism,35,60,3,2,5
Delhi,North,Short Stature/Dwarfism,6,15,1,0,1
Delhi,North,Short Stature/Dwarfism,15,35,1,2,3
Delhi,North,Short Stature/Dwarfism,35,60,1,1,2
Manipur,Noney,Short Stature/Dwarfism,6,15,1,0,1
Manipur,Noney,Short Stature/Dwarfism,15,35,0,1,1
Madhya Pradesh,Niwari,Short Stature/Dwarfism,15,35,1,0,1
Delhi,New Delhi,Short Stature/Dwarfism,35,60,1,1,2
Madhya Pradesh,Neemuch,Short Stature/Dwarfism,35,60,1,0,1
Odisha,Nayagarh,Short Stature/Dwarfism,6,15,2,3,5
Odisha,Nayagarh,Short Stature/Dwarfism,15,35,6,14,20
Odisha,Nayagarh,Short Stature/Dwarfism,35,60,6,6,12
Odisha,Nayagarh,Short Stature/Dwarfism,60,80,1,0,1
Odisha,Nayagarh,Short Stature/Dwarfism,80,100,0,1,1
Bihar,Nawada,Short Stature/Dwarfism,15,35,1,0,1
Bihar,Nawada,Short Stature/Dwarfism,35,60,1,0,1
Gujarat,Navsari,Short Stature/Dwarfism,15,35,0,3,3
Gujarat,Navsari,Short Stature/Dwarfism,35,60,1,0,1
Maharashtra,Nashik,Short Stature/Dwarfism,0,6,1,0,1
Maharashtra,Nashik,Short Stature/Dwarfism,6,15,12,17,29
Maharashtra,Nashik,Short Stature/Dwarfism,15,35,29,40,69
Maharashtra,Nashik,Short Stature/Dwarfism,35,60,20,16,36
Maharashtra,Nashik,Short Stature/Dwarfism,60,80,1,3,4
Madhya Pradesh,Narsinghpur,Short Stature/Dwarfism,6,15,3,2,5
Madhya Pradesh,Narsinghpur,Short Stature/Dwarfism,15,35,8,8,16
Madhya Pradesh,Narsinghpur,Short Stature/Dwarfism,35,60,7,2,9
Madhya Pradesh,Narsinghpur,Short Stature/Dwarfism,60,80,2,0,2
Madhya Pradesh,Narmadapuram,Short Stature/Dwarfism,15,35,3,5,8
Madhya Pradesh,Narmadapuram,Short Stature/Dwarfism,35,60,1,0,1
Madhya Pradesh,Narmadapuram,Short Stature/Dwarfism,60,80,1,0,1
Chhattisgarh,Narayanpur,Short Stature/Dwarfism,15,35,0,1,1
Maharashtra,Nandurbar,Short Stature/Dwarfism,6,15,5,6,11
Maharashtra,Nandurbar,Short Stature/Dwarfism,15,35,12,15,27
Maharashtra,Nandurbar,Short Stature/Dwarfism,35,60,4,7,11
Maharashtra,Nandurbar,Short Stature/Dwarfism,60,80,1,1,2
Maharashtra,Nanded,Short Stature/Dwarfism,6,15,2,1,3
Maharashtra,Nanded,Short Stature/Dwarfism,15,35,19,22,41
Maharashtra,Nanded,Short Stature/Dwarfism,35,60,15,7,22
Maharashtra,Nanded,Short Stature/Dwarfism,60,80,3,1,4
Arunachal Pradesh,Namsai,Short Stature/Dwarfism,15,35,1,3,4
Sikkim,Namchi,Short Stature/Dwarfism,6,15,1,1,2
Sikkim,Namchi,Short Stature/Dwarfism,15,35,3,0,3
Sikkim,Namchi,Short Stature/Dwarfism,35,60,1,2,3
Tamil Nadu,Namakkal,Short Stature/Dwarfism,0,6,0,1,1
Tamil Nadu,Namakkal,Short Stature/Dwarfism,6,15,1,1,2
Tamil Nadu,Namakkal,Short Stature/Dwarfism,15,35,9,5,14
Tamil Nadu,Namakkal,Short Stature/Dwarfism,35,60,8,13,21
Tamil Nadu,Namakkal,Short Stature/Dwarfism,60,80,1,1,2
Tamil Nadu,Namakkal,Short Stature/Dwarfism,80,100,0,1,1
Assam,Nalbari,Short Stature/Dwarfism,0,6,0,1,1
Assam,Nalbari,Short Stature/Dwarfism,6,15,0,1,1
Assam,Nalbari,Short Stature/Dwarfism,15,35,3,6,9
Assam,Nalbari,Short Stature/Dwarfism,35,60,1,3,4
Assam,Nalbari,Short Stature/Dwarfism,60,80,0,1,1
Assam,Nalbari,Short Stature/Dwarfism,80,100,3,0,3
Bihar,Nalanda,Short Stature/Dwarfism,6,15,2,4,6
Bihar,Nalanda,Short Stature/Dwarfism,15,35,6,6,12
Bihar,Nalanda,Short Stature/Dwarfism,35,60,4,2,6
Uttarakhand,Nainital,Short Stature/Dwarfism,6,15,0,3,3
Uttarakhand,Nainital,Short Stature/Dwarfism,15,35,6,13,19
Uttarakhand,Nainital,Short Stature/Dwarfism,35,60,0,2,2
Maharashtra,Nagpur,Short Stature/Dwarfism,15,35,4,2,6
Maharashtra,Nagpur,Short Stature/Dwarfism,35,60,1,2,3
Rajasthan,Nagaur,Short Stature/Dwarfism,6,15,1,1,2
Rajasthan,Nagaur,Short Stature/Dwarfism,15,35,2,5,7
Rajasthan,Nagaur,Short Stature/Dwarfism,35,60,5,2,7
Tamil Nadu,Nagapattinam,Short Stature/Dwarfism,6,15,7,2,9
Tamil Nadu,Nagapattinam,Short Stature/Dwarfism,15,35,14,21,35
Tamil Nadu,Nagapattinam,Short Stature/Dwarfism,35,60,9,17,26
Tamil Nadu,Nagapattinam,Short Stature/Dwarfism,60,80,3,1,4
Assam,Nagaon,Short Stature/Dwarfism,6,15,0,2,2
Assam,Nagaon,Short Stature/Dwarfism,15,35,4,5,9
Assam,Nagaon,Short Stature/Dwarfism,35,60,5,2,7
Odisha,Nabarangpur,Short Stature/Dwarfism,6,15,3,2,5
Odisha,Nabarangpur,Short Stature/Dwarfism,15,35,6,9,15
Odisha,Nabarangpur,Short Stature/Dwarfism,35,60,1,3,4
Odisha,Nabarangpur,Short Stature/Dwarfism,60,80,1,1,2
Karnataka,Mysuru,Short Stature/Dwarfism,6,15,9,8,17
Karnataka,Mysuru,Short Stature/Dwarfism,15,35,20,37,57
Karnataka,Mysuru,Short Stature/Dwarfism,35,60,20,36,56
Karnataka,Mysuru,Short Stature/Dwarfism,60,80,2,2,4
Bihar,Muzaffarpur,Short Stature/Dwarfism,6,15,2,2,4
Bihar,Muzaffarpur,Short Stature/Dwarfism,15,35,7,6,13
Bihar,Muzaffarpur,Short Stature/Dwarfism,35,60,1,2,3
Uttar Pradesh,Muzaffarnagar,Short Stature/Dwarfism,6,15,0,1,1
Uttar Pradesh,Muzaffarnagar,Short Stature/Dwarfism,15,35,2,6,8
Uttar Pradesh,Muzaffarnagar,Short Stature/Dwarfism,35,60,4,1,5
Uttar Pradesh,Muzaffarnagar,Short Stature/Dwarfism,60,80,1,0,1
Bihar,Munger,Short Stature/Dwarfism,6,15,4,0,4
Bihar,Munger,Short Stature/Dwarfism,15,35,3,9,12
Bihar,Munger,Short Stature/Dwarfism,35,60,2,3,5
Chhattisgarh,Mungeli,Short Stature/Dwarfism,6,15,2,3,5
Chhattisgarh,Mungeli,Short Stature/Dwarfism,15,35,5,8,13
Chhattisgarh,Mungeli,Short Stature/Dwarfism,35,60,4,2,6
Maharashtra,Mumbai Suburban,Short Stature/Dwarfism,6,15,0,1,1
Maharashtra,Mumbai Suburban,Short Stature/Dwarfism,15,35,6,5,11
Maharashtra,Mumbai Suburban,Short Stature/Dwarfism,35,60,7,8,15
Maharashtra,Mumbai,Short Stature/Dwarfism,6,15,1,4,5
Maharashtra,Mumbai,Short Stature/Dwarfism,15,35,5,11,16
Maharashtra,Mumbai,Short Stature/Dwarfism,35,60,4,9,13
Maharashtra,Mumbai,Short Stature/Dwarfism,60,80,1,0,1
Madhya Pradesh,Morena,Short Stature/Dwarfism,15,35,0,2,2
Madhya Pradesh,Morena,Short Stature/Dwarfism,35,60,1,0,1
Gujarat,Morbi,Short Stature/Dwarfism,35,60,1,0,1
Uttar Pradesh,Moradabad,Short Stature/Dwarfism,15,35,4,10,14
Uttar Pradesh,Moradabad,Short Stature/Dwarfism,35,60,2,1,3
Nagaland,Mon,Short Stature/Dwarfism,15,35,0,3,3
Nagaland,Mon,Short Stature/Dwarfism,35,60,1,0,1
Nagaland,Mon,Short Stature/Dwarfism,60,80,1,0,1
Punjab,Moga,Short Stature/Dwarfism,6,15,0,1,1
Punjab,Moga,Short Stature/Dwarfism,15,35,3,5,8
Punjab,Moga,Short Stature/Dwarfism,35,60,4,0,4
Punjab,Moga,Short Stature/Dwarfism,60,80,1,0,1
Uttar Pradesh,Mirzapur,Short Stature/Dwarfism,6,15,0,1,1
Uttar Pradesh,Mirzapur,Short Stature/Dwarfism,15,35,6,2,8
Uttar Pradesh,Mirzapur,Short Stature/Dwarfism,35,60,6,2,8
Uttar Pradesh,Mirzapur,Short Stature/Dwarfism,60,80,1,0,1
Uttar Pradesh,Meerut,Short Stature/Dwarfism,15,35,13,11,24
Uttar Pradesh,Meerut,Short Stature/Dwarfism,35,60,4,3,7
Uttar Pradesh,Meerut,Short Stature/Dwarfism,60,80,1,0,1
West Bengal,Medinipur East,Short Stature/Dwarfism,15,35,0,1,1
Odisha,Mayurbhanj,Short Stature/Dwarfism,0,6,0,1,1
Odisha,Mayurbhanj,Short Stature/Dwarfism,6,15,4,6,10
Odisha,Mayurbhanj,Short Stature/Dwarfism,15,35,13,42,55
Odisha,Mayurbhanj,Short Stature/Dwarfism,35,60,6,3,9
Odisha,Mayurbhanj,Short Stature/Dwarfism,60,80,4,1,5
Odisha,Mayurbhanj,Short Stature/Dwarfism,80,100,0,1,1
Tamil Nadu,Mayiladuthurai,Short Stature/Dwarfism,6,15,2,1,3
Tamil Nadu,Mayiladuthurai,Short Stature/Dwarfism,15,35,2,5,7
Tamil Nadu,Mayiladuthurai,Short Stature/Dwarfism,35,60,2,4,6
Uttar Pradesh,Mau,Short Stature/Dwarfism,6,15,0,2,2
Uttar Pradesh,Mau,Short Stature/Dwarfism,15,35,6,7,13
Uttar Pradesh,Mau,Short Stature/Dwarfism,35,60,1,0,1
Uttar Pradesh,Mathura,Short Stature/Dwarfism,15,35,4,6,10
Uttar Pradesh,Mathura,Short Stature/Dwarfism,35,60,4,0,4
Uttar Pradesh,Mathura,Short Stature/Dwarfism,60,80,0,1,1
Assam,Marigaon,Short Stature/Dwarfism,0,6,0,1,1
Assam,Marigaon,Short Stature/Dwarfism,6,15,0,3,3
Assam,Marigaon,Short Stature/Dwarfism,15,35,2,9,11
Assam,Marigaon,Short Stature/Dwarfism,35,60,1,1,2
Punjab,Mansa,Short Stature/Dwarfism,15,35,2,5,7
Punjab,Mansa,Short Stature/Dwarfism,60,80,1,0,1
Karnataka,Mandya,Short Stature/Dwarfism,6,15,4,4,8
Karnataka,Mandya,Short Stature/Dwarfism,15,35,6,10,16
Karnataka,Mandya,Short Stature/Dwarfism,35,60,11,10,21
Karnataka,Mandya,Short Stature/Dwarfism,60,80,2,1,3
Madhya Pradesh,Mandsaur,Short Stature/Dwarfism,6,15,3,2,5
Madhya Pradesh,Mandsaur,Short Stature/Dwarfism,15,35,3,8,11
Madhya Pradesh,Mandsaur,Short Stature/Dwarfism,35,60,4,5,9
Madhya Pradesh,Mandla,Short Stature/Dwarfism,15,35,5,11,16
Madhya Pradesh,Mandla,Short Stature/Dwarfism,35,60,2,4,6
Madhya Pradesh,Mandla,Short Stature/Dwarfism,60,80,0,1,1
Himachal Pradesh,Mandi,Short Stature/Dwarfism,6,15,1,0,1
Himachal Pradesh,Mandi,Short Stature/Dwarfism,15,35,3,3,6
Himachal Pradesh,Mandi,Short Stature/Dwarfism,35,60,2,1,3
Odisha,Malkangiri,Short Stature/Dwarfism,6,15,0,1,1
Odisha,Malkangiri,Short Stature/Dwarfism,15,35,1,2,3
Odisha,Malkangiri,Short Stature/Dwarfism,35,60,0,1,1
Kerala,Malappuram,Short Stature/Dwarfism,0,6,3,0,3
Kerala,Malappuram,Short Stature/Dwarfism,6,15,4,1,5
Kerala,Malappuram,Short Stature/Dwarfism,15,35,9,20,29
Kerala,Malappuram,Short Stature/Dwarfism,35,60,13,23,36
Kerala,Malappuram,Short Stature/Dwarfism,60,80,0,1,1
Uttar Pradesh,Mainpuri,Short Stature/Dwarfism,6,15,3,2,5
Uttar Pradesh,Mainpuri,Short Stature/Dwarfism,15,35,7,12,19
Uttar Pradesh,Mainpuri,Short Stature/Dwarfism,35,60,3,0,3
Uttar Pradesh,Mainpuri,Short Stature/Dwarfism,60,80,1,0,1
Uttar Pradesh,Mahoba,Short Stature/Dwarfism,6,15,0,3,3
Uttar Pradesh,Mahoba,Short Stature/Dwarfism,15,35,3,2,5
Uttar Pradesh,Mahoba,Short Stature/Dwarfism,35,60,3,6,9
Gujarat,Mahisagar,Short Stature/Dwarfism,6,15,2,4,6
Gujarat,Mahisagar,Short Stature/Dwarfism,15,35,5,1,6
Gujarat,Mahisagar,Short Stature/Dwarfism,35,60,2,0,2
Gujarat,Mahesana,Short Stature/Dwarfism,6,15,4,8,12
Gujarat,Mahesana,Short Stature/Dwarfism,15,35,5,8,13
Gujarat,Mahesana,Short Stature/Dwarfism,35,60,1,2,3
Haryana,Mahendragarh,Short Stature/Dwarfism,15,35,0,1,1
Puducherry,Mahe,Short Stature/Dwarfism,6,15,0,1,1
Chhattisgarh,Mahasamund,Short Stature/Dwarfism,6,15,1,3,4
Chhattisgarh,Mahasamund,Short Stature/Dwarfism,15,35,9,15,24
Chhattisgarh,Mahasamund,Short Stature/Dwarfism,35,60,3,3,6
Chhattisgarh,Mahasamund,Short Stature/Dwarfism,60,80,0,1,1
Uttar Pradesh,Maharajganj,Short Stature/Dwarfism,6,15,4,0,4
Uttar Pradesh,Maharajganj,Short Stature/Dwarfism,15,35,10,12,22
Uttar Pradesh,Maharajganj,Short Stature/Dwarfism,35,60,6,6,12
Tamil Nadu,Madurai,Short Stature/Dwarfism,0,6,0,1,1
Tamil Nadu,Madurai,Short Stature/Dwarfism,6,15,1,3,4
Tamil Nadu,Madurai,Short Stature/Dwarfism,15,35,2,9,11
Tamil Nadu,Madurai,Short Stature/Dwarfism,35,60,6,12,18
Tamil Nadu,Madurai,Short Stature/Dwarfism,60,80,1,0,1
Bihar,Madhubani,Short Stature/Dwarfism,0,6,1,0,1
Bihar,Madhubani,Short Stature/Dwarfism,6,15,0,2,2
Bihar,Madhubani,Short Stature/Dwarfism,15,35,5,1,6
Bihar,Madhubani,Short Stature/Dwarfism,35,60,1,3,4
Bihar,Madhubani,Short Stature/Dwarfism,60,80,1,0,1
Bihar,Madhepura,Short Stature/Dwarfism,6,15,3,2,5
Bihar,Madhepura,Short Stature/Dwarfism,15,35,35,12,47
Bihar,Madhepura,Short Stature/Dwarfism,35,60,19,9,28
Bihar,Madhepura,Short Stature/Dwarfism,60,80,4,2,6
Bihar,Madhepura,Short Stature/Dwarfism,80,100,1,0,1
Mizoram,Lunglei,Short Stature/Dwarfism,6,15,0,1,1
Punjab,Ludhiana,Short Stature/Dwarfism,0,6,1,0,1
Punjab,Ludhiana,Short Stature/Dwarfism,6,15,1,0,1
Punjab,Ludhiana,Short Stature/Dwarfism,15,35,5,5,10
Punjab,Ludhiana,Short Stature/Dwarfism,35,60,2,0,2
Punjab,Ludhiana,Short Stature/Dwarfism,60,80,4,0,4
Uttar Pradesh,Lucknow,Short Stature/Dwarfism,6,15,2,1,3
Uttar Pradesh,Lucknow,Short Stature/Dwarfism,15,35,25,14,39
Uttar Pradesh,Lucknow,Short Stature/Dwarfism,35,60,24,6,30
Uttar Pradesh,Lucknow,Short Stature/Dwarfism,60,80,7,1,8
Arunachal Pradesh,Lower Dibang Valley,Short Stature/Dwarfism,15,35,0,1,1
Arunachal Pradesh,Lohit,Short Stature/Dwarfism,35,60,0,1,1
Jharkhand,Lohardaga,Short Stature/Dwarfism,6,15,1,0,1
Jharkhand,Lohardaga,Short Stature/Dwarfism,15,35,2,5,7
Ladakh,Leh Ladakh,Short Stature/Dwarfism,15,35,1,1,2
Maharashtra,Latur,Short Stature/Dwarfism,6,15,3,10,13
Maharashtra,Latur,Short Stature/Dwarfism,15,35,29,34,63
Maharashtra,Latur,Short Stature/Dwarfism,35,60,16,26,42
Maharashtra,Latur,Short Stature/Dwarfism,60,80,5,4,9
Jharkhand,Latehar,Short Stature/Dwarfism,15,35,0,1,1
Jharkhand,Latehar,Short Stature/Dwarfism,35,60,0,1,1
Uttar Pradesh,Lalitpur,Short Stature/Dwarfism,15,35,2,0,2
Uttar Pradesh,Lalitpur,Short Stature/Dwarfism,35,60,2,0,2
Lakshadweep,Lakshadweep District,Short Stature/Dwarfism,15,35,0,1,1
Lakshadweep,Lakshadweep District,Short Stature/Dwarfism,60,80,1,0,1
Bihar,Lakhisarai,Short Stature/Dwarfism,15,35,1,1,2
Bihar,Lakhisarai,Short Stature/Dwarfism,35,60,1,0,1
Assam,Lakhimpur,Short Stature/Dwarfism,6,15,0,1,1
Assam,Lakhimpur,Short Stature/Dwarfism,15,35,3,2,5
Assam,Lakhimpur,Short Stature/Dwarfism,35,60,3,0,3
Uttar Pradesh,Kushi Nagar,Short Stature/Dwarfism,6,15,2,2,4
Uttar Pradesh,Kushi Nagar,Short Stature/Dwarfism,15,35,10,11,21
Uttar Pradesh,Kushi Nagar,Short Stature/Dwarfism,35,60,5,3,8
Haryana,Kurukshetra,Short Stature/Dwarfism,6,15,2,0,2
Haryana,Kurukshetra,Short Stature/Dwarfism,15,35,1,12,13
Haryana,Kurukshetra,Short Stature/Dwarfism,35,60,1,0,1
Andhra Pradesh,Kurnool,Short Stature/Dwarfism,15,35,1,0,1
Andhra Pradesh,Kurnool,Short Stature/Dwarfism,35,60,1,0,1
Jammu And Kashmir,Kupwara,Short Stature/Dwarfism,0,6,1,1,2
Jammu And Kashmir,Kupwara,Short Stature/Dwarfism,6,15,9,4,13
Jammu And Kashmir,Kupwara,Short Stature/Dwarfism,15,35,13,18,31
Jammu And Kashmir,Kupwara,Short Stature/Dwarfism,35,60,2,3,5
Jammu And Kashmir,Kupwara,Short Stature/Dwarfism,60,80,1,0,1
Himachal Pradesh,Kullu,Short Stature/Dwarfism,15,35,5,3,8
Himachal Pradesh,Kullu,Short Stature/Dwarfism,35,60,0,3,3
Jammu And Kashmir,Kulgam,Short Stature/Dwarfism,6,15,0,1,1
Jammu And Kashmir,Kulgam,Short Stature/Dwarfism,15,35,3,18,21
Jammu And Kashmir,Kulgam,Short Stature/Dwarfism,35,60,5,12,17
Jammu And Kashmir,Kulgam,Short Stature/Dwarfism,80,100,0,1,1
Tamil Nadu,Krishnagiri,Short Stature/Dwarfism,6,15,4,1,5
Tamil Nadu,Krishnagiri,Short Stature/Dwarfism,15,35,5,6,11
Tamil Nadu,Krishnagiri,Short Stature/Dwarfism,35,60,2,8,10
Kerala,Kozhikode,Short Stature/Dwarfism,6,15,3,4,7
Kerala,Kozhikode,Short Stature/Dwarfism,15,35,13,24,37
Kerala,Kozhikode,Short Stature/Dwarfism,35,60,22,29,51
Kerala,Kozhikode,Short Stature/Dwarfism,60,80,7,7,14
Kerala,Kottayam,Short Stature/Dwarfism,6,15,6,1,7
Kerala,Kottayam,Short Stature/Dwarfism,15,35,18,11,29
Kerala,Kottayam,Short Stature/Dwarfism,35,60,16,26,42
Kerala,Kottayam,Short Stature/Dwarfism,60,80,0,6,6
Rajasthan,Kota,Short Stature/Dwarfism,6,15,3,0,3
Rajasthan,Kota,Short Stature/Dwarfism,15,35,6,14,20
Rajasthan,Kota,Short Stature/Dwarfism,35,60,0,4,4
Chhattisgarh,Korea,Short Stature/Dwarfism,6,15,1,1,2
Chhattisgarh,Korea,Short Stature/Dwarfism,15,35,4,4,8
Chhattisgarh,Korea,Short Stature/Dwarfism,35,60,2,8,10
Chhattisgarh,Korba,Short Stature/Dwarfism,15,35,0,1,1
Chhattisgarh,Korba,Short Stature/Dwarfism,35,60,1,0,1
Chhattisgarh,Korba,Short Stature/Dwarfism,60,80,1,0,1
Odisha,Koraput,Short Stature/Dwarfism,6,15,2,0,2
Odisha,Koraput,Short Stature/Dwarfism,15,35,2,3,5
Odisha,Koraput,Short Stature/Dwarfism,35,60,4,2,6
Odisha,Koraput,Short Stature/Dwarfism,60,80,0,2,2
Karnataka,Koppal,Short Stature/Dwarfism,6,15,3,6,9
Karnataka,Koppal,Short Stature/Dwarfism,15,35,13,17,30
Karnataka,Koppal,Short Stature/Dwarfism,35,60,9,9,18
Chhattisgarh,Kondagaon,Short Stature/Dwarfism,6,15,8,4,12
Chhattisgarh,Kondagaon,Short Stature/Dwarfism,15,35,26,22,48
Chhattisgarh,Kondagaon,Short Stature/Dwarfism,35,60,12,4,16
Kerala,Kollam,Short Stature/Dwarfism,0,6,0,1,1
Kerala,Kollam,Short Stature/Dwarfism,6,15,0,1,1
Kerala,Kollam,Short Stature/Dwarfism,15,35,2,9,11
Kerala,Kollam,Short Stature/Dwarfism,35,60,7,9,16
Kerala,Kollam,Short Stature/Dwarfism,60,80,1,2,3
Maharashtra,Kolhapur,Short Stature/Dwarfism,6,15,8,4,12
Maharashtra,Kolhapur,Short Stature/Dwarfism,15,35,19,29,48
Maharashtra,Kolhapur,Short Stature/Dwarfism,35,60,13,14,27
Maharashtra,Kolhapur,Short Stature/Dwarfism,60,80,2,0,2
Mizoram,Kolasib,Short Stature/Dwarfism,6,15,1,1,2
Mizoram,Kolasib,Short Stature/Dwarfism,15,35,0,2,2
Karnataka,Kolar,Short Stature/Dwarfism,6,15,4,2,6
Karnataka,Kolar,Short Stature/Dwarfism,15,35,27,34,61
Karnataka,Kolar,Short Stature/Dwarfism,35,60,24,22,46
Karnataka,Kolar,Short Stature/Dwarfism,60,80,3,2,5
Assam,Kokrajhar,Short Stature/Dwarfism,6,15,1,7,8
Assam,Kokrajhar,Short Stature/Dwarfism,15,35,13,24,37
Assam,Kokrajhar,Short Stature/Dwarfism,35,60,7,6,13
Assam,Kokrajhar,Short Stature/Dwarfism,60,80,1,0,1
Nagaland,Kohima,Short Stature/Dwarfism,15,35,0,1,1
Nagaland,Kohima,Short Stature/Dwarfism,35,60,2,2,4
Jharkhand,Koderma,Short Stature/Dwarfism,6,15,2,2,4
Jharkhand,Koderma,Short Stature/Dwarfism,15,35,1,9,10
Jharkhand,Koderma,Short Stature/Dwarfism,35,60,2,2,4
Karnataka,Kodagu,Short Stature/Dwarfism,0,6,0,1,1
Karnataka,Kodagu,Short Stature/Dwarfism,6,15,2,2,4
Karnataka,Kodagu,Short Stature/Dwarfism,15,35,9,8,17
Karnataka,Kodagu,Short Stature/Dwarfism,35,60,10,6,16
Karnataka,Kodagu,Short Stature/Dwarfism,60,80,2,2,4
Karnataka,Kodagu,Short Stature/Dwarfism,80,100,1,0,1
Jammu And Kashmir,Kishtwar,Short Stature/Dwarfism,15,35,4,2,6
Bihar,Kishanganj,Short Stature/Dwarfism,6,15,0,2,2
Bihar,Kishanganj,Short Stature/Dwarfism,15,35,5,6,11
Bihar,Kishanganj,Short Stature/Dwarfism,35,60,1,1,2
Nagaland,Kiphire,Short Stature/Dwarfism,15,35,0,1,1
Jharkhand,Khunti,Short Stature/Dwarfism,15,35,1,2,3
Odisha,Khordha,Short Stature/Dwarfism,6,15,4,11,15
Odisha,Khordha,Short Stature/Dwarfism,15,35,16,27,43
Odisha,Khordha,Short Stature/Dwarfism,35,60,8,16,24
Odisha,Khordha,Short Stature/Dwarfism,60,80,0,1,1
Uttar Pradesh,Kheri,Short Stature/Dwarfism,15,35,13,5,18
Uttar Pradesh,Kheri,Short Stature/Dwarfism,35,60,7,0,7
Madhya Pradesh,Khargone,Short Stature/Dwarfism,6,15,2,3,5
Madhya Pradesh,Khargone,Short Stature/Dwarfism,15,35,12,9,21
Madhya Pradesh,Khargone,Short Stature/Dwarfism,35,60,5,2,7
Bihar,Khagaria,Short Stature/Dwarfism,6,15,0,1,1
Bihar,Khagaria,Short Stature/Dwarfism,15,35,0,2,2
Bihar,Khagaria,Short Stature/Dwarfism,35,60,1,0,1
Odisha,Kendujhar,Short Stature/Dwarfism,0,6,1,1,2
Odisha,Kendujhar,Short Stature/Dwarfism,6,15,11,5,16
Odisha,Kendujhar,Short Stature/Dwarfism,15,35,7,18,25
Odisha,Kendujhar,Short Stature/Dwarfism,35,60,5,7,12
Odisha,Kendujhar,Short Stature/Dwarfism,60,80,1,0,1
Odisha,Kendrapara,Short Stature/Dwarfism,6,15,5,5,10
Odisha,Kendrapara,Short Stature/Dwarfism,15,35,2,9,11
Odisha,Kendrapara,Short Stature/Dwarfism,35,60,4,5,9
Odisha,Kendrapara,Short Stature/Dwarfism,60,80,1,0,1
Uttar Pradesh,Kaushambi,Short Stature/Dwarfism,6,15,1,0,1
Uttar Pradesh,Kaushambi,Short Stature/Dwarfism,15,35,2,3,5
Madhya Pradesh,Katni,Short Stature/Dwarfism,6,15,0,3,3
Madhya Pradesh,Katni,Short Stature/Dwarfism,15,35,3,1,4
Madhya Pradesh,Katni,Short Stature/Dwarfism,35,60,1,2,3
Bihar,Katihar,Short Stature/Dwarfism,0,6,1,1,2
Bihar,Katihar,Short Stature/Dwarfism,6,15,8,12,20
Bihar,Katihar,Short Stature/Dwarfism,15,35,16,24,40
Bihar,Katihar,Short Stature/Dwarfism,35,60,3,6,9
Jammu And Kashmir,Kathua,Short Stature/Dwarfism,6,15,0,4,4
Jammu And Kashmir,Kathua,Short Stature/Dwarfism,15,35,4,4,8
Jammu And Kashmir,Kathua,Short Stature/Dwarfism,35,60,5,4,9
Jammu And Kashmir,Kathua,Short Stature/Dwarfism,60,80,1,1,2
Uttar Pradesh,Kasganj,Short Stature/Dwarfism,15,35,6,2,8
Uttar Pradesh,Kasganj,Short Stature/Dwarfism,35,60,6,1,7
Kerala,Kasaragod,Short Stature/Dwarfism,6,15,1,1,2
Kerala,Kasaragod,Short Stature/Dwarfism,15,35,6,4,10
Kerala,Kasaragod,Short Stature/Dwarfism,35,60,6,9,15
Kerala,Kasaragod,Short Stature/Dwarfism,60,80,1,1,2
Tamil Nadu,Karur,Short Stature/Dwarfism,6,15,2,2,4
Tamil Nadu,Karur,Short Stature/Dwarfism,15,35,13,11,24
Tamil Nadu,Karur,Short Stature/Dwarfism,35,60,6,10,16
Tamil Nadu,Karur,Short Stature/Dwarfism,60,80,1,1,2
Haryana,Karnal,Short Stature/Dwarfism,6,15,1,3,4
Haryana,Karnal,Short Stature/Dwarfism,15,35,3,9,12
Haryana,Karnal,Short Stature/Dwarfism,35,60,0,2,2
Assam,Karimganj,Short Stature/Dwarfism,6,15,0,1,1
Assam,Karimganj,Short Stature/Dwarfism,15,35,2,3,5
Assam,Karimganj,Short Stature/Dwarfism,35,60,1,1,2
Assam,Karimganj,Short Stature/Dwarfism,60,80,1,0,1
Assam,Karbi Anglong,Short Stature/Dwarfism,15,35,1,1,2
Rajasthan,Karauli,Short Stature/Dwarfism,15,35,3,3,6
Rajasthan,Karauli,Short Stature/Dwarfism,35,60,2,1,3
Puducherry,Karaikal,Short Stature/Dwarfism,60,80,1,0,1
Punjab,Kapurthala,Short Stature/Dwarfism,6,15,1,0,1
Punjab,Kapurthala,Short Stature/Dwarfism,15,35,0,2,2
Punjab,Kapurthala,Short Stature/Dwarfism,35,60,1,3,4
Uttar Pradesh,Kanpur Nagar,Short Stature/Dwarfism,6,15,1,0,1
Uttar Pradesh,Kanpur Nagar,Short Stature/Dwarfism,15,35,4,4,8
Uttar Pradesh,Kanpur Nagar,Short Stature/Dwarfism,35,60,2,1,3
Uttar Pradesh,Kanpur Dehat,Short Stature/Dwarfism,15,35,2,1,3
Uttar Pradesh,Kanpur Dehat,Short Stature/Dwarfism,35,60,1,1,2
Kerala,Kannur,Short Stature/Dwarfism,6,15,1,1,2
Kerala,Kannur,Short Stature/Dwarfism,15,35,5,8,13
Kerala,Kannur,Short Stature/Dwarfism,35,60,10,22,32
Kerala,Kannur,Short Stature/Dwarfism,60,80,2,1,3
Tamil Nadu,Kanniyakumari,Short Stature/Dwarfism,6,15,1,0,1
Tamil Nadu,Kanniyakumari,Short Stature/Dwarfism,15,35,5,8,13
Tamil Nadu,Kanniyakumari,Short Stature/Dwarfism,35,60,2,4,6
Uttar Pradesh,Kannauj,Short Stature/Dwarfism,15,35,7,1,8
Uttar Pradesh,Kannauj,Short Stature/Dwarfism,35,60,1,0,1
Chhattisgarh,Kanker,Short Stature/Dwarfism,0,6,1,0,1
Chhattisgarh,Kanker,Short Stature/Dwarfism,6,15,8,2,10
Chhattisgarh,Kanker,Short Stature/Dwarfism,15,35,28,10,38
Chhattisgarh,Kanker,Short Stature/Dwarfism,35,60,8,8,16
Chhattisgarh,Kanker,Short Stature/Dwarfism,60,80,1,0,1
Himachal Pradesh,Kangra,Short Stature/Dwarfism,15,35,5,1,6
Himachal Pradesh,Kangra,Short Stature/Dwarfism,35,60,0,3,3
Himachal Pradesh,Kangra,Short Stature/Dwarfism,60,80,1,1,2
Manipur,Kangpokpi,Short Stature/Dwarfism,15,35,1,0,1
Odisha,Kandhamal,Short Stature/Dwarfism,6,15,4,4,8
Odisha,Kandhamal,Short Stature/Dwarfism,15,35,8,13,21
Odisha,Kandhamal,Short Stature/Dwarfism,35,60,5,3,8
Odisha,Kandhamal,Short Stature/Dwarfism,60,80,1,0,1
Tamil Nadu,Kanchipuram,Short Stature/Dwarfism,6,15,5,5,10
Tamil Nadu,Kanchipuram,Short Stature/Dwarfism,15,35,3,6,9
Tamil Nadu,Kanchipuram,Short Stature/Dwarfism,35,60,3,5,8
Tamil Nadu,Kanchipuram,Short Stature/Dwarfism,60,80,1,1,2
Tamil Nadu,Kanchipuram,Short Stature/Dwarfism,80,100,1,0,1
Assam,Kamrup Metro,Short Stature/Dwarfism,15,35,1,1,2
Assam,Kamrup Metro,Short Stature/Dwarfism,35,60,0,1,1
Assam,Kamrup,Short Stature/Dwarfism,15,35,3,4,7
Assam,Kamrup,Short Stature/Dwarfism,35,60,2,0,2
Tamil Nadu,Kallakurichi,Short Stature/Dwarfism,0,6,0,1,1
Tamil Nadu,Kallakurichi,Short Stature/Dwarfism,6,15,1,1,2
Tamil Nadu,Kallakurichi,Short Stature/Dwarfism,15,35,0,4,4
Tamil Nadu,Kallakurichi,Short Stature/Dwarfism,35,60,2,3,5
Tamil Nadu,Kallakurichi,Short Stature/Dwarfism,60,80,1,0,1
Odisha,Kalahandi,Short Stature/Dwarfism,6,15,1,0,1
Odisha,Kalahandi,Short Stature/Dwarfism,15,35,16,32,48
Odisha,Kalahandi,Short Stature/Dwarfism,35,60,10,12,22
Odisha,Kalahandi,Short Stature/Dwarfism,60,80,1,0,1
Karnataka,Kalaburagi,Short Stature/Dwarfism,0,6,0,1,1
Karnataka,Kalaburagi,Short Stature/Dwarfism,6,15,7,5,12
Karnataka,Kalaburagi,Short Stature/Dwarfism,15,35,30,43,73
Karnataka,Kalaburagi,Short Stature/Dwarfism,35,60,11,9,20
Karnataka,Kalaburagi,Short Stature/Dwarfism,60,80,1,1,2
Manipur,Kakching,Short Stature/Dwarfism,6,15,0,1,1
Manipur,Kakching,Short Stature/Dwarfism,15,35,1,1,2
Manipur,Kakching,Short Stature/Dwarfism,35,60,1,3,4
Haryana,Kaithal,Short Stature/Dwarfism,15,35,1,2,3
Bihar,Kaimur (Bhabua),Short Stature/Dwarfism,15,35,3,2,5
Bihar,Kaimur (Bhabua),Short Stature/Dwarfism,35,60,1,0,1
Gujarat,Kachchh,Short Stature/Dwarfism,6,15,2,0,2
Gujarat,Kachchh,Short Stature/Dwarfism,15,35,2,1,3
Gujarat,Kachchh,Short Stature/Dwarfism,35,60,2,0,2
Chhattisgarh,Kabirdham,Short Stature/Dwarfism,6,15,1,0,1
Chhattisgarh,Kabirdham,Short Stature/Dwarfism,15,35,4,9,13
Chhattisgarh,Kabirdham,Short Stature/Dwarfism,35,60,2,0,2
Gujarat,Junagadh,Short Stature/Dwarfism,0,6,0,1,1
Gujarat,Junagadh,Short Stature/Dwarfism,6,15,9,9,18
Gujarat,Junagadh,Short Stature/Dwarfism,15,35,14,13,27
Gujarat,Junagadh,Short Stature/Dwarfism,35,60,3,6,9
Assam,Jorhat,Short Stature/Dwarfism,6,15,0,1,1
Assam,Jorhat,Short Stature/Dwarfism,15,35,1,8,9
Assam,Jorhat,Short Stature/Dwarfism,35,60,1,1,2
Rajasthan,Jodhpur,Short Stature/Dwarfism,15,35,8,25,33
Rajasthan,Jodhpur,Short Stature/Dwarfism,35,60,15,11,26
Rajasthan,Jodhpur,Short Stature/Dwarfism,60,80,3,1,4
Haryana,Jind,Short Stature/Dwarfism,0,6,1,0,1
Haryana,Jind,Short Stature/Dwarfism,15,35,2,3,5
Haryana,Jind,Short Stature/Dwarfism,35,60,2,1,3
Rajasthan,Jhunjhunu,Short Stature/Dwarfism,0,6,1,0,1
Rajasthan,Jhunjhunu,Short Stature/Dwarfism,15,35,1,4,5
Rajasthan,Jhunjhunu,Short Stature/Dwarfism,35,60,3,0,3
Odisha,Jharsuguda,Short Stature/Dwarfism,6,15,1,1,2
Odisha,Jharsuguda,Short Stature/Dwarfism,15,35,0,4,4
Uttar Pradesh,Jhansi,Short Stature/Dwarfism,15,35,5,2,7
Uttar Pradesh,Jhansi,Short Stature/Dwarfism,35,60,2,1,3
Uttar Pradesh,Jhansi,Short Stature/Dwarfism,60,80,2,0,2
Rajasthan,Jhalawar,Short Stature/Dwarfism,15,35,5,7,12
Rajasthan,Jhalawar,Short Stature/Dwarfism,35,60,2,4,6
Haryana,Jhajjar,Short Stature/Dwarfism,15,35,4,0,4
Madhya Pradesh,Jhabua,Short Stature/Dwarfism,6,15,1,0,1
Madhya Pradesh,Jhabua,Short Stature/Dwarfism,15,35,3,1,4
Madhya Pradesh,Jhabua,Short Stature/Dwarfism,35,60,2,0,2
Madhya Pradesh,Jhabua,Short Stature/Dwarfism,60,80,1,1,2
Bihar,Jehanabad,Short Stature/Dwarfism,15,35,2,1,3
Bihar,Jehanabad,Short Stature/Dwarfism,35,60,3,1,4
Bihar,Jehanabad,Short Stature/Dwarfism,60,80,3,1,4
Uttar Pradesh,Jaunpur,Short Stature/Dwarfism,6,15,3,3,6
Uttar Pradesh,Jaunpur,Short Stature/Dwarfism,15,35,12,8,20
Uttar Pradesh,Jaunpur,Short Stature/Dwarfism,35,60,11,6,17
Uttar Pradesh,Jaunpur,Short Stature/Dwarfism,60,80,1,0,1
Chhattisgarh,Jashpur,Short Stature/Dwarfism,6,15,1,1,2
Chhattisgarh,Jashpur,Short Stature/Dwarfism,15,35,7,12,19
Chhattisgarh,Jashpur,Short Stature/Dwarfism,35,60,1,3,4
Chhattisgarh,Jashpur,Short Stature/Dwarfism,60,80,1,0,1
Chhattisgarh,Janjgir-Champa,Short Stature/Dwarfism,6,15,3,6,9
Chhattisgarh,Janjgir-Champa,Short Stature/Dwarfism,15,35,17,43,60
Chhattisgarh,Janjgir-Champa,Short Stature/Dwarfism,35,60,5,5,10
Chhattisgarh,Janjgir-Champa,Short Stature/Dwarfism,60,80,0,1,1
Bihar,Jamui,Short Stature/Dwarfism,6,15,2,1,3
Bihar,Jamui,Short Stature/Dwarfism,15,35,0,3,3
Bihar,Jamui,Short Stature/Dwarfism,35,60,2,0,2
Jharkhand,Jamtara,Short Stature/Dwarfism,15,35,2,2,4
Jharkhand,Jamtara,Short Stature/Dwarfism,35,60,0,2,2
Jharkhand,Jamtara,Short Stature/Dwarfism,80,100,0,1,1
Gujarat,Jamnagar,Short Stature/Dwarfism,6,15,1,0,1
Gujarat,Jamnagar,Short Stature/Dwarfism,15,35,0,3,3
Jammu And Kashmir,Jammu,Short Stature/Dwarfism,15,35,7,3,10
Jammu And Kashmir,Jammu,Short Stature/Dwarfism,35,60,1,2,3
Jammu And Kashmir,Jammu,Short Stature/Dwarfism,60,80,1,0,1
Rajasthan,Jalore,Short Stature/Dwarfism,6,15,3,0,3
Rajasthan,Jalore,Short Stature/Dwarfism,15,35,4,15,19
Rajasthan,Jalore,Short Stature/Dwarfism,35,60,3,1,4
Maharashtra,Jalna,Short Stature/Dwarfism,6,15,1,2,3
Maharashtra,Jalna,Short Stature/Dwarfism,15,35,12,16,28
Maharashtra,Jalna,Short Stature/Dwarfism,35,60,5,9,14
Maharashtra,Jalgaon,Short Stature/Dwarfism,6,15,3,3,6
Maharashtra,Jalgaon,Short Stature/Dwarfism,15,35,18,22,40
Maharashtra,Jalgaon,Short Stature/Dwarfism,35,60,13,17,30
Maharashtra,Jalgaon,Short Stature/Dwarfism,60,80,2,0,2
Uttar Pradesh,Jalaun,Short Stature/Dwarfism,15,35,10,5,15
Uttar Pradesh,Jalaun,Short Stature/Dwarfism,35,60,10,2,12
Uttar Pradesh,Jalaun,Short Stature/Dwarfism,60,80,1,0,1
Punjab,Jalandhar,Short Stature/Dwarfism,6,15,2,0,2
Punjab,Jalandhar,Short Stature/Dwarfism,15,35,7,9,16
Punjab,Jalandhar,Short Stature/Dwarfism,35,60,4,1,5
Odisha,Jajapur,Short Stature/Dwarfism,6,15,8,7,15
Odisha,Jajapur,Short Stature/Dwarfism,15,35,17,43,60
Odisha,Jajapur,Short Stature/Dwarfism,35,60,6,21,27
Odisha,Jajapur,Short Stature/Dwarfism,60,80,2,0,2
Rajasthan,Jaisalmer,Short Stature/Dwarfism,15,35,0,3,3
Rajasthan,Jaisalmer,Short Stature/Dwarfism,35,60,5,2,7
Rajasthan,Jaipur,Short Stature/Dwarfism,0,6,0,1,1
Rajasthan,Jaipur,Short Stature/Dwarfism,6,15,0,4,4
Rajasthan,Jaipur,Short Stature/Dwarfism,15,35,23,46,69
Rajasthan,Jaipur,Short Stature/Dwarfism,35,60,12,26,38
Rajasthan,Jaipur,Short Stature/Dwarfism,60,80,1,0,1
Odisha,Jagatsinghapur,Short Stature/Dwarfism,6,15,0,2,2
Odisha,Jagatsinghapur,Short Stature/Dwarfism,15,35,2,1,3
Odisha,Jagatsinghapur,Short Stature/Dwarfism,35,60,0,1,1
Madhya Pradesh,Jabalpur,Short Stature/Dwarfism,6,15,1,1,2
Madhya Pradesh,Jabalpur,Short Stature/Dwarfism,15,35,6,3,9
Madhya Pradesh,Jabalpur,Short Stature/Dwarfism,35,60,2,1,3
Madhya Pradesh,Indore,Short Stature/Dwarfism,6,15,1,0,1
Madhya Pradesh,Indore,Short Stature/Dwarfism,15,35,6,1,7
Madhya Pradesh,Indore,Short Stature/Dwarfism,35,60,8,2,10
Madhya Pradesh,Indore,Short Stature/Dwarfism,60,80,0,1,1
Manipur,Imphal West,Short Stature/Dwarfism,15,35,6,6,12
Manipur,Imphal West,Short Stature/Dwarfism,35,60,1,2,3
Manipur,Imphal East,Short Stature/Dwarfism,15,35,2,6,8
Manipur,Imphal East,Short Stature/Dwarfism,35,60,1,3,4
Kerala,Idukki,Short Stature/Dwarfism,6,15,0,1,1
Kerala,Idukki,Short Stature/Dwarfism,15,35,1,3,4
Kerala,Idukki,Short Stature/Dwarfism,35,60,4,5,9
Kerala,Idukki,Short Stature/Dwarfism,60,80,2,0,2
Punjab,Hoshiarpur,Short Stature/Dwarfism,15,35,1,10,11
Punjab,Hoshiarpur,Short Stature/Dwarfism,35,60,4,3,7
Punjab,Hoshiarpur,Short Stature/Dwarfism,60,80,0,2,2
Assam,Hojai,Short Stature/Dwarfism,6,15,1,0,1
Assam,Hojai,Short Stature/Dwarfism,15,35,1,4,5
Assam,Hojai,Short Stature/Dwarfism,60,80,1,0,1
Haryana,Hisar,Short Stature/Dwarfism,6,15,1,0,1
Haryana,Hisar,Short Stature/Dwarfism,15,35,3,4,7
Haryana,Hisar,Short Stature/Dwarfism,35,60,2,1,3
Haryana,Hisar,Short Stature/Dwarfism,60,80,0,1,1
Maharashtra,Hingoli,Short Stature/Dwarfism,6,15,3,2,5
Maharashtra,Hingoli,Short Stature/Dwarfism,15,35,17,26,43
Maharashtra,Hingoli,Short Stature/Dwarfism,35,60,3,7,10
Jharkhand,Hazaribagh,Short Stature/Dwarfism,6,15,0,1,1
Jharkhand,Hazaribagh,Short Stature/Dwarfism,15,35,2,1,3
Jharkhand,Hazaribagh,Short Stature/Dwarfism,35,60,1,0,1
Karnataka,Haveri,Short Stature/Dwarfism,6,15,1,1,2
Karnataka,Haveri,Short Stature/Dwarfism,15,35,13,6,19
Karnataka,Haveri,Short Stature/Dwarfism,35,60,8,5,13
Karnataka,Haveri,Short Stature/Dwarfism,60,80,2,1,3
Uttar Pradesh,Hathras,Short Stature/Dwarfism,15,35,2,1,3
Uttar Pradesh,Hathras,Short Stature/Dwarfism,35,60,0,2,2
Karnataka,Hassan,Short Stature/Dwarfism,0,6,0,1,1
Karnataka,Hassan,Short Stature/Dwarfism,6,15,2,1,3
Karnataka,Hassan,Short Stature/Dwarfism,15,35,8,7,15
Karnataka,Hassan,Short Stature/Dwarfism,35,60,11,18,29
Karnataka,Hassan,Short Stature/Dwarfism,60,80,2,0,2
Uttarakhand,Haridwar,Short Stature/Dwarfism,6,15,0,2,2
Uttarakhand,Haridwar,Short Stature/Dwarfism,15,35,2,6,8
Uttarakhand,Haridwar,Short Stature/Dwarfism,35,60,5,2,7
Uttar Pradesh,Hardoi,Short Stature/Dwarfism,6,15,3,1,4
Uttar Pradesh,Hardoi,Short Stature/Dwarfism,15,35,18,18,36
Uttar Pradesh,Hardoi,Short Stature/Dwarfism,35,60,5,1,6
Uttar Pradesh,Hardoi,Short Stature/Dwarfism,60,80,1,1,2
Uttar Pradesh,Hapur,Short Stature/Dwarfism,15,35,3,1,4
Uttar Pradesh,Hapur,Short Stature/Dwarfism,35,60,2,1,3
Rajasthan,Hanumangarh,Short Stature/Dwarfism,15,35,3,5,8
Rajasthan,Hanumangarh,Short Stature/Dwarfism,35,60,0,1,1
Himachal Pradesh,Hamirpur,Short Stature/Dwarfism,15,35,2,1,3
Himachal Pradesh,Hamirpur,Short Stature/Dwarfism,35,60,2,1,3
Uttar Pradesh,Hamirpur,Short Stature/Dwarfism,6,15,5,1,6
Uttar Pradesh,Hamirpur,Short Stature/Dwarfism,15,35,22,8,30
Uttar Pradesh,Hamirpur,Short Stature/Dwarfism,35,60,91,22,113
Uttar Pradesh,Hamirpur,Short Stature/Dwarfism,60,80,32,6,38
Uttar Pradesh,Hamirpur,Short Stature/Dwarfism,80,100,3,0,3
Assam,Hailakandi,Short Stature/Dwarfism,6,15,1,1,2
Assam,Hailakandi,Short Stature/Dwarfism,15,35,4,8,12
Assam,Hailakandi,Short Stature/Dwarfism,35,60,2,1,3
Sikkim,Gyalshing,Short Stature/Dwarfism,35,60,0,1,1
Madhya Pradesh,Gwalior,Short Stature/Dwarfism,15,35,3,4,7
Madhya Pradesh,Gwalior,Short Stature/Dwarfism,35,60,6,2,8
Haryana,Gurugram,Short Stature/Dwarfism,6,15,3,0,3
Haryana,Gurugram,Short Stature/Dwarfism,15,35,1,3,4
Punjab,Gurdaspur,Short Stature/Dwarfism,6,15,0,1,1
Punjab,Gurdaspur,Short Stature/Dwarfism,15,35,2,0,2
Punjab,Gurdaspur,Short Stature/Dwarfism,35,60,4,3,7
Andhra Pradesh,Guntur,Short Stature/Dwarfism,35,60,0,1,1
Madhya Pradesh,Guna,Short Stature/Dwarfism,6,15,0,1,1
Madhya Pradesh,Guna,Short Stature/Dwarfism,15,35,4,0,4
Madhya Pradesh,Guna,Short Stature/Dwarfism,35,60,1,1,2
Jharkhand,Gumla,Short Stature/Dwarfism,6,15,5,1,6
Jharkhand,Gumla,Short Stature/Dwarfism,15,35,5,7,12
Jharkhand,Gumla,Short Stature/Dwarfism,35,60,4,3,7
Jharkhand,Gumla,Short Stature/Dwarfism,60,80,2,0,2
Uttar Pradesh,Gorakhpur,Short Stature/Dwarfism,6,15,2,3,5
Uttar Pradesh,Gorakhpur,Short Stature/Dwarfism,15,35,15,21,36
Uttar Pradesh,Gorakhpur,Short Stature/Dwarfism,35,60,15,10,25
Bihar,Gopalganj,Short Stature/Dwarfism,6,15,9,6,15
Bihar,Gopalganj,Short Stature/Dwarfism,15,35,10,8,18
Bihar,Gopalganj,Short Stature/Dwarfism,35,60,2,1,3
Maharashtra,Gondia,Short Stature/Dwarfism,6,15,2,1,3
Maharashtra,Gondia,Short Stature/Dwarfism,15,35,3,6,9
Maharashtra,Gondia,Short Stature/Dwarfism,35,60,0,2,2
Uttar Pradesh,Gonda,Short Stature/Dwarfism,15,35,23,11,34
Uttar Pradesh,Gonda,Short Stature/Dwarfism,35,60,13,3,16
Uttar Pradesh,Gonda,Short Stature/Dwarfism,60,80,3,0,3
Uttar Pradesh,Gonda,Short Stature/Dwarfism,80,100,1,0,1
Assam,Golaghat,Short Stature/Dwarfism,0,6,0,1,1
Assam,Golaghat,Short Stature/Dwarfism,15,35,4,2,6
Jharkhand,Godda,Short Stature/Dwarfism,6,15,0,1,1
Jharkhand,Godda,Short Stature/Dwarfism,15,35,21,12,33
Jharkhand,Godda,Short Stature/Dwarfism,35,60,11,5,16
Jharkhand,Godda,Short Stature/Dwarfism,60,80,1,0,1
Assam,Goalpara,Short Stature/Dwarfism,6,15,2,0,2
Assam,Goalpara,Short Stature/Dwarfism,15,35,5,3,8
Assam,Goalpara,Short Stature/Dwarfism,35,60,2,2,4
Jharkhand,Giridih,Short Stature/Dwarfism,6,15,0,1,1
Jharkhand,Giridih,Short Stature/Dwarfism,15,35,5,4,9
Jharkhand,Giridih,Short Stature/Dwarfism,35,60,1,3,4
Jharkhand,Giridih,Short Stature/Dwarfism,60,80,2,0,2
Gujarat,Gir Somnath,Short Stature/Dwarfism,0,6,1,0,1
Gujarat,Gir Somnath,Short Stature/Dwarfism,6,15,9,6,15
Gujarat,Gir Somnath,Short Stature/Dwarfism,15,35,4,13,17
Gujarat,Gir Somnath,Short Stature/Dwarfism,35,60,3,2,5
Uttar Pradesh,Ghazipur,Short Stature/Dwarfism,6,15,0,2,2
Uttar Pradesh,Ghazipur,Short Stature/Dwarfism,15,35,15,18,33
Uttar Pradesh,Ghazipur,Short Stature/Dwarfism,35,60,5,4,9
Uttar Pradesh,Ghazipur,Short Stature/Dwarfism,60,80,2,0,2
Uttar Pradesh,Ghaziabad,Short Stature/Dwarfism,6,15,1,0,1
Uttar Pradesh,Ghaziabad,Short Stature/Dwarfism,15,35,2,2,4
Uttar Pradesh,Ghaziabad,Short Stature/Dwarfism,35,60,4,3,7
Bihar,Gaya,Short Stature/Dwarfism,0,6,1,0,1
Bihar,Gaya,Short Stature/Dwarfism,6,15,9,9,18
Bihar,Gaya,Short Stature/Dwarfism,15,35,11,15,26
Bihar,Gaya,Short Stature/Dwarfism,35,60,8,5,13
Bihar,Gaya,Short Stature/Dwarfism,60,80,2,0,2
Uttar Pradesh,Gautam Buddha Nagar,Short Stature/Dwarfism,6,15,1,0,1
Uttar Pradesh,Gautam Buddha Nagar,Short Stature/Dwarfism,15,35,1,0,1
Uttar Pradesh,Gautam Buddha Nagar,Short Stature/Dwarfism,35,60,1,0,1
Chhattisgarh,Gaurella Pendra Marwahi,Short Stature/Dwarfism,15,35,1,0,1
Chhattisgarh,Gariyaband,Short Stature/Dwarfism,0,6,2,0,2
Chhattisgarh,Gariyaband,Short Stature/Dwarfism,6,15,1,0,1
Chhattisgarh,Gariyaband,Short Stature/Dwarfism,15,35,8,15,23
Chhattisgarh,Gariyaband,Short Stature/Dwarfism,35,60,2,4,6
Jharkhand,Garhwa,Short Stature/Dwarfism,6,15,1,1,2
Jharkhand,Garhwa,Short Stature/Dwarfism,15,35,8,12,20
Jharkhand,Garhwa,Short Stature/Dwarfism,35,60,4,0,4
Odisha,Ganjam,Short Stature/Dwarfism,6,15,0,3,3
Odisha,Ganjam,Short Stature/Dwarfism,15,35,13,39,52
Odisha,Ganjam,Short Stature/Dwarfism,35,60,10,10,20
Odisha,Ganjam,Short Stature/Dwarfism,60,80,1,1,2
Sikkim,Gangtok,Short Stature/Dwarfism,15,35,3,3,6
Sikkim,Gangtok,Short Stature/Dwarfism,35,60,0,1,1
Rajasthan,Ganganagar,Short Stature/Dwarfism,6,15,9,1,10
Rajasthan,Ganganagar,Short Stature/Dwarfism,15,35,15,23,38
Rajasthan,Ganganagar,Short Stature/Dwarfism,35,60,6,16,22
Rajasthan,Ganganagar,Short Stature/Dwarfism,60,80,0,2,2
Gujarat,Gandhinagar,Short Stature/Dwarfism,6,15,0,1,1
Gujarat,Gandhinagar,Short Stature/Dwarfism,15,35,4,6,10
Gujarat,Gandhinagar,Short Stature/Dwarfism,35,60,2,1,3
Jammu And Kashmir,Ganderbal,Short Stature/Dwarfism,0,6,2,1,3
Jammu And Kashmir,Ganderbal,Short Stature/Dwarfism,6,15,1,1,2
Jammu And Kashmir,Ganderbal,Short Stature/Dwarfism,15,35,1,10,11
Jammu And Kashmir,Ganderbal,Short Stature/Dwarfism,35,60,1,5,6
Odisha,Gajapati,Short Stature/Dwarfism,6,15,0,3,3
Odisha,Gajapati,Short Stature/Dwarfism,15,35,3,9,12
Odisha,Gajapati,Short Stature/Dwarfism,35,60,0,1,1
Odisha,Gajapati,Short Stature/Dwarfism,60,80,1,0,1
Maharashtra,Gadchiroli,Short Stature/Dwarfism,6,15,0,3,3
Maharashtra,Gadchiroli,Short Stature/Dwarfism,15,35,1,6,7
Maharashtra,Gadchiroli,Short Stature/Dwarfism,35,60,3,3,6
Karnataka,Gadag,Short Stature/Dwarfism,0,6,1,0,1
Karnataka,Gadag,Short Stature/Dwarfism,6,15,0,3,3
Karnataka,Gadag,Short Stature/Dwarfism,15,35,7,13,20
Karnataka,Gadag,Short Stature/Dwarfism,35,60,8,13,21
Karnataka,Gadag,Short Stature/Dwarfism,60,80,1,2,3
Uttar Pradesh,Firozabad,Short Stature/Dwarfism,6,15,2,4,6
Uttar Pradesh,Firozabad,Short Stature/Dwarfism,15,35,5,6,11
Uttar Pradesh,Firozabad,Short Stature/Dwarfism,35,60,4,1,5
Uttar Pradesh,Firozabad,Short Stature/Dwarfism,60,80,0,1,1
Punjab,Ferozepur,Short Stature/Dwarfism,15,35,3,3,6
Punjab,Ferozepur,Short Stature/Dwarfism,35,60,3,1,4
Punjab,Fazilka,Short Stature/Dwarfism,6,15,0,6,6
Punjab,Fazilka,Short Stature/Dwarfism,15,35,6,10,16
Punjab,Fazilka,Short Stature/Dwarfism,35,60,5,3,8
Uttar Pradesh,Fatehpur,Short Stature/Dwarfism,6,15,2,2,4
Uttar Pradesh,Fatehpur,Short Stature/Dwarfism,15,35,12,9,21
Uttar Pradesh,Fatehpur,Short Stature/Dwarfism,35,60,20,4,24
Uttar Pradesh,Fatehpur,Short Stature/Dwarfism,60,80,8,2,10
Uttar Pradesh,Fatehpur,Short Stature/Dwarfism,80,100,1,0,1
Punjab,Fatehgarh Sahib,Short Stature/Dwarfism,15,35,6,2,8
Punjab,Fatehgarh Sahib,Short Stature/Dwarfism,35,60,3,0,3
Haryana,Fatehabad,Short Stature/Dwarfism,6,15,0,1,1
Haryana,Fatehabad,Short Stature/Dwarfism,15,35,4,5,9
Haryana,Fatehabad,Short Stature/Dwarfism,35,60,1,1,2
Uttar Pradesh,Farrukhabad,Short Stature/Dwarfism,15,35,5,5,10
Uttar Pradesh,Farrukhabad,Short Stature/Dwarfism,35,60,3,1,4
Punjab,Faridkot,Short Stature/Dwarfism,6,15,1,3,4
Punjab,Faridkot,Short Stature/Dwarfism,15,35,5,9,14
Punjab,Faridkot,Short Stature/Dwarfism,35,60,0,4,4
Punjab,Faridkot,Short Stature/Dwarfism,60,80,1,0,1
Haryana,Faridabad,Short Stature/Dwarfism,6,15,0,1,1
Haryana,Faridabad,Short Stature/Dwarfism,15,35,1,1,2
Uttar Pradesh,Etawah,Short Stature/Dwarfism,6,15,1,0,1
Uttar Pradesh,Etawah,Short Stature/Dwarfism,15,35,3,3,6
Uttar Pradesh,Etawah,Short Stature/Dwarfism,35,60,5,1,6
Uttar Pradesh,Etawah,Short Stature/Dwarfism,60,80,1,0,1
Uttar Pradesh,Etah,Short Stature/Dwarfism,15,35,1,1,2
Uttar Pradesh,Etah,Short Stature/Dwarfism,35,60,2,0,2
Uttar Pradesh,Etah,Short Stature/Dwarfism,60,80,0,1,1
Tamil Nadu,Erode,Short Stature/Dwarfism,0,6,1,1,2
Tamil Nadu,Erode,Short Stature/Dwarfism,6,15,2,3,5
Tamil Nadu,Erode,Short Stature/Dwarfism,15,35,6,7,13
Tamil Nadu,Erode,Short Stature/Dwarfism,35,60,2,6,8
Tamil Nadu,Erode,Short Stature/Dwarfism,60,80,1,2,3
Kerala,Ernakulam,Short Stature/Dwarfism,6,15,1,1,2
Kerala,Ernakulam,Short Stature/Dwarfism,15,35,5,7,12
Kerala,Ernakulam,Short Stature/Dwarfism,35,60,8,16,24
Kerala,Ernakulam,Short Stature/Dwarfism,60,80,1,4,5
Jharkhand,East Singhbum,Short Stature/Dwarfism,6,15,0,2,2
Jharkhand,East Singhbum,Short Stature/Dwarfism,15,35,5,3,8
Jharkhand,East Singhbum,Short Stature/Dwarfism,35,60,1,2,3
Arunachal Pradesh,East Siang,Short Stature/Dwarfism,15,35,2,2,4
Madhya Pradesh,East Nimar,Short Stature/Dwarfism,6,15,0,1,1
Madhya Pradesh,East Nimar,Short Stature/Dwarfism,15,35,2,3,5
Madhya Pradesh,East Nimar,Short Stature/Dwarfism,35,60,2,0,2
Meghalaya,East Khasi Hills,Short Stature/Dwarfism,6,15,2,0,2
Meghalaya,East Khasi Hills,Short Stature/Dwarfism,15,35,5,3,8
Meghalaya,East Khasi Hills,Short Stature/Dwarfism,35,60,2,4,6
Arunachal Pradesh,East Kameng,Short Stature/Dwarfism,15,35,0,1,1
Meghalaya,East Jaintia Hills,Short Stature/Dwarfism,15,35,1,1,2
Meghalaya,East Garo Hills,Short Stature/Dwarfism,15,35,1,2,3
Delhi,East,Short Stature/Dwarfism,6,15,1,1,2
Delhi,East,Short Stature/Dwarfism,15,35,1,7,8
Delhi,East,Short Stature/Dwarfism,35,60,2,0,2
Chhattisgarh,Durg,Short Stature/Dwarfism,6,15,2,1,3
Chhattisgarh,Durg,Short Stature/Dwarfism,15,35,7,7,14
Chhattisgarh,Durg,Short Stature/Dwarfism,35,60,3,4,7
Chhattisgarh,Durg,Short Stature/Dwarfism,60,80,1,0,1
Rajasthan,Dungarpur,Short Stature/Dwarfism,6,15,0,3,3
Rajasthan,Dungarpur,Short Stature/Dwarfism,15,35,2,11,13
Rajasthan,Dungarpur,Short Stature/Dwarfism,35,60,5,2,7
Jharkhand,Dumka,Short Stature/Dwarfism,0,6,1,1,2
Jharkhand,Dumka,Short Stature/Dwarfism,6,15,3,1,4
Jharkhand,Dumka,Short Stature/Dwarfism,15,35,8,9,17
Jharkhand,Dumka,Short Stature/Dwarfism,35,60,4,4,8
Jharkhand,Dumka,Short Stature/Dwarfism,60,80,3,0,3
Gujarat,Dohad,Short Stature/Dwarfism,0,6,0,1,1
Gujarat,Dohad,Short Stature/Dwarfism,6,15,5,14,19
Gujarat,Dohad,Short Stature/Dwarfism,15,35,7,11,18
Gujarat,Dohad,Short Stature/Dwarfism,35,60,4,3,7
Jammu And Kashmir,Doda,Short Stature/Dwarfism,6,15,1,0,1
Jammu And Kashmir,Doda,Short Stature/Dwarfism,15,35,2,8,10
Jammu And Kashmir,Doda,Short Stature/Dwarfism,35,60,3,3,6
Dadra Nagar Haveli And Daman And Diu,Diu,Short Stature/Dwarfism,35,60,1,0,1
Madhya Pradesh,Dindori,Short Stature/Dwarfism,0,6,0,1,1
Madhya Pradesh,Dindori,Short Stature/Dwarfism,6,15,0,2,2
Madhya Pradesh,Dindori,Short Stature/Dwarfism,15,35,0,5,5
Madhya Pradesh,Dindori,Short Stature/Dwarfism,35,60,1,2,3
Tamil Nadu,Dindigul,Short Stature/Dwarfism,6,15,8,4,12
Tamil Nadu,Dindigul,Short Stature/Dwarfism,15,35,7,18,25
Tamil Nadu,Dindigul,Short Stature/Dwarfism,35,60,7,13,20
Tamil Nadu,Dindigul,Short Stature/Dwarfism,60,80,0,1,1
Nagaland,Dimapur,Short Stature/Dwarfism,15,35,1,1,2
Assam,Dima Hasao,Short Stature/Dwarfism,6,15,1,1,2
Assam,Dima Hasao,Short Stature/Dwarfism,15,35,1,1,2
Assam,Dima Hasao,Short Stature/Dwarfism,35,60,4,1,5
Assam,Dibrugarh,Short Stature/Dwarfism,6,15,0,1,1
Assam,Dibrugarh,Short Stature/Dwarfism,15,35,3,8,11
Assam,Dibrugarh,Short Stature/Dwarfism,35,60,0,1,1
Assam,Dibrugarh,Short Stature/Dwarfism,60,80,1,0,1
Maharashtra,Dhule,Short Stature/Dwarfism,6,15,1,0,1
Maharashtra,Dhule,Short Stature/Dwarfism,15,35,6,0,6
Maharashtra,Dhule,Short Stature/Dwarfism,35,60,5,3,8
Maharashtra,Dhule,Short Stature/Dwarfism,60,80,0,1,1
Assam,Dhubri,Short Stature/Dwarfism,15,35,0,1,1
Assam,Dhubri,Short Stature/Dwarfism,35,60,2,0,2
Rajasthan,Dholpur,Short Stature/Dwarfism,15,35,6,5,11
Rajasthan,Dholpur,Short Stature/Dwarfism,35,60,2,4,6
Odisha,Dhenkanal,Short Stature/Dwarfism,6,15,5,3,8
Odisha,Dhenkanal,Short Stature/Dwarfism,15,35,14,16,30
Odisha,Dhenkanal,Short Stature/Dwarfism,35,60,7,7,14
Odisha,Dhenkanal,Short Stature/Dwarfism,60,80,0,1,1
Assam,Dhemaji,Short Stature/Dwarfism,6,15,1,2,3
Assam,Dhemaji,Short Stature/Dwarfism,15,35,2,3,5
Karnataka,Dharwad,Short Stature/Dwarfism,6,15,3,2,5
Karnataka,Dharwad,Short Stature/Dwarfism,15,35,13,15,28
Karnataka,Dharwad,Short Stature/Dwarfism,35,60,11,8,19
Karnataka,Dharwad,Short Stature/Dwarfism,60,80,1,1,2
Tamil Nadu,Dharmapuri,Short Stature/Dwarfism,0,6,0,1,1
Tamil Nadu,Dharmapuri,Short Stature/Dwarfism,6,15,5,2,7
Tamil Nadu,Dharmapuri,Short Stature/Dwarfism,15,35,7,10,17
Tamil Nadu,Dharmapuri,Short Stature/Dwarfism,35,60,3,13,16
Tamil Nadu,Dharmapuri,Short Stature/Dwarfism,60,80,2,1,3
Madhya Pradesh,Dhar,Short Stature/Dwarfism,6,15,1,1,2
Madhya Pradesh,Dhar,Short Stature/Dwarfism,15,35,5,8,13
Madhya Pradesh,Dhar,Short Stature/Dwarfism,35,60,3,6,9
Madhya Pradesh,Dhar,Short Stature/Dwarfism,60,80,0,1,1
Jharkhand,Dhanbad,Short Stature/Dwarfism,6,15,1,1,2
Jharkhand,Dhanbad,Short Stature/Dwarfism,15,35,2,5,7
Jharkhand,Dhanbad,Short Stature/Dwarfism,35,60,1,2,3
Chhattisgarh,Dhamtari,Short Stature/Dwarfism,6,15,0,1,1
Chhattisgarh,Dhamtari,Short Stature/Dwarfism,15,35,1,0,1
Chhattisgarh,Dhamtari,Short Stature/Dwarfism,35,60,2,1,3
Chhattisgarh,Dhamtari,Short Stature/Dwarfism,60,80,1,0,1
Madhya Pradesh,Dewas,Short Stature/Dwarfism,6,15,1,2,3
Madhya Pradesh,Dewas,Short Stature/Dwarfism,15,35,12,17,29
Madhya Pradesh,Dewas,Short Stature/Dwarfism,35,60,6,4,10
Madhya Pradesh,Dewas,Short Stature/Dwarfism,80,100,1,0,1
Gujarat,Devbhumi Dwarka,Short Stature/Dwarfism,15,35,1,0,1
Uttar Pradesh,Deoria,Short Stature/Dwarfism,6,15,3,3,6
Uttar Pradesh,Deoria,Short Stature/Dwarfism,15,35,13,10,23
Uttar Pradesh,Deoria,Short Stature/Dwarfism,35,60,11,5,16
Uttar Pradesh,Deoria,Short Stature/Dwarfism,60,80,1,0,1
Jharkhand,Deoghar,Short Stature/Dwarfism,15,35,0,2,2
Jharkhand,Deoghar,Short Stature/Dwarfism,35,60,1,0,1
Odisha,Deogarh,Short Stature/Dwarfism,6,15,3,2,5
Odisha,Deogarh,Short Stature/Dwarfism,15,35,6,7,13
Odisha,Deogarh,Short Stature/Dwarfism,35,60,0,1,1
Uttarakhand,Dehradun,Short Stature/Dwarfism,15,35,4,6,10
Uttarakhand,Dehradun,Short Stature/Dwarfism,35,60,3,4,7
Uttarakhand,Dehradun,Short Stature/Dwarfism,60,80,1,0,1
Karnataka,Davangere,Short Stature/Dwarfism,0,6,0,2,2
Karnataka,Davangere,Short Stature/Dwarfism,6,15,6,7,13
Karnataka,Davangere,Short Stature/Dwarfism,15,35,11,18,29
Karnataka,Davangere,Short Stature/Dwarfism,35,60,10,11,21
Karnataka,Davangere,Short Stature/Dwarfism,60,80,0,2,2
Rajasthan,Dausa,Short Stature/Dwarfism,6,15,1,1,2
Rajasthan,Dausa,Short Stature/Dwarfism,15,35,61,667,728
Rajasthan,Dausa,Short Stature/Dwarfism,35,60,47,407,454
Rajasthan,Dausa,Short Stature/Dwarfism,60,80,1,5,6
Madhya Pradesh,Datia,Short Stature/Dwarfism,6,15,4,1,5
Madhya Pradesh,Datia,Short Stature/Dwarfism,15,35,9,12,21
Madhya Pradesh,Datia,Short Stature/Dwarfism,35,60,4,6,10
Madhya Pradesh,Datia,Short Stature/Dwarfism,60,80,0,2,2
Madhya Pradesh,Datia,Short Stature/Dwarfism,80,100,1,0,1
Assam,Darrang,Short Stature/Dwarfism,15,35,2,2,4
Assam,Darrang,Short Stature/Dwarfism,35,60,3,2,5
Assam,Darrang,Short Stature/Dwarfism,60,80,1,0,1
Bihar,Darbhanga,Short Stature/Dwarfism,6,15,4,1,5
Bihar,Darbhanga,Short Stature/Dwarfism,15,35,5,5,10
Bihar,Darbhanga,Short Stature/Dwarfism,35,60,5,3,8
Bihar,Darbhanga,Short Stature/Dwarfism,60,80,0,1,1
Chhattisgarh,Dantewada,Short Stature/Dwarfism,6,15,1,0,1
Chhattisgarh,Dantewada,Short Stature/Dwarfism,15,35,5,1,6
Chhattisgarh,Dantewada,Short Stature/Dwarfism,35,60,1,0,1
Madhya Pradesh,Damoh,Short Stature/Dwarfism,6,15,4,1,5
Madhya Pradesh,Damoh,Short Stature/Dwarfism,15,35,15,11,26
Madhya Pradesh,Damoh,Short Stature/Dwarfism,35,60,14,10,24
Madhya Pradesh,Damoh,Short Stature/Dwarfism,60,80,4,1,5
Dadra Nagar Haveli And Daman And Diu,Daman,Short Stature/Dwarfism,15,35,0,1,1
Dadra Nagar Haveli And Daman And Diu,Daman,Short Stature/Dwarfism,35,60,0,1,1
Karnataka,Dakshina Kannada,Short Stature/Dwarfism,0,6,1,0,1
Karnataka,Dakshina Kannada,Short Stature/Dwarfism,6,15,2,4,6
Karnataka,Dakshina Kannada,Short Stature/Dwarfism,15,35,11,33,44
Karnataka,Dakshina Kannada,Short Stature/Dwarfism,35,60,23,21,44
Karnataka,Dakshina Kannada,Short Stature/Dwarfism,60,80,4,7,11
Dadra Nagar Haveli And Daman And Diu,Dadra And Nagar Haveli,Short Stature/Dwarfism,0,6,0,1,1
Dadra Nagar Haveli And Daman And Diu,Dadra And Nagar Haveli,Short Stature/Dwarfism,6,15,1,2,3
Dadra Nagar Haveli And Daman And Diu,Dadra And Nagar Haveli,Short Stature/Dwarfism,15,35,1,0,1
Odisha,Cuttack,Short Stature/Dwarfism,0,6,0,1,1
Odisha,Cuttack,Short Stature/Dwarfism,6,15,4,7,11
Odisha,Cuttack,Short Stature/Dwarfism,15,35,11,20,31
Odisha,Cuttack,Short Stature/Dwarfism,35,60,11,4,15
Odisha,Cuttack,Short Stature/Dwarfism,60,80,1,3,4
Tamil Nadu,Cuddalore,Short Stature/Dwarfism,0,6,1,1,2
Tamil Nadu,Cuddalore,Short Stature/Dwarfism,6,15,4,11,15
Tamil Nadu,Cuddalore,Short Stature/Dwarfism,15,35,25,29,54
Tamil Nadu,Cuddalore,Short Stature/Dwarfism,35,60,19,37,56
Tamil Nadu,Cuddalore,Short Stature/Dwarfism,60,80,5,3,8
Tamil Nadu,Cuddalore,Short Stature/Dwarfism,80,100,0,1,1
Tamil Nadu,Coimbatore,Short Stature/Dwarfism,6,15,0,3,3
Tamil Nadu,Coimbatore,Short Stature/Dwarfism,15,35,2,4,6
Tamil Nadu,Coimbatore,Short Stature/Dwarfism,35,60,2,3,5
Tamil Nadu,Coimbatore,Short Stature/Dwarfism,60,80,2,0,2
Rajasthan,Churu,Short Stature/Dwarfism,15,35,4,10,14
Rajasthan,Churu,Short Stature/Dwarfism,35,60,1,2,3
Manipur,Churachandpur,Short Stature/Dwarfism,6,15,1,0,1
Manipur,Churachandpur,Short Stature/Dwarfism,15,35,2,2,4
Manipur,Churachandpur,Short Stature/Dwarfism,35,60,1,1,2
Manipur,Churachandpur,Short Stature/Dwarfism,60,80,0,2,2
Rajasthan,Chittorgarh,Short Stature/Dwarfism,6,15,1,2,3
Rajasthan,Chittorgarh,Short Stature/Dwarfism,15,35,17,16,33
Rajasthan,Chittorgarh,Short Stature/Dwarfism,35,60,7,4,11
Rajasthan,Chittorgarh,Short Stature/Dwarfism,60,80,1,2,3
Andhra Pradesh,Chittoor,Short Stature/Dwarfism,35,60,1,0,1
Uttar Pradesh,Chitrakoot,Short Stature/Dwarfism,15,35,1,3,4
Uttar Pradesh,Chitrakoot,Short Stature/Dwarfism,35,60,4,1,5
Uttar Pradesh,Chitrakoot,Short Stature/Dwarfism,60,80,1,0,1
Karnataka,Chitradurga,Short Stature/Dwarfism,6,15,8,10,18
Karnataka,Chitradurga,Short Stature/Dwarfism,15,35,24,35,59
Karnataka,Chitradurga,Short Stature/Dwarfism,35,60,19,19,38
Karnataka,Chitradurga,Short Stature/Dwarfism,60,80,2,0,2
Assam,Chirang,Short Stature/Dwarfism,15,35,5,12,17
Assam,Chirang,Short Stature/Dwarfism,35,60,0,1,1
Assam,Chirang,Short Stature/Dwarfism,60,80,1,0,1
Karnataka,Chikkamagaluru,Short Stature/Dwarfism,0,6,0,1,1
Karnataka,Chikkamagaluru,Short Stature/Dwarfism,6,15,1,3,4
Karnataka,Chikkamagaluru,Short Stature/Dwarfism,15,35,11,18,29
Karnataka,Chikkamagaluru,Short Stature/Dwarfism,35,60,14,15,29
Karnataka,Chikkamagaluru,Short Stature/Dwarfism,60,80,0,5,5
Karnataka,Chikkaballapura,Short Stature/Dwarfism,0,6,1,0,1
Karnataka,Chikkaballapura,Short Stature/Dwarfism,6,15,3,3,6
Karnataka,Chikkaballapura,Short Stature/Dwarfism,15,35,13,24,37
Karnataka,Chikkaballapura,Short Stature/Dwarfism,35,60,16,15,31
Karnataka,Chikkaballapura,Short Stature/Dwarfism,60,80,2,1,3
Gujarat,Chhotaudepur,Short Stature/Dwarfism,6,15,0,3,3
Gujarat,Chhotaudepur,Short Stature/Dwarfism,15,35,2,1,3
Madhya Pradesh,Chhindwara,Short Stature/Dwarfism,6,15,1,3,4
Madhya Pradesh,Chhindwara,Short Stature/Dwarfism,15,35,10,24,34
Madhya Pradesh,Chhindwara,Short Stature/Dwarfism,35,60,13,11,24
Madhya Pradesh,Chhindwara,Short Stature/Dwarfism,60,80,1,1,2
Madhya Pradesh,Chhatarpur,Short Stature/Dwarfism,6,15,3,1,4
Madhya Pradesh,Chhatarpur,Short Stature/Dwarfism,15,35,0,9,9
Madhya Pradesh,Chhatarpur,Short Stature/Dwarfism,35,60,5,2,7
Tamil Nadu,Chennai,Short Stature/Dwarfism,6,15,5,3,8
Tamil Nadu,Chennai,Short Stature/Dwarfism,15,35,10,14,24
Tamil Nadu,Chennai,Short Stature/Dwarfism,35,60,14,8,22
Tamil Nadu,Chennai,Short Stature/Dwarfism,60,80,1,4,5
Tamil Nadu,Chengalpattu,Short Stature/Dwarfism,6,15,0,3,3
Tamil Nadu,Chengalpattu,Short Stature/Dwarfism,15,35,6,7,13
Tamil Nadu,Chengalpattu,Short Stature/Dwarfism,35,60,6,4,10
Tamil Nadu,Chengalpattu,Short Stature/Dwarfism,60,80,1,0,1
Jharkhand,Chatra,Short Stature/Dwarfism,15,35,0,1,1
Jharkhand,Chatra,Short Stature/Dwarfism,35,60,1,0,1
Haryana,Charki Dadri,Short Stature/Dwarfism,15,35,0,1,1
Assam,Charaideo,Short Stature/Dwarfism,0,6,0,1,1
Assam,Charaideo,Short Stature/Dwarfism,6,15,0,2,2
Assam,Charaideo,Short Stature/Dwarfism,15,35,1,2,3
Assam,Charaideo,Short Stature/Dwarfism,35,60,1,5,6
Maharashtra,Chandrapur,Short Stature/Dwarfism,15,35,13,19,32
Maharashtra,Chandrapur,Short Stature/Dwarfism,35,60,9,8,17
Maharashtra,Chandrapur,Short Stature/Dwarfism,60,80,1,0,1
Chandigarh,Chandigarh,Short Stature/Dwarfism,6,15,0,3,3
Chandigarh,Chandigarh,Short Stature/Dwarfism,15,35,4,2,6
Chandigarh,Chandigarh,Short Stature/Dwarfism,35,60,0,1,1
Chandigarh,Chandigarh,Short Stature/Dwarfism,60,80,1,0,1
Manipur,Chandel,Short Stature/Dwarfism,35,60,0,1,1
Uttar Pradesh,Chandauli,Short Stature/Dwarfism,6,15,2,0,2
Uttar Pradesh,Chandauli,Short Stature/Dwarfism,15,35,11,6,17
Uttar Pradesh,Chandauli,Short Stature/Dwarfism,35,60,4,5,9
Uttarakhand,Champawat,Short Stature/Dwarfism,15,35,4,4,8
Uttarakhand,Champawat,Short Stature/Dwarfism,35,60,4,0,4
Uttarakhand,Chamoli,Short Stature/Dwarfism,6,15,0,1,1
Uttarakhand,Chamoli,Short Stature/Dwarfism,15,35,3,2,5
Uttarakhand,Chamoli,Short Stature/Dwarfism,35,60,5,1,6
Uttarakhand,Chamoli,Short Stature/Dwarfism,60,80,2,0,2
Himachal Pradesh,Chamba,Short Stature/Dwarfism,6,15,0,2,2
Himachal Pradesh,Chamba,Short Stature/Dwarfism,15,35,2,1,3
Karnataka,Chamarajanagara,Short Stature/Dwarfism,6,15,4,4,8
Karnataka,Chamarajanagara,Short Stature/Dwarfism,15,35,20,31,51
Karnataka,Chamarajanagara,Short Stature/Dwarfism,35,60,5,21,26
Karnataka,Chamarajanagara,Short Stature/Dwarfism,60,80,1,1,2
Delhi,Central,Short Stature/Dwarfism,6,15,0,1,1
Assam,Cachar,Short Stature/Dwarfism,6,15,0,1,1
Assam,Cachar,Short Stature/Dwarfism,15,35,8,12,20
Assam,Cachar,Short Stature/Dwarfism,35,60,6,7,13
Bihar,Buxar,Short Stature/Dwarfism,6,15,1,1,2
Bihar,Buxar,Short Stature/Dwarfism,15,35,5,7,12
Bihar,Buxar,Short Stature/Dwarfism,35,60,2,1,3
Bihar,Buxar,Short Stature/Dwarfism,60,80,2,0,2
Bihar,Buxar,Short Stature/Dwarfism,80,100,1,0,1
Madhya Pradesh,Burhanpur,Short Stature/Dwarfism,6,15,1,2,3
Madhya Pradesh,Burhanpur,Short Stature/Dwarfism,15,35,12,9,21
Madhya Pradesh,Burhanpur,Short Stature/Dwarfism,35,60,1,3,4
Rajasthan,Bundi,Short Stature/Dwarfism,6,15,3,2,5
Rajasthan,Bundi,Short Stature/Dwarfism,15,35,5,24,29
Rajasthan,Bundi,Short Stature/Dwarfism,35,60,1,13,14
Rajasthan,Bundi,Short Stature/Dwarfism,60,80,0,1,1
Maharashtra,Buldhana,Short Stature/Dwarfism,0,6,1,1,2
Maharashtra,Buldhana,Short Stature/Dwarfism,6,15,1,10,11
Maharashtra,Buldhana,Short Stature/Dwarfism,15,35,20,27,47
Maharashtra,Buldhana,Short Stature/Dwarfism,35,60,9,14,23
Maharashtra,Buldhana,Short Stature/Dwarfism,60,80,1,2,3
Uttar Pradesh,Bulandshahr,Short Stature/Dwarfism,15,35,6,5,11
Uttar Pradesh,Bulandshahr,Short Stature/Dwarfism,35,60,7,2,9
Uttar Pradesh,Bulandshahr,Short Stature/Dwarfism,60,80,2,0,2
Jammu And Kashmir,Budgam,Short Stature/Dwarfism,0,6,2,0,2
Jammu And Kashmir,Budgam,Short Stature/Dwarfism,6,15,4,6,10
Jammu And Kashmir,Budgam,Short Stature/Dwarfism,15,35,4,14,18
Jammu And Kashmir,Budgam,Short Stature/Dwarfism,35,60,3,11,14
Jammu And Kashmir,Budgam,Short Stature/Dwarfism,60,80,1,1,2
Uttar Pradesh,Budaun,Short Stature/Dwarfism,6,15,1,1,2
Uttar Pradesh,Budaun,Short Stature/Dwarfism,15,35,11,4,15
Uttar Pradesh,Budaun,Short Stature/Dwarfism,35,60,5,1,6
Uttar Pradesh,Budaun,Short Stature/Dwarfism,60,80,1,0,1
Odisha,Boudh,Short Stature/Dwarfism,6,15,0,6,6
Odisha,Boudh,Short Stature/Dwarfism,15,35,1,4,5
Odisha,Boudh,Short Stature/Dwarfism,35,60,2,1,3
Gujarat,Botad,Short Stature/Dwarfism,15,35,1,1,2
Assam,Bongaigaon,Short Stature/Dwarfism,6,15,1,3,4
Assam,Bongaigaon,Short Stature/Dwarfism,15,35,10,6,16
Assam,Bongaigaon,Short Stature/Dwarfism,35,60,2,4,6
Jharkhand,Bokaro,Short Stature/Dwarfism,6,15,2,4,6
Jharkhand,Bokaro,Short Stature/Dwarfism,15,35,14,9,23
Jharkhand,Bokaro,Short Stature/Dwarfism,35,60,7,4,11
Jharkhand,Bokaro,Short Stature/Dwarfism,60,80,1,0,1
Manipur,Bishnupur,Short Stature/Dwarfism,6,15,0,1,1
Manipur,Bishnupur,Short Stature/Dwarfism,15,35,0,3,3
Manipur,Bishnupur,Short Stature/Dwarfism,35,60,1,1,2
Chhattisgarh,Bilaspur,Short Stature/Dwarfism,6,15,2,3,5
Chhattisgarh,Bilaspur,Short Stature/Dwarfism,15,35,13,18,31
Chhattisgarh,Bilaspur,Short Stature/Dwarfism,35,60,7,6,13
Chhattisgarh,Bilaspur,Short Stature/Dwarfism,60,80,3,0,3
Himachal Pradesh,Bilaspur,Short Stature/Dwarfism,35,60,1,1,2
Himachal Pradesh,Bilaspur,Short Stature/Dwarfism,60,80,0,1,1
Rajasthan,Bikaner,Short Stature/Dwarfism,6,15,8,3,11
Rajasthan,Bikaner,Short Stature/Dwarfism,15,35,11,15,26
Rajasthan,Bikaner,Short Stature/Dwarfism,35,60,3,7,10
Uttar Pradesh,Bijnor,Short Stature/Dwarfism,6,15,1,2,3
Uttar Pradesh,Bijnor,Short Stature/Dwarfism,15,35,9,7,16
Uttar Pradesh,Bijnor,Short Stature/Dwarfism,35,60,3,3,6
Chhattisgarh,Bijapur,Short Stature/Dwarfism,6,15,4,1,5
Chhattisgarh,Bijapur,Short Stature/Dwarfism,15,35,3,7,10
Chhattisgarh,Bijapur,Short Stature/Dwarfism,35,60,1,1,2
Chhattisgarh,Bijapur,Short Stature/Dwarfism,60,80,1,0,1
Karnataka,Bidar,Short Stature/Dwarfism,0,6,0,1,1
Karnataka,Bidar,Short Stature/Dwarfism,6,15,2,5,7
Karnataka,Bidar,Short Stature/Dwarfism,15,35,14,30,44
Karnataka,Bidar,Short Stature/Dwarfism,35,60,15,10,25
Karnataka,Bidar,Short Stature/Dwarfism,60,80,3,2,5
Karnataka,Bidar,Short Stature/Dwarfism,80,100,3,0,3
Madhya Pradesh,Bhopal,Short Stature/Dwarfism,6,15,3,2,5
Madhya Pradesh,Bhopal,Short Stature/Dwarfism,15,35,10,3,13
Madhya Pradesh,Bhopal,Short Stature/Dwarfism,35,60,4,7,11
Bihar,Bhojpur,Short Stature/Dwarfism,6,15,1,1,2
Bihar,Bhojpur,Short Stature/Dwarfism,15,35,8,4,12
Bihar,Bhojpur,Short Stature/Dwarfism,35,60,1,3,4
Bihar,Bhojpur,Short Stature/Dwarfism,60,80,2,0,2
Haryana,Bhiwani,Short Stature/Dwarfism,15,35,4,8,12
Haryana,Bhiwani,Short Stature/Dwarfism,35,60,2,0,2
Madhya Pradesh,Bhind,Short Stature/Dwarfism,6,15,2,0,2
Madhya Pradesh,Bhind,Short Stature/Dwarfism,15,35,6,5,11
Rajasthan,Bhilwara,Short Stature/Dwarfism,6,15,2,5,7
Rajasthan,Bhilwara,Short Stature/Dwarfism,15,35,22,33,55
Rajasthan,Bhilwara,Short Stature/Dwarfism,35,60,9,14,23
Rajasthan,Bhilwara,Short Stature/Dwarfism,60,80,5,8,13
Rajasthan,Bhilwara,Short Stature/Dwarfism,80,100,0,2,2
Gujarat,Bhavnagar,Short Stature/Dwarfism,0,6,1,0,1
Gujarat,Bhavnagar,Short Stature/Dwarfism,6,15,4,3,7
Gujarat,Bhavnagar,Short Stature/Dwarfism,15,35,7,11,18
Gujarat,Bhavnagar,Short Stature/Dwarfism,35,60,1,3,4
Gujarat,Bharuch,Short Stature/Dwarfism,6,15,0,6,6
Gujarat,Bharuch,Short Stature/Dwarfism,15,35,6,2,8
Gujarat,Bharuch,Short Stature/Dwarfism,35,60,0,2,2
Rajasthan,Bharatpur,Short Stature/Dwarfism,6,15,3,1,4
Rajasthan,Bharatpur,Short Stature/Dwarfism,15,35,12,21,33
Rajasthan,Bharatpur,Short Stature/Dwarfism,35,60,5,6,11
Rajasthan,Bharatpur,Short Stature/Dwarfism,60,80,1,0,1
Maharashtra,Bhandara,Short Stature/Dwarfism,6,15,3,3,6
Maharashtra,Bhandara,Short Stature/Dwarfism,15,35,11,14,25
Maharashtra,Bhandara,Short Stature/Dwarfism,35,60,5,5,10
Maharashtra,Bhandara,Short Stature/Dwarfism,80,100,1,0,1
Bihar,Bhagalpur,Short Stature/Dwarfism,0,6,2,0,2
Bihar,Bhagalpur,Short Stature/Dwarfism,6,15,9,9,18
Bihar,Bhagalpur,Short Stature/Dwarfism,15,35,14,12,26
Bihar,Bhagalpur,Short Stature/Dwarfism,35,60,9,1,10
Odisha,Bhadrak,Short Stature/Dwarfism,6,15,2,7,9
Odisha,Bhadrak,Short Stature/Dwarfism,15,35,10,23,33
Odisha,Bhadrak,Short Stature/Dwarfism,35,60,7,6,13
Odisha,Bhadrak,Short Stature/Dwarfism,60,80,2,0,2
Uttar Pradesh,Bhadohi,Short Stature/Dwarfism,0,6,0,1,1
Uttar Pradesh,Bhadohi,Short Stature/Dwarfism,6,15,2,1,3
Uttar Pradesh,Bhadohi,Short Stature/Dwarfism,15,35,9,11,20
Uttar Pradesh,Bhadohi,Short Stature/Dwarfism,35,60,1,2,3
Madhya Pradesh,Betul,Short Stature/Dwarfism,6,15,3,4,7
Madhya Pradesh,Betul,Short Stature/Dwarfism,15,35,13,23,36
Madhya Pradesh,Betul,Short Stature/Dwarfism,35,60,4,4,8
Karnataka,Bengaluru Urban,Short Stature/Dwarfism,0,6,1,0,1
Karnataka,Bengaluru Urban,Short Stature/Dwarfism,6,15,2,4,6
Karnataka,Bengaluru Urban,Short Stature/Dwarfism,15,35,28,32,60
Karnataka,Bengaluru Urban,Short Stature/Dwarfism,35,60,25,29,54
Karnataka,Bengaluru Urban,Short Stature/Dwarfism,60,80,2,1,3
Karnataka,Bengaluru Rural,Short Stature/Dwarfism,0,6,0,1,1
Karnataka,Bengaluru Rural,Short Stature/Dwarfism,15,35,5,10,15
Karnataka,Bengaluru Rural,Short Stature/Dwarfism,35,60,5,8,13
Karnataka,Bengaluru Rural,Short Stature/Dwarfism,60,80,2,0,2
Chhattisgarh,Bemetara,Short Stature/Dwarfism,6,15,0,1,1
Chhattisgarh,Bemetara,Short Stature/Dwarfism,15,35,0,7,7
Chhattisgarh,Bemetara,Short Stature/Dwarfism,35,60,0,2,2
Karnataka,Belagavi,Short Stature/Dwarfism,0,6,1,1,2
Karnataka,Belagavi,Short Stature/Dwarfism,6,15,16,15,31
Karnataka,Belagavi,Short Stature/Dwarfism,15,35,28,40,68
Karnataka,Belagavi,Short Stature/Dwarfism,35,60,32,30,62
Karnataka,Belagavi,Short Stature/Dwarfism,60,80,5,4,9
Bihar,Begusarai,Short Stature/Dwarfism,0,6,5,1,6
Bihar,Begusarai,Short Stature/Dwarfism,6,15,11,15,26
Bihar,Begusarai,Short Stature/Dwarfism,15,35,13,13,26
Bihar,Begusarai,Short Stature/Dwarfism,35,60,3,2,5
Maharashtra,Beed,Short Stature/Dwarfism,6,15,1,2,3
Maharashtra,Beed,Short Stature/Dwarfism,15,35,12,21,33
Maharashtra,Beed,Short Stature/Dwarfism,35,60,10,8,18
Maharashtra,Beed,Short Stature/Dwarfism,60,80,1,2,3
Punjab,Bathinda,Short Stature/Dwarfism,6,15,0,1,1
Punjab,Bathinda,Short Stature/Dwarfism,15,35,3,2,5
Uttar Pradesh,Basti,Short Stature/Dwarfism,6,15,2,1,3
Uttar Pradesh,Basti,Short Stature/Dwarfism,15,35,9,7,16
Uttar Pradesh,Basti,Short Stature/Dwarfism,35,60,3,2,5
Uttar Pradesh,Basti,Short Stature/Dwarfism,60,80,1,0,1
Chhattisgarh,Bastar,Short Stature/Dwarfism,6,15,6,5,11
Chhattisgarh,Bastar,Short Stature/Dwarfism,15,35,11,11,22
Chhattisgarh,Bastar,Short Stature/Dwarfism,35,60,0,1,1
Madhya Pradesh,Barwani,Short Stature/Dwarfism,6,15,1,1,2
Madhya Pradesh,Barwani,Short Stature/Dwarfism,15,35,0,8,8
Madhya Pradesh,Barwani,Short Stature/Dwarfism,35,60,3,3,6
Madhya Pradesh,Barwani,Short Stature/Dwarfism,60,80,1,0,1
Assam,Barpeta,Short Stature/Dwarfism,0,6,1,2,3
Assam,Barpeta,Short Stature/Dwarfism,6,15,5,5,10
Assam,Barpeta,Short Stature/Dwarfism,15,35,7,24,31
Assam,Barpeta,Short Stature/Dwarfism,35,60,8,7,15
Punjab,Barnala,Short Stature/Dwarfism,15,35,3,7,10
Punjab,Barnala,Short Stature/Dwarfism,35,60,0,2,2
Rajasthan,Barmer,Short Stature/Dwarfism,6,15,3,3,6
Rajasthan,Barmer,Short Stature/Dwarfism,15,35,10,20,30
Rajasthan,Barmer,Short Stature/Dwarfism,35,60,4,6,10
Odisha,Bargarh,Short Stature/Dwarfism,6,15,3,0,3
Odisha,Bargarh,Short Stature/Dwarfism,15,35,3,6,9
Odisha,Bargarh,Short Stature/Dwarfism,35,60,4,2,6
Odisha,Bargarh,Short Stature/Dwarfism,60,80,1,0,1
Uttar Pradesh,Bareilly,Short Stature/Dwarfism,6,15,0,1,1
Uttar Pradesh,Bareilly,Short Stature/Dwarfism,15,35,10,5,15
Uttar Pradesh,Bareilly,Short Stature/Dwarfism,35,60,3,3,6
Uttar Pradesh,Bareilly,Short Stature/Dwarfism,60,80,1,0,1
Rajasthan,Baran,Short Stature/Dwarfism,6,15,2,0,2
Rajasthan,Baran,Short Stature/Dwarfism,15,35,3,5,8
Jammu And Kashmir,Baramulla,Short Stature/Dwarfism,0,6,1,0,1
Jammu And Kashmir,Baramulla,Short Stature/Dwarfism,6,15,7,4,11
Jammu And Kashmir,Baramulla,Short Stature/Dwarfism,15,35,12,41,53
Jammu And Kashmir,Baramulla,Short Stature/Dwarfism,35,60,12,15,27
Jammu And Kashmir,Baramulla,Short Stature/Dwarfism,60,80,2,0,2
Uttar Pradesh,Barabanki,Short Stature/Dwarfism,6,15,1,2,3
Uttar Pradesh,Barabanki,Short Stature/Dwarfism,15,35,15,13,28
Uttar Pradesh,Barabanki,Short Stature/Dwarfism,35,60,9,1,10
Rajasthan,Banswara,Short Stature/Dwarfism,6,15,0,3,3
Rajasthan,Banswara,Short Stature/Dwarfism,15,35,15,53,68
Rajasthan,Banswara,Short Stature/Dwarfism,35,60,11,37,48
Rajasthan,Banswara,Short Stature/Dwarfism,60,80,1,0,1
Bihar,Banka,Short Stature/Dwarfism,0,6,1,0,1
Bihar,Banka,Short Stature/Dwarfism,6,15,3,4,7
Bihar,Banka,Short Stature/Dwarfism,15,35,12,2,14
Bihar,Banka,Short Stature/Dwarfism,35,60,6,2,8
Bihar,Banka,Short Stature/Dwarfism,60,80,1,0,1
Jammu And Kashmir,Bandipora,Short Stature/Dwarfism,0,6,3,3,6
Jammu And Kashmir,Bandipora,Short Stature/Dwarfism,6,15,2,4,6
Jammu And Kashmir,Bandipora,Short Stature/Dwarfism,15,35,13,17,30
Jammu And Kashmir,Bandipora,Short Stature/Dwarfism,35,60,9,5,14
Jammu And Kashmir,Bandipora,Short Stature/Dwarfism,60,80,3,1,4
Uttar Pradesh,Banda,Short Stature/Dwarfism,15,35,3,0,3
Uttar Pradesh,Banda,Short Stature/Dwarfism,35,60,4,0,4
Uttar Pradesh,Banda,Short Stature/Dwarfism,60,80,1,0,1
Gujarat,Banas Kantha,Short Stature/Dwarfism,6,15,1,1,2
Gujarat,Banas Kantha,Short Stature/Dwarfism,15,35,0,1,1
Gujarat,Banas Kantha,Short Stature/Dwarfism,60,80,1,0,1
Chhattisgarh,Balrampur,Short Stature/Dwarfism,6,15,3,1,4
Chhattisgarh,Balrampur,Short Stature/Dwarfism,15,35,7,10,17
Chhattisgarh,Balrampur,Short Stature/Dwarfism,35,60,4,3,7
Uttar Pradesh,Balrampur,Short Stature/Dwarfism,6,15,2,2,4
Uttar Pradesh,Balrampur,Short Stature/Dwarfism,15,35,8,8,16
Uttar Pradesh,Balrampur,Short Stature/Dwarfism,35,60,4,4,8
Uttar Pradesh,Balrampur,Short Stature/Dwarfism,60,80,1,0,1
Chhattisgarh,Baloda Bazar,Short Stature/Dwarfism,0,6,1,0,1
Chhattisgarh,Baloda Bazar,Short Stature/Dwarfism,6,15,0,5,5
Chhattisgarh,Baloda Bazar,Short Stature/Dwarfism,15,35,12,28,40
Chhattisgarh,Baloda Bazar,Short Stature/Dwarfism,35,60,6,9,15
Chhattisgarh,Baloda Bazar,Short Stature/Dwarfism,60,80,0,1,1
Chhattisgarh,Baloda Bazar,Short Stature/Dwarfism,80,100,0,1,1
Chhattisgarh,Balod,Short Stature/Dwarfism,6,15,1,0,1
Chhattisgarh,Balod,Short Stature/Dwarfism,15,35,2,3,5
Chhattisgarh,Balod,Short Stature/Dwarfism,35,60,0,3,3
Uttar Pradesh,Ballia,Short Stature/Dwarfism,6,15,1,2,3
Uttar Pradesh,Ballia,Short Stature/Dwarfism,15,35,3,5,8
Uttar Pradesh,Ballia,Short Stature/Dwarfism,35,60,3,2,5
Karnataka,Ballari,Short Stature/Dwarfism,6,15,7,8,15
Karnataka,Ballari,Short Stature/Dwarfism,15,35,25,38,63
Karnataka,Ballari,Short Stature/Dwarfism,35,60,16,7,23
Karnataka,Ballari,Short Stature/Dwarfism,60,80,1,1,2
Odisha,Baleshwar,Short Stature/Dwarfism,6,15,2,7,9
Odisha,Baleshwar,Short Stature/Dwarfism,15,35,10,5,15
Odisha,Baleshwar,Short Stature/Dwarfism,35,60,8,5,13
Odisha,Baleshwar,Short Stature/Dwarfism,60,80,1,0,1
Odisha,Balangir,Short Stature/Dwarfism,6,15,1,7,8
Odisha,Balangir,Short Stature/Dwarfism,15,35,17,15,32
Odisha,Balangir,Short Stature/Dwarfism,35,60,2,6,8
Odisha,Balangir,Short Stature/Dwarfism,60,80,1,0,1
Madhya Pradesh,Balaghat,Short Stature/Dwarfism,15,35,1,3,4
Assam,Baksa,Short Stature/Dwarfism,6,15,0,1,1
Assam,Baksa,Short Stature/Dwarfism,15,35,3,8,11
Assam,Baksa,Short Stature/Dwarfism,35,60,7,2,9
Assam,Bajali,Short Stature/Dwarfism,15,35,1,0,1
Assam,Bajali,Short Stature/Dwarfism,35,60,1,1,2
Uttar Pradesh,Bahraich,Short Stature/Dwarfism,6,15,0,3,3
Uttar Pradesh,Bahraich,Short Stature/Dwarfism,15,35,10,11,21
Uttar Pradesh,Bahraich,Short Stature/Dwarfism,35,60,11,7,18
Uttar Pradesh,Bahraich,Short Stature/Dwarfism,60,80,1,0,1
Uttar Pradesh,Baghpat,Short Stature/Dwarfism,15,35,1,1,2
Uttar Pradesh,Baghpat,Short Stature/Dwarfism,35,60,2,0,2
Uttar Pradesh,Baghpat,Short Stature/Dwarfism,60,80,1,0,1
Uttarakhand,Bageshwar,Short Stature/Dwarfism,15,35,3,0,3
Uttarakhand,Bageshwar,Short Stature/Dwarfism,35,60,0,1,1
Karnataka,Bagalkote,Short Stature/Dwarfism,6,15,3,3,6
Karnataka,Bagalkote,Short Stature/Dwarfism,15,35,11,32,43
Karnataka,Bagalkote,Short Stature/Dwarfism,35,60,13,9,22
Karnataka,Bagalkote,Short Stature/Dwarfism,60,80,1,0,1
Uttar Pradesh,Azamgarh,Short Stature/Dwarfism,15,35,1,3,4
Uttar Pradesh,Azamgarh,Short Stature/Dwarfism,35,60,1,1,2
Uttar Pradesh,Ayodhya,Short Stature/Dwarfism,15,35,4,3,7
Uttar Pradesh,Ayodhya,Short Stature/Dwarfism,35,60,2,0,2
Uttar Pradesh,Ayodhya,Short Stature/Dwarfism,60,80,1,0,1
Bihar,Aurangabad,Short Stature/Dwarfism,6,15,1,0,1
Bihar,Aurangabad,Short Stature/Dwarfism,15,35,2,3,5
Bihar,Aurangabad,Short Stature/Dwarfism,35,60,4,2,6
Maharashtra,Aurangabad,Short Stature/Dwarfism,6,15,3,3,6
Maharashtra,Aurangabad,Short Stature/Dwarfism,15,35,10,18,28
Maharashtra,Aurangabad,Short Stature/Dwarfism,35,60,6,9,15
Maharashtra,Aurangabad,Short Stature/Dwarfism,60,80,1,0,1
Uttar Pradesh,Auraiya,Short Stature/Dwarfism,6,15,0,1,1
Uttar Pradesh,Auraiya,Short Stature/Dwarfism,15,35,9,4,13
Uttar Pradesh,Auraiya,Short Stature/Dwarfism,35,60,6,2,8
Uttar Pradesh,Auraiya,Short Stature/Dwarfism,60,80,1,0,1
Madhya Pradesh,Ashoknagar,Short Stature/Dwarfism,15,35,3,3,6
Madhya Pradesh,Ashoknagar,Short Stature/Dwarfism,35,60,1,2,3
Gujarat,Arvalli,Short Stature/Dwarfism,6,15,1,1,2
Gujarat,Arvalli,Short Stature/Dwarfism,15,35,2,1,3
Gujarat,Arvalli,Short Stature/Dwarfism,60,80,1,0,1
Tamil Nadu,Ariyalur,Short Stature/Dwarfism,0,6,0,1,1
Tamil Nadu,Ariyalur,Short Stature/Dwarfism,6,15,7,6,13
Tamil Nadu,Ariyalur,Short Stature/Dwarfism,15,35,17,29,46
Tamil Nadu,Ariyalur,Short Stature/Dwarfism,35,60,9,20,29
Tamil Nadu,Ariyalur,Short Stature/Dwarfism,60,80,2,1,3
Bihar,Araria,Short Stature/Dwarfism,0,6,0,1,1
Bihar,Araria,Short Stature/Dwarfism,6,15,1,2,3
Bihar,Araria,Short Stature/Dwarfism,15,35,5,3,8
Bihar,Araria,Short Stature/Dwarfism,35,60,4,0,4
Bihar,Araria,Short Stature/Dwarfism,60,80,1,0,1
Madhya Pradesh,Anuppur,Short Stature/Dwarfism,6,15,1,1,2
Madhya Pradesh,Anuppur,Short Stature/Dwarfism,15,35,3,4,7
Odisha,Anugul,Short Stature/Dwarfism,0,6,0,2,2
Odisha,Anugul,Short Stature/Dwarfism,6,15,0,2,2
Odisha,Anugul,Short Stature/Dwarfism,15,35,6,10,16
Odisha,Anugul,Short Stature/Dwarfism,35,60,4,7,11
Odisha,Anugul,Short Stature/Dwarfism,60,80,1,0,1
Jammu And Kashmir,Anantnag,Short Stature/Dwarfism,0,6,0,1,1
Jammu And Kashmir,Anantnag,Short Stature/Dwarfism,6,15,2,4,6
Jammu And Kashmir,Anantnag,Short Stature/Dwarfism,15,35,10,13,23
Jammu And Kashmir,Anantnag,Short Stature/Dwarfism,35,60,7,11,18
Jammu And Kashmir,Anantnag,Short Stature/Dwarfism,60,80,1,0,1
Andhra Pradesh,Anantapur,Short Stature/Dwarfism,15,35,1,0,1
Andhra Pradesh,Anantapur,Short Stature/Dwarfism,35,60,1,0,1
Gujarat,Anand,Short Stature/Dwarfism,6,15,4,5,9
Gujarat,Anand,Short Stature/Dwarfism,15,35,2,11,13
Gujarat,Anand,Short Stature/Dwarfism,35,60,2,2,4
Uttar Pradesh,Amroha,Short Stature/Dwarfism,15,35,2,4,6
Uttar Pradesh,Amroha,Short Stature/Dwarfism,35,60,6,1,7
Punjab,Amritsar,Short Stature/Dwarfism,6,15,1,0,1
Punjab,Amritsar,Short Stature/Dwarfism,15,35,4,5,9
Punjab,Amritsar,Short Stature/Dwarfism,35,60,2,3,5
Punjab,Amritsar,Short Stature/Dwarfism,60,80,1,0,1
Gujarat,Amreli,Short Stature/Dwarfism,6,15,6,9,15
Gujarat,Amreli,Short Stature/Dwarfism,15,35,11,5,16
Gujarat,Amreli,Short Stature/Dwarfism,35,60,4,3,7
Maharashtra,Amravati,Short Stature/Dwarfism,15,35,13,16,29
Maharashtra,Amravati,Short Stature/Dwarfism,35,60,12,17,29
Maharashtra,Amravati,Short Stature/Dwarfism,60,80,2,1,3
Uttar Pradesh,Amethi,Short Stature/Dwarfism,15,35,2,2,4
Uttar Pradesh,Ambedkar Nagar,Short Stature/Dwarfism,6,15,0,2,2
Uttar Pradesh,Ambedkar Nagar,Short Stature/Dwarfism,15,35,8,7,15
Uttar Pradesh,Ambedkar Nagar,Short Stature/Dwarfism,35,60,3,2,5
Haryana,Ambala,Short Stature/Dwarfism,15,35,1,0,1
Haryana,Ambala,Short Stature/Dwarfism,35,60,1,0,1
Rajasthan,Alwar,Short Stature/Dwarfism,6,15,3,0,3
Rajasthan,Alwar,Short Stature/Dwarfism,15,35,23,43,66
Rajasthan,Alwar,Short Stature/Dwarfism,35,60,7,14,21
Rajasthan,Alwar,Short Stature/Dwarfism,60,80,2,4,6
Uttarakhand,Almora,Short Stature/Dwarfism,15,35,0,2,2
Uttarakhand,Almora,Short Stature/Dwarfism,35,60,5,1,6
Madhya Pradesh,Alirajpur,Short Stature/Dwarfism,6,15,1,0,1
Madhya Pradesh,Alirajpur,Short Stature/Dwarfism,15,35,0,2,2
Madhya Pradesh,Alirajpur,Short Stature/Dwarfism,60,80,1,0,1
Uttar Pradesh,Aligarh,Short Stature/Dwarfism,6,15,1,0,1
Uttar Pradesh,Aligarh,Short Stature/Dwarfism,15,35,10,4,14
Uttar Pradesh,Aligarh,Short Stature/Dwarfism,35,60,4,0,4
Uttar Pradesh,Aligarh,Short Stature/Dwarfism,60,80,1,0,1
Uttar Pradesh,Aligarh,Short Stature/Dwarfism,80,100,1,0,1
Kerala,Alappuzha,Short Stature/Dwarfism,6,15,1,1,2
Kerala,Alappuzha,Short Stature/Dwarfism,15,35,4,3,7
Kerala,Alappuzha,Short Stature/Dwarfism,35,60,5,5,10
Kerala,Alappuzha,Short Stature/Dwarfism,60,80,1,0,1
Maharashtra,Akola,Short Stature/Dwarfism,6,15,5,0,5
Maharashtra,Akola,Short Stature/Dwarfism,15,35,23,31,54
Maharashtra,Akola,Short Stature/Dwarfism,35,60,14,23,37
Maharashtra,Akola,Short Stature/Dwarfism,60,80,1,2,3
Rajasthan,Ajmer,Short Stature/Dwarfism,0,6,0,1,1
Rajasthan,Ajmer,Short Stature/Dwarfism,6,15,1,1,2
Rajasthan,Ajmer,Short Stature/Dwarfism,15,35,5,16,21
Rajasthan,Ajmer,Short Stature/Dwarfism,35,60,2,6,8
Rajasthan,Ajmer,Short Stature/Dwarfism,60,80,0,2,2
Mizoram,Aizawl,Short Stature/Dwarfism,6,15,0,2,2
Mizoram,Aizawl,Short Stature/Dwarfism,15,35,3,3,6
Mizoram,Aizawl,Short Stature/Dwarfism,35,60,1,5,6
Mizoram,Aizawl,Short Stature/Dwarfism,60,80,1,0,1
Maharashtra,Ahmednagar,Short Stature/Dwarfism,15,35,4,6,10
Maharashtra,Ahmednagar,Short Stature/Dwarfism,35,60,1,1,2
Maharashtra,Ahmednagar,Short Stature/Dwarfism,60,80,0,2,2
Gujarat,Ahmadabad,Short Stature/Dwarfism,6,15,4,0,4
Gujarat,Ahmadabad,Short Stature/Dwarfism,15,35,4,2,6
Gujarat,Ahmadabad,Short Stature/Dwarfism,35,60,3,2,5
Gujarat,Ahmadabad,Short Stature/Dwarfism,60,80,0,1,1
Uttar Pradesh,Agra,Short Stature/Dwarfism,6,15,1,1,2
Uttar Pradesh,Agra,Short Stature/Dwarfism,15,35,11,11,22
Uttar Pradesh,Agra,Short Stature/Dwarfism,35,60,3,1,4
Maharashtra,Yavatmal,Sickle Cell Disease,0,6,1,0,1
Maharashtra,Yavatmal,Sickle Cell Disease,6,15,15,7,22
Maharashtra,Yavatmal,Sickle Cell Disease,15,35,35,37,72
Maharashtra,Yavatmal,Sickle Cell Disease,35,60,9,7,16
Tripura,West Tripura,Sickle Cell Disease,15,35,1,0,1
Jharkhand,West Singhbhum,Sickle Cell Disease,15,35,2,1,3
Jharkhand,West Singhbhum,Sickle Cell Disease,35,60,0,1,1
Andhra Pradesh,West Godavari,Sickle Cell Disease,15,35,1,0,1
Kerala,Wayanad,Sickle Cell Disease,0,6,0,1,1
Kerala,Wayanad,Sickle Cell Disease,6,15,7,7,14
Kerala,Wayanad,Sickle Cell Disease,15,35,27,19,46
Kerala,Wayanad,Sickle Cell Disease,35,60,13,36,49
Kerala,Wayanad,Sickle Cell Disease,60,80,5,1,6
Maharashtra,Washim,Sickle Cell Disease,0,6,2,1,3
Maharashtra,Washim,Sickle Cell Disease,6,15,11,7,18
Maharashtra,Washim,Sickle Cell Disease,15,35,18,12,30
Maharashtra,Washim,Sickle Cell Disease,35,60,6,2,8
Maharashtra,Wardha,Sickle Cell Disease,0,6,2,1,3
Maharashtra,Wardha,Sickle Cell Disease,6,15,3,4,7
Maharashtra,Wardha,Sickle Cell Disease,15,35,18,14,32
Maharashtra,Wardha,Sickle Cell Disease,35,60,2,7,9
Maharashtra,Wardha,Sickle Cell Disease,60,80,0,1,1
Andhra Pradesh,Vizianagaram,Sickle Cell Disease,35,60,0,1,1
Tamil Nadu,Virudhunagar,Sickle Cell Disease,6,15,1,0,1
Tamil Nadu,Virudhunagar,Sickle Cell Disease,35,60,1,0,1
Tamil Nadu,Virudhunagar,Sickle Cell Disease,80,100,1,0,1
Tamil Nadu,Villupuram,Sickle Cell Disease,15,35,1,1,2
Karnataka,Vijayapura,Sickle Cell Disease,6,15,0,1,1
Karnataka,Vijayapura,Sickle Cell Disease,35,60,2,2,4
Madhya Pradesh,Vidisha,Sickle Cell Disease,6,15,1,1,2
Madhya Pradesh,Vidisha,Sickle Cell Disease,15,35,4,2,6
Madhya Pradesh,Vidisha,Sickle Cell Disease,35,60,1,1,2
Tamil Nadu,Vellore,Sickle Cell Disease,35,60,1,1,2
Tamil Nadu,Vellore,Sickle Cell Disease,60,80,3,0,3
Uttar Pradesh,Varanasi,Sickle Cell Disease,15,35,1,0,1
Gujarat,Valsad,Sickle Cell Disease,0,6,0,1,1
Gujarat,Valsad,Sickle Cell Disease,6,15,20,19,39
Gujarat,Valsad,Sickle Cell Disease,15,35,23,16,39
Gujarat,Valsad,Sickle Cell Disease,35,60,3,2,5
Bihar,Vaishali,Sickle Cell Disease,6,15,1,0,1
Bihar,Vaishali,Sickle Cell Disease,15,35,1,0,1
Bihar,Vaishali,Sickle Cell Disease,35,60,6,1,7
Gujarat,Vadodara,Sickle Cell Disease,6,15,4,3,7
Gujarat,Vadodara,Sickle Cell Disease,15,35,6,2,8
Gujarat,Vadodara,Sickle Cell Disease,35,60,3,0,3
Karnataka,Uttara Kannada,Sickle Cell Disease,35,60,0,2,2
Uttarakhand,Uttar Kashi,Sickle Cell Disease,35,60,1,0,1
Uttar Pradesh,Unnao,Sickle Cell Disease,15,35,1,0,1
Uttar Pradesh,Unnao,Sickle Cell Disease,35,60,2,0,2
Uttar Pradesh,Unnao,Sickle Cell Disease,60,80,1,0,1
Tripura,Unakoti,Sickle Cell Disease,15,35,1,0,1
Himachal Pradesh,Una,Sickle Cell Disease,35,60,1,0,1
Madhya Pradesh,Umaria,Sickle Cell Disease,0,6,0,1,1
Madhya Pradesh,Umaria,Sickle Cell Disease,6,15,5,4,9
Madhya Pradesh,Umaria,Sickle Cell Disease,15,35,7,5,12
Madhya Pradesh,Umaria,Sickle Cell Disease,35,60,0,1,1
Madhya Pradesh,Ujjain,Sickle Cell Disease,15,35,2,2,4
Madhya Pradesh,Ujjain,Sickle Cell Disease,35,60,1,0,1
Karnataka,Udupi,Sickle Cell Disease,35,60,0,1,1
Jammu And Kashmir,Udhampur,Sickle Cell Disease,6,15,1,0,1
Uttarakhand,Udam Singh Nagar,Sickle Cell Disease,15,35,0,2,2
Uttarakhand,Udam Singh Nagar,Sickle Cell Disease,35,60,1,0,1
Assam,Udalguri,Sickle Cell Disease,0,6,1,0,1
Rajasthan,Udaipur,Sickle Cell Disease,6,15,1,1,2
Rajasthan,Udaipur,Sickle Cell Disease,15,35,0,1,1
Rajasthan,Udaipur,Sickle Cell Disease,60,80,1,1,2
Karnataka,Tumakuru,Sickle Cell Disease,15,35,2,2,4
Karnataka,Tumakuru,Sickle Cell Disease,35,60,10,3,13
Karnataka,Tumakuru,Sickle Cell Disease,60,80,1,0,1
Rajasthan,Tonk,Sickle Cell Disease,35,60,1,0,1
Tamil Nadu,Tiruvannamalai,Sickle Cell Disease,15,35,1,0,1
Tamil Nadu,Tiruvannamalai,Sickle Cell Disease,35,60,0,1,1
Tamil Nadu,Tiruppur,Sickle Cell Disease,6,15,1,0,1
Tamil Nadu,Tirupathur,Sickle Cell Disease,6,15,1,0,1
Tamil Nadu,Tirupathur,Sickle Cell Disease,15,35,0,1,1
Tamil Nadu,Tirupathur,Sickle Cell Disease,35,60,1,0,1
Tamil Nadu,Tirupathur,Sickle Cell Disease,60,80,1,0,1
Tamil Nadu,Tiruchirappalli,Sickle Cell Disease,6,15,3,0,3
Tamil Nadu,Tiruchirappalli,Sickle Cell Disease,35,60,1,1,2
Assam,Tinsukia,Sickle Cell Disease,15,35,1,0,1
Madhya Pradesh,Tikamgarh,Sickle Cell Disease,15,35,1,0,1
Madhya Pradesh,Tikamgarh,Sickle Cell Disease,35,60,1,1,2
Kerala,Thrissur,Sickle Cell Disease,35,60,1,1,2
Tamil Nadu,Thiruvallur,Sickle Cell Disease,15,35,1,0,1
Tamil Nadu,Thiruvallur,Sickle Cell Disease,35,60,1,1,2
Tamil Nadu,The Nilgiris,Sickle Cell Disease,6,15,4,5,9
Tamil Nadu,The Nilgiris,Sickle Cell Disease,15,35,5,3,8
Tamil Nadu,The Nilgiris,Sickle Cell Disease,35,60,1,0,1
Maharashtra,Thane,Sickle Cell Disease,0,6,0,3,3
Maharashtra,Thane,Sickle Cell Disease,6,15,6,3,9
Maharashtra,Thane,Sickle Cell Disease,15,35,14,6,20
Maharashtra,Thane,Sickle Cell Disease,35,60,4,3,7
Maharashtra,Thane,Sickle Cell Disease,60,80,1,1,2
Gujarat,Tapi,Sickle Cell Disease,0,6,17,11,28
Gujarat,Tapi,Sickle Cell Disease,6,15,227,173,400
Gujarat,Tapi,Sickle Cell Disease,15,35,323,402,725
Gujarat,Tapi,Sickle Cell Disease,35,60,123,211,334
Gujarat,Tapi,Sickle Cell Disease,60,80,10,13,23
Chhattisgarh,Surguja,Sickle Cell Disease,0,6,2,0,2
Chhattisgarh,Surguja,Sickle Cell Disease,6,15,17,19,36
Chhattisgarh,Surguja,Sickle Cell Disease,15,35,15,10,25
Chhattisgarh,Surguja,Sickle Cell Disease,35,60,4,0,4
Gujarat,Surendranagar,Sickle Cell Disease,6,15,1,0,1
Gujarat,Surat,Sickle Cell Disease,0,6,5,1,6
Gujarat,Surat,Sickle Cell Disease,6,15,30,25,55
Gujarat,Surat,Sickle Cell Disease,15,35,26,28,54
Gujarat,Surat,Sickle Cell Disease,35,60,2,3,5
Chhattisgarh,Surajpur,Sickle Cell Disease,0,6,2,0,2
Chhattisgarh,Surajpur,Sickle Cell Disease,6,15,6,4,10
Chhattisgarh,Surajpur,Sickle Cell Disease,15,35,4,5,9
Chhattisgarh,Surajpur,Sickle Cell Disease,35,60,1,0,1
Chhattisgarh,Surajpur,Sickle Cell Disease,80,100,1,0,1
Bihar,Supaul,Sickle Cell Disease,6,15,0,1,1
Bihar,Supaul,Sickle Cell Disease,15,35,1,0,1
Odisha,Sundargarh,Sickle Cell Disease,0,6,18,4,22
Odisha,Sundargarh,Sickle Cell Disease,6,15,163,120,283
Odisha,Sundargarh,Sickle Cell Disease,15,35,249,239,488
Odisha,Sundargarh,Sickle Cell Disease,35,60,100,108,208
Odisha,Sundargarh,Sickle Cell Disease,60,80,10,10,20
Uttar Pradesh,Sultanpur,Sickle Cell Disease,15,35,3,1,4
Uttar Pradesh,Sultanpur,Sickle Cell Disease,35,60,4,0,4
Uttar Pradesh,Sultanpur,Sickle Cell Disease,60,80,1,0,1
Andhra Pradesh,Srikakulam,Sickle Cell Disease,35,60,1,0,1
Punjab,Sri Muktsar Sahib,Sickle Cell Disease,15,35,1,0,1
Andaman And Nicobar Islands,South Andamans,Sickle Cell Disease,15,35,0,1,1
Andaman And Nicobar Islands,South Andamans,Sickle Cell Disease,35,60,0,1,1
Delhi,South,Sickle Cell Disease,35,60,1,0,1
Haryana,Sonipat,Sickle Cell Disease,35,60,1,0,1
Odisha,Sonepur,Sickle Cell Disease,0,6,10,2,12
Odisha,Sonepur,Sickle Cell Disease,6,15,103,54,157
Odisha,Sonepur,Sickle Cell Disease,15,35,128,91,219
Odisha,Sonepur,Sickle Cell Disease,35,60,40,22,62
Odisha,Sonepur,Sickle Cell Disease,60,80,2,2,4
Uttar Pradesh,Sonbhadra,Sickle Cell Disease,0,6,1,0,1
Uttar Pradesh,Sonbhadra,Sickle Cell Disease,6,15,0,2,2
Uttar Pradesh,Sonbhadra,Sickle Cell Disease,15,35,5,4,9
Maharashtra,Solapur,Sickle Cell Disease,15,35,1,0,1
Bihar,Siwan,Sickle Cell Disease,6,15,1,0,1
Bihar,Siwan,Sickle Cell Disease,35,60,1,0,1
Uttar Pradesh,Sitapur,Sickle Cell Disease,15,35,5,0,5
Uttar Pradesh,Sitapur,Sickle Cell Disease,35,60,4,0,4
Uttar Pradesh,Sitapur,Sickle Cell Disease,60,80,1,0,1
Bihar,Sitamarhi,Sickle Cell Disease,35,60,0,1,1
Rajasthan,Sirohi,Sickle Cell Disease,6,15,1,0,1
Himachal Pradesh,Sirmaur,Sickle Cell Disease,15,35,0,1,1
Madhya Pradesh,Singrauli,Sickle Cell Disease,0,6,3,0,3
Madhya Pradesh,Singrauli,Sickle Cell Disease,6,15,2,2,4
Madhya Pradesh,Singrauli,Sickle Cell Disease,15,35,1,0,1
Madhya Pradesh,Singrauli,Sickle Cell Disease,35,60,1,1,2
Maharashtra,Sindhudurg,Sickle Cell Disease,15,35,0,1,1
Maharashtra,Sindhudurg,Sickle Cell Disease,35,60,0,1,1
Maharashtra,Sindhudurg,Sickle Cell Disease,60,80,1,0,1
Jharkhand,Simdega,Sickle Cell Disease,15,35,0,1,1
Madhya Pradesh,Sidhi,Sickle Cell Disease,6,15,1,0,1
Madhya Pradesh,Sidhi,Sickle Cell Disease,15,35,4,4,8
Madhya Pradesh,Sidhi,Sickle Cell Disease,35,60,2,0,2
Madhya Pradesh,Sidhi,Sickle Cell Disease,60,80,2,0,2
Uttar Pradesh,Siddharth Nagar,Sickle Cell Disease,15,35,3,3,6
Uttar Pradesh,Siddharth Nagar,Sickle Cell Disease,35,60,8,4,12
Uttar Pradesh,Siddharth Nagar,Sickle Cell Disease,60,80,3,0,3
Jammu And Kashmir,Shopian,Sickle Cell Disease,6,15,0,2,2
Madhya Pradesh,Shivpuri,Sickle Cell Disease,15,35,2,0,2
Karnataka,Shivamogga,Sickle Cell Disease,15,35,0,1,1
Himachal Pradesh,Shimla,Sickle Cell Disease,35,60,1,0,1
Bihar,Sheohar,Sickle Cell Disease,15,35,1,0,1
Bihar,Sheikhpura,Sickle Cell Disease,15,35,1,0,1
Uttar Pradesh,Shamli,Sickle Cell Disease,15,35,1,0,1
Uttar Pradesh,Shamli,Sickle Cell Disease,35,60,1,0,1
Madhya Pradesh,Shajapur,Sickle Cell Disease,6,15,1,0,1
Madhya Pradesh,Shajapur,Sickle Cell Disease,15,35,0,1,1
Madhya Pradesh,Shajapur,Sickle Cell Disease,35,60,1,0,1
Uttar Pradesh,Shahjahanpur,Sickle Cell Disease,6,15,3,1,4
Uttar Pradesh,Shahjahanpur,Sickle Cell Disease,15,35,18,5,23
Uttar Pradesh,Shahjahanpur,Sickle Cell Disease,35,60,13,8,21
Uttar Pradesh,Shahjahanpur,Sickle Cell Disease,60,80,6,0,6
Punjab,Shahid Bhagat Singh Nagar,Sickle Cell Disease,15,35,1,1,2
Punjab,Shahid Bhagat Singh Nagar,Sickle Cell Disease,35,60,2,1,3
Madhya Pradesh,Shahdol,Sickle Cell Disease,0,6,4,4,8
Madhya Pradesh,Shahdol,Sickle Cell Disease,6,15,22,22,44
Madhya Pradesh,Shahdol,Sickle Cell Disease,15,35,27,21,48
Madhya Pradesh,Shahdol,Sickle Cell Disease,35,60,2,1,3
Madhya Pradesh,Seoni,Sickle Cell Disease,0,6,1,0,1
Madhya Pradesh,Seoni,Sickle Cell Disease,6,15,7,4,11
Madhya Pradesh,Seoni,Sickle Cell Disease,15,35,15,6,21
Madhya Pradesh,Seoni,Sickle Cell Disease,35,60,2,2,4
Madhya Pradesh,Seoni,Sickle Cell Disease,60,80,1,0,1
Madhya Pradesh,Sehore,Sickle Cell Disease,6,15,0,1,1
Madhya Pradesh,Sehore,Sickle Cell Disease,15,35,6,2,8
Madhya Pradesh,Satna,Sickle Cell Disease,6,15,1,0,1
Madhya Pradesh,Satna,Sickle Cell Disease,15,35,6,2,8
Maharashtra,Satara,Sickle Cell Disease,35,60,0,1,1
Bihar,Saran,Sickle Cell Disease,6,15,1,0,1
Bihar,Saran,Sickle Cell Disease,15,35,1,0,1
Bihar,Saran,Sickle Cell Disease,35,60,3,0,3
Uttar Pradesh,Sant Kabeer Nagar,Sickle Cell Disease,35,60,2,0,2
Uttar Pradesh,Sant Kabeer Nagar,Sickle Cell Disease,60,80,1,0,1
Punjab,Sangrur,Sickle Cell Disease,15,35,1,0,1
Uttar Pradesh,Sambhal,Sickle Cell Disease,35,60,1,0,1
Odisha,Sambalpur,Sickle Cell Disease,0,6,14,9,23
Odisha,Sambalpur,Sickle Cell Disease,6,15,138,94,232
Odisha,Sambalpur,Sickle Cell Disease,15,35,164,166,330
Odisha,Sambalpur,Sickle Cell Disease,35,60,76,56,132
Odisha,Sambalpur,Sickle Cell Disease,60,80,1,2,3
Bihar,Samastipur,Sickle Cell Disease,6,15,3,0,3
Bihar,Samastipur,Sickle Cell Disease,15,35,2,2,4
Bihar,Samastipur,Sickle Cell Disease,35,60,4,1,5
Tamil Nadu,Salem,Sickle Cell Disease,6,15,2,2,4
Tamil Nadu,Salem,Sickle Cell Disease,15,35,1,1,2
Bihar,Saharsa,Sickle Cell Disease,15,35,3,0,3
Bihar,Saharsa,Sickle Cell Disease,35,60,2,2,4
Bihar,Saharsa,Sickle Cell Disease,60,80,1,0,1
Uttar Pradesh,Saharanpur,Sickle Cell Disease,15,35,5,3,8
Uttar Pradesh,Saharanpur,Sickle Cell Disease,35,60,7,3,10
Uttar Pradesh,Saharanpur,Sickle Cell Disease,60,80,1,0,1
Madhya Pradesh,Sagar,Sickle Cell Disease,6,15,2,0,2
Madhya Pradesh,Sagar,Sickle Cell Disease,15,35,9,1,10
Madhya Pradesh,Sagar,Sickle Cell Disease,35,60,4,1,5
Gujarat,Sabar Kantha,Sickle Cell Disease,0,6,1,0,1
Gujarat,Sabar Kantha,Sickle Cell Disease,6,15,39,26,65
Gujarat,Sabar Kantha,Sickle Cell Disease,15,35,34,28,62
Gujarat,Sabar Kantha,Sickle Cell Disease,35,60,5,19,24
Gujarat,Sabar Kantha,Sickle Cell Disease,60,80,0,1,1
Punjab,S.A.S Nagar,Sickle Cell Disease,15,35,2,0,2
Punjab,S.A.S Nagar,Sickle Cell Disease,35,60,3,0,3
Punjab,Rupnagar,Sickle Cell Disease,35,60,0,1,1
Uttarakhand,Rudra Prayag,Sickle Cell Disease,15,35,2,0,2
Uttarakhand,Rudra Prayag,Sickle Cell Disease,35,60,2,0,2
Bihar,Rohtas,Sickle Cell Disease,15,35,0,1,1
Bihar,Rohtas,Sickle Cell Disease,35,60,1,1,2
Haryana,Rohtak,Sickle Cell Disease,35,60,0,1,1
Madhya Pradesh,Rewa,Sickle Cell Disease,6,15,2,2,4
Madhya Pradesh,Rewa,Sickle Cell Disease,15,35,3,2,5
Jammu And Kashmir,Reasi,Sickle Cell Disease,35,60,0,1,1
Odisha,Rayagada,Sickle Cell Disease,0,6,27,12,39
Odisha,Rayagada,Sickle Cell Disease,6,15,123,76,199
Odisha,Rayagada,Sickle Cell Disease,15,35,80,87,167
Odisha,Rayagada,Sickle Cell Disease,35,60,15,24,39
Odisha,Rayagada,Sickle Cell Disease,60,80,1,0,1
Maharashtra,Ratnagiri,Sickle Cell Disease,15,35,1,0,1
Madhya Pradesh,Ratlam,Sickle Cell Disease,0,6,0,1,1
Madhya Pradesh,Ratlam,Sickle Cell Disease,6,15,3,1,4
Madhya Pradesh,Ratlam,Sickle Cell Disease,15,35,3,2,5
Tamil Nadu,Ranipet,Sickle Cell Disease,35,60,0,2,2
Jharkhand,Ranchi,Sickle Cell Disease,0,6,1,2,3
Jharkhand,Ranchi,Sickle Cell Disease,6,15,15,8,23
Jharkhand,Ranchi,Sickle Cell Disease,15,35,12,5,17
Jharkhand,Ranchi,Sickle Cell Disease,35,60,3,5,8
Jharkhand,Ranchi,Sickle Cell Disease,60,80,0,1,1
Uttar Pradesh,Rampur,Sickle Cell Disease,15,35,2,3,5
Uttar Pradesh,Rampur,Sickle Cell Disease,35,60,3,0,3
Jharkhand,Ramgarh,Sickle Cell Disease,6,15,2,3,5
Jharkhand,Ramgarh,Sickle Cell Disease,15,35,5,6,11
Jharkhand,Ramgarh,Sickle Cell Disease,35,60,12,12,24
Jharkhand,Ramgarh,Sickle Cell Disease,60,80,1,0,1
Jharkhand,Ramgarh,Sickle Cell Disease,80,100,0,1,1
Jammu And Kashmir,Ramban,Sickle Cell Disease,15,35,1,0,1
Karnataka,Ramanagara,Sickle Cell Disease,6,15,1,0,1
Karnataka,Ramanagara,Sickle Cell Disease,35,60,0,1,1
Rajasthan,Rajsamand,Sickle Cell Disease,15,35,1,0,1
Rajasthan,Rajsamand,Sickle Cell Disease,35,60,2,0,2
Rajasthan,Rajsamand,Sickle Cell Disease,60,80,1,0,1
Jammu And Kashmir,Rajouri,Sickle Cell Disease,35,60,2,0,2
Chhattisgarh,Rajnandgaon,Sickle Cell Disease,0,6,2,4,6
Chhattisgarh,Rajnandgaon,Sickle Cell Disease,6,15,24,21,45
Chhattisgarh,Rajnandgaon,Sickle Cell Disease,15,35,22,12,34
Chhattisgarh,Rajnandgaon,Sickle Cell Disease,35,60,5,5,10
Chhattisgarh,Rajnandgaon,Sickle Cell Disease,80,100,1,0,1
Madhya Pradesh,Rajgarh,Sickle Cell Disease,15,35,1,0,1
Madhya Pradesh,Rajgarh,Sickle Cell Disease,35,60,2,0,2
Madhya Pradesh,Rajgarh,Sickle Cell Disease,60,80,1,0,1
Madhya Pradesh,Raisen,Sickle Cell Disease,6,15,2,2,4
Madhya Pradesh,Raisen,Sickle Cell Disease,15,35,0,3,3
Madhya Pradesh,Raisen,Sickle Cell Disease,35,60,3,0,3
Madhya Pradesh,Raisen,Sickle Cell Disease,60,80,0,2,2
Chhattisgarh,Raipur,Sickle Cell Disease,0,6,1,0,1
Chhattisgarh,Raipur,Sickle Cell Disease,6,15,9,4,13
Chhattisgarh,Raipur,Sickle Cell Disease,15,35,21,19,40
Chhattisgarh,Raipur,Sickle Cell Disease,35,60,4,3,7
Chhattisgarh,Raigarh,Sickle Cell Disease,0,6,1,2,3
Chhattisgarh,Raigarh,Sickle Cell Disease,6,15,46,46,92
Chhattisgarh,Raigarh,Sickle Cell Disease,15,35,70,74,144
Chhattisgarh,Raigarh,Sickle Cell Disease,35,60,19,7,26
Maharashtra,Raigad,Sickle Cell Disease,6,15,3,1,4
Maharashtra,Raigad,Sickle Cell Disease,15,35,3,3,6
Maharashtra,Raigad,Sickle Cell Disease,35,60,1,0,1
Karnataka,Raichur,Sickle Cell Disease,35,60,1,1,2
Bihar,Purnia,Sickle Cell Disease,15,35,1,3,4
Bihar,Purnia,Sickle Cell Disease,35,60,1,0,1
Odisha,Puri,Sickle Cell Disease,0,6,1,0,1
Odisha,Puri,Sickle Cell Disease,6,15,2,0,2
Odisha,Puri,Sickle Cell Disease,15,35,1,1,2
Odisha,Puri,Sickle Cell Disease,35,60,1,0,1
Odisha,Puri,Sickle Cell Disease,60,80,1,2,3
Bihar,Purbi Champaran,Sickle Cell Disease,15,35,1,2,3
Bihar,Purbi Champaran,Sickle Cell Disease,35,60,2,0,2
Maharashtra,Pune,Sickle Cell Disease,0,6,1,1,2
Maharashtra,Pune,Sickle Cell Disease,6,15,2,3,5
Maharashtra,Pune,Sickle Cell Disease,15,35,7,7,14
Maharashtra,Pune,Sickle Cell Disease,35,60,5,3,8
Tamil Nadu,Pudukkottai,Sickle Cell Disease,6,15,2,2,4
Uttar Pradesh,Prayagraj,Sickle Cell Disease,15,35,2,0,2
Uttar Pradesh,Prayagraj,Sickle Cell Disease,35,60,1,0,1
Rajasthan,Pratapgarh,Sickle Cell Disease,15,35,1,0,1
Uttar Pradesh,Pratapgarh,Sickle Cell Disease,15,35,3,1,4
Uttar Pradesh,Pratapgarh,Sickle Cell Disease,35,60,6,2,8
Uttar Pradesh,Pratapgarh,Sickle Cell Disease,60,80,3,0,3
Andhra Pradesh,Prakasam,Sickle Cell Disease,15,35,1,0,1
Gujarat,Porbandar,Sickle Cell Disease,15,35,1,0,1
Gujarat,Porbandar,Sickle Cell Disease,35,60,1,0,1
Jammu And Kashmir,Poonch,Sickle Cell Disease,0,6,3,2,5
Jammu And Kashmir,Poonch,Sickle Cell Disease,6,15,11,10,21
Jammu And Kashmir,Poonch,Sickle Cell Disease,15,35,27,35,62
Jammu And Kashmir,Poonch,Sickle Cell Disease,35,60,39,45,84
Jammu And Kashmir,Poonch,Sickle Cell Disease,60,80,7,5,12
Jammu And Kashmir,Poonch,Sickle Cell Disease,80,100,0,1,1
Uttarakhand,Pithoragarh,Sickle Cell Disease,35,60,1,0,1
Uttar Pradesh,Pilibhit,Sickle Cell Disease,6,15,0,1,1
Uttar Pradesh,Pilibhit,Sickle Cell Disease,15,35,5,0,5
Uttar Pradesh,Pilibhit,Sickle Cell Disease,35,60,10,0,10
Uttar Pradesh,Pilibhit,Sickle Cell Disease,60,80,4,2,6
Uttarakhand,Pauri Garhwal,Sickle Cell Disease,15,35,0,1,1
Uttarakhand,Pauri Garhwal,Sickle Cell Disease,35,60,2,1,3
Uttarakhand,Pauri Garhwal,Sickle Cell Disease,60,80,1,0,1
Uttarakhand,Pauri Garhwal,Sickle Cell Disease,80,100,1,0,1
Bihar,Patna,Sickle Cell Disease,0,6,1,0,1
Bihar,Patna,Sickle Cell Disease,6,15,3,0,3
Bihar,Patna,Sickle Cell Disease,35,60,2,0,2
Bihar,Patna,Sickle Cell Disease,60,80,1,0,1
Punjab,Patiala,Sickle Cell Disease,6,15,1,0,1
Punjab,Patiala,Sickle Cell Disease,15,35,2,1,3
Punjab,Patiala,Sickle Cell Disease,35,60,4,3,7
Punjab,Patiala,Sickle Cell Disease,60,80,2,0,2
Punjab,Pathankot,Sickle Cell Disease,15,35,1,0,1
Punjab,Pathankot,Sickle Cell Disease,35,60,1,0,1
Bihar,Pashchim Champaran,Sickle Cell Disease,35,60,0,1,1
Maharashtra,Parbhani,Sickle Cell Disease,15,35,3,1,4
Madhya Pradesh,Panna,Sickle Cell Disease,15,35,5,0,5
Madhya Pradesh,Panna,Sickle Cell Disease,35,60,1,0,1
Haryana,Panchkula,Sickle Cell Disease,15,35,1,0,1
Gujarat,Panch Mahals,Sickle Cell Disease,0,6,14,9,23
Gujarat,Panch Mahals,Sickle Cell Disease,6,15,93,69,162
Gujarat,Panch Mahals,Sickle Cell Disease,15,35,103,70,173
Gujarat,Panch Mahals,Sickle Cell Disease,35,60,12,11,23
Gujarat,Panch Mahals,Sickle Cell Disease,60,80,2,0,2
Haryana,Palwal,Sickle Cell Disease,6,15,1,0,1
Maharashtra,Palghar,Sickle Cell Disease,0,6,4,0,4
Maharashtra,Palghar,Sickle Cell Disease,6,15,14,11,25
Maharashtra,Palghar,Sickle Cell Disease,15,35,22,19,41
Maharashtra,Palghar,Sickle Cell Disease,35,60,4,6,10
Maharashtra,Palghar,Sickle Cell Disease,60,80,2,0,2
Jharkhand,Palamu,Sickle Cell Disease,0,6,0,1,1
Jharkhand,Palamu,Sickle Cell Disease,6,15,2,3,5
Jharkhand,Palamu,Sickle Cell Disease,15,35,3,6,9
Jharkhand,Palamu,Sickle Cell Disease,35,60,5,0,5
Jharkhand,Pakur,Sickle Cell Disease,35,60,0,1,1
Maharashtra,Osmanabad,Sickle Cell Disease,35,60,0,1,1
Odisha,Nuapada,Sickle Cell Disease,0,6,10,1,11
Odisha,Nuapada,Sickle Cell Disease,6,15,86,54,140
Odisha,Nuapada,Sickle Cell Disease,15,35,48,42,90
Odisha,Nuapada,Sickle Cell Disease,35,60,22,15,37
Goa,North Goa,Sickle Cell Disease,60,80,0,1,1
Andaman And Nicobar Islands,North And Middle Andaman,Sickle Cell Disease,15,35,1,0,1
Andaman And Nicobar Islands,North And Middle Andaman,Sickle Cell Disease,35,60,0,1,1
Madhya Pradesh,Niwari,Sickle Cell Disease,15,35,2,0,2
Madhya Pradesh,Niwari,Sickle Cell Disease,35,60,1,1,2
Madhya Pradesh,Neemuch,Sickle Cell Disease,60,80,1,0,1
Odisha,Nayagarh,Sickle Cell Disease,0,6,24,12,36
Odisha,Nayagarh,Sickle Cell Disease,6,15,140,71,211
Odisha,Nayagarh,Sickle Cell Disease,15,35,152,92,244
Odisha,Nayagarh,Sickle Cell Disease,35,60,44,38,82
Odisha,Nayagarh,Sickle Cell Disease,60,80,1,0,1
Odisha,Nayagarh,Sickle Cell Disease,80,100,1,0,1
Bihar,Nawada,Sickle Cell Disease,6,15,0,1,1
Bihar,Nawada,Sickle Cell Disease,15,35,1,0,1
Gujarat,Navsari,Sickle Cell Disease,0,6,1,0,1
Gujarat,Navsari,Sickle Cell Disease,6,15,75,63,138
Gujarat,Navsari,Sickle Cell Disease,15,35,44,49,93
Gujarat,Navsari,Sickle Cell Disease,35,60,10,8,18
Maharashtra,Nashik,Sickle Cell Disease,0,6,2,4,6
Maharashtra,Nashik,Sickle Cell Disease,6,15,10,6,16
Maharashtra,Nashik,Sickle Cell Disease,15,35,17,17,34
Maharashtra,Nashik,Sickle Cell Disease,35,60,3,2,5
Madhya Pradesh,Narsinghpur,Sickle Cell Disease,0,6,5,2,7
Madhya Pradesh,Narsinghpur,Sickle Cell Disease,6,15,22,13,35
Madhya Pradesh,Narsinghpur,Sickle Cell Disease,15,35,22,18,40
Madhya Pradesh,Narsinghpur,Sickle Cell Disease,35,60,18,4,22
Madhya Pradesh,Narsinghpur,Sickle Cell Disease,60,80,1,1,2
Madhya Pradesh,Narmadapuram,Sickle Cell Disease,15,35,4,1,5
Madhya Pradesh,Narmadapuram,Sickle Cell Disease,35,60,0,2,2
Gujarat,Narmada,Sickle Cell Disease,0,6,1,0,1
Gujarat,Narmada,Sickle Cell Disease,6,15,7,1,8
Gujarat,Narmada,Sickle Cell Disease,15,35,6,11,17
Gujarat,Narmada,Sickle Cell Disease,35,60,2,1,3
Chhattisgarh,Narayanpur,Sickle Cell Disease,15,35,2,0,2
Maharashtra,Nandurbar,Sickle Cell Disease,0,6,7,2,9
Maharashtra,Nandurbar,Sickle Cell Disease,6,15,23,14,37
Maharashtra,Nandurbar,Sickle Cell Disease,15,35,70,50,120
Maharashtra,Nandurbar,Sickle Cell Disease,35,60,13,16,29
Maharashtra,Nanded,Sickle Cell Disease,0,6,0,2,2
Maharashtra,Nanded,Sickle Cell Disease,6,15,12,7,19
Maharashtra,Nanded,Sickle Cell Disease,15,35,25,19,44
Maharashtra,Nanded,Sickle Cell Disease,35,60,4,5,9
Tamil Nadu,Namakkal,Sickle Cell Disease,6,15,1,1,2
Tamil Nadu,Namakkal,Sickle Cell Disease,35,60,1,0,1
Assam,Nalbari,Sickle Cell Disease,35,60,0,1,1
Bihar,Nalanda,Sickle Cell Disease,15,35,0,1,1
Bihar,Nalanda,Sickle Cell Disease,35,60,0,1,1
Uttarakhand,Nainital,Sickle Cell Disease,35,60,1,0,1
Maharashtra,Nagpur,Sickle Cell Disease,0,6,20,6,26
Maharashtra,Nagpur,Sickle Cell Disease,6,15,77,55,132
Maharashtra,Nagpur,Sickle Cell Disease,15,35,114,88,202
Maharashtra,Nagpur,Sickle Cell Disease,35,60,28,33,61
Maharashtra,Nagpur,Sickle Cell Disease,60,80,2,2,4
Odisha,Nabarangpur,Sickle Cell Disease,35,60,1,0,1
Karnataka,Mysuru,Sickle Cell Disease,15,35,1,2,3
Karnataka,Mysuru,Sickle Cell Disease,35,60,0,1,1
Karnataka,Mysuru,Sickle Cell Disease,60,80,1,0,1
Bihar,Muzaffarpur,Sickle Cell Disease,15,35,2,0,2
Bihar,Muzaffarpur,Sickle Cell Disease,60,80,1,0,1
Uttar Pradesh,Muzaffarnagar,Sickle Cell Disease,15,35,0,1,1
Uttar Pradesh,Muzaffarnagar,Sickle Cell Disease,35,60,4,0,4
Uttar Pradesh,Muzaffarnagar,Sickle Cell Disease,60,80,1,0,1
Bihar,Munger,Sickle Cell Disease,35,60,3,0,3
Chhattisgarh,Mungeli,Sickle Cell Disease,15,35,0,1,1
Maharashtra,Mumbai Suburban,Sickle Cell Disease,6,15,0,1,1
Maharashtra,Mumbai Suburban,Sickle Cell Disease,15,35,2,0,2
Maharashtra,Mumbai,Sickle Cell Disease,15,35,3,1,4
Maharashtra,Mumbai,Sickle Cell Disease,35,60,1,1,2
Madhya Pradesh,Morena,Sickle Cell Disease,15,35,0,1,1
Madhya Pradesh,Morena,Sickle Cell Disease,35,60,1,0,1
Punjab,Moga,Sickle Cell Disease,15,35,1,0,1
Punjab,Moga,Sickle Cell Disease,35,60,0,1,1
Uttar Pradesh,Mirzapur,Sickle Cell Disease,15,35,2,1,3
Uttar Pradesh,Mirzapur,Sickle Cell Disease,35,60,2,0,2
Uttar Pradesh,Meerut,Sickle Cell Disease,15,35,1,0,1
Uttar Pradesh,Meerut,Sickle Cell Disease,35,60,1,0,1
Odisha,Mayurbhanj,Sickle Cell Disease,0,6,2,2,4
Odisha,Mayurbhanj,Sickle Cell Disease,6,15,20,6,26
Odisha,Mayurbhanj,Sickle Cell Disease,15,35,26,13,39
Odisha,Mayurbhanj,Sickle Cell Disease,35,60,6,2,8
Odisha,Mayurbhanj,Sickle Cell Disease,60,80,1,0,1
Uttar Pradesh,Mathura,Sickle Cell Disease,35,60,1,0,1
Assam,Marigaon,Sickle Cell Disease,15,35,0,1,1
Punjab,Mansa,Sickle Cell Disease,15,35,3,1,4
Punjab,Mansa,Sickle Cell Disease,35,60,5,1,6
Punjab,Mansa,Sickle Cell Disease,60,80,1,0,1
Sikkim,Mangan,Sickle Cell Disease,35,60,0,1,1
Karnataka,Mandya,Sickle Cell Disease,35,60,1,0,1
Madhya Pradesh,Mandla,Sickle Cell Disease,0,6,3,5,8
Madhya Pradesh,Mandla,Sickle Cell Disease,6,15,43,28,71
Madhya Pradesh,Mandla,Sickle Cell Disease,15,35,35,41,76
Madhya Pradesh,Mandla,Sickle Cell Disease,35,60,7,4,11
Himachal Pradesh,Mandi,Sickle Cell Disease,15,35,1,0,1
Himachal Pradesh,Mandi,Sickle Cell Disease,35,60,4,0,4
Himachal Pradesh,Mandi,Sickle Cell Disease,60,80,0,1,1
Odisha,Malkangiri,Sickle Cell Disease,0,6,4,3,7
Odisha,Malkangiri,Sickle Cell Disease,6,15,26,23,49
Odisha,Malkangiri,Sickle Cell Disease,15,35,22,40,62
Odisha,Malkangiri,Sickle Cell Disease,35,60,5,8,13
Kerala,Malappuram,Sickle Cell Disease,6,15,0,1,1
Kerala,Malappuram,Sickle Cell Disease,15,35,1,0,1
Assam,Majuli,Sickle Cell Disease,6,15,0,1,1
Uttar Pradesh,Mainpuri,Sickle Cell Disease,15,35,1,0,1
Uttar Pradesh,Mainpuri,Sickle Cell Disease,35,60,5,0,5
Uttar Pradesh,Mahoba,Sickle Cell Disease,15,35,3,0,3
Uttar Pradesh,Mahoba,Sickle Cell Disease,35,60,8,0,8
Gujarat,Mahisagar,Sickle Cell Disease,0,6,1,0,1
Gujarat,Mahisagar,Sickle Cell Disease,6,15,25,12,37
Gujarat,Mahisagar,Sickle Cell Disease,15,35,50,55,105
Gujarat,Mahisagar,Sickle Cell Disease,35,60,13,18,31
Gujarat,Mahisagar,Sickle Cell Disease,60,80,1,2,3
Gujarat,Mahisagar,Sickle Cell Disease,80,100,0,1,1
Chhattisgarh,Mahasamund,Sickle Cell Disease,0,6,2,0,2
Chhattisgarh,Mahasamund,Sickle Cell Disease,6,15,10,9,19
Chhattisgarh,Mahasamund,Sickle Cell Disease,15,35,18,12,30
Chhattisgarh,Mahasamund,Sickle Cell Disease,35,60,4,3,7
Chhattisgarh,Mahasamund,Sickle Cell Disease,60,80,1,1,2
Uttar Pradesh,Maharajganj,Sickle Cell Disease,6,15,0,1,1
Uttar Pradesh,Maharajganj,Sickle Cell Disease,15,35,1,2,3
Uttar Pradesh,Maharajganj,Sickle Cell Disease,35,60,0,1,1
Bihar,Madhubani,Sickle Cell Disease,15,35,2,0,2
Bihar,Madhubani,Sickle Cell Disease,35,60,4,0,4
Bihar,Madhubani,Sickle Cell Disease,60,80,2,0,2
Bihar,Madhepura,Sickle Cell Disease,15,35,3,4,7
Bihar,Madhepura,Sickle Cell Disease,35,60,1,1,2
Bihar,Madhepura,Sickle Cell Disease,60,80,1,1,2
Punjab,Ludhiana,Sickle Cell Disease,35,60,1,2,3
Punjab,Ludhiana,Sickle Cell Disease,60,80,1,0,1
Uttar Pradesh,Lucknow,Sickle Cell Disease,6,15,0,1,1
Uttar Pradesh,Lucknow,Sickle Cell Disease,15,35,4,6,10
Uttar Pradesh,Lucknow,Sickle Cell Disease,35,60,9,1,10
Uttar Pradesh,Lucknow,Sickle Cell Disease,60,80,5,1,6
Uttar Pradesh,Lucknow,Sickle Cell Disease,80,100,1,0,1
Jharkhand,Lohardaga,Sickle Cell Disease,15,35,0,1,1
Maharashtra,Latur,Sickle Cell Disease,6,15,0,1,1
Maharashtra,Latur,Sickle Cell Disease,15,35,1,3,4
Maharashtra,Latur,Sickle Cell Disease,60,80,1,0,1
Uttar Pradesh,Lalitpur,Sickle Cell Disease,15,35,3,0,3
Uttar Pradesh,Lalitpur,Sickle Cell Disease,35,60,1,0,1
Bihar,Lakhisarai,Sickle Cell Disease,6,15,2,1,3
Bihar,Lakhisarai,Sickle Cell Disease,15,35,1,0,1
Bihar,Lakhisarai,Sickle Cell Disease,35,60,2,0,2
Uttar Pradesh,Kushi Nagar,Sickle Cell Disease,15,35,5,0,5
Uttar Pradesh,Kushi Nagar,Sickle Cell Disease,35,60,1,0,1
Andhra Pradesh,Kurnool,Sickle Cell Disease,35,60,1,0,1
Jammu And Kashmir,Kupwara,Sickle Cell Disease,15,35,4,2,6
Jammu And Kashmir,Kupwara,Sickle Cell Disease,35,60,3,4,7
Jammu And Kashmir,Kupwara,Sickle Cell Disease,60,80,0,1,1
Jammu And Kashmir,Kupwara,Sickle Cell Disease,80,100,1,0,1
Himachal Pradesh,Kullu,Sickle Cell Disease,15,35,1,0,1
Jammu And Kashmir,Kulgam,Sickle Cell Disease,15,35,1,0,1
Tamil Nadu,Krishnagiri,Sickle Cell Disease,15,35,1,1,2
Tamil Nadu,Krishnagiri,Sickle Cell Disease,35,60,1,1,2
Tamil Nadu,Krishnagiri,Sickle Cell Disease,60,80,0,1,1
Kerala,Kozhikode,Sickle Cell Disease,35,60,1,0,1
Kerala,Kozhikode,Sickle Cell Disease,60,80,1,0,1
Kerala,Kottayam,Sickle Cell Disease,35,60,1,0,1
Kerala,Kottayam,Sickle Cell Disease,60,80,0,1,1
Rajasthan,Kota,Sickle Cell Disease,35,60,2,0,2
Chhattisgarh,Korea,Sickle Cell Disease,6,15,3,3,6
Chhattisgarh,Korea,Sickle Cell Disease,15,35,12,7,19
Chhattisgarh,Korea,Sickle Cell Disease,35,60,0,3,3
Chhattisgarh,Korba,Sickle Cell Disease,6,15,0,1,1
Chhattisgarh,Korba,Sickle Cell Disease,15,35,5,3,8
Chhattisgarh,Korba,Sickle Cell Disease,35,60,0,1,1
Odisha,Koraput,Sickle Cell Disease,0,6,24,14,38
Odisha,Koraput,Sickle Cell Disease,6,15,72,65,137
Odisha,Koraput,Sickle Cell Disease,15,35,85,92,177
Odisha,Koraput,Sickle Cell Disease,35,60,12,20,32
Odisha,Koraput,Sickle Cell Disease,60,80,0,1,1
Chhattisgarh,Kondagaon,Sickle Cell Disease,0,6,0,1,1
Chhattisgarh,Kondagaon,Sickle Cell Disease,6,15,49,50,99
Chhattisgarh,Kondagaon,Sickle Cell Disease,15,35,61,93,154
Chhattisgarh,Kondagaon,Sickle Cell Disease,35,60,5,1,6
Kerala,Kollam,Sickle Cell Disease,15,35,1,0,1
Kerala,Kollam,Sickle Cell Disease,35,60,0,1,1
Maharashtra,Kolhapur,Sickle Cell Disease,6,15,1,0,1
Maharashtra,Kolhapur,Sickle Cell Disease,15,35,0,1,1
Karnataka,Kolar,Sickle Cell Disease,15,35,0,2,2
Jharkhand,Koderma,Sickle Cell Disease,15,35,0,1,1
Jharkhand,Koderma,Sickle Cell Disease,35,60,1,1,2
Jammu And Kashmir,Kishtwar,Sickle Cell Disease,35,60,2,0,2
Jharkhand,Khunti,Sickle Cell Disease,6,15,1,0,1
Jharkhand,Khunti,Sickle Cell Disease,15,35,1,5,6
Jharkhand,Khunti,Sickle Cell Disease,35,60,6,3,9
Jharkhand,Khunti,Sickle Cell Disease,60,80,1,0,1
Odisha,Khordha,Sickle Cell Disease,0,6,1,1,2
Odisha,Khordha,Sickle Cell Disease,6,15,7,5,12
Odisha,Khordha,Sickle Cell Disease,15,35,6,11,17
Odisha,Khordha,Sickle Cell Disease,35,60,3,2,5
Uttar Pradesh,Kheri,Sickle Cell Disease,15,35,2,1,3
Uttar Pradesh,Kheri,Sickle Cell Disease,35,60,3,1,4
Uttar Pradesh,Kheri,Sickle Cell Disease,60,80,1,0,1
Gujarat,Kheda,Sickle Cell Disease,6,15,2,2,4
Gujarat,Kheda,Sickle Cell Disease,15,35,1,0,1
Madhya Pradesh,Khargone,Sickle Cell Disease,0,6,6,8,14
Madhya Pradesh,Khargone,Sickle Cell Disease,6,15,54,33,87
Madhya Pradesh,Khargone,Sickle Cell Disease,15,35,40,38,78
Madhya Pradesh,Khargone,Sickle Cell Disease,35,60,3,4,7
Madhya Pradesh,Khargone,Sickle Cell Disease,60,80,1,1,2
Bihar,Khagaria,Sickle Cell Disease,15,35,1,0,1
Bihar,Khagaria,Sickle Cell Disease,35,60,1,1,2
Odisha,Kendujhar,Sickle Cell Disease,0,6,3,4,7
Odisha,Kendujhar,Sickle Cell Disease,6,15,18,14,32
Odisha,Kendujhar,Sickle Cell Disease,15,35,16,6,22
Odisha,Kendujhar,Sickle Cell Disease,35,60,4,4,8
Odisha,Kendrapara,Sickle Cell Disease,6,15,1,1,2
Odisha,Kendrapara,Sickle Cell Disease,15,35,2,2,4
Odisha,Kendrapara,Sickle Cell Disease,35,60,2,1,3
Odisha,Kendrapara,Sickle Cell Disease,60,80,2,0,2
Uttar Pradesh,Kaushambi,Sickle Cell Disease,6,15,1,0,1
Uttar Pradesh,Kaushambi,Sickle Cell Disease,15,35,16,3,19
Uttar Pradesh,Kaushambi,Sickle Cell Disease,35,60,29,4,33
Uttar Pradesh,Kaushambi,Sickle Cell Disease,60,80,1,2,3
Madhya Pradesh,Katni,Sickle Cell Disease,0,6,1,0,1
Madhya Pradesh,Katni,Sickle Cell Disease,6,15,2,1,3
Madhya Pradesh,Katni,Sickle Cell Disease,15,35,3,3,6
Madhya Pradesh,Katni,Sickle Cell Disease,35,60,3,1,4
Madhya Pradesh,Katni,Sickle Cell Disease,60,80,1,0,1
Bihar,Katihar,Sickle Cell Disease,15,35,2,0,2
Jammu And Kashmir,Kathua,Sickle Cell Disease,6,15,1,0,1
Jammu And Kashmir,Kathua,Sickle Cell Disease,15,35,2,0,2
Jammu And Kashmir,Kathua,Sickle Cell Disease,35,60,2,0,2
Jammu And Kashmir,Kathua,Sickle Cell Disease,80,100,1,0,1
Uttar Pradesh,Kasganj,Sickle Cell Disease,15,35,1,1,2
Uttar Pradesh,Kasganj,Sickle Cell Disease,35,60,1,0,1
Assam,Karbi Anglong,Sickle Cell Disease,0,6,1,0,1
Uttar Pradesh,Kanpur Nagar,Sickle Cell Disease,35,60,5,2,7
Uttar Pradesh,Kanpur Dehat,Sickle Cell Disease,15,35,0,1,1
Uttar Pradesh,Kanpur Dehat,Sickle Cell Disease,35,60,2,1,3
Tamil Nadu,Kanniyakumari,Sickle Cell Disease,35,60,0,1,1
Uttar Pradesh,Kannauj,Sickle Cell Disease,35,60,0,1,1
Chhattisgarh,Kanker,Sickle Cell Disease,0,6,1,0,1
Chhattisgarh,Kanker,Sickle Cell Disease,6,15,13,4,17
Chhattisgarh,Kanker,Sickle Cell Disease,15,35,6,11,17
Chhattisgarh,Kanker,Sickle Cell Disease,35,60,2,6,8
Chhattisgarh,Kanker,Sickle Cell Disease,60,80,1,2,3
Chhattisgarh,Kanker,Sickle Cell Disease,80,100,1,0,1
Himachal Pradesh,Kangra,Sickle Cell Disease,60,80,1,0,1
Odisha,Kandhamal,Sickle Cell Disease,0,6,43,31,74
Odisha,Kandhamal,Sickle Cell Disease,6,15,245,166,411
Odisha,Kandhamal,Sickle Cell Disease,15,35,229,228,457
Odisha,Kandhamal,Sickle Cell Disease,35,60,54,74,128
Odisha,Kandhamal,Sickle Cell Disease,60,80,1,5,6
Assam,Kamrup Metro,Sickle Cell Disease,35,60,0,1,1
Tamil Nadu,Kallakurichi,Sickle Cell Disease,15,35,0,1,1
Odisha,Kalahandi,Sickle Cell Disease,0,6,1,3,4
Odisha,Kalahandi,Sickle Cell Disease,6,15,21,7,28
Odisha,Kalahandi,Sickle Cell Disease,15,35,31,20,51
Odisha,Kalahandi,Sickle Cell Disease,35,60,8,7,15
Odisha,Kalahandi,Sickle Cell Disease,60,80,1,0,1
Karnataka,Kalaburagi,Sickle Cell Disease,15,35,1,0,1
Karnataka,Kalaburagi,Sickle Cell Disease,35,60,0,2,2
Haryana,Kaithal,Sickle Cell Disease,15,35,1,1,2
Bihar,Kaimur (Bhabua),Sickle Cell Disease,6,15,1,0,1
Bihar,Kaimur (Bhabua),Sickle Cell Disease,15,35,2,1,3
Bihar,Kaimur (Bhabua),Sickle Cell Disease,35,60,2,1,3
Bihar,Kaimur (Bhabua),Sickle Cell Disease,60,80,2,0,2
Chhattisgarh,Kabirdham,Sickle Cell Disease,15,35,0,2,2
Gujarat,Junagadh,Sickle Cell Disease,6,15,2,2,4
Gujarat,Junagadh,Sickle Cell Disease,15,35,0,1,1
Assam,Jorhat,Sickle Cell Disease,6,15,7,6,13
Assam,Jorhat,Sickle Cell Disease,15,35,2,0,2
Haryana,Jind,Sickle Cell Disease,15,35,1,0,1
Rajasthan,Jhunjhunu,Sickle Cell Disease,15,35,1,0,1
Rajasthan,Jhunjhunu,Sickle Cell Disease,35,60,3,0,3
Odisha,Jharsuguda,Sickle Cell Disease,0,6,7,9,16
Odisha,Jharsuguda,Sickle Cell Disease,6,15,34,35,69
Odisha,Jharsuguda,Sickle Cell Disease,15,35,47,35,82
Odisha,Jharsuguda,Sickle Cell Disease,35,60,21,26,47
Odisha,Jharsuguda,Sickle Cell Disease,60,80,0,1,1
Uttar Pradesh,Jhansi,Sickle Cell Disease,15,35,2,0,2
Uttar Pradesh,Jhansi,Sickle Cell Disease,35,60,3,0,3
Rajasthan,Jhalawar,Sickle Cell Disease,15,35,0,1,1
Rajasthan,Jhalawar,Sickle Cell Disease,35,60,1,0,1
Haryana,Jhajjar,Sickle Cell Disease,35,60,5,1,6
Madhya Pradesh,Jhabua,Sickle Cell Disease,15,35,2,0,2
Madhya Pradesh,Jhabua,Sickle Cell Disease,35,60,0,2,2
Madhya Pradesh,Jhabua,Sickle Cell Disease,60,80,0,1,1
Bihar,Jehanabad,Sickle Cell Disease,15,35,1,0,1
Uttar Pradesh,Jaunpur,Sickle Cell Disease,6,15,1,1,2
Uttar Pradesh,Jaunpur,Sickle Cell Disease,15,35,6,3,9
Uttar Pradesh,Jaunpur,Sickle Cell Disease,35,60,9,1,10
Uttar Pradesh,Jaunpur,Sickle Cell Disease,60,80,1,0,1
Chhattisgarh,Jashpur,Sickle Cell Disease,0,6,6,4,10
Chhattisgarh,Jashpur,Sickle Cell Disease,6,15,20,15,35
Chhattisgarh,Jashpur,Sickle Cell Disease,15,35,23,21,44
Chhattisgarh,Jashpur,Sickle Cell Disease,35,60,2,9,11
Chhattisgarh,Jashpur,Sickle Cell Disease,60,80,1,0,1
Chhattisgarh,Janjgir-Champa,Sickle Cell Disease,0,6,1,1,2
Chhattisgarh,Janjgir-Champa,Sickle Cell Disease,6,15,9,4,13
Chhattisgarh,Janjgir-Champa,Sickle Cell Disease,15,35,25,15,40
Chhattisgarh,Janjgir-Champa,Sickle Cell Disease,35,60,2,1,3
Bihar,Jamui,Sickle Cell Disease,15,35,0,1,1
Bihar,Jamui,Sickle Cell Disease,35,60,1,0,1
Jharkhand,Jamtara,Sickle Cell Disease,6,15,2,0,2
Jharkhand,Jamtara,Sickle Cell Disease,15,35,0,1,1
Jharkhand,Jamtara,Sickle Cell Disease,35,60,1,0,1
Gujarat,Jamnagar,Sickle Cell Disease,6,15,1,0,1
Rajasthan,Jalore,Sickle Cell Disease,35,60,2,0,2
Maharashtra,Jalna,Sickle Cell Disease,15,35,1,0,1
Maharashtra,Jalna,Sickle Cell Disease,35,60,1,0,1
Maharashtra,Jalgaon,Sickle Cell Disease,6,15,9,8,17
Maharashtra,Jalgaon,Sickle Cell Disease,15,35,24,11,35
Maharashtra,Jalgaon,Sickle Cell Disease,35,60,9,4,13
Uttar Pradesh,Jalaun,Sickle Cell Disease,15,35,3,1,4
Uttar Pradesh,Jalaun,Sickle Cell Disease,35,60,1,0,1
Uttar Pradesh,Jalaun,Sickle Cell Disease,60,80,2,1,3
Punjab,Jalandhar,Sickle Cell Disease,35,60,1,0,1
Odisha,Jajapur,Sickle Cell Disease,0,6,1,1,2
Odisha,Jajapur,Sickle Cell Disease,6,15,3,5,8
Odisha,Jajapur,Sickle Cell Disease,15,35,11,4,15
Odisha,Jajapur,Sickle Cell Disease,35,60,5,2,7
Rajasthan,Jaipur,Sickle Cell Disease,15,35,1,1,2
Rajasthan,Jaipur,Sickle Cell Disease,35,60,1,1,2
Odisha,Jagatsinghapur,Sickle Cell Disease,6,15,1,0,1
Odisha,Jagatsinghapur,Sickle Cell Disease,15,35,1,1,2
Madhya Pradesh,Jabalpur,Sickle Cell Disease,0,6,10,3,13
Madhya Pradesh,Jabalpur,Sickle Cell Disease,6,15,26,23,49
Madhya Pradesh,Jabalpur,Sickle Cell Disease,15,35,34,35,69
Madhya Pradesh,Jabalpur,Sickle Cell Disease,35,60,8,4,12
Madhya Pradesh,Indore,Sickle Cell Disease,0,6,1,0,1
Madhya Pradesh,Indore,Sickle Cell Disease,6,15,4,1,5
Madhya Pradesh,Indore,Sickle Cell Disease,15,35,5,7,12
Madhya Pradesh,Indore,Sickle Cell Disease,35,60,8,2,10
Madhya Pradesh,Indore,Sickle Cell Disease,60,80,3,0,3
Kerala,Idukki,Sickle Cell Disease,15,35,0,1,1
Punjab,Hoshiarpur,Sickle Cell Disease,35,60,4,0,4
Punjab,Hoshiarpur,Sickle Cell Disease,60,80,0,1,1
Maharashtra,Hingoli,Sickle Cell Disease,15,35,6,4,10
Jharkhand,Hazaribagh,Sickle Cell Disease,6,15,1,0,1
Jharkhand,Hazaribagh,Sickle Cell Disease,15,35,5,0,5
Jharkhand,Hazaribagh,Sickle Cell Disease,35,60,4,0,4
Karnataka,Haveri,Sickle Cell Disease,6,15,1,0,1
Karnataka,Haveri,Sickle Cell Disease,15,35,2,0,2
Karnataka,Haveri,Sickle Cell Disease,35,60,4,3,7
Uttar Pradesh,Hathras,Sickle Cell Disease,15,35,1,0,1
Uttar Pradesh,Hathras,Sickle Cell Disease,35,60,3,0,3
Uttar Pradesh,Hathras,Sickle Cell Disease,60,80,1,0,1
Karnataka,Hassan,Sickle Cell Disease,15,35,1,2,3
Karnataka,Hassan,Sickle Cell Disease,35,60,1,1,2
Karnataka,Hassan,Sickle Cell Disease,60,80,1,0,1
Uttarakhand,Haridwar,Sickle Cell Disease,15,35,3,0,3
Uttarakhand,Haridwar,Sickle Cell Disease,35,60,1,0,1
Uttarakhand,Haridwar,Sickle Cell Disease,60,80,0,1,1
Uttar Pradesh,Hardoi,Sickle Cell Disease,15,35,1,0,1
Uttar Pradesh,Hardoi,Sickle Cell Disease,35,60,7,0,7
Uttar Pradesh,Hardoi,Sickle Cell Disease,60,80,2,0,2
Madhya Pradesh,Harda,Sickle Cell Disease,0,6,0,1,1
Madhya Pradesh,Harda,Sickle Cell Disease,6,15,0,1,1
Madhya Pradesh,Harda,Sickle Cell Disease,15,35,0,1,1
Uttar Pradesh,Hapur,Sickle Cell Disease,15,35,1,0,1
Uttar Pradesh,Hapur,Sickle Cell Disease,60,80,1,0,1
Himachal Pradesh,Hamirpur,Sickle Cell Disease,35,60,1,0,1
Himachal Pradesh,Hamirpur,Sickle Cell Disease,60,80,1,0,1
Uttar Pradesh,Hamirpur,Sickle Cell Disease,6,15,3,0,3
Uttar Pradesh,Hamirpur,Sickle Cell Disease,15,35,2,1,3
Uttar Pradesh,Hamirpur,Sickle Cell Disease,35,60,2,0,2
Uttar Pradesh,Hamirpur,Sickle Cell Disease,60,80,1,0,1
Madhya Pradesh,Gwalior,Sickle Cell Disease,35,60,1,0,1
Punjab,Gurdaspur,Sickle Cell Disease,35,60,1,1,2
Punjab,Gurdaspur,Sickle Cell Disease,60,80,1,0,1
Madhya Pradesh,Guna,Sickle Cell Disease,15,35,1,2,3
Jharkhand,Gumla,Sickle Cell Disease,0,6,1,1,2
Jharkhand,Gumla,Sickle Cell Disease,6,15,15,9,24
Jharkhand,Gumla,Sickle Cell Disease,15,35,12,8,20
Jharkhand,Gumla,Sickle Cell Disease,35,60,9,6,15
Jharkhand,Gumla,Sickle Cell Disease,60,80,2,2,4
Uttar Pradesh,Gorakhpur,Sickle Cell Disease,6,15,2,1,3
Uttar Pradesh,Gorakhpur,Sickle Cell Disease,15,35,9,2,11
Uttar Pradesh,Gorakhpur,Sickle Cell Disease,35,60,3,1,4
Uttar Pradesh,Gorakhpur,Sickle Cell Disease,60,80,3,1,4
Bihar,Gopalganj,Sickle Cell Disease,15,35,0,1,1
Maharashtra,Gondia,Sickle Cell Disease,0,6,6,0,6
Maharashtra,Gondia,Sickle Cell Disease,6,15,39,20,59
Maharashtra,Gondia,Sickle Cell Disease,15,35,88,48,136
Maharashtra,Gondia,Sickle Cell Disease,35,60,13,17,30
Maharashtra,Gondia,Sickle Cell Disease,60,80,1,0,1
Uttar Pradesh,Gonda,Sickle Cell Disease,6,15,0,1,1
Uttar Pradesh,Gonda,Sickle Cell Disease,15,35,12,6,18
Uttar Pradesh,Gonda,Sickle Cell Disease,35,60,14,2,16
Uttar Pradesh,Gonda,Sickle Cell Disease,60,80,2,1,3
Assam,Golaghat,Sickle Cell Disease,6,15,1,0,1
Assam,Golaghat,Sickle Cell Disease,15,35,2,1,3
Jharkhand,Godda,Sickle Cell Disease,15,35,3,1,4
Jharkhand,Godda,Sickle Cell Disease,35,60,2,1,3
Jharkhand,Godda,Sickle Cell Disease,60,80,0,2,2
Assam,Goalpara,Sickle Cell Disease,35,60,0,1,1
Jharkhand,Giridih,Sickle Cell Disease,6,15,1,0,1
Jharkhand,Giridih,Sickle Cell Disease,15,35,3,2,5
Jharkhand,Giridih,Sickle Cell Disease,35,60,2,0,2
Jharkhand,Giridih,Sickle Cell Disease,60,80,1,0,1
Gujarat,Gir Somnath,Sickle Cell Disease,6,15,1,0,1
Uttar Pradesh,Ghazipur,Sickle Cell Disease,15,35,2,1,3
Uttar Pradesh,Ghazipur,Sickle Cell Disease,35,60,2,0,2
Uttar Pradesh,Ghaziabad,Sickle Cell Disease,35,60,1,0,1
Uttar Pradesh,Gautam Buddha Nagar,Sickle Cell Disease,15,35,1,0,1
Uttar Pradesh,Gautam Buddha Nagar,Sickle Cell Disease,35,60,1,0,1
Chhattisgarh,Gaurella Pendra Marwahi,Sickle Cell Disease,0,6,1,0,1
Chhattisgarh,Gaurella Pendra Marwahi,Sickle Cell Disease,6,15,2,5,7
Chhattisgarh,Gaurella Pendra Marwahi,Sickle Cell Disease,15,35,8,12,20
Chhattisgarh,Gaurella Pendra Marwahi,Sickle Cell Disease,35,60,5,1,6
Chhattisgarh,Gariyaband,Sickle Cell Disease,0,6,2,4,6
Chhattisgarh,Gariyaband,Sickle Cell Disease,6,15,10,5,15
Chhattisgarh,Gariyaband,Sickle Cell Disease,15,35,8,15,23
Chhattisgarh,Gariyaband,Sickle Cell Disease,35,60,4,3,7
Jharkhand,Garhwa,Sickle Cell Disease,0,6,4,3,7
Jharkhand,Garhwa,Sickle Cell Disease,6,15,23,7,30
Jharkhand,Garhwa,Sickle Cell Disease,15,35,18,12,30
Jharkhand,Garhwa,Sickle Cell Disease,35,60,7,0,7
Odisha,Ganjam,Sickle Cell Disease,0,6,3,1,4
Odisha,Ganjam,Sickle Cell Disease,6,15,85,33,118
Odisha,Ganjam,Sickle Cell Disease,15,35,35,31,66
Odisha,Ganjam,Sickle Cell Disease,35,60,5,5,10
Gujarat,Gandhinagar,Sickle Cell Disease,15,35,2,0,2
Jammu And Kashmir,Ganderbal,Sickle Cell Disease,15,35,1,4,5
Jammu And Kashmir,Ganderbal,Sickle Cell Disease,35,60,0,4,4
Odisha,Gajapati,Sickle Cell Disease,0,6,8,9,17
Odisha,Gajapati,Sickle Cell Disease,6,15,72,53,125
Odisha,Gajapati,Sickle Cell Disease,15,35,33,27,60
Odisha,Gajapati,Sickle Cell Disease,35,60,5,5,10
Maharashtra,Gadchiroli,Sickle Cell Disease,0,6,4,7,11
Maharashtra,Gadchiroli,Sickle Cell Disease,6,15,52,58,110
Maharashtra,Gadchiroli,Sickle Cell Disease,15,35,134,120,254
Maharashtra,Gadchiroli,Sickle Cell Disease,35,60,42,34,76
Maharashtra,Gadchiroli,Sickle Cell Disease,60,80,1,2,3
Karnataka,Gadag,Sickle Cell Disease,35,60,1,0,1
Uttar Pradesh,Firozabad,Sickle Cell Disease,6,15,0,1,1
Uttar Pradesh,Firozabad,Sickle Cell Disease,15,35,1,3,4
Uttar Pradesh,Firozabad,Sickle Cell Disease,35,60,3,0,3
Punjab,Ferozepur,Sickle Cell Disease,35,60,2,0,2
Uttar Pradesh,Fatehpur,Sickle Cell Disease,15,35,1,1,2
Uttar Pradesh,Fatehpur,Sickle Cell Disease,35,60,6,1,7
Uttar Pradesh,Fatehpur,Sickle Cell Disease,60,80,1,0,1
Punjab,Fatehgarh Sahib,Sickle Cell Disease,15,35,1,0,1
Punjab,Fatehgarh Sahib,Sickle Cell Disease,35,60,1,1,2
Haryana,Fatehabad,Sickle Cell Disease,35,60,1,0,1
Uttar Pradesh,Farrukhabad,Sickle Cell Disease,15,35,3,0,3
Uttar Pradesh,Farrukhabad,Sickle Cell Disease,35,60,1,3,4
Uttar Pradesh,Farrukhabad,Sickle Cell Disease,60,80,3,0,3
Uttar Pradesh,Farrukhabad,Sickle Cell Disease,80,100,1,0,1
Uttar Pradesh,Etawah,Sickle Cell Disease,15,35,5,4,9
Uttar Pradesh,Etawah,Sickle Cell Disease,35,60,12,3,15
Uttar Pradesh,Etawah,Sickle Cell Disease,60,80,8,0,8
Uttar Pradesh,Etah,Sickle Cell Disease,15,35,1,0,1
Uttar Pradesh,Etah,Sickle Cell Disease,60,80,1,0,1
Tamil Nadu,Erode,Sickle Cell Disease,6,15,2,0,2
Tamil Nadu,Erode,Sickle Cell Disease,15,35,1,0,1
Tamil Nadu,Erode,Sickle Cell Disease,35,60,1,0,1
Jharkhand,East Singhbum,Sickle Cell Disease,6,15,2,1,3
Jharkhand,East Singhbum,Sickle Cell Disease,15,35,5,3,8
Jharkhand,East Singhbum,Sickle Cell Disease,35,60,2,1,3
Madhya Pradesh,East Nimar,Sickle Cell Disease,6,15,6,7,13
Madhya Pradesh,East Nimar,Sickle Cell Disease,15,35,10,1,11
Madhya Pradesh,East Nimar,Sickle Cell Disease,35,60,4,0,4
Chhattisgarh,Durg,Sickle Cell Disease,0,6,1,1,2
Chhattisgarh,Durg,Sickle Cell Disease,6,15,17,8,25
Chhattisgarh,Durg,Sickle Cell Disease,15,35,30,21,51
Chhattisgarh,Durg,Sickle Cell Disease,35,60,7,4,11
Jharkhand,Dumka,Sickle Cell Disease,15,35,1,0,1
Jharkhand,Dumka,Sickle Cell Disease,35,60,1,1,2
Gujarat,Dohad,Sickle Cell Disease,0,6,5,0,5
Gujarat,Dohad,Sickle Cell Disease,6,15,46,37,83
Gujarat,Dohad,Sickle Cell Disease,15,35,90,57,147
Gujarat,Dohad,Sickle Cell Disease,35,60,36,31,67
Gujarat,Dohad,Sickle Cell Disease,60,80,4,4,8
Madhya Pradesh,Dindori,Sickle Cell Disease,0,6,11,15,26
Madhya Pradesh,Dindori,Sickle Cell Disease,6,15,59,42,101
Madhya Pradesh,Dindori,Sickle Cell Disease,15,35,63,77,140
Madhya Pradesh,Dindori,Sickle Cell Disease,35,60,12,11,23
Madhya Pradesh,Dindori,Sickle Cell Disease,60,80,1,0,1
Tamil Nadu,Dindigul,Sickle Cell Disease,15,35,1,0,1
Tamil Nadu,Dindigul,Sickle Cell Disease,35,60,1,0,1
Assam,Dibrugarh,Sickle Cell Disease,6,15,1,1,2
Assam,Dibrugarh,Sickle Cell Disease,15,35,3,1,4
Assam,Dibrugarh,Sickle Cell Disease,35,60,0,1,1
Maharashtra,Dhule,Sickle Cell Disease,0,6,0,1,1
Maharashtra,Dhule,Sickle Cell Disease,6,15,0,2,2
Maharashtra,Dhule,Sickle Cell Disease,15,35,9,4,13
Maharashtra,Dhule,Sickle Cell Disease,35,60,5,2,7
Odisha,Dhenkanal,Sickle Cell Disease,0,6,12,8,20
Odisha,Dhenkanal,Sickle Cell Disease,6,15,116,62,178
Odisha,Dhenkanal,Sickle Cell Disease,15,35,113,72,185
Odisha,Dhenkanal,Sickle Cell Disease,35,60,31,28,59
Odisha,Dhenkanal,Sickle Cell Disease,60,80,1,2,3
Tamil Nadu,Dharmapuri,Sickle Cell Disease,6,15,1,0,1
Tamil Nadu,Dharmapuri,Sickle Cell Disease,15,35,1,0,1
Madhya Pradesh,Dhar,Sickle Cell Disease,0,6,0,1,1
Madhya Pradesh,Dhar,Sickle Cell Disease,6,15,10,5,15
Madhya Pradesh,Dhar,Sickle Cell Disease,15,35,25,24,49
Madhya Pradesh,Dhar,Sickle Cell Disease,35,60,7,1,8
Madhya Pradesh,Dhar,Sickle Cell Disease,60,80,1,0,1
Jharkhand,Dhanbad,Sickle Cell Disease,15,35,4,0,4
Jharkhand,Dhanbad,Sickle Cell Disease,35,60,3,0,3
Chhattisgarh,Dhamtari,Sickle Cell Disease,6,15,6,9,15
Chhattisgarh,Dhamtari,Sickle Cell Disease,15,35,11,11,22
Chhattisgarh,Dhamtari,Sickle Cell Disease,35,60,1,0,1
Madhya Pradesh,Dewas,Sickle Cell Disease,6,15,1,0,1
Madhya Pradesh,Dewas,Sickle Cell Disease,15,35,0,1,1
Madhya Pradesh,Dewas,Sickle Cell Disease,35,60,1,0,1
Uttar Pradesh,Deoria,Sickle Cell Disease,15,35,5,1,6
Uttar Pradesh,Deoria,Sickle Cell Disease,35,60,7,1,8
Uttar Pradesh,Deoria,Sickle Cell Disease,60,80,1,1,2
Jharkhand,Deoghar,Sickle Cell Disease,35,60,1,0,1
Odisha,Deogarh,Sickle Cell Disease,0,6,4,8,12
Odisha,Deogarh,Sickle Cell Disease,6,15,87,49,136
Odisha,Deogarh,Sickle Cell Disease,15,35,108,110,218
Odisha,Deogarh,Sickle Cell Disease,35,60,33,43,76
Odisha,Deogarh,Sickle Cell Disease,60,80,1,2,3
Uttarakhand,Dehradun,Sickle Cell Disease,15,35,1,0,1
Uttarakhand,Dehradun,Sickle Cell Disease,35,60,1,0,1
Karnataka,Davangere,Sickle Cell Disease,15,35,0,1,1
Karnataka,Davangere,Sickle Cell Disease,35,60,1,0,1
Rajasthan,Dausa,Sickle Cell Disease,35,60,2,1,3
Madhya Pradesh,Datia,Sickle Cell Disease,15,35,0,1,1
Madhya Pradesh,Datia,Sickle Cell Disease,35,60,1,0,1
Assam,Darrang,Sickle Cell Disease,35,60,1,1,2
Bihar,Darbhanga,Sickle Cell Disease,0,6,1,0,1
Bihar,Darbhanga,Sickle Cell Disease,15,35,0,1,1
Bihar,Darbhanga,Sickle Cell Disease,35,60,1,0,1
Chhattisgarh,Dantewada,Sickle Cell Disease,6,15,2,2,4
Chhattisgarh,Dantewada,Sickle Cell Disease,15,35,26,9,35
Chhattisgarh,Dantewada,Sickle Cell Disease,35,60,6,3,9
Chhattisgarh,Dantewada,Sickle Cell Disease,60,80,0,2,2
Gujarat,Dang,Sickle Cell Disease,15,35,1,0,1
Madhya Pradesh,Damoh,Sickle Cell Disease,6,15,1,0,1
Madhya Pradesh,Damoh,Sickle Cell Disease,15,35,3,1,4
Madhya Pradesh,Damoh,Sickle Cell Disease,35,60,2,2,4
Madhya Pradesh,Damoh,Sickle Cell Disease,60,80,1,1,2
Karnataka,Dakshina Kannada,Sickle Cell Disease,6,15,1,0,1
Dadra Nagar Haveli And Daman And Diu,Dadra And Nagar Haveli,Sickle Cell Disease,0,6,11,18,29
Dadra Nagar Haveli And Daman And Diu,Dadra And Nagar Haveli,Sickle Cell Disease,6,15,64,59,123
Dadra Nagar Haveli And Daman And Diu,Dadra And Nagar Haveli,Sickle Cell Disease,15,35,97,120,217
Dadra Nagar Haveli And Daman And Diu,Dadra And Nagar Haveli,Sickle Cell Disease,35,60,19,39,58
Dadra Nagar Haveli And Daman And Diu,Dadra And Nagar Haveli,Sickle Cell Disease,60,80,5,2,7
Odisha,Cuttack,Sickle Cell Disease,6,15,4,1,5
Odisha,Cuttack,Sickle Cell Disease,15,35,6,5,11
Odisha,Cuttack,Sickle Cell Disease,35,60,5,3,8
Odisha,Cuttack,Sickle Cell Disease,60,80,1,0,1
Tamil Nadu,Cuddalore,Sickle Cell Disease,15,35,1,0,1
Rajasthan,Chittorgarh,Sickle Cell Disease,35,60,2,1,3
Uttar Pradesh,Chitrakoot,Sickle Cell Disease,15,35,5,0,5
Uttar Pradesh,Chitrakoot,Sickle Cell Disease,35,60,2,1,3
Uttar Pradesh,Chitrakoot,Sickle Cell Disease,60,80,2,0,2
Karnataka,Chitradurga,Sickle Cell Disease,15,35,1,1,2
Karnataka,Chikkamagaluru,Sickle Cell Disease,15,35,1,0,1
Karnataka,Chikkamagaluru,Sickle Cell Disease,35,60,1,1,2
Karnataka,Chikkamagaluru,Sickle Cell Disease,60,80,0,1,1
Karnataka,Chikkaballapura,Sickle Cell Disease,35,60,1,0,1
Gujarat,Chhotaudepur,Sickle Cell Disease,0,6,3,0,3
Gujarat,Chhotaudepur,Sickle Cell Disease,6,15,16,9,25
Gujarat,Chhotaudepur,Sickle Cell Disease,15,35,28,24,52
Gujarat,Chhotaudepur,Sickle Cell Disease,35,60,7,5,12
Madhya Pradesh,Chhindwara,Sickle Cell Disease,0,6,8,8,16
Madhya Pradesh,Chhindwara,Sickle Cell Disease,6,15,43,18,61
Madhya Pradesh,Chhindwara,Sickle Cell Disease,15,35,51,43,94
Madhya Pradesh,Chhindwara,Sickle Cell Disease,35,60,13,6,19
Madhya Pradesh,Chhatarpur,Sickle Cell Disease,15,35,2,1,3
Madhya Pradesh,Chhatarpur,Sickle Cell Disease,35,60,2,1,3
Tamil Nadu,Chengalpattu,Sickle Cell Disease,0,6,1,0,1
Tamil Nadu,Chengalpattu,Sickle Cell Disease,35,60,1,0,1
Maharashtra,Chandrapur,Sickle Cell Disease,0,6,4,6,10
Maharashtra,Chandrapur,Sickle Cell Disease,6,15,109,104,213
Maharashtra,Chandrapur,Sickle Cell Disease,15,35,174,149,323
Maharashtra,Chandrapur,Sickle Cell Disease,35,60,40,37,77
Maharashtra,Chandrapur,Sickle Cell Disease,60,80,6,3,9
Uttarakhand,Champawat,Sickle Cell Disease,15,35,1,1,2
Uttarakhand,Champawat,Sickle Cell Disease,35,60,1,0,1
Uttarakhand,Chamoli,Sickle Cell Disease,60,80,0,1,1
Karnataka,Chamarajanagara,Sickle Cell Disease,6,15,1,2,3
Karnataka,Chamarajanagara,Sickle Cell Disease,15,35,1,0,1
Delhi,Central,Sickle Cell Disease,35,60,1,0,1
Bihar,Buxar,Sickle Cell Disease,35,60,0,1,1
Bihar,Buxar,Sickle Cell Disease,60,80,1,0,1
Madhya Pradesh,Burhanpur,Sickle Cell Disease,6,15,1,1,2
Madhya Pradesh,Burhanpur,Sickle Cell Disease,15,35,3,1,4
Rajasthan,Bundi,Sickle Cell Disease,6,15,1,0,1
Rajasthan,Bundi,Sickle Cell Disease,35,60,0,1,1
Maharashtra,Buldhana,Sickle Cell Disease,0,6,4,2,6
Maharashtra,Buldhana,Sickle Cell Disease,6,15,21,12,33
Maharashtra,Buldhana,Sickle Cell Disease,15,35,29,12,41
Maharashtra,Buldhana,Sickle Cell Disease,35,60,6,8,14
Uttar Pradesh,Bulandshahr,Sickle Cell Disease,15,35,0,1,1
Uttar Pradesh,Bulandshahr,Sickle Cell Disease,35,60,2,1,3
Jammu And Kashmir,Budgam,Sickle Cell Disease,15,35,1,0,1
Odisha,Boudh,Sickle Cell Disease,0,6,7,2,9
Odisha,Boudh,Sickle Cell Disease,6,15,34,31,65
Odisha,Boudh,Sickle Cell Disease,15,35,31,16,47
Odisha,Boudh,Sickle Cell Disease,35,60,8,6,14
Assam,Bongaigaon,Sickle Cell Disease,15,35,0,1,1
Jharkhand,Bokaro,Sickle Cell Disease,0,6,0,2,2
Jharkhand,Bokaro,Sickle Cell Disease,6,15,2,0,2
Jharkhand,Bokaro,Sickle Cell Disease,15,35,16,5,21
Jharkhand,Bokaro,Sickle Cell Disease,35,60,19,5,24
Chhattisgarh,Bilaspur,Sickle Cell Disease,0,6,1,1,2
Chhattisgarh,Bilaspur,Sickle Cell Disease,6,15,9,10,19
Chhattisgarh,Bilaspur,Sickle Cell Disease,15,35,40,32,72
Chhattisgarh,Bilaspur,Sickle Cell Disease,35,60,9,5,14
Rajasthan,Bikaner,Sickle Cell Disease,15,35,2,0,2
Rajasthan,Bikaner,Sickle Cell Disease,35,60,0,1,1
Uttar Pradesh,Bijnor,Sickle Cell Disease,6,15,2,0,2
Uttar Pradesh,Bijnor,Sickle Cell Disease,15,35,3,0,3
Uttar Pradesh,Bijnor,Sickle Cell Disease,35,60,5,0,5
Chhattisgarh,Bijapur,Sickle Cell Disease,0,6,0,1,1
Chhattisgarh,Bijapur,Sickle Cell Disease,6,15,6,11,17
Chhattisgarh,Bijapur,Sickle Cell Disease,15,35,7,13,20
Chhattisgarh,Bijapur,Sickle Cell Disease,35,60,1,1,2
Karnataka,Bidar,Sickle Cell Disease,6,15,0,1,1
Karnataka,Bidar,Sickle Cell Disease,15,35,0,1,1
Karnataka,Bidar,Sickle Cell Disease,35,60,4,2,6
Madhya Pradesh,Bhopal,Sickle Cell Disease,6,15,1,1,2
Madhya Pradesh,Bhopal,Sickle Cell Disease,15,35,15,9,24
Madhya Pradesh,Bhopal,Sickle Cell Disease,35,60,10,7,17
Madhya Pradesh,Bhopal,Sickle Cell Disease,60,80,4,0,4
Bihar,Bhojpur,Sickle Cell Disease,15,35,3,2,5
Bihar,Bhojpur,Sickle Cell Disease,35,60,1,1,2
Bihar,Bhojpur,Sickle Cell Disease,60,80,0,1,1
Haryana,Bhiwani,Sickle Cell Disease,35,60,0,1,1
Haryana,Bhiwani,Sickle Cell Disease,60,80,1,0,1
Madhya Pradesh,Bhind,Sickle Cell Disease,35,60,1,0,1
Madhya Pradesh,Bhind,Sickle Cell Disease,60,80,2,0,2
Rajasthan,Bhilwara,Sickle Cell Disease,35,60,2,0,2
Gujarat,Bhavnagar,Sickle Cell Disease,15,35,5,0,5
Gujarat,Bhavnagar,Sickle Cell Disease,35,60,0,1,1
Gujarat,Bharuch,Sickle Cell Disease,0,6,6,6,12
Gujarat,Bharuch,Sickle Cell Disease,6,15,81,70,151
Gujarat,Bharuch,Sickle Cell Disease,15,35,70,118,188
Gujarat,Bharuch,Sickle Cell Disease,35,60,16,20,36
Gujarat,Bharuch,Sickle Cell Disease,60,80,0,3,3
Maharashtra,Bhandara,Sickle Cell Disease,0,6,4,5,9
Maharashtra,Bhandara,Sickle Cell Disease,6,15,48,37,85
Maharashtra,Bhandara,Sickle Cell Disease,15,35,83,54,137
Maharashtra,Bhandara,Sickle Cell Disease,35,60,20,28,48
Maharashtra,Bhandara,Sickle Cell Disease,60,80,0,1,1
Bihar,Bhagalpur,Sickle Cell Disease,6,15,1,0,1
Bihar,Bhagalpur,Sickle Cell Disease,15,35,2,2,4
Bihar,Bhagalpur,Sickle Cell Disease,35,60,4,1,5
Odisha,Bhadrak,Sickle Cell Disease,6,15,4,3,7
Odisha,Bhadrak,Sickle Cell Disease,15,35,2,2,4
Odisha,Bhadrak,Sickle Cell Disease,35,60,3,1,4
Odisha,Bhadrak,Sickle Cell Disease,60,80,0,1,1
Madhya Pradesh,Betul,Sickle Cell Disease,0,6,5,4,9
Madhya Pradesh,Betul,Sickle Cell Disease,6,15,26,18,44
Madhya Pradesh,Betul,Sickle Cell Disease,15,35,32,35,67
Madhya Pradesh,Betul,Sickle Cell Disease,35,60,16,7,23
Madhya Pradesh,Betul,Sickle Cell Disease,60,80,0,1,1
Karnataka,Bengaluru Urban,Sickle Cell Disease,15,35,1,1,2
Karnataka,Bengaluru Urban,Sickle Cell Disease,35,60,1,0,1
Chhattisgarh,Bemetara,Sickle Cell Disease,15,35,4,2,6
Chhattisgarh,Bemetara,Sickle Cell Disease,35,60,0,1,1
Karnataka,Belagavi,Sickle Cell Disease,15,35,0,1,1
Karnataka,Belagavi,Sickle Cell Disease,35,60,4,1,5
Bihar,Begusarai,Sickle Cell Disease,0,6,1,1,2
Bihar,Begusarai,Sickle Cell Disease,6,15,0,1,1
Bihar,Begusarai,Sickle Cell Disease,15,35,1,1,2
Bihar,Begusarai,Sickle Cell Disease,35,60,2,1,3
Maharashtra,Beed,Sickle Cell Disease,0,6,0,1,1
Maharashtra,Beed,Sickle Cell Disease,6,15,2,0,2
Maharashtra,Beed,Sickle Cell Disease,35,60,1,0,1
Punjab,Bathinda,Sickle Cell Disease,35,60,0,1,1
Punjab,Bathinda,Sickle Cell Disease,60,80,0,1,1
Uttar Pradesh,Basti,Sickle Cell Disease,15,35,1,0,1
Uttar Pradesh,Basti,Sickle Cell Disease,35,60,3,0,3
Chhattisgarh,Bastar,Sickle Cell Disease,0,6,7,3,10
Chhattisgarh,Bastar,Sickle Cell Disease,6,15,65,85,150
Chhattisgarh,Bastar,Sickle Cell Disease,15,35,80,125,205
Chhattisgarh,Bastar,Sickle Cell Disease,35,60,13,6,19
Madhya Pradesh,Barwani,Sickle Cell Disease,0,6,14,13,27
Madhya Pradesh,Barwani,Sickle Cell Disease,6,15,85,56,141
Madhya Pradesh,Barwani,Sickle Cell Disease,15,35,114,71,185
Madhya Pradesh,Barwani,Sickle Cell Disease,35,60,17,15,32
Madhya Pradesh,Barwani,Sickle Cell Disease,60,80,1,0,1
Assam,Barpeta,Sickle Cell Disease,6,15,1,0,1
Assam,Barpeta,Sickle Cell Disease,15,35,2,2,4
Assam,Barpeta,Sickle Cell Disease,35,60,1,0,1
Assam,Barpeta,Sickle Cell Disease,60,80,0,1,1
Punjab,Barnala,Sickle Cell Disease,35,60,1,0,1
Rajasthan,Barmer,Sickle Cell Disease,35,60,1,0,1
Odisha,Bargarh,Sickle Cell Disease,0,6,5,4,9
Odisha,Bargarh,Sickle Cell Disease,6,15,67,28,95
Odisha,Bargarh,Sickle Cell Disease,15,35,75,70,145
Odisha,Bargarh,Sickle Cell Disease,35,60,51,18,69
Odisha,Bargarh,Sickle Cell Disease,60,80,7,2,9
Uttar Pradesh,Bareilly,Sickle Cell Disease,15,35,5,1,6
Uttar Pradesh,Bareilly,Sickle Cell Disease,35,60,7,0,7
Uttar Pradesh,Bareilly,Sickle Cell Disease,60,80,1,0,1
Jammu And Kashmir,Baramulla,Sickle Cell Disease,6,15,0,1,1
Jammu And Kashmir,Baramulla,Sickle Cell Disease,35,60,4,1,5
Jammu And Kashmir,Baramulla,Sickle Cell Disease,60,80,1,0,1
Uttar Pradesh,Barabanki,Sickle Cell Disease,15,35,2,0,2
Uttar Pradesh,Barabanki,Sickle Cell Disease,35,60,3,3,6
Rajasthan,Banswara,Sickle Cell Disease,0,6,1,0,1
Rajasthan,Banswara,Sickle Cell Disease,6,15,0,1,1
Rajasthan,Banswara,Sickle Cell Disease,15,35,0,3,3
Bihar,Banka,Sickle Cell Disease,15,35,2,0,2
Bihar,Banka,Sickle Cell Disease,35,60,1,0,1
Bihar,Banka,Sickle Cell Disease,60,80,1,0,1
Jammu And Kashmir,Bandipora,Sickle Cell Disease,0,6,1,0,1
Jammu And Kashmir,Bandipora,Sickle Cell Disease,6,15,1,0,1
Jammu And Kashmir,Bandipora,Sickle Cell Disease,15,35,1,1,2
Uttar Pradesh,Banda,Sickle Cell Disease,35,60,2,0,2
Gujarat,Banas Kantha,Sickle Cell Disease,6,15,14,20,34
Gujarat,Banas Kantha,Sickle Cell Disease,15,35,27,24,51
Gujarat,Banas Kantha,Sickle Cell Disease,35,60,1,1,2
Gujarat,Banas Kantha,Sickle Cell Disease,60,80,1,1,2
Chhattisgarh,Balrampur,Sickle Cell Disease,0,6,2,3,5
Chhattisgarh,Balrampur,Sickle Cell Disease,6,15,4,8,12
Chhattisgarh,Balrampur,Sickle Cell Disease,15,35,24,11,35
Chhattisgarh,Balrampur,Sickle Cell Disease,35,60,5,2,7
Uttar Pradesh,Balrampur,Sickle Cell Disease,15,35,2,0,2
Uttar Pradesh,Balrampur,Sickle Cell Disease,35,60,2,0,2
Chhattisgarh,Baloda Bazar,Sickle Cell Disease,15,35,1,1,2
Chhattisgarh,Baloda Bazar,Sickle Cell Disease,35,60,3,0,3
Chhattisgarh,Baloda Bazar,Sickle Cell Disease,60,80,1,0,1
Chhattisgarh,Balod,Sickle Cell Disease,0,6,0,1,1
Chhattisgarh,Balod,Sickle Cell Disease,6,15,1,1,2
Chhattisgarh,Balod,Sickle Cell Disease,15,35,2,1,3
Uttar Pradesh,Ballia,Sickle Cell Disease,35,60,3,1,4
Uttar Pradesh,Ballia,Sickle Cell Disease,60,80,1,0,1
Karnataka,Ballari,Sickle Cell Disease,6,15,0,3,3
Karnataka,Ballari,Sickle Cell Disease,15,35,2,4,6
Karnataka,Ballari,Sickle Cell Disease,35,60,3,1,4
Karnataka,Ballari,Sickle Cell Disease,60,80,0,1,1
Odisha,Baleshwar,Sickle Cell Disease,0,6,1,0,1
Odisha,Baleshwar,Sickle Cell Disease,6,15,5,2,7
Odisha,Baleshwar,Sickle Cell Disease,15,35,12,4,16
Odisha,Baleshwar,Sickle Cell Disease,35,60,16,7,23
Odisha,Baleshwar,Sickle Cell Disease,60,80,5,0,5
Odisha,Balangir,Sickle Cell Disease,0,6,119,41,160
Odisha,Balangir,Sickle Cell Disease,6,15,447,309,756
Odisha,Balangir,Sickle Cell Disease,15,35,705,617,1322
Odisha,Balangir,Sickle Cell Disease,35,60,236,266,502
Odisha,Balangir,Sickle Cell Disease,60,80,28,21,49
Madhya Pradesh,Balaghat,Sickle Cell Disease,0,6,27,30,57
Madhya Pradesh,Balaghat,Sickle Cell Disease,6,15,93,77,170
Madhya Pradesh,Balaghat,Sickle Cell Disease,15,35,95,108,203
Madhya Pradesh,Balaghat,Sickle Cell Disease,35,60,16,18,34
Madhya Pradesh,Balaghat,Sickle Cell Disease,60,80,1,1,2
Assam,Baksa,Sickle Cell Disease,35,60,1,0,1
Uttar Pradesh,Bahraich,Sickle Cell Disease,35,60,1,2,3
Uttar Pradesh,Baghpat,Sickle Cell Disease,15,35,1,0,1
Uttar Pradesh,Baghpat,Sickle Cell Disease,35,60,2,0,2
Uttarakhand,Bageshwar,Sickle Cell Disease,15,35,1,0,1
Uttarakhand,Bageshwar,Sickle Cell Disease,35,60,3,1,4
Uttarakhand,Bageshwar,Sickle Cell Disease,60,80,1,0,1
Karnataka,Bagalkote,Sickle Cell Disease,6,15,1,0,1
Karnataka,Bagalkote,Sickle Cell Disease,15,35,0,1,1
Karnataka,Bagalkote,Sickle Cell Disease,35,60,1,0,1
Uttar Pradesh,Azamgarh,Sickle Cell Disease,6,15,1,0,1
Uttar Pradesh,Ayodhya,Sickle Cell Disease,15,35,2,0,2
Uttar Pradesh,Ayodhya,Sickle Cell Disease,60,80,1,1,2
Bihar,Aurangabad,Sickle Cell Disease,15,35,2,1,3
Maharashtra,Aurangabad,Sickle Cell Disease,6,15,1,0,1
Maharashtra,Aurangabad,Sickle Cell Disease,15,35,9,3,12
Maharashtra,Aurangabad,Sickle Cell Disease,35,60,2,2,4
Uttar Pradesh,Auraiya,Sickle Cell Disease,15,35,1,0,1
Uttar Pradesh,Auraiya,Sickle Cell Disease,35,60,0,4,4
Bihar,Arwal,Sickle Cell Disease,15,35,1,0,1
Gujarat,Arvalli,Sickle Cell Disease,35,60,1,0,1
Bihar,Araria,Sickle Cell Disease,15,35,2,0,2
Bihar,Araria,Sickle Cell Disease,35,60,1,0,1
Madhya Pradesh,Anuppur,Sickle Cell Disease,0,6,5,3,8
Madhya Pradesh,Anuppur,Sickle Cell Disease,6,15,33,38,71
Madhya Pradesh,Anuppur,Sickle Cell Disease,15,35,53,66,119
Madhya Pradesh,Anuppur,Sickle Cell Disease,35,60,11,8,19
Odisha,Anugul,Sickle Cell Disease,0,6,18,8,26
Odisha,Anugul,Sickle Cell Disease,6,15,138,55,193
Odisha,Anugul,Sickle Cell Disease,15,35,176,127,303
Odisha,Anugul,Sickle Cell Disease,35,60,56,44,100
Odisha,Anugul,Sickle Cell Disease,60,80,0,1,1
Jammu And Kashmir,Anantnag,Sickle Cell Disease,6,15,1,0,1
Jammu And Kashmir,Anantnag,Sickle Cell Disease,35,60,1,1,2
Gujarat,Anand,Sickle Cell Disease,6,15,1,0,1
Uttar Pradesh,Amroha,Sickle Cell Disease,15,35,1,2,3
Uttar Pradesh,Amroha,Sickle Cell Disease,35,60,3,0,3
Uttar Pradesh,Amroha,Sickle Cell Disease,60,80,1,0,1
Punjab,Amritsar,Sickle Cell Disease,15,35,1,0,1
Maharashtra,Amravati,Sickle Cell Disease,0,6,3,6,9
Maharashtra,Amravati,Sickle Cell Disease,6,15,31,19,50
Maharashtra,Amravati,Sickle Cell Disease,15,35,58,45,103
Maharashtra,Amravati,Sickle Cell Disease,35,60,19,11,30
Maharashtra,Amravati,Sickle Cell Disease,60,80,1,1,2
Uttar Pradesh,Amethi,Sickle Cell Disease,15,35,1,0,1
Uttar Pradesh,Ambedkar Nagar,Sickle Cell Disease,15,35,1,1,2
Uttar Pradesh,Ambedkar Nagar,Sickle Cell Disease,35,60,1,0,1
Haryana,Ambala,Sickle Cell Disease,35,60,0,1,1
Rajasthan,Alwar,Sickle Cell Disease,35,60,1,2,3
Rajasthan,Alwar,Sickle Cell Disease,60,80,1,0,1
Uttarakhand,Almora,Sickle Cell Disease,35,60,0,1,1
Madhya Pradesh,Alirajpur,Sickle Cell Disease,15,35,2,2,4
Madhya Pradesh,Alirajpur,Sickle Cell Disease,35,60,3,3,6
Uttar Pradesh,Aligarh,Sickle Cell Disease,15,35,5,1,6
Uttar Pradesh,Aligarh,Sickle Cell Disease,35,60,5,2,7
Uttar Pradesh,Aligarh,Sickle Cell Disease,60,80,1,0,1
Maharashtra,Akola,Sickle Cell Disease,0,6,4,4,8
Maharashtra,Akola,Sickle Cell Disease,6,15,20,17,37
Maharashtra,Akola,Sickle Cell Disease,15,35,47,40,87
Maharashtra,Akola,Sickle Cell Disease,35,60,12,6,18
Gujarat,Ahmadabad,Sickle Cell Disease,35,60,0,1,1
Uttar Pradesh,Agra,Sickle Cell Disease,35,60,1,0,1
Maharashtra,Yavatmal,Specific Learning Disabilities,6,15,1,1,2
Maharashtra,Yavatmal,Specific Learning Disabilities,15,35,2,0,2
Maharashtra,Yavatmal,Specific Learning Disabilities,35,60,0,1,1
Haryana,Yamunanagar,Specific Learning Disabilities,15,35,1,0,1
Haryana,Yamunanagar,Specific Learning Disabilities,35,60,1,0,1
Karnataka,Yadgir,Specific Learning Disabilities,35,60,0,1,1
Jharkhand,West Singhbhum,Specific Learning Disabilities,15,35,1,0,1
Jharkhand,West Singhbhum,Specific Learning Disabilities,35,60,1,1,2
Jharkhand,West Singhbhum,Specific Learning Disabilities,60,80,1,0,1
Meghalaya,West Khasi Hills,Specific Learning Disabilities,6,15,1,0,1
Meghalaya,West Khasi Hills,Specific Learning Disabilities,15,35,1,1,2
Meghalaya,West Jaintia Hills,Specific Learning Disabilities,6,15,1,0,1
Meghalaya,West Jaintia Hills,Specific Learning Disabilities,15,35,4,1,5
Delhi,West,Specific Learning Disabilities,6,15,24,9,33
Delhi,West,Specific Learning Disabilities,15,35,48,20,68
Kerala,Wayanad,Specific Learning Disabilities,6,15,2,0,2
Kerala,Wayanad,Specific Learning Disabilities,15,35,3,2,5
Maharashtra,Washim,Specific Learning Disabilities,6,15,50,41,91
Maharashtra,Washim,Specific Learning Disabilities,15,35,12,8,20
Maharashtra,Wardha,Specific Learning Disabilities,15,35,1,0,1
Andhra Pradesh,Visakhapatanam,Specific Learning Disabilities,6,15,1,0,1
Tamil Nadu,Virudhunagar,Specific Learning Disabilities,0,6,1,0,1
Tamil Nadu,Virudhunagar,Specific Learning Disabilities,6,15,54,13,67
Tamil Nadu,Virudhunagar,Specific Learning Disabilities,15,35,11,15,26
Tamil Nadu,Virudhunagar,Specific Learning Disabilities,35,60,1,0,1
Tamil Nadu,Villupuram,Specific Learning Disabilities,6,15,3,3,6
Tamil Nadu,Villupuram,Specific Learning Disabilities,15,35,3,1,4
Tamil Nadu,Villupuram,Specific Learning Disabilities,60,80,1,0,1
Karnataka,Vijayapura,Specific Learning Disabilities,35,60,4,0,4
Madhya Pradesh,Vidisha,Specific Learning Disabilities,6,15,2,2,4
Madhya Pradesh,Vidisha,Specific Learning Disabilities,15,35,5,3,8
Madhya Pradesh,Vidisha,Specific Learning Disabilities,35,60,3,2,5
Madhya Pradesh,Vidisha,Specific Learning Disabilities,60,80,4,0,4
Madhya Pradesh,Vidisha,Specific Learning Disabilities,80,100,1,0,1
Tamil Nadu,Vellore,Specific Learning Disabilities,6,15,2,1,3
Tamil Nadu,Vellore,Specific Learning Disabilities,15,35,11,8,19
Tamil Nadu,Vellore,Specific Learning Disabilities,35,60,3,3,6
Tamil Nadu,Vellore,Specific Learning Disabilities,60,80,1,0,1
Uttar Pradesh,Varanasi,Specific Learning Disabilities,6,15,1,0,1
Uttar Pradesh,Varanasi,Specific Learning Disabilities,15,35,1,1,2
Gujarat,Valsad,Specific Learning Disabilities,6,15,9,0,9
Gujarat,Valsad,Specific Learning Disabilities,15,35,2,3,5
Gujarat,Valsad,Specific Learning Disabilities,35,60,1,0,1
Bihar,Vaishali,Specific Learning Disabilities,6,15,0,1,1
Bihar,Vaishali,Specific Learning Disabilities,15,35,7,1,8
Bihar,Vaishali,Specific Learning Disabilities,35,60,4,0,4
Gujarat,Vadodara,Specific Learning Disabilities,6,15,24,18,42
Gujarat,Vadodara,Specific Learning Disabilities,15,35,50,19,69
Karnataka,Uttara Kannada,Specific Learning Disabilities,6,15,3,0,3
Karnataka,Uttara Kannada,Specific Learning Disabilities,15,35,2,1,3
Uttarakhand,Uttar Kashi,Specific Learning Disabilities,35,60,0,1,1
Uttar Pradesh,Unnao,Specific Learning Disabilities,15,35,1,1,2
Uttar Pradesh,Unnao,Specific Learning Disabilities,35,60,3,0,3
Himachal Pradesh,Una,Specific Learning Disabilities,15,35,1,0,1
Himachal Pradesh,Una,Specific Learning Disabilities,35,60,1,0,1
Madhya Pradesh,Umaria,Specific Learning Disabilities,15,35,1,0,1
Madhya Pradesh,Ujjain,Specific Learning Disabilities,6,15,1,0,1
Madhya Pradesh,Ujjain,Specific Learning Disabilities,15,35,2,1,3
Karnataka,Udupi,Specific Learning Disabilities,35,60,3,0,3
Jammu And Kashmir,Udhampur,Specific Learning Disabilities,6,15,0,1,1
Uttarakhand,Udam Singh Nagar,Specific Learning Disabilities,6,15,1,0,1
Uttarakhand,Udam Singh Nagar,Specific Learning Disabilities,15,35,2,2,4
Uttarakhand,Udam Singh Nagar,Specific Learning Disabilities,35,60,0,1,1
Assam,Udalguri,Specific Learning Disabilities,15,35,1,1,2
Rajasthan,Udaipur,Specific Learning Disabilities,15,35,3,1,4
Rajasthan,Udaipur,Specific Learning Disabilities,35,60,0,1,1
Rajasthan,Udaipur,Specific Learning Disabilities,60,80,1,0,1
Tamil Nadu,Tuticorin,Specific Learning Disabilities,6,15,1,1,2
Tamil Nadu,Tuticorin,Specific Learning Disabilities,35,60,0,2,2
Karnataka,Tumakuru,Specific Learning Disabilities,6,15,3,2,5
Karnataka,Tumakuru,Specific Learning Disabilities,15,35,3,4,7
Karnataka,Tumakuru,Specific Learning Disabilities,35,60,3,3,6
Karnataka,Tumakuru,Specific Learning Disabilities,60,80,1,0,1
Rajasthan,Tonk,Specific Learning Disabilities,35,60,1,0,1
Tamil Nadu,Tiruvannamalai,Specific Learning Disabilities,6,15,2,1,3
Tamil Nadu,Tiruvannamalai,Specific Learning Disabilities,15,35,3,1,4
Tamil Nadu,Tiruvannamalai,Specific Learning Disabilities,35,60,2,0,2
Tamil Nadu,Tiruvannamalai,Specific Learning Disabilities,60,80,2,1,3
Tamil Nadu,Tiruppur,Specific Learning Disabilities,6,15,3,0,3
Tamil Nadu,Tiruppur,Specific Learning Disabilities,15,35,2,2,4
Tamil Nadu,Tiruppur,Specific Learning Disabilities,35,60,2,0,2
Tamil Nadu,Tirupathur,Specific Learning Disabilities,15,35,3,0,3
Tamil Nadu,Tirupathur,Specific Learning Disabilities,35,60,0,1,1
Tamil Nadu,Tirunelveli,Specific Learning Disabilities,6,15,1,1,2
Tamil Nadu,Tirunelveli,Specific Learning Disabilities,15,35,1,1,2
Tamil Nadu,Tiruchirappalli,Specific Learning Disabilities,6,15,4,1,5
Tamil Nadu,Tiruchirappalli,Specific Learning Disabilities,15,35,12,1,13
Tamil Nadu,Tiruchirappalli,Specific Learning Disabilities,35,60,0,2,2
Assam,Tinsukia,Specific Learning Disabilities,15,35,0,1,1
Madhya Pradesh,Tikamgarh,Specific Learning Disabilities,35,60,1,0,1
Kerala,Thrissur,Specific Learning Disabilities,6,15,232,51,283
Kerala,Thrissur,Specific Learning Disabilities,15,35,415,68,483
Tamil Nadu,Thiruvarur,Specific Learning Disabilities,0,6,1,0,1
Kerala,Thiruvananthapuram,Specific Learning Disabilities,6,15,90,23,113
Kerala,Thiruvananthapuram,Specific Learning Disabilities,15,35,249,67,316
Tamil Nadu,Thiruvallur,Specific Learning Disabilities,6,15,23,10,33
Tamil Nadu,Thiruvallur,Specific Learning Disabilities,15,35,23,15,38
Tamil Nadu,Thiruvallur,Specific Learning Disabilities,35,60,2,2,4
Tamil Nadu,Thiruvallur,Specific Learning Disabilities,60,80,1,0,1
Tamil Nadu,Theni,Specific Learning Disabilities,35,60,0,1,1
Tamil Nadu,The Nilgiris,Specific Learning Disabilities,6,15,1,0,1
Tamil Nadu,The Nilgiris,Specific Learning Disabilities,35,60,0,1,1
Tamil Nadu,Thanjavur,Specific Learning Disabilities,6,15,30,14,44
Tamil Nadu,Thanjavur,Specific Learning Disabilities,15,35,11,6,17
Maharashtra,Thane,Specific Learning Disabilities,6,15,43,11,54
Maharashtra,Thane,Specific Learning Disabilities,15,35,184,52,236
Maharashtra,Thane,Specific Learning Disabilities,35,60,1,0,1
Tamil Nadu,Tenkasi,Specific Learning Disabilities,15,35,0,1,1
Uttarakhand,Tehri Garhwal,Specific Learning Disabilities,60,80,1,0,1
Punjab,Tarn Taran,Specific Learning Disabilities,6,15,1,0,1
Punjab,Tarn Taran,Specific Learning Disabilities,15,35,1,1,2
Punjab,Tarn Taran,Specific Learning Disabilities,35,60,3,0,3
Gujarat,Tapi,Specific Learning Disabilities,6,15,23,18,41
Gujarat,Tapi,Specific Learning Disabilities,15,35,11,8,19
Manipur,Tamenglong,Specific Learning Disabilities,6,15,1,0,1
Manipur,Tamenglong,Specific Learning Disabilities,15,35,1,0,1
Manipur,Tamenglong,Specific Learning Disabilities,35,60,1,0,1
Gujarat,Surendranagar,Specific Learning Disabilities,35,60,1,0,1
Gujarat,Surendranagar,Specific Learning Disabilities,60,80,0,1,1
Gujarat,Surat,Specific Learning Disabilities,6,15,8,4,12
Gujarat,Surat,Specific Learning Disabilities,15,35,21,5,26
Gujarat,Surat,Specific Learning Disabilities,60,80,1,0,1
Chhattisgarh,Surajpur,Specific Learning Disabilities,6,15,4,2,6
Chhattisgarh,Surajpur,Specific Learning Disabilities,15,35,4,2,6
Chhattisgarh,Surajpur,Specific Learning Disabilities,35,60,1,1,2
Bihar,Supaul,Specific Learning Disabilities,6,15,1,1,2
Bihar,Supaul,Specific Learning Disabilities,15,35,1,0,1
Bihar,Supaul,Specific Learning Disabilities,60,80,1,0,1
Odisha,Sundargarh,Specific Learning Disabilities,0,6,1,3,4
Odisha,Sundargarh,Specific Learning Disabilities,6,15,7,4,11
Odisha,Sundargarh,Specific Learning Disabilities,15,35,8,9,17
Odisha,Sundargarh,Specific Learning Disabilities,35,60,7,3,10
Uttar Pradesh,Sultanpur,Specific Learning Disabilities,15,35,4,5,9
Uttar Pradesh,Sultanpur,Specific Learning Disabilities,35,60,2,1,3
Chhattisgarh,Sukma,Specific Learning Disabilities,6,15,2,2,4
Chhattisgarh,Sukma,Specific Learning Disabilities,35,60,1,0,1
Jammu And Kashmir,Srinagar,Specific Learning Disabilities,15,35,2,0,2
Punjab,Sri Muktsar Sahib,Specific Learning Disabilities,15,35,2,2,4
Punjab,Sri Muktsar Sahib,Specific Learning Disabilities,35,60,2,2,4
Meghalaya,South West Khasi Hills,Specific Learning Disabilities,6,15,1,0,1
Meghalaya,South West Khasi Hills,Specific Learning Disabilities,15,35,4,2,6
Meghalaya,South West Garo Hills,Specific Learning Disabilities,15,35,0,1,1
Delhi,South West,Specific Learning Disabilities,6,15,34,20,54
Delhi,South West,Specific Learning Disabilities,15,35,53,31,84
Goa,South Goa,Specific Learning Disabilities,6,15,32,9,41
Goa,South Goa,Specific Learning Disabilities,15,35,18,10,28
Meghalaya,South Garo Hills,Specific Learning Disabilities,35,60,1,0,1
Delhi,South East,Specific Learning Disabilities,6,15,15,7,22
Delhi,South East,Specific Learning Disabilities,15,35,22,13,35
Andaman And Nicobar Islands,South Andamans,Specific Learning Disabilities,0,6,0,1,1
Andaman And Nicobar Islands,South Andamans,Specific Learning Disabilities,15,35,1,0,1
Delhi,South,Specific Learning Disabilities,6,15,31,19,50
Delhi,South,Specific Learning Disabilities,15,35,55,28,83
Delhi,South,Specific Learning Disabilities,35,60,0,1,1
Haryana,Sonipat,Specific Learning Disabilities,15,35,2,2,4
Odisha,Sonepur,Specific Learning Disabilities,6,15,0,1,1
Uttar Pradesh,Sonbhadra,Specific Learning Disabilities,6,15,2,1,3
Uttar Pradesh,Sonbhadra,Specific Learning Disabilities,15,35,2,0,2
Uttar Pradesh,Sonbhadra,Specific Learning Disabilities,35,60,4,3,7
Maharashtra,Solapur,Specific Learning Disabilities,6,15,1,0,1
Maharashtra,Solapur,Specific Learning Disabilities,15,35,18,4,22
Maharashtra,Solapur,Specific Learning Disabilities,35,60,0,1,1
Himachal Pradesh,Solan,Specific Learning Disabilities,6,15,0,1,1
Himachal Pradesh,Solan,Specific Learning Disabilities,15,35,2,1,3
Himachal Pradesh,Solan,Specific Learning Disabilities,35,60,0,1,1
Bihar,Siwan,Specific Learning Disabilities,6,15,1,1,2
Bihar,Siwan,Specific Learning Disabilities,15,35,1,1,2
Bihar,Siwan,Specific Learning Disabilities,60,80,1,0,1
Tamil Nadu,Sivaganga,Specific Learning Disabilities,15,35,1,0,1
Uttar Pradesh,Sitapur,Specific Learning Disabilities,15,35,3,1,4
Uttar Pradesh,Sitapur,Specific Learning Disabilities,35,60,2,0,2
Uttar Pradesh,Sitapur,Specific Learning Disabilities,60,80,1,0,1
Haryana,Sirsa,Specific Learning Disabilities,6,15,1,0,1
Rajasthan,Sirohi,Specific Learning Disabilities,15,35,2,1,3
Rajasthan,Sirohi,Specific Learning Disabilities,35,60,3,1,4
Himachal Pradesh,Sirmaur,Specific Learning Disabilities,0,6,1,2,3
Himachal Pradesh,Sirmaur,Specific Learning Disabilities,6,15,5,1,6
Himachal Pradesh,Sirmaur,Specific Learning Disabilities,15,35,3,3,6
Himachal Pradesh,Sirmaur,Specific Learning Disabilities,35,60,2,0,2
Madhya Pradesh,Singrauli,Specific Learning Disabilities,35,60,1,0,1
Maharashtra,Sindhudurg,Specific Learning Disabilities,6,15,1,0,1
Jharkhand,Simdega,Specific Learning Disabilities,15,35,3,1,4
Jharkhand,Simdega,Specific Learning Disabilities,35,60,1,2,3
Rajasthan,Sikar,Specific Learning Disabilities,6,15,0,1,1
Rajasthan,Sikar,Specific Learning Disabilities,15,35,1,0,1
Madhya Pradesh,Sidhi,Specific Learning Disabilities,6,15,0,2,2
Madhya Pradesh,Sidhi,Specific Learning Disabilities,15,35,6,2,8
Madhya Pradesh,Sidhi,Specific Learning Disabilities,35,60,4,0,4
Madhya Pradesh,Sidhi,Specific Learning Disabilities,60,80,2,0,2
Uttar Pradesh,Siddharth Nagar,Specific Learning Disabilities,15,35,5,3,8
Uttar Pradesh,Siddharth Nagar,Specific Learning Disabilities,35,60,4,1,5
Uttar Pradesh,Shravasti,Specific Learning Disabilities,6,15,0,1,1
Uttar Pradesh,Shravasti,Specific Learning Disabilities,15,35,1,0,1
Uttar Pradesh,Shravasti,Specific Learning Disabilities,35,60,0,1,1
Madhya Pradesh,Shivpuri,Specific Learning Disabilities,15,35,1,0,1
Madhya Pradesh,Shivpuri,Specific Learning Disabilities,35,60,2,0,2
Madhya Pradesh,Shivpuri,Specific Learning Disabilities,60,80,0,1,1
Karnataka,Shivamogga,Specific Learning Disabilities,15,35,2,1,3
Karnataka,Shivamogga,Specific Learning Disabilities,35,60,2,2,4
Madhya Pradesh,Sheopur,Specific Learning Disabilities,6,15,0,1,1
Bihar,Sheohar,Specific Learning Disabilities,6,15,2,2,4
Bihar,Sheohar,Specific Learning Disabilities,15,35,2,1,3
Bihar,Sheikhpura,Specific Learning Disabilities,15,35,0,1,1
Uttar Pradesh,Shamli,Specific Learning Disabilities,15,35,1,0,1
Uttar Pradesh,Shamli,Specific Learning Disabilities,60,80,0,1,1
Uttar Pradesh,Shahjahanpur,Specific Learning Disabilities,0,6,0,1,1
Uttar Pradesh,Shahjahanpur,Specific Learning Disabilities,6,15,2,1,3
Uttar Pradesh,Shahjahanpur,Specific Learning Disabilities,15,35,11,1,12
Uttar Pradesh,Shahjahanpur,Specific Learning Disabilities,35,60,3,3,6
Uttar Pradesh,Shahjahanpur,Specific Learning Disabilities,60,80,2,0,2
Punjab,Shahid Bhagat Singh Nagar,Specific Learning Disabilities,6,15,1,1,2
Punjab,Shahid Bhagat Singh Nagar,Specific Learning Disabilities,15,35,2,4,6
Punjab,Shahid Bhagat Singh Nagar,Specific Learning Disabilities,35,60,7,4,11
Punjab,Shahid Bhagat Singh Nagar,Specific Learning Disabilities,60,80,4,1,5
Punjab,Shahid Bhagat Singh Nagar,Specific Learning Disabilities,80,100,1,0,1
Madhya Pradesh,Shahdol,Specific Learning Disabilities,6,15,1,0,1
Madhya Pradesh,Shahdol,Specific Learning Disabilities,15,35,2,2,4
Madhya Pradesh,Shahdol,Specific Learning Disabilities,35,60,3,0,3
Madhya Pradesh,Shahdol,Specific Learning Disabilities,60,80,2,0,2
Delhi,Shahdara,Specific Learning Disabilities,6,15,3,1,4
Delhi,Shahdara,Specific Learning Disabilities,15,35,17,6,23
Madhya Pradesh,Seoni,Specific Learning Disabilities,15,35,6,1,7
Madhya Pradesh,Seoni,Specific Learning Disabilities,35,60,5,1,6
Madhya Pradesh,Seoni,Specific Learning Disabilities,60,80,1,1,2
Madhya Pradesh,Sehore,Specific Learning Disabilities,6,15,2,1,3
Madhya Pradesh,Sehore,Specific Learning Disabilities,15,35,4,2,6
Madhya Pradesh,Sehore,Specific Learning Disabilities,35,60,1,1,2
Rajasthan,Sawai Madhopur,Specific Learning Disabilities,15,35,1,0,1
Madhya Pradesh,Satna,Specific Learning Disabilities,6,15,1,1,2
Madhya Pradesh,Satna,Specific Learning Disabilities,15,35,2,0,2
Maharashtra,Satara,Specific Learning Disabilities,6,15,1,0,1
Bihar,Saran,Specific Learning Disabilities,0,6,1,1,2
Bihar,Saran,Specific Learning Disabilities,6,15,4,0,4
Bihar,Saran,Specific Learning Disabilities,15,35,5,1,6
Bihar,Saran,Specific Learning Disabilities,35,60,1,1,2
Bihar,Saran,Specific Learning Disabilities,60,80,0,1,1
Uttar Pradesh,Sant Kabeer Nagar,Specific Learning Disabilities,15,35,1,0,1
Uttar Pradesh,Sant Kabeer Nagar,Specific Learning Disabilities,35,60,1,0,1
Punjab,Sangrur,Specific Learning Disabilities,6,15,3,4,7
Punjab,Sangrur,Specific Learning Disabilities,15,35,3,2,5
Punjab,Sangrur,Specific Learning Disabilities,35,60,1,0,1
Punjab,Sangrur,Specific Learning Disabilities,60,80,0,1,1
Maharashtra,Sangli,Specific Learning Disabilities,6,15,15,6,21
Maharashtra,Sangli,Specific Learning Disabilities,15,35,14,2,16
Odisha,Sambalpur,Specific Learning Disabilities,6,15,2,1,3
Bihar,Samastipur,Specific Learning Disabilities,6,15,2,0,2
Bihar,Samastipur,Specific Learning Disabilities,15,35,8,5,13
Bihar,Samastipur,Specific Learning Disabilities,35,60,1,5,6
Bihar,Samastipur,Specific Learning Disabilities,60,80,2,0,2
Tamil Nadu,Salem,Specific Learning Disabilities,6,15,15,10,25
Tamil Nadu,Salem,Specific Learning Disabilities,15,35,16,6,22
Jharkhand,Sahebganj,Specific Learning Disabilities,15,35,1,0,1
Bihar,Saharsa,Specific Learning Disabilities,15,35,1,1,2
Uttar Pradesh,Saharanpur,Specific Learning Disabilities,15,35,5,2,7
Uttar Pradesh,Saharanpur,Specific Learning Disabilities,35,60,10,1,11
Uttar Pradesh,Saharanpur,Specific Learning Disabilities,60,80,1,0,1
Madhya Pradesh,Sagar,Specific Learning Disabilities,0,6,1,0,1
Madhya Pradesh,Sagar,Specific Learning Disabilities,6,15,15,6,21
Madhya Pradesh,Sagar,Specific Learning Disabilities,15,35,24,9,33
Madhya Pradesh,Sagar,Specific Learning Disabilities,35,60,8,6,14
Madhya Pradesh,Sagar,Specific Learning Disabilities,60,80,0,1,1
Gujarat,Sabar Kantha,Specific Learning Disabilities,6,15,0,2,2
Gujarat,Sabar Kantha,Specific Learning Disabilities,15,35,0,2,2
Punjab,S.A.S Nagar,Specific Learning Disabilities,6,15,26,18,44
Punjab,S.A.S Nagar,Specific Learning Disabilities,15,35,15,5,20
Punjab,S.A.S Nagar,Specific Learning Disabilities,35,60,1,1,2
Punjab,S.A.S Nagar,Specific Learning Disabilities,60,80,1,0,1
Punjab,Rupnagar,Specific Learning Disabilities,6,15,0,1,1
Uttarakhand,Rudra Prayag,Specific Learning Disabilities,15,35,1,0,1
Uttarakhand,Rudra Prayag,Specific Learning Disabilities,35,60,1,1,2
Bihar,Rohtas,Specific Learning Disabilities,6,15,1,1,2
Bihar,Rohtas,Specific Learning Disabilities,15,35,6,1,7
Bihar,Rohtas,Specific Learning Disabilities,35,60,2,0,2
Haryana,Rohtak,Specific Learning Disabilities,15,35,1,0,1
Meghalaya,Ri Bhoi,Specific Learning Disabilities,6,15,5,2,7
Meghalaya,Ri Bhoi,Specific Learning Disabilities,15,35,4,7,11
Meghalaya,Ri Bhoi,Specific Learning Disabilities,35,60,2,1,3
Madhya Pradesh,Rewa,Specific Learning Disabilities,15,35,2,0,2
Odisha,Rayagada,Specific Learning Disabilities,35,60,0,2,2
Maharashtra,Ratnagiri,Specific Learning Disabilities,6,15,45,19,64
Maharashtra,Ratnagiri,Specific Learning Disabilities,15,35,27,6,33
Tamil Nadu,Ranipet,Specific Learning Disabilities,0,6,1,0,1
Tamil Nadu,Ranipet,Specific Learning Disabilities,6,15,1,1,2
Tamil Nadu,Ranipet,Specific Learning Disabilities,15,35,2,1,3
Tamil Nadu,Ranipet,Specific Learning Disabilities,35,60,0,2,2
Telangana,Ranga Reddy,Specific Learning Disabilities,15,35,0,1,1
Jharkhand,Ranchi,Specific Learning Disabilities,6,15,4,6,10
Jharkhand,Ranchi,Specific Learning Disabilities,15,35,1,0,1
Uttar Pradesh,Rampur,Specific Learning Disabilities,15,35,4,0,4
Uttar Pradesh,Rampur,Specific Learning Disabilities,35,60,5,0,5
Jharkhand,Ramgarh,Specific Learning Disabilities,6,15,2,0,2
Jharkhand,Ramgarh,Specific Learning Disabilities,15,35,2,2,4
Jharkhand,Ramgarh,Specific Learning Disabilities,35,60,0,1,1
Tamil Nadu,Ramanathapuram,Specific Learning Disabilities,0,6,1,0,1
Tamil Nadu,Ramanathapuram,Specific Learning Disabilities,6,15,1,2,3
Karnataka,Ramanagara,Specific Learning Disabilities,15,35,1,1,2
Karnataka,Ramanagara,Specific Learning Disabilities,35,60,1,0,1
Rajasthan,Rajsamand,Specific Learning Disabilities,6,15,3,1,4
Rajasthan,Rajsamand,Specific Learning Disabilities,15,35,1,1,2
Rajasthan,Rajsamand,Specific Learning Disabilities,35,60,1,0,1
Jammu And Kashmir,Rajouri,Specific Learning Disabilities,6,15,1,0,1
Jammu And Kashmir,Rajouri,Specific Learning Disabilities,15,35,0,1,1
Chhattisgarh,Rajnandgaon,Specific Learning Disabilities,6,15,2,0,2
Chhattisgarh,Rajnandgaon,Specific Learning Disabilities,15,35,5,1,6
Chhattisgarh,Rajnandgaon,Specific Learning Disabilities,35,60,6,0,6
Chhattisgarh,Rajnandgaon,Specific Learning Disabilities,60,80,0,2,2
Gujarat,Rajkot,Specific Learning Disabilities,15,35,3,0,3
Madhya Pradesh,Rajgarh,Specific Learning Disabilities,15,35,1,0,1
Madhya Pradesh,Rajgarh,Specific Learning Disabilities,35,60,0,1,1
Madhya Pradesh,Rajgarh,Specific Learning Disabilities,60,80,0,1,1
Madhya Pradesh,Raisen,Specific Learning Disabilities,6,15,1,0,1
Madhya Pradesh,Raisen,Specific Learning Disabilities,15,35,0,1,1
Chhattisgarh,Raipur,Specific Learning Disabilities,6,15,1,0,1
Chhattisgarh,Raipur,Specific Learning Disabilities,15,35,2,0,2
Chhattisgarh,Raigarh,Specific Learning Disabilities,15,35,1,0,1
Chhattisgarh,Raigarh,Specific Learning Disabilities,35,60,0,1,1
Maharashtra,Raigad,Specific Learning Disabilities,6,15,2,2,4
Maharashtra,Raigad,Specific Learning Disabilities,15,35,18,8,26
Maharashtra,Raigad,Specific Learning Disabilities,35,60,1,1,2
Karnataka,Raichur,Specific Learning Disabilities,6,15,2,0,2
Karnataka,Raichur,Specific Learning Disabilities,15,35,3,1,4
Uttar Pradesh,Rae Bareli,Specific Learning Disabilities,35,60,1,0,1
Bihar,Purnia,Specific Learning Disabilities,15,35,0,2,2
Bihar,Purnia,Specific Learning Disabilities,35,60,1,0,1
Bihar,Purnia,Specific Learning Disabilities,60,80,1,0,1
Odisha,Puri,Specific Learning Disabilities,6,15,1,1,2
Odisha,Puri,Specific Learning Disabilities,15,35,1,0,1
Odisha,Puri,Specific Learning Disabilities,35,60,3,0,3
Bihar,Purbi Champaran,Specific Learning Disabilities,6,15,4,5,9
Bihar,Purbi Champaran,Specific Learning Disabilities,15,35,18,2,20
Bihar,Purbi Champaran,Specific Learning Disabilities,35,60,17,13,30
Bihar,Purbi Champaran,Specific Learning Disabilities,60,80,3,0,3
Bihar,Purbi Champaran,Specific Learning Disabilities,80,100,2,0,2
Maharashtra,Pune,Specific Learning Disabilities,6,15,53,18,71
Maharashtra,Pune,Specific Learning Disabilities,15,35,249,61,310
Maharashtra,Pune,Specific Learning Disabilities,35,60,0,1,1
Jammu And Kashmir,Pulwama,Specific Learning Disabilities,6,15,1,0,1
Jammu And Kashmir,Pulwama,Specific Learning Disabilities,15,35,1,0,1
Jammu And Kashmir,Pulwama,Specific Learning Disabilities,35,60,1,0,1
Tamil Nadu,Pudukkottai,Specific Learning Disabilities,6,15,13,4,17
Tamil Nadu,Pudukkottai,Specific Learning Disabilities,15,35,5,2,7
Uttar Pradesh,Prayagraj,Specific Learning Disabilities,6,15,2,0,2
Uttar Pradesh,Prayagraj,Specific Learning Disabilities,35,60,3,0,3
Rajasthan,Pratapgarh,Specific Learning Disabilities,6,15,2,0,2
Rajasthan,Pratapgarh,Specific Learning Disabilities,15,35,1,0,1
Rajasthan,Pratapgarh,Specific Learning Disabilities,35,60,0,1,1
Uttar Pradesh,Pratapgarh,Specific Learning Disabilities,15,35,7,0,7
Uttar Pradesh,Pratapgarh,Specific Learning Disabilities,35,60,10,1,11
Uttar Pradesh,Pratapgarh,Specific Learning Disabilities,60,80,1,0,1
Gujarat,Porbandar,Specific Learning Disabilities,6,15,5,6,11
Gujarat,Porbandar,Specific Learning Disabilities,15,35,4,3,7
Jammu And Kashmir,Poonch,Specific Learning Disabilities,6,15,4,5,9
Jammu And Kashmir,Poonch,Specific Learning Disabilities,15,35,9,11,20
Jammu And Kashmir,Poonch,Specific Learning Disabilities,35,60,9,8,17
Jammu And Kashmir,Poonch,Specific Learning Disabilities,60,80,1,1,2
Puducherry,Pondicherry,Specific Learning Disabilities,15,35,0,1,1
Puducherry,Pondicherry,Specific Learning Disabilities,35,60,1,0,1
Uttar Pradesh,Pilibhit,Specific Learning Disabilities,6,15,1,0,1
Uttar Pradesh,Pilibhit,Specific Learning Disabilities,15,35,4,1,5
Uttar Pradesh,Pilibhit,Specific Learning Disabilities,35,60,3,1,4
Uttar Pradesh,Pilibhit,Specific Learning Disabilities,60,80,1,0,1
Uttarakhand,Pauri Garhwal,Specific Learning Disabilities,35,60,4,0,4
Bihar,Patna,Specific Learning Disabilities,6,15,1,0,1
Bihar,Patna,Specific Learning Disabilities,15,35,1,0,1
Bihar,Patna,Specific Learning Disabilities,35,60,2,0,2
Bihar,Patna,Specific Learning Disabilities,60,80,1,0,1
Punjab,Patiala,Specific Learning Disabilities,0,6,1,0,1
Punjab,Patiala,Specific Learning Disabilities,6,15,2,5,7
Punjab,Patiala,Specific Learning Disabilities,15,35,7,1,8
Punjab,Patiala,Specific Learning Disabilities,35,60,4,2,6
Punjab,Pathankot,Specific Learning Disabilities,0,6,1,0,1
Punjab,Pathankot,Specific Learning Disabilities,6,15,4,1,5
Punjab,Pathankot,Specific Learning Disabilities,15,35,1,2,3
Kerala,Pathanamthitta,Specific Learning Disabilities,6,15,7,1,8
Kerala,Pathanamthitta,Specific Learning Disabilities,15,35,9,2,11
Kerala,Pathanamthitta,Specific Learning Disabilities,35,60,1,0,1
Gujarat,Patan,Specific Learning Disabilities,6,15,1,0,1
Bihar,Pashchim Champaran,Specific Learning Disabilities,6,15,16,3,19
Bihar,Pashchim Champaran,Specific Learning Disabilities,15,35,14,2,16
Bihar,Pashchim Champaran,Specific Learning Disabilities,35,60,9,6,15
Maharashtra,Parbhani,Specific Learning Disabilities,15,35,2,2,4
Maharashtra,Parbhani,Specific Learning Disabilities,35,60,1,0,1
Arunachal Pradesh,Papum Pare,Specific Learning Disabilities,6,15,1,0,1
Madhya Pradesh,Panna,Specific Learning Disabilities,6,15,0,2,2
Madhya Pradesh,Panna,Specific Learning Disabilities,15,35,6,3,9
Madhya Pradesh,Panna,Specific Learning Disabilities,35,60,4,0,4
Haryana,Panipat,Specific Learning Disabilities,6,15,3,0,3
Haryana,Panipat,Specific Learning Disabilities,15,35,1,0,1
Haryana,Panchkula,Specific Learning Disabilities,6,15,2,0,2
Haryana,Panchkula,Specific Learning Disabilities,15,35,7,4,11
Gujarat,Panch Mahals,Specific Learning Disabilities,6,15,2,1,3
Gujarat,Panch Mahals,Specific Learning Disabilities,15,35,1,2,3
Haryana,Palwal,Specific Learning Disabilities,6,15,1,0,1
Haryana,Palwal,Specific Learning Disabilities,15,35,1,0,1
Maharashtra,Palghar,Specific Learning Disabilities,6,15,6,2,8
Maharashtra,Palghar,Specific Learning Disabilities,15,35,9,2,11
Maharashtra,Palghar,Specific Learning Disabilities,35,60,1,0,1
Jharkhand,Palamu,Specific Learning Disabilities,15,35,2,0,2
Jharkhand,Palamu,Specific Learning Disabilities,35,60,4,0,4
Kerala,Palakkad,Specific Learning Disabilities,6,15,17,5,22
Kerala,Palakkad,Specific Learning Disabilities,15,35,15,7,22
Jharkhand,Pakur,Specific Learning Disabilities,35,60,0,1,1
Maharashtra,Osmanabad,Specific Learning Disabilities,15,35,2,0,2
Maharashtra,Osmanabad,Specific Learning Disabilities,35,60,1,0,1
Maharashtra,Osmanabad,Specific Learning Disabilities,60,80,2,0,2
Odisha,Nuapada,Specific Learning Disabilities,0,6,1,0,1
Odisha,Nuapada,Specific Learning Disabilities,6,15,1,0,1
Odisha,Nuapada,Specific Learning Disabilities,15,35,0,4,4
Odisha,Nuapada,Specific Learning Disabilities,35,60,0,1,1
Delhi,North West,Specific Learning Disabilities,6,15,22,18,40
Delhi,North West,Specific Learning Disabilities,15,35,72,30,102
Goa,North Goa,Specific Learning Disabilities,0,6,1,0,1
Goa,North Goa,Specific Learning Disabilities,6,15,57,11,68
Goa,North Goa,Specific Learning Disabilities,15,35,35,12,47
Meghalaya,North Garo Hills,Specific Learning Disabilities,6,15,1,0,1
Meghalaya,North Garo Hills,Specific Learning Disabilities,15,35,1,0,1
Delhi,North East,Specific Learning Disabilities,6,15,6,0,6
Delhi,North East,Specific Learning Disabilities,15,35,11,1,12
Andaman And Nicobar Islands,North And Middle Andaman,Specific Learning Disabilities,35,60,1,1,2
Delhi,North,Specific Learning Disabilities,6,15,3,3,6
Delhi,North,Specific Learning Disabilities,15,35,20,5,25
Madhya Pradesh,Niwari,Specific Learning Disabilities,15,35,1,0,1
Madhya Pradesh,Niwari,Specific Learning Disabilities,35,60,1,2,3
Delhi,New Delhi,Specific Learning Disabilities,6,15,5,3,8
Delhi,New Delhi,Specific Learning Disabilities,15,35,28,11,39
Madhya Pradesh,Neemuch,Specific Learning Disabilities,6,15,1,0,1
Odisha,Nayagarh,Specific Learning Disabilities,6,15,1,1,2
Odisha,Nayagarh,Specific Learning Disabilities,15,35,3,0,3
Odisha,Nayagarh,Specific Learning Disabilities,35,60,2,0,2
Odisha,Nayagarh,Specific Learning Disabilities,60,80,0,1,1
Bihar,Nawada,Specific Learning Disabilities,6,15,2,2,4
Bihar,Nawada,Specific Learning Disabilities,15,35,4,4,8
Bihar,Nawada,Specific Learning Disabilities,35,60,1,0,1
Bihar,Nawada,Specific Learning Disabilities,60,80,1,0,1
Gujarat,Navsari,Specific Learning Disabilities,6,15,3,1,4
Gujarat,Navsari,Specific Learning Disabilities,15,35,1,1,2
Maharashtra,Nashik,Specific Learning Disabilities,6,15,2,2,4
Maharashtra,Nashik,Specific Learning Disabilities,15,35,7,0,7
Madhya Pradesh,Narsinghpur,Specific Learning Disabilities,15,35,5,3,8
Madhya Pradesh,Narsinghpur,Specific Learning Disabilities,35,60,6,3,9
Madhya Pradesh,Narsinghpur,Specific Learning Disabilities,60,80,0,1,1
Madhya Pradesh,Narsinghpur,Specific Learning Disabilities,80,100,0,1,1
Madhya Pradesh,Narmadapuram,Specific Learning Disabilities,6,15,1,0,1
Madhya Pradesh,Narmadapuram,Specific Learning Disabilities,15,35,4,0,4
Madhya Pradesh,Narmadapuram,Specific Learning Disabilities,35,60,3,2,5
Chhattisgarh,Narayanpur,Specific Learning Disabilities,15,35,0,1,1
Maharashtra,Nanded,Specific Learning Disabilities,15,35,1,1,2
Maharashtra,Nanded,Specific Learning Disabilities,35,60,2,0,2
Sikkim,Namchi,Specific Learning Disabilities,6,15,2,4,6
Sikkim,Namchi,Specific Learning Disabilities,15,35,1,0,1
Tamil Nadu,Namakkal,Specific Learning Disabilities,6,15,7,2,9
Tamil Nadu,Namakkal,Specific Learning Disabilities,15,35,4,4,8
Tamil Nadu,Namakkal,Specific Learning Disabilities,60,80,0,1,1
Assam,Nalbari,Specific Learning Disabilities,0,6,0,1,1
Assam,Nalbari,Specific Learning Disabilities,6,15,1,0,1
Assam,Nalbari,Specific Learning Disabilities,15,35,0,1,1
Bihar,Nalanda,Specific Learning Disabilities,15,35,1,1,2
Bihar,Nalanda,Specific Learning Disabilities,35,60,1,1,2
Bihar,Nalanda,Specific Learning Disabilities,60,80,2,0,2
Maharashtra,Nagpur,Specific Learning Disabilities,6,15,29,26,55
Maharashtra,Nagpur,Specific Learning Disabilities,15,35,103,31,134
Tamil Nadu,Nagapattinam,Specific Learning Disabilities,15,35,1,1,2
Assam,Nagaon,Specific Learning Disabilities,6,15,1,0,1
Assam,Nagaon,Specific Learning Disabilities,15,35,1,0,1
Assam,Nagaon,Specific Learning Disabilities,35,60,0,1,1
Odisha,Nabarangpur,Specific Learning Disabilities,6,15,1,3,4
Odisha,Nabarangpur,Specific Learning Disabilities,15,35,5,0,5
Odisha,Nabarangpur,Specific Learning Disabilities,35,60,1,0,1
Karnataka,Mysuru,Specific Learning Disabilities,0,6,1,0,1
Karnataka,Mysuru,Specific Learning Disabilities,6,15,1,0,1
Karnataka,Mysuru,Specific Learning Disabilities,15,35,9,6,15
Karnataka,Mysuru,Specific Learning Disabilities,35,60,0,1,1
Karnataka,Mysuru,Specific Learning Disabilities,60,80,0,1,1
Bihar,Muzaffarpur,Specific Learning Disabilities,6,15,3,2,5
Bihar,Muzaffarpur,Specific Learning Disabilities,15,35,1,0,1
Bihar,Muzaffarpur,Specific Learning Disabilities,35,60,2,0,2
Bihar,Muzaffarpur,Specific Learning Disabilities,60,80,1,0,1
Uttar Pradesh,Muzaffarnagar,Specific Learning Disabilities,15,35,4,0,4
Uttar Pradesh,Muzaffarnagar,Specific Learning Disabilities,35,60,2,2,4
Uttar Pradesh,Muzaffarnagar,Specific Learning Disabilities,60,80,1,0,1
Bihar,Munger,Specific Learning Disabilities,15,35,1,1,2
Bihar,Munger,Specific Learning Disabilities,35,60,2,1,3
Chhattisgarh,Mungeli,Specific Learning Disabilities,15,35,2,1,3
Chhattisgarh,Mungeli,Specific Learning Disabilities,35,60,1,0,1
Maharashtra,Mumbai Suburban,Specific Learning Disabilities,6,15,40,26,66
Maharashtra,Mumbai Suburban,Specific Learning Disabilities,15,35,174,51,225
Maharashtra,Mumbai Suburban,Specific Learning Disabilities,35,60,1,0,1
Maharashtra,Mumbai,Specific Learning Disabilities,6,15,111,28,139
Maharashtra,Mumbai,Specific Learning Disabilities,15,35,283,106,389
Maharashtra,Mumbai,Specific Learning Disabilities,35,60,1,0,1
Madhya Pradesh,Morena,Specific Learning Disabilities,6,15,0,1,1
Madhya Pradesh,Morena,Specific Learning Disabilities,15,35,1,0,1
Madhya Pradesh,Morena,Specific Learning Disabilities,35,60,1,0,1
Gujarat,Morbi,Specific Learning Disabilities,35,60,0,1,1
Uttar Pradesh,Moradabad,Specific Learning Disabilities,6,15,0,1,1
Uttar Pradesh,Moradabad,Specific Learning Disabilities,15,35,1,1,2
Uttar Pradesh,Moradabad,Specific Learning Disabilities,35,60,3,0,3
Uttar Pradesh,Moradabad,Specific Learning Disabilities,60,80,1,0,1
Nagaland,Mokokchung,Specific Learning Disabilities,6,15,0,1,1
Punjab,Moga,Specific Learning Disabilities,6,15,0,1,1
Punjab,Moga,Specific Learning Disabilities,15,35,1,0,1
Punjab,Moga,Specific Learning Disabilities,35,60,1,0,1
Uttar Pradesh,Mirzapur,Specific Learning Disabilities,35,60,2,1,3
Uttar Pradesh,Meerut,Specific Learning Disabilities,6,15,1,0,1
Uttar Pradesh,Meerut,Specific Learning Disabilities,15,35,4,0,4
Uttar Pradesh,Meerut,Specific Learning Disabilities,35,60,0,1,1
Uttar Pradesh,Mathura,Specific Learning Disabilities,15,35,1,0,1
Assam,Marigaon,Specific Learning Disabilities,0,6,1,0,1
Assam,Marigaon,Specific Learning Disabilities,6,15,3,0,3
Assam,Marigaon,Specific Learning Disabilities,15,35,0,1,1
Punjab,Mansa,Specific Learning Disabilities,15,35,3,0,3
Punjab,Mansa,Specific Learning Disabilities,35,60,0,1,1
Punjab,Mansa,Specific Learning Disabilities,80,100,1,0,1
Sikkim,Mangan,Specific Learning Disabilities,6,15,1,0,1
Karnataka,Mandya,Specific Learning Disabilities,15,35,2,0,2
Karnataka,Mandya,Specific Learning Disabilities,35,60,2,0,2
Madhya Pradesh,Mandla,Specific Learning Disabilities,6,15,1,0,1
Madhya Pradesh,Mandla,Specific Learning Disabilities,15,35,1,1,2
Madhya Pradesh,Mandla,Specific Learning Disabilities,35,60,1,1,2
Himachal Pradesh,Mandi,Specific Learning Disabilities,15,35,3,1,4
Himachal Pradesh,Mandi,Specific Learning Disabilities,35,60,2,2,4
Himachal Pradesh,Mandi,Specific Learning Disabilities,60,80,2,1,3
Odisha,Malkangiri,Specific Learning Disabilities,0,6,1,0,1
Odisha,Malkangiri,Specific Learning Disabilities,15,35,3,2,5
Kerala,Malappuram,Specific Learning Disabilities,0,6,1,0,1
Kerala,Malappuram,Specific Learning Disabilities,6,15,10,0,10
Kerala,Malappuram,Specific Learning Disabilities,15,35,14,4,18
Kerala,Malappuram,Specific Learning Disabilities,35,60,1,2,3
Assam,Majuli,Specific Learning Disabilities,0,6,1,0,1
Assam,Majuli,Specific Learning Disabilities,6,15,0,1,1
Assam,Majuli,Specific Learning Disabilities,35,60,0,1,1
Uttar Pradesh,Mainpuri,Specific Learning Disabilities,15,35,6,0,6
Uttar Pradesh,Mainpuri,Specific Learning Disabilities,35,60,2,1,3
Uttar Pradesh,Mainpuri,Specific Learning Disabilities,60,80,1,2,3
Uttar Pradesh,Mahoba,Specific Learning Disabilities,15,35,8,0,8
Uttar Pradesh,Mahoba,Specific Learning Disabilities,35,60,8,1,9
Uttar Pradesh,Mahoba,Specific Learning Disabilities,60,80,1,0,1
Gujarat,Mahisagar,Specific Learning Disabilities,6,15,1,0,1
Gujarat,Mahesana,Specific Learning Disabilities,6,15,47,30,77
Gujarat,Mahesana,Specific Learning Disabilities,15,35,85,6,91
Haryana,Mahendragarh,Specific Learning Disabilities,15,35,0,1,1
Haryana,Mahendragarh,Specific Learning Disabilities,35,60,1,0,1
Uttar Pradesh,Maharajganj,Specific Learning Disabilities,15,35,2,0,2
Uttar Pradesh,Maharajganj,Specific Learning Disabilities,35,60,1,0,1
Tamil Nadu,Madurai,Specific Learning Disabilities,6,15,1,1,2
Tamil Nadu,Madurai,Specific Learning Disabilities,15,35,4,1,5
Tamil Nadu,Madurai,Specific Learning Disabilities,35,60,1,0,1
Tamil Nadu,Madurai,Specific Learning Disabilities,80,100,1,0,1
Bihar,Madhubani,Specific Learning Disabilities,6,15,1,3,4
Bihar,Madhubani,Specific Learning Disabilities,15,35,5,1,6
Bihar,Madhepura,Specific Learning Disabilities,15,35,3,1,4
Mizoram,Lunglei,Specific Learning Disabilities,6,15,0,1,1
Punjab,Ludhiana,Specific Learning Disabilities,6,15,6,1,7
Punjab,Ludhiana,Specific Learning Disabilities,15,35,7,2,9
Punjab,Ludhiana,Specific Learning Disabilities,35,60,2,1,3
Punjab,Ludhiana,Specific Learning Disabilities,60,80,2,0,2
Punjab,Ludhiana,Specific Learning Disabilities,80,100,1,0,1
Uttar Pradesh,Lucknow,Specific Learning Disabilities,6,15,1,0,1
Uttar Pradesh,Lucknow,Specific Learning Disabilities,15,35,5,2,7
Uttar Pradesh,Lucknow,Specific Learning Disabilities,35,60,2,3,5
Arunachal Pradesh,Lower Dibang Valley,Specific Learning Disabilities,6,15,0,1,1
Arunachal Pradesh,Lower Dibang Valley,Specific Learning Disabilities,35,60,1,0,1
Jharkhand,Lohardaga,Specific Learning Disabilities,6,15,0,2,2
Jharkhand,Lohardaga,Specific Learning Disabilities,15,35,3,3,6
Jharkhand,Lohardaga,Specific Learning Disabilities,35,60,1,1,2
Ladakh,Leh Ladakh,Specific Learning Disabilities,15,35,1,1,2
Maharashtra,Latur,Specific Learning Disabilities,6,15,1,0,1
Maharashtra,Latur,Specific Learning Disabilities,15,35,2,1,3
Maharashtra,Latur,Specific Learning Disabilities,35,60,1,0,1
Maharashtra,Latur,Specific Learning Disabilities,60,80,1,0,1
Uttar Pradesh,Lalitpur,Specific Learning Disabilities,15,35,4,0,4
Uttar Pradesh,Lalitpur,Specific Learning Disabilities,35,60,2,0,2
Lakshadweep,Lakshadweep District,Specific Learning Disabilities,6,15,1,0,1
Bihar,Lakhisarai,Specific Learning Disabilities,35,60,1,0,1
Assam,Lakhimpur,Specific Learning Disabilities,6,15,1,0,1
Assam,Lakhimpur,Specific Learning Disabilities,60,80,1,0,1
Uttar Pradesh,Kushi Nagar,Specific Learning Disabilities,35,60,3,2,5
Haryana,Kurukshetra,Specific Learning Disabilities,35,60,0,1,1
Andhra Pradesh,Kurnool,Specific Learning Disabilities,15,35,1,2,3
Andhra Pradesh,Kurnool,Specific Learning Disabilities,35,60,1,8,9
Andhra Pradesh,Kurnool,Specific Learning Disabilities,60,80,1,0,1
Tamil Nadu,Krishnagiri,Specific Learning Disabilities,0,6,0,1,1
Tamil Nadu,Krishnagiri,Specific Learning Disabilities,6,15,7,3,10
Tamil Nadu,Krishnagiri,Specific Learning Disabilities,15,35,5,6,11
Tamil Nadu,Krishnagiri,Specific Learning Disabilities,35,60,7,1,8
Tamil Nadu,Krishnagiri,Specific Learning Disabilities,60,80,1,2,3
Kerala,Kozhikode,Specific Learning Disabilities,6,15,40,6,46
Kerala,Kozhikode,Specific Learning Disabilities,15,35,63,8,71
Kerala,Kozhikode,Specific Learning Disabilities,35,60,1,1,2
Kerala,Kottayam,Specific Learning Disabilities,6,15,6,1,7
Kerala,Kottayam,Specific Learning Disabilities,15,35,17,2,19
Rajasthan,Kota,Specific Learning Disabilities,35,60,1,0,1
Chhattisgarh,Korea,Specific Learning Disabilities,6,15,1,5,6
Chhattisgarh,Korea,Specific Learning Disabilities,15,35,2,0,2
Chhattisgarh,Korea,Specific Learning Disabilities,35,60,1,1,2
Chhattisgarh,Korea,Specific Learning Disabilities,60,80,1,1,2
Chhattisgarh,Korba,Specific Learning Disabilities,6,15,1,0,1
Chhattisgarh,Korba,Specific Learning Disabilities,15,35,0,1,1
Odisha,Koraput,Specific Learning Disabilities,0,6,0,1,1
Odisha,Koraput,Specific Learning Disabilities,6,15,0,1,1
Odisha,Koraput,Specific Learning Disabilities,15,35,0,1,1
Odisha,Koraput,Specific Learning Disabilities,35,60,1,0,1
Karnataka,Koppal,Specific Learning Disabilities,6,15,1,0,1
Karnataka,Koppal,Specific Learning Disabilities,15,35,1,1,2
Karnataka,Koppal,Specific Learning Disabilities,35,60,1,0,1
Chhattisgarh,Kondagaon,Specific Learning Disabilities,6,15,0,1,1
Kerala,Kollam,Specific Learning Disabilities,6,15,1,0,1
Kerala,Kollam,Specific Learning Disabilities,15,35,14,5,19
Kerala,Kollam,Specific Learning Disabilities,35,60,0,1,1
Kerala,Kollam,Specific Learning Disabilities,60,80,0,1,1
Maharashtra,Kolhapur,Specific Learning Disabilities,6,15,14,4,18
Maharashtra,Kolhapur,Specific Learning Disabilities,15,35,36,9,45
Mizoram,Kolasib,Specific Learning Disabilities,35,60,0,1,1
Karnataka,Kolar,Specific Learning Disabilities,6,15,0,2,2
Karnataka,Kolar,Specific Learning Disabilities,15,35,0,1,1
Karnataka,Kolar,Specific Learning Disabilities,60,80,0,1,1
Assam,Kokrajhar,Specific Learning Disabilities,6,15,1,0,1
Assam,Kokrajhar,Specific Learning Disabilities,15,35,1,1,2
Assam,Kokrajhar,Specific Learning Disabilities,35,60,1,1,2
Nagaland,Kohima,Specific Learning Disabilities,6,15,2,0,2
Nagaland,Kohima,Specific Learning Disabilities,15,35,1,0,1
Jharkhand,Koderma,Specific Learning Disabilities,6,15,0,1,1
Jharkhand,Koderma,Specific Learning Disabilities,15,35,1,0,1
Karnataka,Kodagu,Specific Learning Disabilities,6,15,0,1,1
Jammu And Kashmir,Kishtwar,Specific Learning Disabilities,0,6,0,1,1
Jammu And Kashmir,Kishtwar,Specific Learning Disabilities,6,15,1,0,1
Jammu And Kashmir,Kishtwar,Specific Learning Disabilities,15,35,1,0,1
Jammu And Kashmir,Kishtwar,Specific Learning Disabilities,35,60,1,0,1
Jammu And Kashmir,Kishtwar,Specific Learning Disabilities,60,80,1,0,1
Bihar,Kishanganj,Specific Learning Disabilities,6,15,0,1,1
Bihar,Kishanganj,Specific Learning Disabilities,60,80,2,0,2
Jharkhand,Khunti,Specific Learning Disabilities,15,35,1,0,1
Odisha,Khordha,Specific Learning Disabilities,6,15,1,1,2
Odisha,Khordha,Specific Learning Disabilities,15,35,1,0,1
Odisha,Khordha,Specific Learning Disabilities,35,60,1,0,1
Uttar Pradesh,Kheri,Specific Learning Disabilities,15,35,3,3,6
Uttar Pradesh,Kheri,Specific Learning Disabilities,35,60,8,1,9
Gujarat,Kheda,Specific Learning Disabilities,6,15,2,1,3
Gujarat,Kheda,Specific Learning Disabilities,15,35,2,4,6
Madhya Pradesh,Khargone,Specific Learning Disabilities,6,15,1,0,1
Madhya Pradesh,Khargone,Specific Learning Disabilities,15,35,1,4,5
Madhya Pradesh,Khargone,Specific Learning Disabilities,35,60,1,0,1
Bihar,Khagaria,Specific Learning Disabilities,15,35,0,1,1
Odisha,Kendrapara,Specific Learning Disabilities,6,15,0,1,1
Odisha,Kendrapara,Specific Learning Disabilities,15,35,3,0,3
Odisha,Kendrapara,Specific Learning Disabilities,60,80,1,0,1
Odisha,Kendrapara,Specific Learning Disabilities,80,100,1,0,1
Uttar Pradesh,Kaushambi,Specific Learning Disabilities,15,35,2,1,3
Uttar Pradesh,Kaushambi,Specific Learning Disabilities,35,60,1,1,2
Uttar Pradesh,Kaushambi,Specific Learning Disabilities,60,80,1,0,1
Madhya Pradesh,Katni,Specific Learning Disabilities,6,15,1,0,1
Madhya Pradesh,Katni,Specific Learning Disabilities,15,35,1,0,1
Bihar,Katihar,Specific Learning Disabilities,6,15,1,1,2
Bihar,Katihar,Specific Learning Disabilities,15,35,1,2,3
Bihar,Katihar,Specific Learning Disabilities,35,60,2,0,2
Bihar,Katihar,Specific Learning Disabilities,60,80,2,0,2
Jammu And Kashmir,Kathua,Specific Learning Disabilities,6,15,1,0,1
Uttar Pradesh,Kasganj,Specific Learning Disabilities,6,15,1,0,1
Uttar Pradesh,Kasganj,Specific Learning Disabilities,15,35,3,0,3
Uttar Pradesh,Kasganj,Specific Learning Disabilities,35,60,1,0,1
Kerala,Kasaragod,Specific Learning Disabilities,6,15,12,3,15
Kerala,Kasaragod,Specific Learning Disabilities,15,35,16,9,25
Kerala,Kasaragod,Specific Learning Disabilities,60,80,0,1,1
Tamil Nadu,Karur,Specific Learning Disabilities,6,15,8,0,8
Haryana,Karnal,Specific Learning Disabilities,15,35,1,0,1
Puducherry,Karaikal,Specific Learning Disabilities,15,35,1,0,1
Puducherry,Karaikal,Specific Learning Disabilities,35,60,0,2,2
Punjab,Kapurthala,Specific Learning Disabilities,6,15,1,0,1
Uttar Pradesh,Kanpur Nagar,Specific Learning Disabilities,6,15,6,6,12
Uttar Pradesh,Kanpur Nagar,Specific Learning Disabilities,15,35,5,3,8
Uttar Pradesh,Kanpur Nagar,Specific Learning Disabilities,60,80,1,0,1
Uttar Pradesh,Kanpur Dehat,Specific Learning Disabilities,6,15,2,0,2
Uttar Pradesh,Kanpur Dehat,Specific Learning Disabilities,15,35,1,0,1
Uttar Pradesh,Kanpur Dehat,Specific Learning Disabilities,35,60,1,0,1
Kerala,Kannur,Specific Learning Disabilities,6,15,12,5,17
Kerala,Kannur,Specific Learning Disabilities,15,35,1,0,1
Tamil Nadu,Kanniyakumari,Specific Learning Disabilities,6,15,3,0,3
Tamil Nadu,Kanniyakumari,Specific Learning Disabilities,15,35,5,0,5
Tamil Nadu,Kanniyakumari,Specific Learning Disabilities,35,60,2,0,2
Tamil Nadu,Kanniyakumari,Specific Learning Disabilities,60,80,1,0,1
Chhattisgarh,Kanker,Specific Learning Disabilities,0,6,0,1,1
Chhattisgarh,Kanker,Specific Learning Disabilities,6,15,4,3,7
Chhattisgarh,Kanker,Specific Learning Disabilities,15,35,3,6,9
Chhattisgarh,Kanker,Specific Learning Disabilities,35,60,3,4,7
Chhattisgarh,Kanker,Specific Learning Disabilities,60,80,1,3,4
Himachal Pradesh,Kangra,Specific Learning Disabilities,15,35,1,0,1
Odisha,Kandhamal,Specific Learning Disabilities,6,15,1,0,1
Odisha,Kandhamal,Specific Learning Disabilities,15,35,0,3,3
Odisha,Kandhamal,Specific Learning Disabilities,35,60,1,2,3
Tamil Nadu,Kanchipuram,Specific Learning Disabilities,6,15,2,0,2
Tamil Nadu,Kanchipuram,Specific Learning Disabilities,15,35,5,1,6
Tamil Nadu,Kanchipuram,Specific Learning Disabilities,35,60,2,0,2
Tamil Nadu,Kanchipuram,Specific Learning Disabilities,60,80,1,0,1
Assam,Kamrup Metro,Specific Learning Disabilities,15,35,3,0,3
Assam,Kamrup,Specific Learning Disabilities,6,15,1,0,1
Tamil Nadu,Kallakurichi,Specific Learning Disabilities,6,15,1,0,1
Tamil Nadu,Kallakurichi,Specific Learning Disabilities,15,35,3,4,7
Tamil Nadu,Kallakurichi,Specific Learning Disabilities,35,60,2,0,2
Tamil Nadu,Kallakurichi,Specific Learning Disabilities,60,80,0,2,2
Odisha,Kalahandi,Specific Learning Disabilities,35,60,2,0,2
Karnataka,Kalaburagi,Specific Learning Disabilities,0,6,1,0,1
Karnataka,Kalaburagi,Specific Learning Disabilities,6,15,0,1,1
Karnataka,Kalaburagi,Specific Learning Disabilities,15,35,2,1,3
Haryana,Kaithal,Specific Learning Disabilities,15,35,1,0,1
Haryana,Kaithal,Specific Learning Disabilities,35,60,3,0,3
Bihar,Kaimur (Bhabua),Specific Learning Disabilities,15,35,2,5,7
Bihar,Kaimur (Bhabua),Specific Learning Disabilities,35,60,4,0,4
Bihar,Kaimur (Bhabua),Specific Learning Disabilities,60,80,1,0,1
Gujarat,Kachchh,Specific Learning Disabilities,6,15,0,2,2
Gujarat,Kachchh,Specific Learning Disabilities,15,35,23,25,48
Gujarat,Junagadh,Specific Learning Disabilities,15,35,1,0,1
Assam,Jorhat,Specific Learning Disabilities,15,35,1,0,1
Assam,Jorhat,Specific Learning Disabilities,35,60,1,0,1
Rajasthan,Jodhpur,Specific Learning Disabilities,35,60,1,0,1
Rajasthan,Jhunjhunu,Specific Learning Disabilities,6,15,0,2,2
Rajasthan,Jhunjhunu,Specific Learning Disabilities,15,35,2,0,2
Rajasthan,Jhunjhunu,Specific Learning Disabilities,35,60,1,0,1
Odisha,Jharsuguda,Specific Learning Disabilities,15,35,1,0,1
Odisha,Jharsuguda,Specific Learning Disabilities,35,60,7,3,10
Odisha,Jharsuguda,Specific Learning Disabilities,60,80,1,1,2
Uttar Pradesh,Jhansi,Specific Learning Disabilities,6,15,0,1,1
Uttar Pradesh,Jhansi,Specific Learning Disabilities,35,60,1,1,2
Uttar Pradesh,Jhansi,Specific Learning Disabilities,60,80,1,0,1
Rajasthan,Jhalawar,Specific Learning Disabilities,6,15,0,1,1
Rajasthan,Jhalawar,Specific Learning Disabilities,15,35,2,0,2
Haryana,Jhajjar,Specific Learning Disabilities,15,35,1,0,1
Madhya Pradesh,Jhabua,Specific Learning Disabilities,6,15,2,1,3
Madhya Pradesh,Jhabua,Specific Learning Disabilities,15,35,8,3,11
Madhya Pradesh,Jhabua,Specific Learning Disabilities,35,60,7,7,14
Madhya Pradesh,Jhabua,Specific Learning Disabilities,60,80,2,2,4
Madhya Pradesh,Jhabua,Specific Learning Disabilities,80,100,1,0,1
Bihar,Jehanabad,Specific Learning Disabilities,35,60,1,0,1
Uttar Pradesh,Jaunpur,Specific Learning Disabilities,0,6,1,1,2
Uttar Pradesh,Jaunpur,Specific Learning Disabilities,6,15,1,0,1
Uttar Pradesh,Jaunpur,Specific Learning Disabilities,15,35,5,4,9
Uttar Pradesh,Jaunpur,Specific Learning Disabilities,35,60,4,0,4
Chhattisgarh,Jashpur,Specific Learning Disabilities,35,60,1,2,3
Chhattisgarh,Janjgir-Champa,Specific Learning Disabilities,6,15,3,1,4
Chhattisgarh,Janjgir-Champa,Specific Learning Disabilities,15,35,6,2,8
Chhattisgarh,Janjgir-Champa,Specific Learning Disabilities,35,60,1,3,4
Bihar,Jamui,Specific Learning Disabilities,6,15,0,1,1
Bihar,Jamui,Specific Learning Disabilities,15,35,1,0,1
Bihar,Jamui,Specific Learning Disabilities,35,60,0,1,1
Jharkhand,Jamtara,Specific Learning Disabilities,6,15,2,4,6
Jharkhand,Jamtara,Specific Learning Disabilities,15,35,6,6,12
Jharkhand,Jamtara,Specific Learning Disabilities,35,60,5,2,7
Jharkhand,Jamtara,Specific Learning Disabilities,60,80,1,0,1
Gujarat,Jamnagar,Specific Learning Disabilities,6,15,2,5,7
Gujarat,Jamnagar,Specific Learning Disabilities,15,35,4,0,4
Jammu And Kashmir,Jammu,Specific Learning Disabilities,6,15,0,1,1
Jammu And Kashmir,Jammu,Specific Learning Disabilities,15,35,2,0,2
Jammu And Kashmir,Jammu,Specific Learning Disabilities,35,60,3,1,4
Rajasthan,Jalore,Specific Learning Disabilities,6,15,0,1,1
Rajasthan,Jalore,Specific Learning Disabilities,15,35,5,1,6
Maharashtra,Jalna,Specific Learning Disabilities,15,35,13,2,15
Maharashtra,Jalna,Specific Learning Disabilities,35,60,0,1,1
Maharashtra,Jalgaon,Specific Learning Disabilities,35,60,2,0,2
Uttar Pradesh,Jalaun,Specific Learning Disabilities,15,35,5,2,7
Uttar Pradesh,Jalaun,Specific Learning Disabilities,35,60,10,4,14
Uttar Pradesh,Jalaun,Specific Learning Disabilities,60,80,2,0,2
Punjab,Jalandhar,Specific Learning Disabilities,6,15,0,1,1
Punjab,Jalandhar,Specific Learning Disabilities,15,35,9,1,10
Rajasthan,Jaisalmer,Specific Learning Disabilities,6,15,1,0,1
Rajasthan,Jaisalmer,Specific Learning Disabilities,15,35,3,1,4
Rajasthan,Jaisalmer,Specific Learning Disabilities,35,60,1,1,2
Rajasthan,Jaisalmer,Specific Learning Disabilities,60,80,1,0,1
Rajasthan,Jaipur,Specific Learning Disabilities,6,15,1,1,2
Rajasthan,Jaipur,Specific Learning Disabilities,15,35,7,2,9
Odisha,Jagatsinghapur,Specific Learning Disabilities,60,80,1,0,1
Madhya Pradesh,Jabalpur,Specific Learning Disabilities,6,15,0,3,3
Madhya Pradesh,Jabalpur,Specific Learning Disabilities,15,35,7,1,8
Madhya Pradesh,Indore,Specific Learning Disabilities,6,15,2,0,2
Madhya Pradesh,Indore,Specific Learning Disabilities,15,35,7,3,10
Madhya Pradesh,Indore,Specific Learning Disabilities,35,60,3,3,6
Manipur,Imphal West,Specific Learning Disabilities,15,35,1,0,1
Kerala,Idukki,Specific Learning Disabilities,6,15,1,0,1
Kerala,Idukki,Specific Learning Disabilities,15,35,1,1,2
Kerala,Idukki,Specific Learning Disabilities,60,80,2,0,2
Punjab,Hoshiarpur,Specific Learning Disabilities,0,6,0,1,1
Punjab,Hoshiarpur,Specific Learning Disabilities,6,15,1,0,1
Punjab,Hoshiarpur,Specific Learning Disabilities,15,35,3,1,4
Punjab,Hoshiarpur,Specific Learning Disabilities,35,60,5,3,8
Punjab,Hoshiarpur,Specific Learning Disabilities,60,80,2,0,2
Haryana,Hisar,Specific Learning Disabilities,6,15,1,0,1
Haryana,Hisar,Specific Learning Disabilities,35,60,1,0,1
Jharkhand,Hazaribagh,Specific Learning Disabilities,0,6,0,1,1
Jharkhand,Hazaribagh,Specific Learning Disabilities,6,15,1,1,2
Jharkhand,Hazaribagh,Specific Learning Disabilities,15,35,1,1,2
Jharkhand,Hazaribagh,Specific Learning Disabilities,35,60,1,0,1
Jharkhand,Hazaribagh,Specific Learning Disabilities,60,80,1,0,1
Karnataka,Haveri,Specific Learning Disabilities,6,15,1,0,1
Karnataka,Haveri,Specific Learning Disabilities,15,35,2,2,4
Karnataka,Haveri,Specific Learning Disabilities,35,60,1,0,1
Uttar Pradesh,Hathras,Specific Learning Disabilities,6,15,1,0,1
Uttar Pradesh,Hathras,Specific Learning Disabilities,15,35,3,0,3
Uttar Pradesh,Hathras,Specific Learning Disabilities,35,60,1,0,1
Karnataka,Hassan,Specific Learning Disabilities,6,15,1,0,1
Karnataka,Hassan,Specific Learning Disabilities,15,35,4,0,4
Karnataka,Hassan,Specific Learning Disabilities,35,60,1,0,1
Uttarakhand,Haridwar,Specific Learning Disabilities,15,35,3,0,3
Uttarakhand,Haridwar,Specific Learning Disabilities,35,60,3,0,3
Uttar Pradesh,Hardoi,Specific Learning Disabilities,15,35,3,0,3
Uttar Pradesh,Hardoi,Specific Learning Disabilities,35,60,3,1,4
Uttar Pradesh,Hardoi,Specific Learning Disabilities,60,80,2,0,2
Madhya Pradesh,Harda,Specific Learning Disabilities,0,6,1,0,1
Uttar Pradesh,Hapur,Specific Learning Disabilities,15,35,1,0,1
Uttar Pradesh,Hapur,Specific Learning Disabilities,35,60,1,0,1
Uttar Pradesh,Hapur,Specific Learning Disabilities,80,100,1,0,1
Himachal Pradesh,Hamirpur,Specific Learning Disabilities,6,15,1,0,1
Uttar Pradesh,Hamirpur,Specific Learning Disabilities,0,6,2,0,2
Uttar Pradesh,Hamirpur,Specific Learning Disabilities,6,15,12,6,18
Uttar Pradesh,Hamirpur,Specific Learning Disabilities,15,35,5,0,5
Uttar Pradesh,Hamirpur,Specific Learning Disabilities,35,60,7,0,7
Uttar Pradesh,Hamirpur,Specific Learning Disabilities,60,80,1,0,1
Assam,Hailakandi,Specific Learning Disabilities,6,15,4,0,4
Assam,Hailakandi,Specific Learning Disabilities,15,35,0,1,1
Sikkim,Gyalshing,Specific Learning Disabilities,6,15,0,1,1
Madhya Pradesh,Gwalior,Specific Learning Disabilities,6,15,0,1,1
Madhya Pradesh,Gwalior,Specific Learning Disabilities,15,35,3,0,3
Haryana,Gurugram,Specific Learning Disabilities,6,15,8,1,9
Haryana,Gurugram,Specific Learning Disabilities,15,35,28,8,36
Punjab,Gurdaspur,Specific Learning Disabilities,6,15,0,1,1
Madhya Pradesh,Guna,Specific Learning Disabilities,15,35,1,0,1
Jharkhand,Gumla,Specific Learning Disabilities,6,15,1,1,2
Jharkhand,Gumla,Specific Learning Disabilities,15,35,7,3,10
Jharkhand,Gumla,Specific Learning Disabilities,35,60,8,4,12
Jharkhand,Gumla,Specific Learning Disabilities,60,80,2,2,4
Uttar Pradesh,Gorakhpur,Specific Learning Disabilities,6,15,0,1,1
Uttar Pradesh,Gorakhpur,Specific Learning Disabilities,15,35,3,1,4
Uttar Pradesh,Gorakhpur,Specific Learning Disabilities,35,60,3,0,3
Uttar Pradesh,Gorakhpur,Specific Learning Disabilities,60,80,3,0,3
Bihar,Gopalganj,Specific Learning Disabilities,6,15,1,0,1
Bihar,Gopalganj,Specific Learning Disabilities,60,80,1,0,1
Maharashtra,Gondia,Specific Learning Disabilities,0,6,1,1,2
Maharashtra,Gondia,Specific Learning Disabilities,6,15,2,1,3
Maharashtra,Gondia,Specific Learning Disabilities,15,35,3,2,5
Uttar Pradesh,Gonda,Specific Learning Disabilities,15,35,3,1,4
Uttar Pradesh,Gonda,Specific Learning Disabilities,35,60,7,1,8
Uttar Pradesh,Gonda,Specific Learning Disabilities,60,80,2,0,2
Assam,Golaghat,Specific Learning Disabilities,35,60,1,0,1
Jharkhand,Godda,Specific Learning Disabilities,6,15,2,1,3
Jharkhand,Godda,Specific Learning Disabilities,15,35,23,6,29
Jharkhand,Godda,Specific Learning Disabilities,35,60,6,5,11
Jharkhand,Godda,Specific Learning Disabilities,60,80,1,0,1
Jharkhand,Godda,Specific Learning Disabilities,80,100,1,0,1
Assam,Goalpara,Specific Learning Disabilities,35,60,1,1,2
Jharkhand,Giridih,Specific Learning Disabilities,6,15,0,2,2
Jharkhand,Giridih,Specific Learning Disabilities,15,35,5,1,6
Jharkhand,Giridih,Specific Learning Disabilities,35,60,2,2,4
Jharkhand,Giridih,Specific Learning Disabilities,60,80,3,1,4
Gujarat,Gir Somnath,Specific Learning Disabilities,6,15,1,1,2
Gujarat,Gir Somnath,Specific Learning Disabilities,15,35,1,0,1
Uttar Pradesh,Ghaziabad,Specific Learning Disabilities,6,15,2,0,2
Uttar Pradesh,Ghaziabad,Specific Learning Disabilities,15,35,15,3,18
Bihar,Gaya,Specific Learning Disabilities,6,15,1,0,1
Bihar,Gaya,Specific Learning Disabilities,15,35,1,0,1
Uttar Pradesh,Gautam Buddha Nagar,Specific Learning Disabilities,6,15,6,7,13
Uttar Pradesh,Gautam Buddha Nagar,Specific Learning Disabilities,15,35,42,22,64
Chhattisgarh,Gaurella Pendra Marwahi,Specific Learning Disabilities,35,60,1,0,1
Chhattisgarh,Gaurella Pendra Marwahi,Specific Learning Disabilities,60,80,0,1,1
Chhattisgarh,Gariyaband,Specific Learning Disabilities,15,35,1,1,2
Chhattisgarh,Gariyaband,Specific Learning Disabilities,35,60,1,1,2
Jharkhand,Garhwa,Specific Learning Disabilities,6,15,2,0,2
Jharkhand,Garhwa,Specific Learning Disabilities,15,35,0,2,2
Jharkhand,Garhwa,Specific Learning Disabilities,35,60,0,2,2
Odisha,Ganjam,Specific Learning Disabilities,6,15,1,0,1
Odisha,Ganjam,Specific Learning Disabilities,15,35,1,0,1
Rajasthan,Ganganagar,Specific Learning Disabilities,6,15,1,1,2
Rajasthan,Ganganagar,Specific Learning Disabilities,15,35,2,2,4
Rajasthan,Ganganagar,Specific Learning Disabilities,60,80,1,0,1
Gujarat,Gandhinagar,Specific Learning Disabilities,6,15,2,0,2
Gujarat,Gandhinagar,Specific Learning Disabilities,15,35,5,1,6
Jammu And Kashmir,Ganderbal,Specific Learning Disabilities,15,35,1,0,1
Odisha,Gajapati,Specific Learning Disabilities,6,15,1,0,1
Odisha,Gajapati,Specific Learning Disabilities,15,35,0,1,1
Maharashtra,Gadchiroli,Specific Learning Disabilities,6,15,0,2,2
Maharashtra,Gadchiroli,Specific Learning Disabilities,15,35,1,0,1
Maharashtra,Gadchiroli,Specific Learning Disabilities,35,60,1,0,1
Karnataka,Gadag,Specific Learning Disabilities,15,35,0,2,2
Karnataka,Gadag,Specific Learning Disabilities,35,60,1,0,1
Karnataka,Gadag,Specific Learning Disabilities,60,80,1,0,1
Uttar Pradesh,Firozabad,Specific Learning Disabilities,15,35,2,0,2
Uttar Pradesh,Firozabad,Specific Learning Disabilities,35,60,2,1,3
Punjab,Fazilka,Specific Learning Disabilities,35,60,0,1,1
Uttar Pradesh,Fatehpur,Specific Learning Disabilities,15,35,3,1,4
Uttar Pradesh,Fatehpur,Specific Learning Disabilities,35,60,3,0,3
Punjab,Fatehgarh Sahib,Specific Learning Disabilities,6,15,2,0,2
Punjab,Fatehgarh Sahib,Specific Learning Disabilities,15,35,4,1,5
Punjab,Fatehgarh Sahib,Specific Learning Disabilities,60,80,1,0,1
Haryana,Fatehabad,Specific Learning Disabilities,0,6,1,0,1
Haryana,Fatehabad,Specific Learning Disabilities,6,15,0,1,1
Haryana,Fatehabad,Specific Learning Disabilities,15,35,2,3,5
Haryana,Fatehabad,Specific Learning Disabilities,35,60,3,0,3
Uttar Pradesh,Farrukhabad,Specific Learning Disabilities,6,15,0,1,1
Uttar Pradesh,Farrukhabad,Specific Learning Disabilities,15,35,3,0,3
Uttar Pradesh,Farrukhabad,Specific Learning Disabilities,35,60,1,1,2
Haryana,Faridabad,Specific Learning Disabilities,6,15,21,7,28
Haryana,Faridabad,Specific Learning Disabilities,15,35,26,22,48
Uttar Pradesh,Etawah,Specific Learning Disabilities,15,35,4,0,4
Uttar Pradesh,Etawah,Specific Learning Disabilities,35,60,3,0,3
Uttar Pradesh,Etawah,Specific Learning Disabilities,60,80,1,0,1
Tamil Nadu,Erode,Specific Learning Disabilities,0,6,0,1,1
Tamil Nadu,Erode,Specific Learning Disabilities,6,15,355,210,565
Tamil Nadu,Erode,Specific Learning Disabilities,15,35,108,55,163
Tamil Nadu,Erode,Specific Learning Disabilities,35,60,1,0,1
Kerala,Ernakulam,Specific Learning Disabilities,6,15,8,0,8
Kerala,Ernakulam,Specific Learning Disabilities,15,35,19,8,27
Meghalaya,Eastern West Khasi Hills,Specific Learning Disabilities,6,15,2,2,4
Meghalaya,Eastern West Khasi Hills,Specific Learning Disabilities,15,35,2,1,3
Jharkhand,East Singhbum,Specific Learning Disabilities,15,35,6,10,16
Jharkhand,East Singhbum,Specific Learning Disabilities,35,60,5,2,7
Jharkhand,East Singhbum,Specific Learning Disabilities,60,80,0,1,1
Jharkhand,East Singhbum,Specific Learning Disabilities,80,100,1,0,1
Madhya Pradesh,East Nimar,Specific Learning Disabilities,6,15,20,14,34
Madhya Pradesh,East Nimar,Specific Learning Disabilities,15,35,55,47,102
Madhya Pradesh,East Nimar,Specific Learning Disabilities,35,60,32,12,44
Madhya Pradesh,East Nimar,Specific Learning Disabilities,60,80,10,3,13
Meghalaya,East Khasi Hills,Specific Learning Disabilities,6,15,24,7,31
Meghalaya,East Khasi Hills,Specific Learning Disabilities,15,35,45,22,67
Meghalaya,East Khasi Hills,Specific Learning Disabilities,35,60,6,0,6
Delhi,East,Specific Learning Disabilities,6,15,20,4,24
Delhi,East,Specific Learning Disabilities,15,35,37,25,62
Chhattisgarh,Durg,Specific Learning Disabilities,6,15,1,0,1
Chhattisgarh,Durg,Specific Learning Disabilities,35,60,0,1,1
Rajasthan,Dungarpur,Specific Learning Disabilities,15,35,2,1,3
Jharkhand,Dumka,Specific Learning Disabilities,6,15,1,0,1
Jharkhand,Dumka,Specific Learning Disabilities,15,35,1,1,2
Jharkhand,Dumka,Specific Learning Disabilities,35,60,0,1,1
Gujarat,Dohad,Specific Learning Disabilities,35,60,1,0,1
Dadra Nagar Haveli And Daman And Diu,Diu,Specific Learning Disabilities,6,15,1,0,1
Madhya Pradesh,Dindori,Specific Learning Disabilities,6,15,0,1,1
Madhya Pradesh,Dindori,Specific Learning Disabilities,15,35,1,0,1
Madhya Pradesh,Dindori,Specific Learning Disabilities,35,60,2,0,2
Tamil Nadu,Dindigul,Specific Learning Disabilities,15,35,1,0,1
Tamil Nadu,Dindigul,Specific Learning Disabilities,35,60,2,0,2
Tamil Nadu,Dindigul,Specific Learning Disabilities,60,80,1,0,1
Assam,Dibrugarh,Specific Learning Disabilities,6,15,6,1,7
Maharashtra,Dhule,Specific Learning Disabilities,6,15,3,0,3
Maharashtra,Dhule,Specific Learning Disabilities,15,35,2,2,4
Maharashtra,Dhule,Specific Learning Disabilities,35,60,8,7,15
Maharashtra,Dhule,Specific Learning Disabilities,60,80,5,1,6
Odisha,Dhenkanal,Specific Learning Disabilities,6,15,3,0,3
Odisha,Dhenkanal,Specific Learning Disabilities,15,35,1,0,1
Odisha,Dhenkanal,Specific Learning Disabilities,35,60,2,1,3
Odisha,Dhenkanal,Specific Learning Disabilities,60,80,1,0,1
Karnataka,Dharwad,Specific Learning Disabilities,6,15,2,0,2
Karnataka,Dharwad,Specific Learning Disabilities,15,35,2,1,3
Karnataka,Dharwad,Specific Learning Disabilities,35,60,1,0,1
Tamil Nadu,Dharmapuri,Specific Learning Disabilities,0,6,1,0,1
Tamil Nadu,Dharmapuri,Specific Learning Disabilities,6,15,1,0,1
Tamil Nadu,Dharmapuri,Specific Learning Disabilities,15,35,0,1,1
Madhya Pradesh,Dhar,Specific Learning Disabilities,6,15,1,0,1
Madhya Pradesh,Dhar,Specific Learning Disabilities,15,35,4,1,5
Madhya Pradesh,Dhar,Specific Learning Disabilities,35,60,3,0,3
Madhya Pradesh,Dhar,Specific Learning Disabilities,60,80,1,0,1
Jharkhand,Dhanbad,Specific Learning Disabilities,6,15,1,0,1
Jharkhand,Dhanbad,Specific Learning Disabilities,15,35,3,2,5
Jharkhand,Dhanbad,Specific Learning Disabilities,35,60,4,1,5
Madhya Pradesh,Dewas,Specific Learning Disabilities,15,35,0,1,1
Madhya Pradesh,Dewas,Specific Learning Disabilities,35,60,0,1,1
Madhya Pradesh,Dewas,Specific Learning Disabilities,60,80,1,0,1
Madhya Pradesh,Dewas,Specific Learning Disabilities,80,100,0,1,1
Uttar Pradesh,Deoria,Specific Learning Disabilities,15,35,5,3,8
Uttar Pradesh,Deoria,Specific Learning Disabilities,35,60,3,1,4
Jharkhand,Deoghar,Specific Learning Disabilities,15,35,4,1,5
Jharkhand,Deoghar,Specific Learning Disabilities,35,60,2,0,2
Uttarakhand,Dehradun,Specific Learning Disabilities,6,15,2,1,3
Uttarakhand,Dehradun,Specific Learning Disabilities,15,35,14,1,15
Karnataka,Davangere,Specific Learning Disabilities,15,35,3,1,4
Karnataka,Davangere,Specific Learning Disabilities,35,60,3,0,3
Karnataka,Davangere,Specific Learning Disabilities,60,80,1,0,1
Rajasthan,Dausa,Specific Learning Disabilities,0,6,1,0,1
Rajasthan,Dausa,Specific Learning Disabilities,6,15,0,1,1
Rajasthan,Dausa,Specific Learning Disabilities,35,60,1,0,1
Madhya Pradesh,Datia,Specific Learning Disabilities,0,6,1,0,1
Assam,Darrang,Specific Learning Disabilities,6,15,1,2,3
Assam,Darrang,Specific Learning Disabilities,15,35,0,1,1
Assam,Darrang,Specific Learning Disabilities,35,60,2,0,2
Bihar,Darbhanga,Specific Learning Disabilities,6,15,0,1,1
Bihar,Darbhanga,Specific Learning Disabilities,15,35,10,12,22
Bihar,Darbhanga,Specific Learning Disabilities,35,60,7,2,9
Bihar,Darbhanga,Specific Learning Disabilities,60,80,3,1,4
Gujarat,Dang,Specific Learning Disabilities,15,35,1,1,2
Gujarat,Dang,Specific Learning Disabilities,60,80,0,1,1
Madhya Pradesh,Damoh,Specific Learning Disabilities,6,15,1,0,1
Madhya Pradesh,Damoh,Specific Learning Disabilities,15,35,3,1,4
Madhya Pradesh,Damoh,Specific Learning Disabilities,35,60,5,3,8
Dadra Nagar Haveli And Daman And Diu,Daman,Specific Learning Disabilities,6,15,4,1,5
Karnataka,Dakshina Kannada,Specific Learning Disabilities,6,15,1,0,1
Karnataka,Dakshina Kannada,Specific Learning Disabilities,15,35,0,1,1
Odisha,Cuttack,Specific Learning Disabilities,6,15,1,1,2
Odisha,Cuttack,Specific Learning Disabilities,35,60,1,1,2
Tamil Nadu,Cuddalore,Specific Learning Disabilities,6,15,1,1,2
Tamil Nadu,Cuddalore,Specific Learning Disabilities,15,35,1,1,2
Tamil Nadu,Coimbatore,Specific Learning Disabilities,6,15,6,3,9
Tamil Nadu,Coimbatore,Specific Learning Disabilities,15,35,4,3,7
Tamil Nadu,Coimbatore,Specific Learning Disabilities,35,60,1,0,1
Tamil Nadu,Coimbatore,Specific Learning Disabilities,60,80,2,0,2
Rajasthan,Churu,Specific Learning Disabilities,15,35,1,0,1
Rajasthan,Churu,Specific Learning Disabilities,35,60,1,0,1
Manipur,Churachandpur,Specific Learning Disabilities,35,60,0,1,1
Rajasthan,Chittorgarh,Specific Learning Disabilities,6,15,1,4,5
Rajasthan,Chittorgarh,Specific Learning Disabilities,15,35,4,1,5
Uttar Pradesh,Chitrakoot,Specific Learning Disabilities,6,15,5,3,8
Uttar Pradesh,Chitrakoot,Specific Learning Disabilities,15,35,2,1,3
Uttar Pradesh,Chitrakoot,Specific Learning Disabilities,35,60,5,2,7
Uttar Pradesh,Chitrakoot,Specific Learning Disabilities,60,80,1,0,1
Karnataka,Chitradurga,Specific Learning Disabilities,6,15,6,2,8
Karnataka,Chitradurga,Specific Learning Disabilities,15,35,15,12,27
Karnataka,Chitradurga,Specific Learning Disabilities,35,60,9,7,16
Karnataka,Chitradurga,Specific Learning Disabilities,60,80,2,5,7
Karnataka,Chitradurga,Specific Learning Disabilities,80,100,1,0,1
Karnataka,Chikkamagaluru,Specific Learning Disabilities,6,15,0,1,1
Karnataka,Chikkamagaluru,Specific Learning Disabilities,15,35,2,2,4
Karnataka,Chikkaballapura,Specific Learning Disabilities,6,15,0,1,1
Karnataka,Chikkaballapura,Specific Learning Disabilities,15,35,3,2,5
Karnataka,Chikkaballapura,Specific Learning Disabilities,35,60,3,1,4
Karnataka,Chikkaballapura,Specific Learning Disabilities,60,80,2,0,2
Gujarat,Chhotaudepur,Specific Learning Disabilities,15,35,4,1,5
Madhya Pradesh,Chhindwara,Specific Learning Disabilities,0,6,1,0,1
Madhya Pradesh,Chhindwara,Specific Learning Disabilities,6,15,1,0,1
Madhya Pradesh,Chhindwara,Specific Learning Disabilities,15,35,2,2,4
Madhya Pradesh,Chhindwara,Specific Learning Disabilities,35,60,4,1,5
Madhya Pradesh,Chhatarpur,Specific Learning Disabilities,6,15,2,0,2
Madhya Pradesh,Chhatarpur,Specific Learning Disabilities,15,35,1,1,2
Madhya Pradesh,Chhatarpur,Specific Learning Disabilities,35,60,1,2,3
Madhya Pradesh,Chhatarpur,Specific Learning Disabilities,60,80,1,0,1
Tamil Nadu,Chennai,Specific Learning Disabilities,0,6,1,0,1
Tamil Nadu,Chennai,Specific Learning Disabilities,6,15,35,14,49
Tamil Nadu,Chennai,Specific Learning Disabilities,15,35,127,49,176
Tamil Nadu,Chennai,Specific Learning Disabilities,60,80,1,0,1
Tamil Nadu,Chengalpattu,Specific Learning Disabilities,6,15,2,3,5
Tamil Nadu,Chengalpattu,Specific Learning Disabilities,15,35,4,4,8
Tamil Nadu,Chengalpattu,Specific Learning Disabilities,35,60,2,1,3
Jharkhand,Chatra,Specific Learning Disabilities,6,15,1,1,2
Jharkhand,Chatra,Specific Learning Disabilities,15,35,1,0,1
Chandigarh,Chandigarh,Specific Learning Disabilities,6,15,17,3,20
Chandigarh,Chandigarh,Specific Learning Disabilities,15,35,22,5,27
Chandigarh,Chandigarh,Specific Learning Disabilities,35,60,3,0,3
Uttar Pradesh,Chandauli,Specific Learning Disabilities,15,35,1,0,1
Uttarakhand,Champawat,Specific Learning Disabilities,6,15,0,1,1
Uttarakhand,Chamoli,Specific Learning Disabilities,15,35,1,1,2
Uttarakhand,Chamoli,Specific Learning Disabilities,35,60,1,0,1
Himachal Pradesh,Chamba,Specific Learning Disabilities,6,15,0,2,2
Karnataka,Chamarajanagara,Specific Learning Disabilities,35,60,1,1,2
Delhi,Central,Specific Learning Disabilities,6,15,17,6,23
Delhi,Central,Specific Learning Disabilities,15,35,35,12,47
Assam,Cachar,Specific Learning Disabilities,6,15,1,0,1
Assam,Cachar,Specific Learning Disabilities,60,80,0,1,1
Bihar,Buxar,Specific Learning Disabilities,15,35,1,0,1
Bihar,Buxar,Specific Learning Disabilities,35,60,0,1,1
Madhya Pradesh,Burhanpur,Specific Learning Disabilities,6,15,2,1,3
Madhya Pradesh,Burhanpur,Specific Learning Disabilities,15,35,1,2,3
Madhya Pradesh,Burhanpur,Specific Learning Disabilities,35,60,3,1,4
Rajasthan,Bundi,Specific Learning Disabilities,6,15,1,0,1
Rajasthan,Bundi,Specific Learning Disabilities,15,35,0,2,2
Rajasthan,Bundi,Specific Learning Disabilities,35,60,0,1,1
Maharashtra,Buldhana,Specific Learning Disabilities,15,35,2,0,2
Maharashtra,Buldhana,Specific Learning Disabilities,60,80,1,0,1
Uttar Pradesh,Bulandshahr,Specific Learning Disabilities,6,15,1,2,3
Uttar Pradesh,Bulandshahr,Specific Learning Disabilities,15,35,5,1,6
Uttar Pradesh,Bulandshahr,Specific Learning Disabilities,35,60,5,2,7
Jammu And Kashmir,Budgam,Specific Learning Disabilities,0,6,1,0,1
Jammu And Kashmir,Budgam,Specific Learning Disabilities,15,35,1,0,1
Uttar Pradesh,Budaun,Specific Learning Disabilities,0,6,1,0,1
Uttar Pradesh,Budaun,Specific Learning Disabilities,15,35,4,3,7
Uttar Pradesh,Budaun,Specific Learning Disabilities,60,80,1,0,1
Odisha,Boudh,Specific Learning Disabilities,6,15,2,1,3
Odisha,Boudh,Specific Learning Disabilities,15,35,0,2,2
Odisha,Boudh,Specific Learning Disabilities,35,60,1,1,2
Gujarat,Botad,Specific Learning Disabilities,6,15,44,27,71
Gujarat,Botad,Specific Learning Disabilities,15,35,6,4,10
Assam,Bongaigaon,Specific Learning Disabilities,15,35,1,0,1
Jharkhand,Bokaro,Specific Learning Disabilities,6,15,3,1,4
Jharkhand,Bokaro,Specific Learning Disabilities,15,35,10,4,14
Jharkhand,Bokaro,Specific Learning Disabilities,35,60,6,1,7
Chhattisgarh,Bilaspur,Specific Learning Disabilities,6,15,2,0,2
Chhattisgarh,Bilaspur,Specific Learning Disabilities,15,35,2,0,2
Rajasthan,Bikaner,Specific Learning Disabilities,6,15,1,0,1
Uttar Pradesh,Bijnor,Specific Learning Disabilities,0,6,0,2,2
Uttar Pradesh,Bijnor,Specific Learning Disabilities,6,15,2,0,2
Uttar Pradesh,Bijnor,Specific Learning Disabilities,15,35,8,7,15
Uttar Pradesh,Bijnor,Specific Learning Disabilities,35,60,8,0,8
Uttar Pradesh,Bijnor,Specific Learning Disabilities,60,80,6,0,6
Chhattisgarh,Bijapur,Specific Learning Disabilities,15,35,0,1,1
Karnataka,Bidar,Specific Learning Disabilities,6,15,2,0,2
Karnataka,Bidar,Specific Learning Disabilities,15,35,2,2,4
Karnataka,Bidar,Specific Learning Disabilities,35,60,4,1,5
Karnataka,Bidar,Specific Learning Disabilities,60,80,1,1,2
Madhya Pradesh,Bhopal,Specific Learning Disabilities,6,15,6,4,10
Madhya Pradesh,Bhopal,Specific Learning Disabilities,15,35,17,4,21
Madhya Pradesh,Bhopal,Specific Learning Disabilities,35,60,5,1,6
Bihar,Bhojpur,Specific Learning Disabilities,6,15,0,1,1
Bihar,Bhojpur,Specific Learning Disabilities,15,35,2,0,2
Bihar,Bhojpur,Specific Learning Disabilities,35,60,2,1,3
Haryana,Bhiwani,Specific Learning Disabilities,15,35,1,0,1
Madhya Pradesh,Bhind,Specific Learning Disabilities,15,35,2,0,2
Madhya Pradesh,Bhind,Specific Learning Disabilities,35,60,3,0,3
Rajasthan,Bhilwara,Specific Learning Disabilities,6,15,1,0,1
Rajasthan,Bhilwara,Specific Learning Disabilities,15,35,8,4,12
Rajasthan,Bhilwara,Specific Learning Disabilities,35,60,1,0,1
Rajasthan,Bhilwara,Specific Learning Disabilities,60,80,1,0,1
Gujarat,Bhavnagar,Specific Learning Disabilities,6,15,25,12,37
Gujarat,Bhavnagar,Specific Learning Disabilities,15,35,13,1,14
Gujarat,Bharuch,Specific Learning Disabilities,6,15,3,0,3
Gujarat,Bharuch,Specific Learning Disabilities,15,35,3,1,4
Rajasthan,Bharatpur,Specific Learning Disabilities,15,35,1,2,3
Maharashtra,Bhandara,Specific Learning Disabilities,6,15,17,7,24
Maharashtra,Bhandara,Specific Learning Disabilities,15,35,7,4,11
Bihar,Bhagalpur,Specific Learning Disabilities,15,35,2,0,2
Bihar,Bhagalpur,Specific Learning Disabilities,35,60,0,1,1
Odisha,Bhadrak,Specific Learning Disabilities,6,15,4,0,4
Odisha,Bhadrak,Specific Learning Disabilities,15,35,3,2,5
Odisha,Bhadrak,Specific Learning Disabilities,35,60,3,3,6
Odisha,Bhadrak,Specific Learning Disabilities,60,80,1,0,1
Odisha,Bhadrak,Specific Learning Disabilities,80,100,0,1,1
Madhya Pradesh,Betul,Specific Learning Disabilities,6,15,1,0,1
Madhya Pradesh,Betul,Specific Learning Disabilities,15,35,3,1,4
Madhya Pradesh,Betul,Specific Learning Disabilities,35,60,0,2,2
Karnataka,Bengaluru Urban,Specific Learning Disabilities,6,15,1,2,3
Karnataka,Bengaluru Urban,Specific Learning Disabilities,15,35,10,2,12
Karnataka,Bengaluru Urban,Specific Learning Disabilities,35,60,2,1,3
Karnataka,Bengaluru Rural,Specific Learning Disabilities,6,15,2,0,2
Karnataka,Bengaluru Rural,Specific Learning Disabilities,15,35,1,0,1
Chhattisgarh,Bemetara,Specific Learning Disabilities,15,35,1,0,1
Chhattisgarh,Bemetara,Specific Learning Disabilities,35,60,1,0,1
Karnataka,Belagavi,Specific Learning Disabilities,6,15,3,3,6
Karnataka,Belagavi,Specific Learning Disabilities,15,35,7,6,13
Karnataka,Belagavi,Specific Learning Disabilities,35,60,5,1,6
Karnataka,Belagavi,Specific Learning Disabilities,60,80,2,0,2
Karnataka,Belagavi,Specific Learning Disabilities,80,100,1,0,1
Bihar,Begusarai,Specific Learning Disabilities,0,6,0,1,1
Bihar,Begusarai,Specific Learning Disabilities,6,15,1,1,2
Bihar,Begusarai,Specific Learning Disabilities,15,35,1,0,1
Maharashtra,Beed,Specific Learning Disabilities,15,35,3,0,3
Maharashtra,Beed,Specific Learning Disabilities,35,60,1,0,1
Maharashtra,Beed,Specific Learning Disabilities,60,80,0,1,1
Punjab,Bathinda,Specific Learning Disabilities,15,35,1,0,1
Uttar Pradesh,Basti,Specific Learning Disabilities,6,15,1,1,2
Uttar Pradesh,Basti,Specific Learning Disabilities,35,60,1,0,1
Chhattisgarh,Bastar,Specific Learning Disabilities,6,15,10,10,20
Chhattisgarh,Bastar,Specific Learning Disabilities,15,35,3,1,4
Madhya Pradesh,Barwani,Specific Learning Disabilities,6,15,1,1,2
Madhya Pradesh,Barwani,Specific Learning Disabilities,15,35,1,3,4
Assam,Barpeta,Specific Learning Disabilities,6,15,1,1,2
Assam,Barpeta,Specific Learning Disabilities,15,35,3,1,4
Assam,Barpeta,Specific Learning Disabilities,35,60,1,3,4
Assam,Barpeta,Specific Learning Disabilities,60,80,1,0,1
Punjab,Barnala,Specific Learning Disabilities,6,15,2,0,2
Rajasthan,Barmer,Specific Learning Disabilities,15,35,0,1,1
Rajasthan,Barmer,Specific Learning Disabilities,35,60,1,1,2
Rajasthan,Barmer,Specific Learning Disabilities,60,80,1,0,1
Uttar Pradesh,Bareilly,Specific Learning Disabilities,15,35,3,0,3
Uttar Pradesh,Bareilly,Specific Learning Disabilities,35,60,1,1,2
Rajasthan,Baran,Specific Learning Disabilities,6,15,1,0,1
Jammu And Kashmir,Baramulla,Specific Learning Disabilities,6,15,1,0,1
Uttar Pradesh,Barabanki,Specific Learning Disabilities,6,15,1,1,2
Uttar Pradesh,Barabanki,Specific Learning Disabilities,15,35,4,0,4
Uttar Pradesh,Barabanki,Specific Learning Disabilities,35,60,3,1,4
Uttar Pradesh,Barabanki,Specific Learning Disabilities,60,80,2,0,2
Rajasthan,Banswara,Specific Learning Disabilities,15,35,2,1,3
Rajasthan,Banswara,Specific Learning Disabilities,35,60,0,1,1
Bihar,Banka,Specific Learning Disabilities,6,15,0,3,3
Bihar,Banka,Specific Learning Disabilities,15,35,3,1,4
Bihar,Banka,Specific Learning Disabilities,35,60,2,2,4
Jammu And Kashmir,Bandipora,Specific Learning Disabilities,6,15,1,0,1
Jammu And Kashmir,Bandipora,Specific Learning Disabilities,15,35,1,3,4
Jammu And Kashmir,Bandipora,Specific Learning Disabilities,35,60,1,1,2
Jammu And Kashmir,Bandipora,Specific Learning Disabilities,60,80,2,0,2
Uttar Pradesh,Banda,Specific Learning Disabilities,6,15,0,1,1
Uttar Pradesh,Banda,Specific Learning Disabilities,15,35,3,0,3
Uttar Pradesh,Banda,Specific Learning Disabilities,35,60,2,0,2
Uttar Pradesh,Balrampur,Specific Learning Disabilities,15,35,2,0,2
Uttar Pradesh,Balrampur,Specific Learning Disabilities,35,60,2,0,2
Chhattisgarh,Baloda Bazar,Specific Learning Disabilities,6,15,4,3,7
Chhattisgarh,Baloda Bazar,Specific Learning Disabilities,15,35,10,7,17
Chhattisgarh,Baloda Bazar,Specific Learning Disabilities,35,60,5,4,9
Uttar Pradesh,Ballia,Specific Learning Disabilities,15,35,1,2,3
Karnataka,Ballari,Specific Learning Disabilities,6,15,1,4,5
Karnataka,Ballari,Specific Learning Disabilities,15,35,4,4,8
Karnataka,Ballari,Specific Learning Disabilities,35,60,0,3,3
Karnataka,Ballari,Specific Learning Disabilities,60,80,1,0,1
Odisha,Baleshwar,Specific Learning Disabilities,0,6,1,0,1
Odisha,Baleshwar,Specific Learning Disabilities,6,15,8,3,11
Odisha,Baleshwar,Specific Learning Disabilities,15,35,11,6,17
Odisha,Baleshwar,Specific Learning Disabilities,35,60,4,3,7
Odisha,Baleshwar,Specific Learning Disabilities,60,80,2,2,4
Odisha,Balangir,Specific Learning Disabilities,0,6,0,1,1
Odisha,Balangir,Specific Learning Disabilities,6,15,2,4,6
Odisha,Balangir,Specific Learning Disabilities,15,35,5,4,9
Odisha,Balangir,Specific Learning Disabilities,35,60,1,0,1
Madhya Pradesh,Balaghat,Specific Learning Disabilities,6,15,2,0,2
Madhya Pradesh,Balaghat,Specific Learning Disabilities,15,35,5,1,6
Madhya Pradesh,Balaghat,Specific Learning Disabilities,35,60,2,2,4
Assam,Baksa,Specific Learning Disabilities,15,35,0,1,1
Assam,Baksa,Specific Learning Disabilities,35,60,0,1,1
Assam,Baksa,Specific Learning Disabilities,60,80,1,0,1
Uttar Pradesh,Bahraich,Specific Learning Disabilities,15,35,1,0,1
Uttar Pradesh,Baghpat,Specific Learning Disabilities,6,15,0,1,1
Uttar Pradesh,Baghpat,Specific Learning Disabilities,15,35,3,0,3
Uttar Pradesh,Baghpat,Specific Learning Disabilities,35,60,5,1,6
Uttar Pradesh,Baghpat,Specific Learning Disabilities,60,80,1,0,1
Uttarakhand,Bageshwar,Specific Learning Disabilities,15,35,2,0,2
Karnataka,Bagalkote,Specific Learning Disabilities,15,35,1,0,1
Karnataka,Bagalkote,Specific Learning Disabilities,35,60,1,0,1
Uttar Pradesh,Ayodhya,Specific Learning Disabilities,15,35,4,2,6
Uttar Pradesh,Ayodhya,Specific Learning Disabilities,35,60,5,0,5
Bihar,Aurangabad,Specific Learning Disabilities,6,15,0,1,1
Bihar,Aurangabad,Specific Learning Disabilities,15,35,3,1,4
Bihar,Aurangabad,Specific Learning Disabilities,35,60,1,1,2
Bihar,Aurangabad,Specific Learning Disabilities,60,80,1,0,1
Maharashtra,Aurangabad,Specific Learning Disabilities,15,35,2,0,2
Uttar Pradesh,Auraiya,Specific Learning Disabilities,15,35,1,0,1
Tamil Nadu,Ariyalur,Specific Learning Disabilities,6,15,14,10,24
Tamil Nadu,Ariyalur,Specific Learning Disabilities,15,35,4,2,6
Bihar,Araria,Specific Learning Disabilities,35,60,0,1,1
Madhya Pradesh,Anuppur,Specific Learning Disabilities,6,15,0,1,1
Odisha,Anugul,Specific Learning Disabilities,60,80,0,1,1
Jammu And Kashmir,Anantnag,Specific Learning Disabilities,6,15,1,0,1
Andhra Pradesh,Anantapur,Specific Learning Disabilities,6,15,1,0,1
Gujarat,Anand,Specific Learning Disabilities,6,15,6,1,7
Gujarat,Anand,Specific Learning Disabilities,15,35,17,5,22
Uttar Pradesh,Amroha,Specific Learning Disabilities,15,35,3,1,4
Uttar Pradesh,Amroha,Specific Learning Disabilities,35,60,2,1,3
Punjab,Amritsar,Specific Learning Disabilities,6,15,3,1,4
Punjab,Amritsar,Specific Learning Disabilities,15,35,0,1,1
Gujarat,Amreli,Specific Learning Disabilities,0,6,0,1,1
Gujarat,Amreli,Specific Learning Disabilities,6,15,78,49,127
Gujarat,Amreli,Specific Learning Disabilities,15,35,67,34,101
Gujarat,Amreli,Specific Learning Disabilities,60,80,0,1,1
Maharashtra,Amravati,Specific Learning Disabilities,6,15,1,0,1
Maharashtra,Amravati,Specific Learning Disabilities,15,35,5,0,5
Uttar Pradesh,Ambedkar Nagar,Specific Learning Disabilities,6,15,0,1,1
Uttar Pradesh,Ambedkar Nagar,Specific Learning Disabilities,15,35,0,1,1
Haryana,Ambala,Specific Learning Disabilities,15,35,1,0,1
Haryana,Ambala,Specific Learning Disabilities,35,60,1,0,1
Rajasthan,Alwar,Specific Learning Disabilities,6,15,2,0,2
Rajasthan,Alwar,Specific Learning Disabilities,15,35,2,0,2
Rajasthan,Alwar,Specific Learning Disabilities,35,60,0,1,1
Uttarakhand,Almora,Specific Learning Disabilities,15,35,1,0,1
Madhya Pradesh,Alirajpur,Specific Learning Disabilities,15,35,1,0,1
Uttar Pradesh,Aligarh,Specific Learning Disabilities,6,15,3,1,4
Uttar Pradesh,Aligarh,Specific Learning Disabilities,15,35,7,2,9
Uttar Pradesh,Aligarh,Specific Learning Disabilities,35,60,8,6,14
Uttar Pradesh,Aligarh,Specific Learning Disabilities,60,80,3,2,5
Kerala,Alappuzha,Specific Learning Disabilities,6,15,37,9,46
Kerala,Alappuzha,Specific Learning Disabilities,15,35,64,16,80
Kerala,Alappuzha,Specific Learning Disabilities,35,60,0,1,1
Maharashtra,Akola,Specific Learning Disabilities,0,6,0,1,1
Maharashtra,Akola,Specific Learning Disabilities,6,15,1,1,2
Maharashtra,Akola,Specific Learning Disabilities,15,35,1,0,1
Rajasthan,Ajmer,Specific Learning Disabilities,6,15,0,3,3
Rajasthan,Ajmer,Specific Learning Disabilities,80,100,1,0,1
Mizoram,Aizawl,Specific Learning Disabilities,6,15,1,0,1
Maharashtra,Ahmednagar,Specific Learning Disabilities,6,15,11,4,15
Maharashtra,Ahmednagar,Specific Learning Disabilities,15,35,15,0,15
Gujarat,Ahmadabad,Specific Learning Disabilities,6,15,53,21,74
Gujarat,Ahmadabad,Specific Learning Disabilities,15,35,45,17,62
Uttar Pradesh,Agra,Specific Learning Disabilities,15,35,0,1,1
Uttar Pradesh,Agra,Specific Learning Disabilities,60,80,1,0,1
Madhya Pradesh,Agar Malwa,Specific Learning Disabilities,15,35,1,0,1
Nagaland,Zunheboto,Speech And Language Disability,15,35,1,0,1
Maharashtra,Yavatmal,Speech And Language Disability,0,6,1,0,1
Maharashtra,Yavatmal,Speech And Language Disability,6,15,1,0,1
Maharashtra,Yavatmal,Speech And Language Disability,15,35,7,5,12
Maharashtra,Yavatmal,Speech And Language Disability,35,60,8,10,18
Maharashtra,Yavatmal,Speech And Language Disability,60,80,5,1,6
Puducherry,Yanam,Speech And Language Disability,15,35,1,0,1
Puducherry,Yanam,Speech And Language Disability,35,60,1,1,2
Haryana,Yamunanagar,Speech And Language Disability,6,15,1,0,1
Haryana,Yamunanagar,Speech And Language Disability,15,35,3,0,3
Haryana,Yamunanagar,Speech And Language Disability,35,60,2,0,2
Haryana,Yamunanagar,Speech And Language Disability,60,80,1,0,1
Karnataka,Yadgir,Speech And Language Disability,0,6,1,1,2
Karnataka,Yadgir,Speech And Language Disability,6,15,8,7,15
Karnataka,Yadgir,Speech And Language Disability,15,35,10,9,19
Karnataka,Yadgir,Speech And Language Disability,35,60,10,2,12
Nagaland,Wokha,Speech And Language Disability,0,6,0,1,1
Nagaland,Wokha,Speech And Language Disability,6,15,2,2,4
Nagaland,Wokha,Speech And Language Disability,15,35,3,5,8
Nagaland,Wokha,Speech And Language Disability,35,60,1,0,1
Tripura,West Tripura,Speech And Language Disability,15,35,1,1,2
Tripura,West Tripura,Speech And Language Disability,35,60,2,0,2
Jharkhand,West Singhbhum,Speech And Language Disability,6,15,5,4,9
Jharkhand,West Singhbhum,Speech And Language Disability,15,35,13,7,20
Jharkhand,West Singhbhum,Speech And Language Disability,35,60,5,4,9
Jharkhand,West Singhbhum,Speech And Language Disability,60,80,1,0,1
Meghalaya,West Khasi Hills,Speech And Language Disability,6,15,1,0,1
Meghalaya,West Khasi Hills,Speech And Language Disability,15,35,5,3,8
Meghalaya,West Khasi Hills,Speech And Language Disability,35,60,0,1,1
Assam,West Karbi Anglong,Speech And Language Disability,6,15,2,0,2
Assam,West Karbi Anglong,Speech And Language Disability,15,35,0,1,1
Assam,West Karbi Anglong,Speech And Language Disability,35,60,0,1,1
Meghalaya,West Jaintia Hills,Speech And Language Disability,6,15,2,3,5
Meghalaya,West Jaintia Hills,Speech And Language Disability,15,35,13,11,24
Meghalaya,West Jaintia Hills,Speech And Language Disability,35,60,1,12,13
Meghalaya,West Jaintia Hills,Speech And Language Disability,60,80,2,2,4
Meghalaya,West Garo Hills,Speech And Language Disability,0,6,5,1,6
Meghalaya,West Garo Hills,Speech And Language Disability,6,15,20,11,31
Meghalaya,West Garo Hills,Speech And Language Disability,15,35,50,51,101
Meghalaya,West Garo Hills,Speech And Language Disability,35,60,13,13,26
Meghalaya,West Garo Hills,Speech And Language Disability,60,80,2,0,2
Delhi,West,Speech And Language Disability,6,15,3,2,5
Delhi,West,Speech And Language Disability,15,35,5,2,7
Delhi,West,Speech And Language Disability,35,60,1,0,1
Delhi,West,Speech And Language Disability,60,80,1,0,1
Kerala,Wayanad,Speech And Language Disability,15,35,7,2,9
Kerala,Wayanad,Speech And Language Disability,35,60,4,5,9
Kerala,Wayanad,Speech And Language Disability,60,80,4,3,7
Maharashtra,Washim,Speech And Language Disability,6,15,17,15,32
Maharashtra,Washim,Speech And Language Disability,15,35,32,16,48
Maharashtra,Washim,Speech And Language Disability,35,60,26,5,31
Maharashtra,Washim,Speech And Language Disability,60,80,6,1,7
Maharashtra,Wardha,Speech And Language Disability,15,35,2,2,4
Maharashtra,Wardha,Speech And Language Disability,35,60,6,1,7
Maharashtra,Wardha,Speech And Language Disability,60,80,2,0,2
Andhra Pradesh,Vizianagaram,Speech And Language Disability,35,60,1,0,1
Andhra Pradesh,Visakhapatanam,Speech And Language Disability,6,15,1,0,1
Andhra Pradesh,Visakhapatanam,Speech And Language Disability,15,35,1,0,1
Andhra Pradesh,Visakhapatanam,Speech And Language Disability,35,60,1,0,1
Tamil Nadu,Virudhunagar,Speech And Language Disability,6,15,6,3,9
Tamil Nadu,Virudhunagar,Speech And Language Disability,15,35,10,2,12
Tamil Nadu,Virudhunagar,Speech And Language Disability,35,60,2,1,3
Tamil Nadu,Villupuram,Speech And Language Disability,6,15,1,1,2
Tamil Nadu,Villupuram,Speech And Language Disability,15,35,8,9,17
Tamil Nadu,Villupuram,Speech And Language Disability,35,60,7,5,12
Tamil Nadu,Villupuram,Speech And Language Disability,60,80,4,0,4
Karnataka,Vijayapura,Speech And Language Disability,0,6,6,0,6
Karnataka,Vijayapura,Speech And Language Disability,6,15,15,12,27
Karnataka,Vijayapura,Speech And Language Disability,15,35,23,14,37
Karnataka,Vijayapura,Speech And Language Disability,35,60,19,7,26
Karnataka,Vijayanagar,Speech And Language Disability,6,15,1,0,1
Madhya Pradesh,Vidisha,Speech And Language Disability,0,6,7,2,9
Madhya Pradesh,Vidisha,Speech And Language Disability,6,15,48,36,84
Madhya Pradesh,Vidisha,Speech And Language Disability,15,35,73,52,125
Madhya Pradesh,Vidisha,Speech And Language Disability,35,60,39,15,54
Madhya Pradesh,Vidisha,Speech And Language Disability,60,80,7,3,10
Madhya Pradesh,Vidisha,Speech And Language Disability,80,100,1,0,1
Tamil Nadu,Vellore,Speech And Language Disability,6,15,6,4,10
Tamil Nadu,Vellore,Speech And Language Disability,15,35,18,7,25
Tamil Nadu,Vellore,Speech And Language Disability,35,60,10,6,16
Tamil Nadu,Vellore,Speech And Language Disability,60,80,3,3,6
Uttar Pradesh,Varanasi,Speech And Language Disability,15,35,5,2,7
Uttar Pradesh,Varanasi,Speech And Language Disability,35,60,1,2,3
Gujarat,Valsad,Speech And Language Disability,6,15,1,1,2
Gujarat,Valsad,Speech And Language Disability,15,35,6,3,9
Gujarat,Valsad,Speech And Language Disability,35,60,1,0,1
Gujarat,Valsad,Speech And Language Disability,60,80,1,0,1
Bihar,Vaishali,Speech And Language Disability,0,6,3,2,5
Bihar,Vaishali,Speech And Language Disability,6,15,26,10,36
Bihar,Vaishali,Speech And Language Disability,15,35,39,25,64
Bihar,Vaishali,Speech And Language Disability,35,60,19,8,27
Bihar,Vaishali,Speech And Language Disability,60,80,2,1,3
Gujarat,Vadodara,Speech And Language Disability,6,15,0,1,1
Gujarat,Vadodara,Speech And Language Disability,15,35,1,0,1
Gujarat,Vadodara,Speech And Language Disability,35,60,0,1,1
Karnataka,Uttara Kannada,Speech And Language Disability,0,6,0,2,2
Karnataka,Uttara Kannada,Speech And Language Disability,6,15,3,3,6
Karnataka,Uttara Kannada,Speech And Language Disability,15,35,12,8,20
Karnataka,Uttara Kannada,Speech And Language Disability,35,60,14,5,19
Uttarakhand,Uttar Kashi,Speech And Language Disability,6,15,1,3,4
Uttarakhand,Uttar Kashi,Speech And Language Disability,15,35,3,0,3
Uttarakhand,Uttar Kashi,Speech And Language Disability,35,60,3,0,3
Uttarakhand,Uttar Kashi,Speech And Language Disability,60,80,1,1,2
Arunachal Pradesh,Upper Subansiri,Speech And Language Disability,15,35,1,1,2
Arunachal Pradesh,Upper Siang,Speech And Language Disability,15,35,2,0,2
Uttar Pradesh,Unnao,Speech And Language Disability,6,15,1,1,2
Uttar Pradesh,Unnao,Speech And Language Disability,15,35,16,15,31
Uttar Pradesh,Unnao,Speech And Language Disability,35,60,14,5,19
Uttar Pradesh,Unnao,Speech And Language Disability,60,80,2,1,3
Tripura,Unakoti,Speech And Language Disability,6,15,2,1,3
Tripura,Unakoti,Speech And Language Disability,15,35,2,0,2
Himachal Pradesh,Una,Speech And Language Disability,0,6,1,0,1
Himachal Pradesh,Una,Speech And Language Disability,6,15,1,1,2
Himachal Pradesh,Una,Speech And Language Disability,15,35,3,2,5
Himachal Pradesh,Una,Speech And Language Disability,35,60,4,4,8
Himachal Pradesh,Una,Speech And Language Disability,60,80,4,1,5
Madhya Pradesh,Umaria,Speech And Language Disability,6,15,6,0,6
Madhya Pradesh,Umaria,Speech And Language Disability,15,35,8,14,22
Madhya Pradesh,Umaria,Speech And Language Disability,35,60,5,2,7
Madhya Pradesh,Umaria,Speech And Language Disability,60,80,3,0,3
Manipur,Ukhrul,Speech And Language Disability,6,15,1,0,1
Manipur,Ukhrul,Speech And Language Disability,15,35,0,1,1
Manipur,Ukhrul,Speech And Language Disability,35,60,0,1,1
Madhya Pradesh,Ujjain,Speech And Language Disability,6,15,0,1,1
Madhya Pradesh,Ujjain,Speech And Language Disability,15,35,5,4,9
Madhya Pradesh,Ujjain,Speech And Language Disability,35,60,8,3,11
Madhya Pradesh,Ujjain,Speech And Language Disability,60,80,2,1,3
Karnataka,Udupi,Speech And Language Disability,0,6,1,0,1
Karnataka,Udupi,Speech And Language Disability,6,15,14,2,16
Karnataka,Udupi,Speech And Language Disability,15,35,35,15,50
Karnataka,Udupi,Speech And Language Disability,35,60,33,27,60
Karnataka,Udupi,Speech And Language Disability,60,80,6,5,11
Jammu And Kashmir,Udhampur,Speech And Language Disability,0,6,0,2,2
Jammu And Kashmir,Udhampur,Speech And Language Disability,6,15,5,5,10
Jammu And Kashmir,Udhampur,Speech And Language Disability,15,35,12,4,16
Jammu And Kashmir,Udhampur,Speech And Language Disability,35,60,6,5,11
Uttarakhand,Udam Singh Nagar,Speech And Language Disability,0,6,3,0,3
Uttarakhand,Udam Singh Nagar,Speech And Language Disability,6,15,25,17,42
Uttarakhand,Udam Singh Nagar,Speech And Language Disability,15,35,47,34,81
Uttarakhand,Udam Singh Nagar,Speech And Language Disability,35,60,10,10,20
Uttarakhand,Udam Singh Nagar,Speech And Language Disability,60,80,2,0,2
Assam,Udalguri,Speech And Language Disability,6,15,1,2,3
Assam,Udalguri,Speech And Language Disability,15,35,10,4,14
Assam,Udalguri,Speech And Language Disability,35,60,8,7,15
Assam,Udalguri,Speech And Language Disability,60,80,1,0,1
Rajasthan,Udaipur,Speech And Language Disability,6,15,11,10,21
Rajasthan,Udaipur,Speech And Language Disability,15,35,23,14,37
Rajasthan,Udaipur,Speech And Language Disability,35,60,18,7,25
Rajasthan,Udaipur,Speech And Language Disability,60,80,3,0,3
Tamil Nadu,Tuticorin,Speech And Language Disability,6,15,2,2,4
Tamil Nadu,Tuticorin,Speech And Language Disability,15,35,5,2,7
Tamil Nadu,Tuticorin,Speech And Language Disability,35,60,2,0,2
Tamil Nadu,Tuticorin,Speech And Language Disability,60,80,1,2,3
Karnataka,Tumakuru,Speech And Language Disability,0,6,11,7,18
Karnataka,Tumakuru,Speech And Language Disability,6,15,34,26,60
Karnataka,Tumakuru,Speech And Language Disability,15,35,65,60,125
Karnataka,Tumakuru,Speech And Language Disability,35,60,72,48,120
Karnataka,Tumakuru,Speech And Language Disability,60,80,18,1,19
Nagaland,Tuensang,Speech And Language Disability,15,35,0,1,1
Rajasthan,Tonk,Speech And Language Disability,6,15,3,0,3
Rajasthan,Tonk,Speech And Language Disability,15,35,3,1,4
Rajasthan,Tonk,Speech And Language Disability,35,60,6,0,6
Rajasthan,Tonk,Speech And Language Disability,60,80,1,0,1
Tamil Nadu,Tiruvannamalai,Speech And Language Disability,0,6,2,2,4
Tamil Nadu,Tiruvannamalai,Speech And Language Disability,6,15,7,2,9
Tamil Nadu,Tiruvannamalai,Speech And Language Disability,15,35,17,9,26
Tamil Nadu,Tiruvannamalai,Speech And Language Disability,35,60,15,13,28
Tamil Nadu,Tiruvannamalai,Speech And Language Disability,60,80,5,6,11
Tamil Nadu,Tiruvannamalai,Speech And Language Disability,80,100,1,0,1
Tamil Nadu,Tiruppur,Speech And Language Disability,0,6,0,1,1
Tamil Nadu,Tiruppur,Speech And Language Disability,6,15,2,1,3
Tamil Nadu,Tiruppur,Speech And Language Disability,15,35,1,0,1
Tamil Nadu,Tiruppur,Speech And Language Disability,35,60,0,1,1
Tamil Nadu,Tiruppur,Speech And Language Disability,60,80,1,0,1
Tamil Nadu,Tirupathur,Speech And Language Disability,0,6,1,0,1
Tamil Nadu,Tirupathur,Speech And Language Disability,6,15,2,1,3
Tamil Nadu,Tirupathur,Speech And Language Disability,35,60,4,3,7
Tamil Nadu,Tirunelveli,Speech And Language Disability,15,35,0,1,1
Tamil Nadu,Tiruchirappalli,Speech And Language Disability,0,6,1,0,1
Tamil Nadu,Tiruchirappalli,Speech And Language Disability,6,15,0,1,1
Tamil Nadu,Tiruchirappalli,Speech And Language Disability,15,35,7,2,9
Tamil Nadu,Tiruchirappalli,Speech And Language Disability,35,60,1,0,1
Tamil Nadu,Tiruchirappalli,Speech And Language Disability,60,80,0,1,1
Arunachal Pradesh,Tirap,Speech And Language Disability,6,15,1,0,1
Assam,Tinsukia,Speech And Language Disability,6,15,2,1,3
Assam,Tinsukia,Speech And Language Disability,15,35,1,0,1
Madhya Pradesh,Tikamgarh,Speech And Language Disability,6,15,2,0,2
Madhya Pradesh,Tikamgarh,Speech And Language Disability,15,35,3,1,4
Madhya Pradesh,Tikamgarh,Speech And Language Disability,35,60,1,0,1
Madhya Pradesh,Tikamgarh,Speech And Language Disability,60,80,1,0,1
Kerala,Thrissur,Speech And Language Disability,6,15,4,1,5
Kerala,Thrissur,Speech And Language Disability,15,35,9,4,13
Kerala,Thrissur,Speech And Language Disability,35,60,6,6,12
Kerala,Thrissur,Speech And Language Disability,60,80,1,4,5
Tamil Nadu,Thiruvarur,Speech And Language Disability,15,35,4,0,4
Tamil Nadu,Thiruvarur,Speech And Language Disability,35,60,1,0,1
Kerala,Thiruvananthapuram,Speech And Language Disability,0,6,0,1,1
Kerala,Thiruvananthapuram,Speech And Language Disability,6,15,3,3,6
Kerala,Thiruvananthapuram,Speech And Language Disability,15,35,6,5,11
Kerala,Thiruvananthapuram,Speech And Language Disability,35,60,9,7,16
Tamil Nadu,Thiruvallur,Speech And Language Disability,0,6,1,1,2
Tamil Nadu,Thiruvallur,Speech And Language Disability,6,15,7,4,11
Tamil Nadu,Thiruvallur,Speech And Language Disability,15,35,6,2,8
Tamil Nadu,Thiruvallur,Speech And Language Disability,35,60,5,2,7
Tamil Nadu,Thiruvallur,Speech And Language Disability,60,80,4,0,4
Tamil Nadu,Theni,Speech And Language Disability,6,15,1,0,1
Tamil Nadu,Theni,Speech And Language Disability,15,35,0,1,1
Tamil Nadu,Theni,Speech And Language Disability,60,80,1,0,1
Tamil Nadu,The Nilgiris,Speech And Language Disability,6,15,2,0,2
Tamil Nadu,The Nilgiris,Speech And Language Disability,15,35,2,1,3
Tamil Nadu,The Nilgiris,Speech And Language Disability,35,60,1,0,1
Tamil Nadu,Thanjavur,Speech And Language Disability,6,15,0,1,1
Tamil Nadu,Thanjavur,Speech And Language Disability,15,35,2,0,2
Tamil Nadu,Thanjavur,Speech And Language Disability,35,60,1,0,1
Maharashtra,Thane,Speech And Language Disability,0,6,1,2,3
Maharashtra,Thane,Speech And Language Disability,6,15,5,4,9
Maharashtra,Thane,Speech And Language Disability,15,35,21,8,29
Maharashtra,Thane,Speech And Language Disability,35,60,25,7,32
Maharashtra,Thane,Speech And Language Disability,60,80,11,0,11
Tamil Nadu,Tenkasi,Speech And Language Disability,6,15,1,0,1
Tamil Nadu,Tenkasi,Speech And Language Disability,15,35,3,2,5
Tamil Nadu,Tenkasi,Speech And Language Disability,35,60,1,0,1
Tamil Nadu,Tenkasi,Speech And Language Disability,60,80,2,1,3
Uttarakhand,Tehri Garhwal,Speech And Language Disability,15,35,3,0,3
Uttarakhand,Tehri Garhwal,Speech And Language Disability,35,60,2,2,4
Uttarakhand,Tehri Garhwal,Speech And Language Disability,60,80,1,1,2
Punjab,Tarn Taran,Speech And Language Disability,6,15,10,10,20
Punjab,Tarn Taran,Speech And Language Disability,15,35,28,8,36
Punjab,Tarn Taran,Speech And Language Disability,35,60,15,7,22
Punjab,Tarn Taran,Speech And Language Disability,60,80,0,1,1
Gujarat,Tapi,Speech And Language Disability,6,15,3,4,7
Gujarat,Tapi,Speech And Language Disability,15,35,10,7,17
Gujarat,Tapi,Speech And Language Disability,35,60,9,1,10
Gujarat,Tapi,Speech And Language Disability,60,80,1,0,1
Manipur,Tamenglong,Speech And Language Disability,6,15,1,2,3
Manipur,Tamenglong,Speech And Language Disability,15,35,5,2,7
Manipur,Tamenglong,Speech And Language Disability,35,60,1,3,4
Manipur,Tamenglong,Speech And Language Disability,60,80,0,2,2
Chhattisgarh,Surguja,Speech And Language Disability,6,15,4,1,5
Chhattisgarh,Surguja,Speech And Language Disability,15,35,11,9,20
Chhattisgarh,Surguja,Speech And Language Disability,35,60,3,1,4
Gujarat,Surendranagar,Speech And Language Disability,15,35,10,7,17
Gujarat,Surendranagar,Speech And Language Disability,35,60,5,5,10
Gujarat,Surat,Speech And Language Disability,6,15,6,7,13
Gujarat,Surat,Speech And Language Disability,15,35,12,2,14
Gujarat,Surat,Speech And Language Disability,35,60,3,2,5
Gujarat,Surat,Speech And Language Disability,60,80,3,0,3
Chhattisgarh,Surajpur,Speech And Language Disability,6,15,16,14,30
Chhattisgarh,Surajpur,Speech And Language Disability,15,35,61,46,107
Chhattisgarh,Surajpur,Speech And Language Disability,35,60,28,18,46
Chhattisgarh,Surajpur,Speech And Language Disability,60,80,1,4,5
Chhattisgarh,Surajpur,Speech And Language Disability,80,100,1,1,2
Bihar,Supaul,Speech And Language Disability,0,6,3,6,9
Bihar,Supaul,Speech And Language Disability,6,15,27,33,60
Bihar,Supaul,Speech And Language Disability,15,35,22,23,45
Bihar,Supaul,Speech And Language Disability,35,60,10,5,15
Bihar,Supaul,Speech And Language Disability,60,80,2,0,2
Odisha,Sundargarh,Speech And Language Disability,0,6,16,10,26
Odisha,Sundargarh,Speech And Language Disability,6,15,61,45,106
Odisha,Sundargarh,Speech And Language Disability,15,35,70,40,110
Odisha,Sundargarh,Speech And Language Disability,35,60,30,25,55
Odisha,Sundargarh,Speech And Language Disability,60,80,6,0,6
Odisha,Sundargarh,Speech And Language Disability,80,100,1,0,1
Uttar Pradesh,Sultanpur,Speech And Language Disability,0,6,1,0,1
Uttar Pradesh,Sultanpur,Speech And Language Disability,6,15,6,4,10
Uttar Pradesh,Sultanpur,Speech And Language Disability,15,35,34,14,48
Uttar Pradesh,Sultanpur,Speech And Language Disability,35,60,9,7,16
Uttar Pradesh,Sultanpur,Speech And Language Disability,60,80,3,0,3
Chhattisgarh,Sukma,Speech And Language Disability,6,15,4,0,4
Chhattisgarh,Sukma,Speech And Language Disability,15,35,9,1,10
Chhattisgarh,Sukma,Speech And Language Disability,35,60,0,3,3
Jammu And Kashmir,Srinagar,Speech And Language Disability,6,15,4,3,7
Jammu And Kashmir,Srinagar,Speech And Language Disability,15,35,9,1,10
Jammu And Kashmir,Srinagar,Speech And Language Disability,35,60,4,2,6
Jammu And Kashmir,Srinagar,Speech And Language Disability,60,80,1,0,1
Andhra Pradesh,Srikakulam,Speech And Language Disability,15,35,0,2,2
Andhra Pradesh,Srikakulam,Speech And Language Disability,35,60,0,1,1
Punjab,Sri Muktsar Sahib,Speech And Language Disability,6,15,4,1,5
Punjab,Sri Muktsar Sahib,Speech And Language Disability,15,35,19,12,31
Punjab,Sri Muktsar Sahib,Speech And Language Disability,35,60,16,8,24
Punjab,Sri Muktsar Sahib,Speech And Language Disability,60,80,3,1,4
Andhra Pradesh,Spsr Nellore,Speech And Language Disability,35,60,1,1,2
Meghalaya,South West Khasi Hills,Speech And Language Disability,15,35,1,0,1
Meghalaya,South West Khasi Hills,Speech And Language Disability,35,60,0,1,1
Meghalaya,South West Garo Hills,Speech And Language Disability,0,6,2,0,2
Meghalaya,South West Garo Hills,Speech And Language Disability,6,15,13,17,30
Meghalaya,South West Garo Hills,Speech And Language Disability,15,35,22,17,39
Meghalaya,South West Garo Hills,Speech And Language Disability,35,60,3,1,4
Delhi,South West,Speech And Language Disability,15,35,3,3,6
Delhi,South West,Speech And Language Disability,35,60,6,1,7
Delhi,South West,Speech And Language Disability,60,80,2,0,2
Tripura,South Tripura,Speech And Language Disability,35,60,1,0,1
Assam,South Salmara Mancachar,Speech And Language Disability,15,35,0,1,1
Goa,South Goa,Speech And Language Disability,15,35,5,1,6
Goa,South Goa,Speech And Language Disability,35,60,6,3,9
Goa,South Goa,Speech And Language Disability,60,80,2,0,2
Meghalaya,South Garo Hills,Speech And Language Disability,0,6,1,0,1
Meghalaya,South Garo Hills,Speech And Language Disability,6,15,13,10,23
Meghalaya,South Garo Hills,Speech And Language Disability,15,35,9,9,18
Meghalaya,South Garo Hills,Speech And Language Disability,35,60,3,1,4
Andaman And Nicobar Islands,South Andamans,Speech And Language Disability,0,6,1,0,1
Andaman And Nicobar Islands,South Andamans,Speech And Language Disability,6,15,3,2,5
Andaman And Nicobar Islands,South Andamans,Speech And Language Disability,15,35,11,8,19
Andaman And Nicobar Islands,South Andamans,Speech And Language Disability,35,60,23,9,32
Andaman And Nicobar Islands,South Andamans,Speech And Language Disability,60,80,1,1,2
Delhi,South,Speech And Language Disability,15,35,1,3,4
Assam,Sonitpur,Speech And Language Disability,0,6,1,1,2
Assam,Sonitpur,Speech And Language Disability,6,15,5,7,12
Assam,Sonitpur,Speech And Language Disability,15,35,7,1,8
Assam,Sonitpur,Speech And Language Disability,35,60,7,5,12
Assam,Sonitpur,Speech And Language Disability,60,80,1,1,2
Haryana,Sonipat,Speech And Language Disability,15,35,1,1,2
Haryana,Sonipat,Speech And Language Disability,35,60,3,0,3
Haryana,Sonipat,Speech And Language Disability,60,80,1,0,1
Odisha,Sonepur,Speech And Language Disability,0,6,2,0,2
Odisha,Sonepur,Speech And Language Disability,6,15,4,3,7
Odisha,Sonepur,Speech And Language Disability,15,35,17,9,26
Odisha,Sonepur,Speech And Language Disability,35,60,8,2,10
Odisha,Sonepur,Speech And Language Disability,60,80,0,1,1
Uttar Pradesh,Sonbhadra,Speech And Language Disability,0,6,3,1,4
Uttar Pradesh,Sonbhadra,Speech And Language Disability,6,15,11,3,14
Uttar Pradesh,Sonbhadra,Speech And Language Disability,15,35,50,24,74
Uttar Pradesh,Sonbhadra,Speech And Language Disability,35,60,25,4,29
Uttar Pradesh,Sonbhadra,Speech And Language Disability,60,80,0,1,1
Uttar Pradesh,Sonbhadra,Speech And Language Disability,80,100,1,0,1
Maharashtra,Solapur,Speech And Language Disability,6,15,1,0,1
Maharashtra,Solapur,Speech And Language Disability,15,35,7,1,8
Maharashtra,Solapur,Speech And Language Disability,35,60,4,0,4
Himachal Pradesh,Solan,Speech And Language Disability,6,15,1,1,2
Himachal Pradesh,Solan,Speech And Language Disability,15,35,2,1,3
Himachal Pradesh,Solan,Speech And Language Disability,35,60,0,1,1
Bihar,Siwan,Speech And Language Disability,0,6,3,2,5
Bihar,Siwan,Speech And Language Disability,6,15,14,10,24
Bihar,Siwan,Speech And Language Disability,15,35,21,6,27
Bihar,Siwan,Speech And Language Disability,35,60,4,1,5
Bihar,Siwan,Speech And Language Disability,60,80,1,0,1
Assam,Sivasagar,Speech And Language Disability,6,15,2,2,4
Assam,Sivasagar,Speech And Language Disability,15,35,3,5,8
Assam,Sivasagar,Speech And Language Disability,35,60,4,1,5
Tamil Nadu,Sivaganga,Speech And Language Disability,0,6,2,2,4
Tamil Nadu,Sivaganga,Speech And Language Disability,6,15,5,0,5
Tamil Nadu,Sivaganga,Speech And Language Disability,15,35,2,1,3
Tamil Nadu,Sivaganga,Speech And Language Disability,35,60,3,0,3
Tamil Nadu,Sivaganga,Speech And Language Disability,60,80,1,0,1
Uttar Pradesh,Sitapur,Speech And Language Disability,0,6,1,1,2
Uttar Pradesh,Sitapur,Speech And Language Disability,6,15,45,47,92
Uttar Pradesh,Sitapur,Speech And Language Disability,15,35,59,34,93
Uttar Pradesh,Sitapur,Speech And Language Disability,35,60,17,8,25
Uttar Pradesh,Sitapur,Speech And Language Disability,60,80,1,2,3
Bihar,Sitamarhi,Speech And Language Disability,0,6,3,0,3
Bihar,Sitamarhi,Speech And Language Disability,6,15,13,11,24
Bihar,Sitamarhi,Speech And Language Disability,15,35,26,7,33
Bihar,Sitamarhi,Speech And Language Disability,35,60,8,4,12
Bihar,Sitamarhi,Speech And Language Disability,60,80,4,0,4
Haryana,Sirsa,Speech And Language Disability,6,15,8,4,12
Haryana,Sirsa,Speech And Language Disability,15,35,9,10,19
Haryana,Sirsa,Speech And Language Disability,35,60,3,1,4
Haryana,Sirsa,Speech And Language Disability,60,80,1,0,1
Rajasthan,Sirohi,Speech And Language Disability,0,6,0,1,1
Rajasthan,Sirohi,Speech And Language Disability,6,15,13,10,23
Rajasthan,Sirohi,Speech And Language Disability,15,35,43,9,52
Rajasthan,Sirohi,Speech And Language Disability,35,60,19,4,23
Rajasthan,Sirohi,Speech And Language Disability,60,80,1,2,3
Himachal Pradesh,Sirmaur,Speech And Language Disability,0,6,7,2,9
Himachal Pradesh,Sirmaur,Speech And Language Disability,6,15,10,7,17
Himachal Pradesh,Sirmaur,Speech And Language Disability,15,35,10,8,18
Himachal Pradesh,Sirmaur,Speech And Language Disability,35,60,9,4,13
Himachal Pradesh,Sirmaur,Speech And Language Disability,60,80,2,0,2
Madhya Pradesh,Singrauli,Speech And Language Disability,6,15,2,2,4
Madhya Pradesh,Singrauli,Speech And Language Disability,15,35,9,4,13
Madhya Pradesh,Singrauli,Speech And Language Disability,35,60,4,0,4
Maharashtra,Sindhudurg,Speech And Language Disability,6,15,2,0,2
Maharashtra,Sindhudurg,Speech And Language Disability,15,35,5,3,8
Maharashtra,Sindhudurg,Speech And Language Disability,35,60,7,3,10
Maharashtra,Sindhudurg,Speech And Language Disability,60,80,0,1,1
Maharashtra,Sindhudurg,Speech And Language Disability,80,100,1,0,1
Jharkhand,Simdega,Speech And Language Disability,0,6,1,2,3
Jharkhand,Simdega,Speech And Language Disability,6,15,9,8,17
Jharkhand,Simdega,Speech And Language Disability,15,35,29,18,47
Jharkhand,Simdega,Speech And Language Disability,35,60,9,9,18
Jharkhand,Simdega,Speech And Language Disability,60,80,2,1,3
Rajasthan,Sikar,Speech And Language Disability,0,6,1,0,1
Rajasthan,Sikar,Speech And Language Disability,6,15,1,1,2
Rajasthan,Sikar,Speech And Language Disability,15,35,22,8,30
Rajasthan,Sikar,Speech And Language Disability,35,60,6,4,10
Rajasthan,Sikar,Speech And Language Disability,60,80,1,0,1
Madhya Pradesh,Sidhi,Speech And Language Disability,0,6,0,1,1
Madhya Pradesh,Sidhi,Speech And Language Disability,6,15,17,8,25
Madhya Pradesh,Sidhi,Speech And Language Disability,15,35,38,19,57
Madhya Pradesh,Sidhi,Speech And Language Disability,35,60,21,8,29
Madhya Pradesh,Sidhi,Speech And Language Disability,60,80,5,1,6
Uttar Pradesh,Siddharth Nagar,Speech And Language Disability,0,6,2,1,3
Uttar Pradesh,Siddharth Nagar,Speech And Language Disability,6,15,23,16,39
Uttar Pradesh,Siddharth Nagar,Speech And Language Disability,15,35,58,47,105
Uttar Pradesh,Siddharth Nagar,Speech And Language Disability,35,60,25,19,44
Uttar Pradesh,Siddharth Nagar,Speech And Language Disability,60,80,2,3,5
Arunachal Pradesh,Siang,Speech And Language Disability,15,35,0,1,1
Uttar Pradesh,Shravasti,Speech And Language Disability,0,6,0,2,2
Uttar Pradesh,Shravasti,Speech And Language Disability,6,15,3,2,5
Uttar Pradesh,Shravasti,Speech And Language Disability,15,35,2,1,3
Uttar Pradesh,Shravasti,Speech And Language Disability,35,60,1,0,1
Uttar Pradesh,Shravasti,Speech And Language Disability,60,80,1,0,1
Jammu And Kashmir,Shopian,Speech And Language Disability,6,15,6,5,11
Jammu And Kashmir,Shopian,Speech And Language Disability,15,35,27,26,53
Jammu And Kashmir,Shopian,Speech And Language Disability,35,60,16,8,24
Jammu And Kashmir,Shopian,Speech And Language Disability,60,80,2,0,2
Jammu And Kashmir,Shopian,Speech And Language Disability,80,100,1,0,1
Madhya Pradesh,Shivpuri,Speech And Language Disability,6,15,2,4,6
Madhya Pradesh,Shivpuri,Speech And Language Disability,15,35,25,19,44
Madhya Pradesh,Shivpuri,Speech And Language Disability,35,60,7,2,9
Madhya Pradesh,Shivpuri,Speech And Language Disability,60,80,0,3,3
Karnataka,Shivamogga,Speech And Language Disability,0,6,2,0,2
Karnataka,Shivamogga,Speech And Language Disability,6,15,5,5,10
Karnataka,Shivamogga,Speech And Language Disability,15,35,29,18,47
Karnataka,Shivamogga,Speech And Language Disability,35,60,26,20,46
Karnataka,Shivamogga,Speech And Language Disability,60,80,1,0,1
Karnataka,Shivamogga,Speech And Language Disability,80,100,0,1,1
Himachal Pradesh,Shimla,Speech And Language Disability,6,15,2,0,2
Himachal Pradesh,Shimla,Speech And Language Disability,15,35,5,3,8
Himachal Pradesh,Shimla,Speech And Language Disability,35,60,3,0,3
Himachal Pradesh,Shimla,Speech And Language Disability,60,80,1,0,1
Arunachal Pradesh,Shi Yomi,Speech And Language Disability,6,15,0,1,1
Madhya Pradesh,Sheopur,Speech And Language Disability,0,6,3,0,3
Madhya Pradesh,Sheopur,Speech And Language Disability,6,15,7,4,11
Madhya Pradesh,Sheopur,Speech And Language Disability,15,35,11,8,19
Madhya Pradesh,Sheopur,Speech And Language Disability,35,60,3,3,6
Madhya Pradesh,Sheopur,Speech And Language Disability,60,80,1,0,1
Bihar,Sheohar,Speech And Language Disability,0,6,8,6,14
Bihar,Sheohar,Speech And Language Disability,6,15,68,47,115
Bihar,Sheohar,Speech And Language Disability,15,35,19,18,37
Bihar,Sheohar,Speech And Language Disability,35,60,2,5,7
Bihar,Sheohar,Speech And Language Disability,60,80,0,1,1
Bihar,Sheikhpura,Speech And Language Disability,6,15,2,3,5
Bihar,Sheikhpura,Speech And Language Disability,15,35,5,3,8
Bihar,Sheikhpura,Speech And Language Disability,60,80,1,0,1
Uttar Pradesh,Shamli,Speech And Language Disability,0,6,2,0,2
Uttar Pradesh,Shamli,Speech And Language Disability,6,15,2,2,4
Uttar Pradesh,Shamli,Speech And Language Disability,15,35,6,5,11
Uttar Pradesh,Shamli,Speech And Language Disability,35,60,5,2,7
Madhya Pradesh,Shajapur,Speech And Language Disability,6,15,1,0,1
Madhya Pradesh,Shajapur,Speech And Language Disability,15,35,1,0,1
Madhya Pradesh,Shajapur,Speech And Language Disability,35,60,3,1,4
Madhya Pradesh,Shajapur,Speech And Language Disability,60,80,1,0,1
Uttar Pradesh,Shahjahanpur,Speech And Language Disability,0,6,5,2,7
Uttar Pradesh,Shahjahanpur,Speech And Language Disability,6,15,41,23,64
Uttar Pradesh,Shahjahanpur,Speech And Language Disability,15,35,92,55,147
Uttar Pradesh,Shahjahanpur,Speech And Language Disability,35,60,43,25,68
Uttar Pradesh,Shahjahanpur,Speech And Language Disability,60,80,6,4,10
Punjab,Shahid Bhagat Singh Nagar,Speech And Language Disability,0,6,1,0,1
Punjab,Shahid Bhagat Singh Nagar,Speech And Language Disability,6,15,5,0,5
Punjab,Shahid Bhagat Singh Nagar,Speech And Language Disability,15,35,25,8,33
Punjab,Shahid Bhagat Singh Nagar,Speech And Language Disability,35,60,18,12,30
Punjab,Shahid Bhagat Singh Nagar,Speech And Language Disability,60,80,3,3,6
Madhya Pradesh,Shahdol,Speech And Language Disability,0,6,1,0,1
Madhya Pradesh,Shahdol,Speech And Language Disability,6,15,17,16,33
Madhya Pradesh,Shahdol,Speech And Language Disability,15,35,31,18,49
Madhya Pradesh,Shahdol,Speech And Language Disability,35,60,24,19,43
Madhya Pradesh,Shahdol,Speech And Language Disability,60,80,3,4,7
Madhya Pradesh,Shahdol,Speech And Language Disability,80,100,0,2,2
Delhi,Shahdara,Speech And Language Disability,35,60,2,0,2
Mizoram,Serchhip,Speech And Language Disability,60,80,1,0,1
Tripura,Sepahijala,Speech And Language Disability,15,35,1,2,3
Tripura,Sepahijala,Speech And Language Disability,35,60,2,0,2
Madhya Pradesh,Seoni,Speech And Language Disability,6,15,10,8,18
Madhya Pradesh,Seoni,Speech And Language Disability,15,35,31,17,48
Madhya Pradesh,Seoni,Speech And Language Disability,35,60,25,8,33
Madhya Pradesh,Seoni,Speech And Language Disability,60,80,5,3,8
Manipur,Senapati,Speech And Language Disability,15,35,0,1,1
Madhya Pradesh,Sehore,Speech And Language Disability,6,15,2,2,4
Madhya Pradesh,Sehore,Speech And Language Disability,15,35,7,3,10
Madhya Pradesh,Sehore,Speech And Language Disability,35,60,8,2,10
Rajasthan,Sawai Madhopur,Speech And Language Disability,6,15,0,1,1
Rajasthan,Sawai Madhopur,Speech And Language Disability,15,35,2,1,3
Madhya Pradesh,Satna,Speech And Language Disability,0,6,0,1,1
Madhya Pradesh,Satna,Speech And Language Disability,6,15,12,5,17
Madhya Pradesh,Satna,Speech And Language Disability,15,35,46,32,78
Madhya Pradesh,Satna,Speech And Language Disability,35,60,26,14,40
Madhya Pradesh,Satna,Speech And Language Disability,60,80,5,2,7
Maharashtra,Satara,Speech And Language Disability,6,15,10,4,14
Maharashtra,Satara,Speech And Language Disability,15,35,14,6,20
Maharashtra,Satara,Speech And Language Disability,35,60,6,2,8
Maharashtra,Satara,Speech And Language Disability,60,80,3,0,3
Bihar,Saran,Speech And Language Disability,0,6,8,7,15
Bihar,Saran,Speech And Language Disability,6,15,70,44,114
Bihar,Saran,Speech And Language Disability,15,35,38,12,50
Bihar,Saran,Speech And Language Disability,35,60,11,8,19
Bihar,Saran,Speech And Language Disability,60,80,1,0,1
Jharkhand,Saraikela Kharsawan,Speech And Language Disability,6,15,2,5,7
Jharkhand,Saraikela Kharsawan,Speech And Language Disability,15,35,14,7,21
Jharkhand,Saraikela Kharsawan,Speech And Language Disability,35,60,8,2,10
Uttar Pradesh,Sant Kabeer Nagar,Speech And Language Disability,15,35,8,7,15
Uttar Pradesh,Sant Kabeer Nagar,Speech And Language Disability,35,60,6,1,7
Punjab,Sangrur,Speech And Language Disability,0,6,2,2,4
Punjab,Sangrur,Speech And Language Disability,6,15,22,18,40
Punjab,Sangrur,Speech And Language Disability,15,35,53,22,75
Punjab,Sangrur,Speech And Language Disability,35,60,13,9,22
Punjab,Sangrur,Speech And Language Disability,60,80,1,2,3
Maharashtra,Sangli,Speech And Language Disability,6,15,2,0,2
Maharashtra,Sangli,Speech And Language Disability,15,35,9,1,10
Maharashtra,Sangli,Speech And Language Disability,35,60,2,2,4
Maharashtra,Sangli,Speech And Language Disability,60,80,1,0,1
Uttar Pradesh,Sambhal,Speech And Language Disability,6,15,1,1,2
Uttar Pradesh,Sambhal,Speech And Language Disability,15,35,1,1,2
Uttar Pradesh,Sambhal,Speech And Language Disability,35,60,1,1,2
Odisha,Sambalpur,Speech And Language Disability,0,6,2,0,2
Odisha,Sambalpur,Speech And Language Disability,6,15,4,2,6
Odisha,Sambalpur,Speech And Language Disability,15,35,6,1,7
Odisha,Sambalpur,Speech And Language Disability,35,60,7,3,10
Odisha,Sambalpur,Speech And Language Disability,60,80,1,0,1
Jammu And Kashmir,Samba,Speech And Language Disability,15,35,4,2,6
Jammu And Kashmir,Samba,Speech And Language Disability,35,60,1,1,2
Jammu And Kashmir,Samba,Speech And Language Disability,60,80,1,0,1
Bihar,Samastipur,Speech And Language Disability,0,6,6,8,14
Bihar,Samastipur,Speech And Language Disability,6,15,38,34,72
Bihar,Samastipur,Speech And Language Disability,15,35,50,30,80
Bihar,Samastipur,Speech And Language Disability,35,60,19,9,28
Bihar,Samastipur,Speech And Language Disability,60,80,3,1,4
Bihar,Samastipur,Speech And Language Disability,80,100,0,1,1
Tamil Nadu,Salem,Speech And Language Disability,0,6,1,0,1
Tamil Nadu,Salem,Speech And Language Disability,6,15,4,1,5
Tamil Nadu,Salem,Speech And Language Disability,15,35,3,1,4
Tamil Nadu,Salem,Speech And Language Disability,35,60,3,2,5
Tamil Nadu,Salem,Speech And Language Disability,60,80,2,0,2
Mizoram,Saiha,Speech And Language Disability,15,35,0,2,2
Jharkhand,Sahebganj,Speech And Language Disability,0,6,2,3,5
Jharkhand,Sahebganj,Speech And Language Disability,6,15,33,31,64
Jharkhand,Sahebganj,Speech And Language Disability,15,35,27,27,54
Jharkhand,Sahebganj,Speech And Language Disability,35,60,16,5,21
Jharkhand,Sahebganj,Speech And Language Disability,60,80,1,0,1
Bihar,Saharsa,Speech And Language Disability,0,6,1,3,4
Bihar,Saharsa,Speech And Language Disability,6,15,9,8,17
Bihar,Saharsa,Speech And Language Disability,15,35,9,3,12
Bihar,Saharsa,Speech And Language Disability,35,60,2,2,4
Bihar,Saharsa,Speech And Language Disability,60,80,0,1,1
Uttar Pradesh,Saharanpur,Speech And Language Disability,0,6,3,4,7
Uttar Pradesh,Saharanpur,Speech And Language Disability,6,15,13,4,17
Uttar Pradesh,Saharanpur,Speech And Language Disability,15,35,34,16,50
Uttar Pradesh,Saharanpur,Speech And Language Disability,35,60,13,7,20
Uttar Pradesh,Saharanpur,Speech And Language Disability,60,80,1,0,1
Madhya Pradesh,Sagar,Speech And Language Disability,0,6,2,4,6
Madhya Pradesh,Sagar,Speech And Language Disability,6,15,37,27,64
Madhya Pradesh,Sagar,Speech And Language Disability,15,35,85,48,133
Madhya Pradesh,Sagar,Speech And Language Disability,35,60,98,30,128
Madhya Pradesh,Sagar,Speech And Language Disability,60,80,25,5,30
Madhya Pradesh,Sagar,Speech And Language Disability,80,100,2,1,3
Gujarat,Sabar Kantha,Speech And Language Disability,15,35,2,0,2
Punjab,S.A.S Nagar,Speech And Language Disability,0,6,1,0,1
Punjab,S.A.S Nagar,Speech And Language Disability,6,15,19,9,28
Punjab,S.A.S Nagar,Speech And Language Disability,15,35,20,18,38
Punjab,S.A.S Nagar,Speech And Language Disability,35,60,15,5,20
Punjab,S.A.S Nagar,Speech And Language Disability,60,80,2,0,2
Punjab,Rupnagar,Speech And Language Disability,6,15,3,2,5
Punjab,Rupnagar,Speech And Language Disability,15,35,13,5,18
Punjab,Rupnagar,Speech And Language Disability,35,60,20,12,32
Punjab,Rupnagar,Speech And Language Disability,60,80,2,0,2
Uttarakhand,Rudra Prayag,Speech And Language Disability,6,15,2,1,3
Uttarakhand,Rudra Prayag,Speech And Language Disability,15,35,7,3,10
Uttarakhand,Rudra Prayag,Speech And Language Disability,35,60,7,4,11
Bihar,Rohtas,Speech And Language Disability,0,6,0,2,2
Bihar,Rohtas,Speech And Language Disability,6,15,13,9,22
Bihar,Rohtas,Speech And Language Disability,15,35,23,19,42
Bihar,Rohtas,Speech And Language Disability,35,60,10,8,18
Bihar,Rohtas,Speech And Language Disability,60,80,0,1,1
Haryana,Rohtak,Speech And Language Disability,15,35,6,3,9
Haryana,Rohtak,Speech And Language Disability,35,60,11,1,12
Haryana,Rohtak,Speech And Language Disability,60,80,1,0,1
Meghalaya,Ri Bhoi,Speech And Language Disability,6,15,1,2,3
Meghalaya,Ri Bhoi,Speech And Language Disability,15,35,6,1,7
Meghalaya,Ri Bhoi,Speech And Language Disability,35,60,1,0,1
Meghalaya,Ri Bhoi,Speech And Language Disability,80,100,1,0,1
Haryana,Rewari,Speech And Language Disability,6,15,2,2,4
Haryana,Rewari,Speech And Language Disability,15,35,5,7,12
Haryana,Rewari,Speech And Language Disability,35,60,6,1,7
Madhya Pradesh,Rewa,Speech And Language Disability,15,35,10,3,13
Madhya Pradesh,Rewa,Speech And Language Disability,35,60,3,3,6
Madhya Pradesh,Rewa,Speech And Language Disability,60,80,0,2,2
Jammu And Kashmir,Reasi,Speech And Language Disability,0,6,1,1,2
Jammu And Kashmir,Reasi,Speech And Language Disability,6,15,7,4,11
Jammu And Kashmir,Reasi,Speech And Language Disability,15,35,6,4,10
Jammu And Kashmir,Reasi,Speech And Language Disability,35,60,2,1,3
Jammu And Kashmir,Reasi,Speech And Language Disability,60,80,0,1,1
Odisha,Rayagada,Speech And Language Disability,0,6,1,1,2
Odisha,Rayagada,Speech And Language Disability,6,15,2,6,8
Odisha,Rayagada,Speech And Language Disability,15,35,11,13,24
Odisha,Rayagada,Speech And Language Disability,35,60,10,6,16
Odisha,Rayagada,Speech And Language Disability,60,80,2,0,2
Maharashtra,Ratnagiri,Speech And Language Disability,6,15,1,0,1
Maharashtra,Ratnagiri,Speech And Language Disability,15,35,1,2,3
Maharashtra,Ratnagiri,Speech And Language Disability,35,60,4,0,4
Maharashtra,Ratnagiri,Speech And Language Disability,60,80,2,0,2
Madhya Pradesh,Ratlam,Speech And Language Disability,6,15,6,2,8
Madhya Pradesh,Ratlam,Speech And Language Disability,15,35,6,2,8
Madhya Pradesh,Ratlam,Speech And Language Disability,35,60,8,1,9
Tamil Nadu,Ranipet,Speech And Language Disability,6,15,0,2,2
Tamil Nadu,Ranipet,Speech And Language Disability,15,35,4,3,7
Tamil Nadu,Ranipet,Speech And Language Disability,35,60,7,3,10
Tamil Nadu,Ranipet,Speech And Language Disability,60,80,3,2,5
Jharkhand,Ranchi,Speech And Language Disability,0,6,1,1,2
Jharkhand,Ranchi,Speech And Language Disability,6,15,47,32,79
Jharkhand,Ranchi,Speech And Language Disability,15,35,40,24,64
Jharkhand,Ranchi,Speech And Language Disability,35,60,15,6,21
Jharkhand,Ranchi,Speech And Language Disability,60,80,4,3,7
Uttar Pradesh,Rampur,Speech And Language Disability,0,6,1,0,1
Uttar Pradesh,Rampur,Speech And Language Disability,6,15,5,4,9
Uttar Pradesh,Rampur,Speech And Language Disability,15,35,28,16,44
Uttar Pradesh,Rampur,Speech And Language Disability,35,60,16,6,22
Uttar Pradesh,Rampur,Speech And Language Disability,60,80,2,0,2
Jharkhand,Ramgarh,Speech And Language Disability,0,6,9,5,14
Jharkhand,Ramgarh,Speech And Language Disability,6,15,19,13,32
Jharkhand,Ramgarh,Speech And Language Disability,15,35,47,47,94
Jharkhand,Ramgarh,Speech And Language Disability,35,60,41,15,56
Jharkhand,Ramgarh,Speech And Language Disability,60,80,3,1,4
Jammu And Kashmir,Ramban,Speech And Language Disability,0,6,1,0,1
Jammu And Kashmir,Ramban,Speech And Language Disability,6,15,21,9,30
Jammu And Kashmir,Ramban,Speech And Language Disability,15,35,35,33,68
Jammu And Kashmir,Ramban,Speech And Language Disability,35,60,9,11,20
Jammu And Kashmir,Ramban,Speech And Language Disability,60,80,3,0,3
Tamil Nadu,Ramanathapuram,Speech And Language Disability,15,35,0,2,2
Tamil Nadu,Ramanathapuram,Speech And Language Disability,35,60,0,1,1
Karnataka,Ramanagara,Speech And Language Disability,6,15,4,3,7
Karnataka,Ramanagara,Speech And Language Disability,15,35,23,20,43
Karnataka,Ramanagara,Speech And Language Disability,35,60,15,17,32
Karnataka,Ramanagara,Speech And Language Disability,60,80,8,2,10
Rajasthan,Rajsamand,Speech And Language Disability,0,6,3,5,8
Rajasthan,Rajsamand,Speech And Language Disability,6,15,50,25,75
Rajasthan,Rajsamand,Speech And Language Disability,15,35,55,27,82
Rajasthan,Rajsamand,Speech And Language Disability,35,60,20,7,27
Rajasthan,Rajsamand,Speech And Language Disability,60,80,6,0,6
Rajasthan,Rajsamand,Speech And Language Disability,80,100,1,0,1
Jammu And Kashmir,Rajouri,Speech And Language Disability,0,6,10,8,18
Jammu And Kashmir,Rajouri,Speech And Language Disability,6,15,54,47,101
Jammu And Kashmir,Rajouri,Speech And Language Disability,15,35,84,73,157
Jammu And Kashmir,Rajouri,Speech And Language Disability,35,60,77,29,106
Jammu And Kashmir,Rajouri,Speech And Language Disability,60,80,7,4,11
Chhattisgarh,Rajnandgaon,Speech And Language Disability,0,6,1,0,1
Chhattisgarh,Rajnandgaon,Speech And Language Disability,6,15,5,8,13
Chhattisgarh,Rajnandgaon,Speech And Language Disability,15,35,46,52,98
Chhattisgarh,Rajnandgaon,Speech And Language Disability,35,60,30,30,60
Chhattisgarh,Rajnandgaon,Speech And Language Disability,60,80,7,4,11
Chhattisgarh,Rajnandgaon,Speech And Language Disability,80,100,0,1,1
Gujarat,Rajkot,Speech And Language Disability,60,80,2,0,2
Madhya Pradesh,Rajgarh,Speech And Language Disability,15,35,6,1,7
Madhya Pradesh,Rajgarh,Speech And Language Disability,35,60,1,0,1
Madhya Pradesh,Rajgarh,Speech And Language Disability,60,80,0,1,1
Madhya Pradesh,Rajgarh,Speech And Language Disability,80,100,1,0,1
Madhya Pradesh,Raisen,Speech And Language Disability,6,15,2,8,10
Madhya Pradesh,Raisen,Speech And Language Disability,15,35,11,12,23
Madhya Pradesh,Raisen,Speech And Language Disability,35,60,11,7,18
Madhya Pradesh,Raisen,Speech And Language Disability,60,80,4,4,8
Chhattisgarh,Raipur,Speech And Language Disability,15,35,3,3,6
Chhattisgarh,Raipur,Speech And Language Disability,35,60,2,1,3
Chhattisgarh,Raigarh,Speech And Language Disability,15,35,3,9,12
Chhattisgarh,Raigarh,Speech And Language Disability,35,60,6,1,7
Chhattisgarh,Raigarh,Speech And Language Disability,60,80,0,1,1
Maharashtra,Raigad,Speech And Language Disability,6,15,2,0,2
Maharashtra,Raigad,Speech And Language Disability,15,35,21,15,36
Maharashtra,Raigad,Speech And Language Disability,35,60,12,4,16
Maharashtra,Raigad,Speech And Language Disability,60,80,2,0,2
Karnataka,Raichur,Speech And Language Disability,0,6,14,2,16
Karnataka,Raichur,Speech And Language Disability,6,15,48,26,74
Karnataka,Raichur,Speech And Language Disability,15,35,56,28,84
Karnataka,Raichur,Speech And Language Disability,35,60,50,17,67
Karnataka,Raichur,Speech And Language Disability,60,80,4,0,4
Uttar Pradesh,Rae Bareli,Speech And Language Disability,6,15,0,2,2
Uttar Pradesh,Rae Bareli,Speech And Language Disability,15,35,4,1,5
Uttar Pradesh,Rae Bareli,Speech And Language Disability,35,60,4,2,6
Bihar,Purnia,Speech And Language Disability,0,6,2,0,2
Bihar,Purnia,Speech And Language Disability,6,15,7,10,17
Bihar,Purnia,Speech And Language Disability,15,35,12,10,22
Bihar,Purnia,Speech And Language Disability,35,60,8,2,10
Bihar,Purnia,Speech And Language Disability,60,80,1,0,1
Odisha,Puri,Speech And Language Disability,6,15,22,17,39
Odisha,Puri,Speech And Language Disability,15,35,52,38,90
Odisha,Puri,Speech And Language Disability,35,60,49,15,64
Odisha,Puri,Speech And Language Disability,60,80,11,4,15
Odisha,Puri,Speech And Language Disability,80,100,1,2,3
Bihar,Purbi Champaran,Speech And Language Disability,6,15,17,6,23
Bihar,Purbi Champaran,Speech And Language Disability,15,35,20,19,39
Bihar,Purbi Champaran,Speech And Language Disability,35,60,10,8,18
Bihar,Purbi Champaran,Speech And Language Disability,60,80,3,1,4
Maharashtra,Pune,Speech And Language Disability,0,6,1,0,1
Maharashtra,Pune,Speech And Language Disability,6,15,5,3,8
Maharashtra,Pune,Speech And Language Disability,15,35,17,6,23
Maharashtra,Pune,Speech And Language Disability,35,60,9,3,12
Maharashtra,Pune,Speech And Language Disability,60,80,2,0,2
Jammu And Kashmir,Pulwama,Speech And Language Disability,0,6,1,2,3
Jammu And Kashmir,Pulwama,Speech And Language Disability,6,15,27,22,49
Jammu And Kashmir,Pulwama,Speech And Language Disability,15,35,49,47,96
Jammu And Kashmir,Pulwama,Speech And Language Disability,35,60,24,25,49
Jammu And Kashmir,Pulwama,Speech And Language Disability,60,80,6,4,10
Tamil Nadu,Pudukkottai,Speech And Language Disability,0,6,1,1,2
Tamil Nadu,Pudukkottai,Speech And Language Disability,6,15,1,2,3
Tamil Nadu,Pudukkottai,Speech And Language Disability,15,35,2,2,4
Tamil Nadu,Pudukkottai,Speech And Language Disability,35,60,1,0,1
Uttar Pradesh,Prayagraj,Speech And Language Disability,6,15,1,0,1
Uttar Pradesh,Prayagraj,Speech And Language Disability,15,35,20,5,25
Uttar Pradesh,Prayagraj,Speech And Language Disability,35,60,16,9,25
Uttar Pradesh,Prayagraj,Speech And Language Disability,60,80,4,2,6
Rajasthan,Pratapgarh,Speech And Language Disability,0,6,0,1,1
Rajasthan,Pratapgarh,Speech And Language Disability,6,15,9,9,18
Rajasthan,Pratapgarh,Speech And Language Disability,15,35,31,22,53
Rajasthan,Pratapgarh,Speech And Language Disability,35,60,9,16,25
Rajasthan,Pratapgarh,Speech And Language Disability,60,80,4,2,6
Uttar Pradesh,Pratapgarh,Speech And Language Disability,0,6,4,6,10
Uttar Pradesh,Pratapgarh,Speech And Language Disability,6,15,21,9,30
Uttar Pradesh,Pratapgarh,Speech And Language Disability,15,35,106,52,158
Uttar Pradesh,Pratapgarh,Speech And Language Disability,35,60,29,26,55
Uttar Pradesh,Pratapgarh,Speech And Language Disability,60,80,1,0,1
Uttar Pradesh,Pratapgarh,Speech And Language Disability,80,100,1,0,1
Andhra Pradesh,Prakasam,Speech And Language Disability,6,15,0,1,1
Andhra Pradesh,Prakasam,Speech And Language Disability,15,35,1,0,1
Andhra Pradesh,Prakasam,Speech And Language Disability,35,60,1,0,1
Gujarat,Porbandar,Speech And Language Disability,6,15,4,1,5
Gujarat,Porbandar,Speech And Language Disability,15,35,10,2,12
Gujarat,Porbandar,Speech And Language Disability,35,60,3,1,4
Gujarat,Porbandar,Speech And Language Disability,60,80,1,0,1
Jammu And Kashmir,Poonch,Speech And Language Disability,0,6,12,16,28
Jammu And Kashmir,Poonch,Speech And Language Disability,6,15,56,61,117
Jammu And Kashmir,Poonch,Speech And Language Disability,15,35,122,81,203
Jammu And Kashmir,Poonch,Speech And Language Disability,35,60,54,43,97
Jammu And Kashmir,Poonch,Speech And Language Disability,60,80,3,2,5
Puducherry,Pondicherry,Speech And Language Disability,6,15,1,2,3
Puducherry,Pondicherry,Speech And Language Disability,35,60,2,2,4
Uttarakhand,Pithoragarh,Speech And Language Disability,6,15,2,0,2
Uttarakhand,Pithoragarh,Speech And Language Disability,15,35,5,5,10
Uttarakhand,Pithoragarh,Speech And Language Disability,35,60,5,3,8
Uttarakhand,Pithoragarh,Speech And Language Disability,60,80,1,0,1
Uttar Pradesh,Pilibhit,Speech And Language Disability,0,6,2,2,4
Uttar Pradesh,Pilibhit,Speech And Language Disability,6,15,23,18,41
Uttar Pradesh,Pilibhit,Speech And Language Disability,15,35,63,52,115
Uttar Pradesh,Pilibhit,Speech And Language Disability,35,60,37,23,60
Uttar Pradesh,Pilibhit,Speech And Language Disability,60,80,3,1,4
Nagaland,Phek,Speech And Language Disability,15,35,2,0,2
Tamil Nadu,Perambalur,Speech And Language Disability,0,6,0,1,1
Tamil Nadu,Perambalur,Speech And Language Disability,15,35,0,1,1
Tamil Nadu,Perambalur,Speech And Language Disability,35,60,1,0,1
Uttarakhand,Pauri Garhwal,Speech And Language Disability,6,15,4,0,4
Uttarakhand,Pauri Garhwal,Speech And Language Disability,15,35,4,0,4
Uttarakhand,Pauri Garhwal,Speech And Language Disability,35,60,6,1,7
Uttarakhand,Pauri Garhwal,Speech And Language Disability,60,80,2,0,2
Bihar,Patna,Speech And Language Disability,0,6,2,0,2
Bihar,Patna,Speech And Language Disability,6,15,21,17,38
Bihar,Patna,Speech And Language Disability,15,35,35,19,54
Bihar,Patna,Speech And Language Disability,35,60,20,5,25
Bihar,Patna,Speech And Language Disability,60,80,1,0,1
Punjab,Patiala,Speech And Language Disability,0,6,1,0,1
Punjab,Patiala,Speech And Language Disability,6,15,14,6,20
Punjab,Patiala,Speech And Language Disability,15,35,34,25,59
Punjab,Patiala,Speech And Language Disability,35,60,26,15,41
Punjab,Patiala,Speech And Language Disability,60,80,6,0,6
Punjab,Pathankot,Speech And Language Disability,0,6,0,2,2
Punjab,Pathankot,Speech And Language Disability,6,15,6,3,9
Punjab,Pathankot,Speech And Language Disability,15,35,10,13,23
Punjab,Pathankot,Speech And Language Disability,35,60,12,5,17
Punjab,Pathankot,Speech And Language Disability,60,80,2,2,4
Kerala,Pathanamthitta,Speech And Language Disability,0,6,1,0,1
Kerala,Pathanamthitta,Speech And Language Disability,6,15,0,1,1
Kerala,Pathanamthitta,Speech And Language Disability,15,35,3,1,4
Kerala,Pathanamthitta,Speech And Language Disability,35,60,5,3,8
Kerala,Pathanamthitta,Speech And Language Disability,60,80,1,0,1
Gujarat,Patan,Speech And Language Disability,15,35,2,0,2
Gujarat,Patan,Speech And Language Disability,35,60,2,0,2
Bihar,Pashchim Champaran,Speech And Language Disability,0,6,13,14,27
Bihar,Pashchim Champaran,Speech And Language Disability,6,15,82,70,152
Bihar,Pashchim Champaran,Speech And Language Disability,15,35,126,72,198
Bihar,Pashchim Champaran,Speech And Language Disability,35,60,45,39,84
Bihar,Pashchim Champaran,Speech And Language Disability,60,80,12,4,16
Maharashtra,Parbhani,Speech And Language Disability,0,6,6,5,11
Maharashtra,Parbhani,Speech And Language Disability,6,15,14,9,23
Maharashtra,Parbhani,Speech And Language Disability,15,35,26,11,37
Maharashtra,Parbhani,Speech And Language Disability,35,60,8,5,13
Maharashtra,Parbhani,Speech And Language Disability,60,80,5,2,7
Arunachal Pradesh,Papum Pare,Speech And Language Disability,0,6,3,0,3
Arunachal Pradesh,Papum Pare,Speech And Language Disability,6,15,3,1,4
Arunachal Pradesh,Papum Pare,Speech And Language Disability,15,35,1,2,3
Arunachal Pradesh,Papum Pare,Speech And Language Disability,35,60,1,0,1
Madhya Pradesh,Panna,Speech And Language Disability,0,6,2,1,3
Madhya Pradesh,Panna,Speech And Language Disability,6,15,10,7,17
Madhya Pradesh,Panna,Speech And Language Disability,15,35,33,20,53
Madhya Pradesh,Panna,Speech And Language Disability,35,60,12,11,23
Madhya Pradesh,Panna,Speech And Language Disability,60,80,4,1,5
Haryana,Panipat,Speech And Language Disability,0,6,0,2,2
Haryana,Panipat,Speech And Language Disability,6,15,2,4,6
Haryana,Panipat,Speech And Language Disability,15,35,6,8,14
Haryana,Panipat,Speech And Language Disability,35,60,7,2,9
Haryana,Panipat,Speech And Language Disability,60,80,2,0,2
Haryana,Panipat,Speech And Language Disability,80,100,0,1,1
Haryana,Panchkula,Speech And Language Disability,6,15,1,1,2
Haryana,Panchkula,Speech And Language Disability,15,35,7,1,8
Haryana,Panchkula,Speech And Language Disability,35,60,2,1,3
Haryana,Panchkula,Speech And Language Disability,60,80,1,0,1
Gujarat,Panch Mahals,Speech And Language Disability,6,15,1,1,2
Gujarat,Panch Mahals,Speech And Language Disability,15,35,1,1,2
Gujarat,Panch Mahals,Speech And Language Disability,35,60,1,1,2
Haryana,Palwal,Speech And Language Disability,6,15,0,2,2
Haryana,Palwal,Speech And Language Disability,15,35,4,0,4
Haryana,Palwal,Speech And Language Disability,35,60,2,1,3
Haryana,Palwal,Speech And Language Disability,60,80,2,0,2
Rajasthan,Pali,Speech And Language Disability,6,15,1,0,1
Rajasthan,Pali,Speech And Language Disability,15,35,0,1,1
Rajasthan,Pali,Speech And Language Disability,35,60,1,0,1
Rajasthan,Pali,Speech And Language Disability,60,80,0,1,1
Maharashtra,Palghar,Speech And Language Disability,6,15,3,1,4
Maharashtra,Palghar,Speech And Language Disability,15,35,11,3,14
Maharashtra,Palghar,Speech And Language Disability,35,60,2,1,3
Jharkhand,Palamu,Speech And Language Disability,0,6,1,0,1
Jharkhand,Palamu,Speech And Language Disability,6,15,4,1,5
Jharkhand,Palamu,Speech And Language Disability,15,35,17,9,26
Jharkhand,Palamu,Speech And Language Disability,35,60,7,5,12
Jharkhand,Palamu,Speech And Language Disability,60,80,4,1,5
Kerala,Palakkad,Speech And Language Disability,0,6,1,0,1
Kerala,Palakkad,Speech And Language Disability,6,15,3,3,6
Kerala,Palakkad,Speech And Language Disability,15,35,20,11,31
Kerala,Palakkad,Speech And Language Disability,35,60,13,18,31
Kerala,Palakkad,Speech And Language Disability,60,80,4,5,9
Jharkhand,Pakur,Speech And Language Disability,6,15,1,1,2
Jharkhand,Pakur,Speech And Language Disability,15,35,6,3,9
Jharkhand,Pakur,Speech And Language Disability,35,60,9,6,15
Maharashtra,Osmanabad,Speech And Language Disability,0,6,1,0,1
Maharashtra,Osmanabad,Speech And Language Disability,6,15,1,2,3
Maharashtra,Osmanabad,Speech And Language Disability,15,35,7,4,11
Maharashtra,Osmanabad,Speech And Language Disability,35,60,2,0,2
Maharashtra,Osmanabad,Speech And Language Disability,80,100,1,0,1
Haryana,Nuh,Speech And Language Disability,6,15,2,3,5
Haryana,Nuh,Speech And Language Disability,15,35,6,6,12
Haryana,Nuh,Speech And Language Disability,35,60,6,2,8
Haryana,Nuh,Speech And Language Disability,60,80,1,0,1
Odisha,Nuapada,Speech And Language Disability,0,6,2,2,4
Odisha,Nuapada,Speech And Language Disability,6,15,13,16,29
Odisha,Nuapada,Speech And Language Disability,15,35,19,13,32
Odisha,Nuapada,Speech And Language Disability,35,60,14,7,21
Odisha,Nuapada,Speech And Language Disability,60,80,2,0,2
Delhi,North West,Speech And Language Disability,6,15,1,0,1
Delhi,North West,Speech And Language Disability,15,35,2,2,4
Delhi,North West,Speech And Language Disability,35,60,4,0,4
Delhi,North West,Speech And Language Disability,60,80,3,1,4
Tripura,North Tripura,Speech And Language Disability,15,35,1,0,1
Goa,North Goa,Speech And Language Disability,6,15,1,0,1
Goa,North Goa,Speech And Language Disability,15,35,5,1,6
Goa,North Goa,Speech And Language Disability,35,60,6,2,8
Goa,North Goa,Speech And Language Disability,60,80,3,0,3
Meghalaya,North Garo Hills,Speech And Language Disability,0,6,0,1,1
Meghalaya,North Garo Hills,Speech And Language Disability,6,15,7,10,17
Meghalaya,North Garo Hills,Speech And Language Disability,15,35,11,9,20
Meghalaya,North Garo Hills,Speech And Language Disability,35,60,1,1,2
Delhi,North East,Speech And Language Disability,15,35,3,1,4
Delhi,North East,Speech And Language Disability,35,60,1,0,1
Andaman And Nicobar Islands,North And Middle Andaman,Speech And Language Disability,6,15,5,1,6
Andaman And Nicobar Islands,North And Middle Andaman,Speech And Language Disability,15,35,11,9,20
Andaman And Nicobar Islands,North And Middle Andaman,Speech And Language Disability,35,60,10,4,14
Andaman And Nicobar Islands,North And Middle Andaman,Speech And Language Disability,60,80,2,0,2
Delhi,North,Speech And Language Disability,15,35,0,1,1
Delhi,North,Speech And Language Disability,35,60,1,0,1
Delhi,North,Speech And Language Disability,60,80,2,0,2
Madhya Pradesh,Niwari,Speech And Language Disability,6,15,1,2,3
Madhya Pradesh,Niwari,Speech And Language Disability,15,35,9,4,13
Madhya Pradesh,Niwari,Speech And Language Disability,35,60,7,3,10
Madhya Pradesh,Niwari,Speech And Language Disability,60,80,0,1,1
Andaman And Nicobar Islands,Nicobars,Speech And Language Disability,6,15,1,0,1
Andaman And Nicobar Islands,Nicobars,Speech And Language Disability,15,35,2,5,7
Andaman And Nicobar Islands,Nicobars,Speech And Language Disability,35,60,2,2,4
Delhi,New Delhi,Speech And Language Disability,35,60,1,0,1
Madhya Pradesh,Neemuch,Speech And Language Disability,6,15,2,1,3
Madhya Pradesh,Neemuch,Speech And Language Disability,15,35,2,3,5
Madhya Pradesh,Neemuch,Speech And Language Disability,35,60,0,2,2
Odisha,Nayagarh,Speech And Language Disability,0,6,9,2,11
Odisha,Nayagarh,Speech And Language Disability,6,15,41,30,71
Odisha,Nayagarh,Speech And Language Disability,15,35,46,33,79
Odisha,Nayagarh,Speech And Language Disability,35,60,42,16,58
Odisha,Nayagarh,Speech And Language Disability,60,80,14,2,16
Odisha,Nayagarh,Speech And Language Disability,80,100,1,0,1
Bihar,Nawada,Speech And Language Disability,0,6,1,1,2
Bihar,Nawada,Speech And Language Disability,6,15,27,23,50
Bihar,Nawada,Speech And Language Disability,15,35,50,33,83
Bihar,Nawada,Speech And Language Disability,35,60,23,12,35
Bihar,Nawada,Speech And Language Disability,60,80,3,2,5
Gujarat,Navsari,Speech And Language Disability,6,15,1,0,1
Gujarat,Navsari,Speech And Language Disability,15,35,0,1,1
Gujarat,Navsari,Speech And Language Disability,35,60,1,1,2
Maharashtra,Nashik,Speech And Language Disability,6,15,3,0,3
Maharashtra,Nashik,Speech And Language Disability,15,35,5,2,7
Maharashtra,Nashik,Speech And Language Disability,35,60,2,1,3
Maharashtra,Nashik,Speech And Language Disability,60,80,5,0,5
Madhya Pradesh,Narsinghpur,Speech And Language Disability,6,15,15,8,23
Madhya Pradesh,Narsinghpur,Speech And Language Disability,15,35,64,46,110
Madhya Pradesh,Narsinghpur,Speech And Language Disability,35,60,40,31,71
Madhya Pradesh,Narsinghpur,Speech And Language Disability,60,80,8,2,10
Madhya Pradesh,Narmadapuram,Speech And Language Disability,6,15,3,5,8
Madhya Pradesh,Narmadapuram,Speech And Language Disability,15,35,8,4,12
Madhya Pradesh,Narmadapuram,Speech And Language Disability,35,60,9,3,12
Madhya Pradesh,Narmadapuram,Speech And Language Disability,60,80,2,2,4
Madhya Pradesh,Narmadapuram,Speech And Language Disability,80,100,1,0,1
Gujarat,Narmada,Speech And Language Disability,6,15,1,0,1
Chhattisgarh,Narayanpur,Speech And Language Disability,15,35,1,0,1
Maharashtra,Nandurbar,Speech And Language Disability,6,15,2,0,2
Maharashtra,Nandurbar,Speech And Language Disability,60,80,1,0,1
Maharashtra,Nanded,Speech And Language Disability,0,6,0,1,1
Maharashtra,Nanded,Speech And Language Disability,6,15,8,3,11
Maharashtra,Nanded,Speech And Language Disability,15,35,13,7,20
Maharashtra,Nanded,Speech And Language Disability,35,60,3,1,4
Arunachal Pradesh,Namsai,Speech And Language Disability,0,6,1,0,1
Arunachal Pradesh,Namsai,Speech And Language Disability,6,15,1,0,1
Arunachal Pradesh,Namsai,Speech And Language Disability,15,35,3,0,3
Sikkim,Namchi,Speech And Language Disability,0,6,0,1,1
Sikkim,Namchi,Speech And Language Disability,6,15,2,1,3
Sikkim,Namchi,Speech And Language Disability,15,35,3,0,3
Sikkim,Namchi,Speech And Language Disability,35,60,1,0,1
Sikkim,Namchi,Speech And Language Disability,60,80,1,0,1
Tamil Nadu,Namakkal,Speech And Language Disability,6,15,6,2,8
Tamil Nadu,Namakkal,Speech And Language Disability,15,35,4,2,6
Tamil Nadu,Namakkal,Speech And Language Disability,35,60,1,2,3
Assam,Nalbari,Speech And Language Disability,0,6,4,2,6
Assam,Nalbari,Speech And Language Disability,6,15,14,13,27
Assam,Nalbari,Speech And Language Disability,15,35,14,8,22
Assam,Nalbari,Speech And Language Disability,35,60,11,9,20
Assam,Nalbari,Speech And Language Disability,60,80,4,0,4
Bihar,Nalanda,Speech And Language Disability,0,6,6,0,6
Bihar,Nalanda,Speech And Language Disability,6,15,28,17,45
Bihar,Nalanda,Speech And Language Disability,15,35,35,15,50
Bihar,Nalanda,Speech And Language Disability,35,60,11,7,18
Bihar,Nalanda,Speech And Language Disability,60,80,2,0,2
Uttarakhand,Nainital,Speech And Language Disability,6,15,2,1,3
Uttarakhand,Nainital,Speech And Language Disability,15,35,12,6,18
Uttarakhand,Nainital,Speech And Language Disability,35,60,9,2,11
Maharashtra,Nagpur,Speech And Language Disability,6,15,2,1,3
Maharashtra,Nagpur,Speech And Language Disability,15,35,10,2,12
Maharashtra,Nagpur,Speech And Language Disability,35,60,9,1,10
Maharashtra,Nagpur,Speech And Language Disability,60,80,1,0,1
Rajasthan,Nagaur,Speech And Language Disability,6,15,9,4,13
Rajasthan,Nagaur,Speech And Language Disability,15,35,21,13,34
Rajasthan,Nagaur,Speech And Language Disability,35,60,14,4,18
Rajasthan,Nagaur,Speech And Language Disability,60,80,2,1,3
Tamil Nadu,Nagapattinam,Speech And Language Disability,15,35,4,2,6
Tamil Nadu,Nagapattinam,Speech And Language Disability,35,60,4,0,4
Tamil Nadu,Nagapattinam,Speech And Language Disability,60,80,1,0,1
Assam,Nagaon,Speech And Language Disability,0,6,1,1,2
Assam,Nagaon,Speech And Language Disability,6,15,9,13,22
Assam,Nagaon,Speech And Language Disability,15,35,16,11,27
Assam,Nagaon,Speech And Language Disability,35,60,13,6,19
Assam,Nagaon,Speech And Language Disability,60,80,3,1,4
Odisha,Nabarangpur,Speech And Language Disability,0,6,6,6,12
Odisha,Nabarangpur,Speech And Language Disability,6,15,50,32,82
Odisha,Nabarangpur,Speech And Language Disability,15,35,35,30,65
Odisha,Nabarangpur,Speech And Language Disability,35,60,10,6,16
Odisha,Nabarangpur,Speech And Language Disability,60,80,0,1,1
Karnataka,Mysuru,Speech And Language Disability,0,6,1,0,1
Karnataka,Mysuru,Speech And Language Disability,6,15,33,13,46
Karnataka,Mysuru,Speech And Language Disability,15,35,43,20,63
Karnataka,Mysuru,Speech And Language Disability,35,60,37,24,61
Karnataka,Mysuru,Speech And Language Disability,60,80,12,1,13
Bihar,Muzaffarpur,Speech And Language Disability,0,6,0,1,1
Bihar,Muzaffarpur,Speech And Language Disability,6,15,9,7,16
Bihar,Muzaffarpur,Speech And Language Disability,15,35,19,14,33
Bihar,Muzaffarpur,Speech And Language Disability,35,60,6,2,8
Bihar,Muzaffarpur,Speech And Language Disability,60,80,2,1,3
Uttar Pradesh,Muzaffarnagar,Speech And Language Disability,6,15,8,6,14
Uttar Pradesh,Muzaffarnagar,Speech And Language Disability,15,35,17,7,24
Uttar Pradesh,Muzaffarnagar,Speech And Language Disability,35,60,6,1,7
Uttar Pradesh,Muzaffarnagar,Speech And Language Disability,60,80,3,0,3
Bihar,Munger,Speech And Language Disability,0,6,3,2,5
Bihar,Munger,Speech And Language Disability,6,15,19,7,26
Bihar,Munger,Speech And Language Disability,15,35,15,16,31
Bihar,Munger,Speech And Language Disability,35,60,12,3,15
Bihar,Munger,Speech And Language Disability,60,80,2,0,2
Chhattisgarh,Mungeli,Speech And Language Disability,0,6,2,0,2
Chhattisgarh,Mungeli,Speech And Language Disability,6,15,13,10,23
Chhattisgarh,Mungeli,Speech And Language Disability,15,35,44,36,80
Chhattisgarh,Mungeli,Speech And Language Disability,35,60,18,11,29
Chhattisgarh,Mungeli,Speech And Language Disability,60,80,5,1,6
Maharashtra,Mumbai Suburban,Speech And Language Disability,6,15,0,1,1
Maharashtra,Mumbai Suburban,Speech And Language Disability,15,35,9,3,12
Maharashtra,Mumbai Suburban,Speech And Language Disability,35,60,9,0,9
Maharashtra,Mumbai Suburban,Speech And Language Disability,60,80,3,0,3
Maharashtra,Mumbai,Speech And Language Disability,15,35,2,3,5
Maharashtra,Mumbai,Speech And Language Disability,35,60,8,0,8
Maharashtra,Mumbai,Speech And Language Disability,60,80,2,0,2
Maharashtra,Mumbai,Speech And Language Disability,80,100,1,0,1
Madhya Pradesh,Morena,Speech And Language Disability,0,6,0,1,1
Madhya Pradesh,Morena,Speech And Language Disability,6,15,5,2,7
Madhya Pradesh,Morena,Speech And Language Disability,15,35,3,1,4
Madhya Pradesh,Morena,Speech And Language Disability,35,60,7,0,7
Madhya Pradesh,Morena,Speech And Language Disability,60,80,2,1,3
Gujarat,Morbi,Speech And Language Disability,15,35,1,0,1
Gujarat,Morbi,Speech And Language Disability,60,80,1,0,1
Uttar Pradesh,Moradabad,Speech And Language Disability,6,15,2,1,3
Uttar Pradesh,Moradabad,Speech And Language Disability,15,35,12,7,19
Uttar Pradesh,Moradabad,Speech And Language Disability,35,60,8,6,14
Uttar Pradesh,Moradabad,Speech And Language Disability,60,80,3,1,4
Nagaland,Mon,Speech And Language Disability,6,15,0,1,1
Nagaland,Mon,Speech And Language Disability,15,35,1,0,1
Nagaland,Mon,Speech And Language Disability,35,60,1,0,1
Nagaland,Mokokchung,Speech And Language Disability,15,35,2,0,2
Nagaland,Mokokchung,Speech And Language Disability,35,60,4,1,5
Punjab,Moga,Speech And Language Disability,0,6,2,1,3
Punjab,Moga,Speech And Language Disability,6,15,9,4,13
Punjab,Moga,Speech And Language Disability,15,35,17,16,33
Punjab,Moga,Speech And Language Disability,35,60,18,5,23
Punjab,Moga,Speech And Language Disability,60,80,1,0,1
Uttar Pradesh,Mirzapur,Speech And Language Disability,6,15,8,3,11
Uttar Pradesh,Mirzapur,Speech And Language Disability,15,35,41,28,69
Uttar Pradesh,Mirzapur,Speech And Language Disability,35,60,22,11,33
Uttar Pradesh,Mirzapur,Speech And Language Disability,60,80,2,1,3
Uttar Pradesh,Meerut,Speech And Language Disability,6,15,5,7,12
Uttar Pradesh,Meerut,Speech And Language Disability,15,35,33,14,47
Uttar Pradesh,Meerut,Speech And Language Disability,35,60,18,8,26
Uttar Pradesh,Meerut,Speech And Language Disability,60,80,2,0,2
Odisha,Mayurbhanj,Speech And Language Disability,6,15,7,5,12
Odisha,Mayurbhanj,Speech And Language Disability,15,35,16,21,37
Odisha,Mayurbhanj,Speech And Language Disability,35,60,23,14,37
Odisha,Mayurbhanj,Speech And Language Disability,60,80,5,0,5
Tamil Nadu,Mayiladuthurai,Speech And Language Disability,6,15,1,0,1
Tamil Nadu,Mayiladuthurai,Speech And Language Disability,15,35,1,0,1
Tamil Nadu,Mayiladuthurai,Speech And Language Disability,60,80,0,1,1
Uttar Pradesh,Mau,Speech And Language Disability,6,15,4,2,6
Uttar Pradesh,Mau,Speech And Language Disability,15,35,29,13,42
Uttar Pradesh,Mau,Speech And Language Disability,35,60,8,5,13
Uttar Pradesh,Mau,Speech And Language Disability,60,80,2,0,2
Uttar Pradesh,Mathura,Speech And Language Disability,6,15,1,0,1
Uttar Pradesh,Mathura,Speech And Language Disability,15,35,4,2,6
Uttar Pradesh,Mathura,Speech And Language Disability,35,60,5,0,5
Uttar Pradesh,Mathura,Speech And Language Disability,60,80,3,0,3
Assam,Marigaon,Speech And Language Disability,0,6,1,0,1
Assam,Marigaon,Speech And Language Disability,6,15,5,6,11
Assam,Marigaon,Speech And Language Disability,15,35,10,4,14
Assam,Marigaon,Speech And Language Disability,35,60,5,2,7
Assam,Marigaon,Speech And Language Disability,60,80,1,0,1
Punjab,Mansa,Speech And Language Disability,6,15,3,3,6
Punjab,Mansa,Speech And Language Disability,15,35,19,14,33
Punjab,Mansa,Speech And Language Disability,35,60,11,7,18
Punjab,Mansa,Speech And Language Disability,60,80,3,0,3
Sikkim,Mangan,Speech And Language Disability,15,35,1,0,1
Sikkim,Mangan,Speech And Language Disability,35,60,0,1,1
Karnataka,Mandya,Speech And Language Disability,0,6,1,2,3
Karnataka,Mandya,Speech And Language Disability,6,15,8,3,11
Karnataka,Mandya,Speech And Language Disability,15,35,25,14,39
Karnataka,Mandya,Speech And Language Disability,35,60,27,18,45
Karnataka,Mandya,Speech And Language Disability,60,80,13,2,15
Madhya Pradesh,Mandsaur,Speech And Language Disability,6,15,0,1,1
Madhya Pradesh,Mandsaur,Speech And Language Disability,15,35,2,0,2
Madhya Pradesh,Mandsaur,Speech And Language Disability,35,60,6,0,6
Madhya Pradesh,Mandsaur,Speech And Language Disability,60,80,3,0,3
Madhya Pradesh,Mandla,Speech And Language Disability,6,15,2,2,4
Madhya Pradesh,Mandla,Speech And Language Disability,15,35,20,15,35
Madhya Pradesh,Mandla,Speech And Language Disability,35,60,9,4,13
Himachal Pradesh,Mandi,Speech And Language Disability,0,6,1,0,1
Himachal Pradesh,Mandi,Speech And Language Disability,6,15,8,3,11
Himachal Pradesh,Mandi,Speech And Language Disability,15,35,33,13,46
Himachal Pradesh,Mandi,Speech And Language Disability,35,60,30,10,40
Himachal Pradesh,Mandi,Speech And Language Disability,60,80,6,1,7
Odisha,Malkangiri,Speech And Language Disability,0,6,13,8,21
Odisha,Malkangiri,Speech And Language Disability,6,15,38,26,64
Odisha,Malkangiri,Speech And Language Disability,15,35,38,39,77
Odisha,Malkangiri,Speech And Language Disability,35,60,27,12,39
Odisha,Malkangiri,Speech And Language Disability,60,80,4,4,8
Odisha,Malkangiri,Speech And Language Disability,80,100,1,0,1
Punjab,Malerkotla,Speech And Language Disability,0,6,1,0,1
Punjab,Malerkotla,Speech And Language Disability,15,35,2,2,4
Punjab,Malerkotla,Speech And Language Disability,35,60,4,0,4
Kerala,Malappuram,Speech And Language Disability,0,6,3,0,3
Kerala,Malappuram,Speech And Language Disability,6,15,11,12,23
Kerala,Malappuram,Speech And Language Disability,15,35,63,59,122
Kerala,Malappuram,Speech And Language Disability,35,60,53,62,115
Kerala,Malappuram,Speech And Language Disability,60,80,10,5,15
Assam,Majuli,Speech And Language Disability,6,15,2,2,4
Assam,Majuli,Speech And Language Disability,15,35,4,1,5
Assam,Majuli,Speech And Language Disability,35,60,3,1,4
Assam,Majuli,Speech And Language Disability,60,80,0,1,1
Uttar Pradesh,Mainpuri,Speech And Language Disability,6,15,9,6,15
Uttar Pradesh,Mainpuri,Speech And Language Disability,15,35,16,11,27
Uttar Pradesh,Mainpuri,Speech And Language Disability,35,60,20,7,27
Uttar Pradesh,Mainpuri,Speech And Language Disability,60,80,1,0,1
Uttar Pradesh,Mahoba,Speech And Language Disability,0,6,1,1,2
Uttar Pradesh,Mahoba,Speech And Language Disability,6,15,7,3,10
Uttar Pradesh,Mahoba,Speech And Language Disability,15,35,15,6,21
Uttar Pradesh,Mahoba,Speech And Language Disability,35,60,5,4,9
Uttar Pradesh,Mahoba,Speech And Language Disability,60,80,1,0,1
Gujarat,Mahisagar,Speech And Language Disability,6,15,5,1,6
Gujarat,Mahisagar,Speech And Language Disability,15,35,3,1,4
Gujarat,Mahisagar,Speech And Language Disability,60,80,1,0,1
Gujarat,Mahesana,Speech And Language Disability,6,15,1,1,2
Gujarat,Mahesana,Speech And Language Disability,15,35,3,2,5
Haryana,Mahendragarh,Speech And Language Disability,6,15,0,1,1
Haryana,Mahendragarh,Speech And Language Disability,15,35,12,7,19
Haryana,Mahendragarh,Speech And Language Disability,35,60,29,10,39
Haryana,Mahendragarh,Speech And Language Disability,60,80,3,3,6
Haryana,Mahendragarh,Speech And Language Disability,80,100,0,3,3
Puducherry,Mahe,Speech And Language Disability,15,35,1,0,1
Chhattisgarh,Mahasamund,Speech And Language Disability,6,15,1,1,2
Chhattisgarh,Mahasamund,Speech And Language Disability,15,35,5,0,5
Chhattisgarh,Mahasamund,Speech And Language Disability,35,60,0,2,2
Uttar Pradesh,Maharajganj,Speech And Language Disability,0,6,1,0,1
Uttar Pradesh,Maharajganj,Speech And Language Disability,6,15,5,9,14
Uttar Pradesh,Maharajganj,Speech And Language Disability,15,35,62,36,98
Uttar Pradesh,Maharajganj,Speech And Language Disability,35,60,19,15,34
Uttar Pradesh,Maharajganj,Speech And Language Disability,60,80,3,1,4
Tamil Nadu,Madurai,Speech And Language Disability,0,6,0,1,1
Tamil Nadu,Madurai,Speech And Language Disability,6,15,3,0,3
Tamil Nadu,Madurai,Speech And Language Disability,15,35,1,2,3
Tamil Nadu,Madurai,Speech And Language Disability,35,60,4,2,6
Bihar,Madhubani,Speech And Language Disability,0,6,1,0,1
Bihar,Madhubani,Speech And Language Disability,6,15,7,7,14
Bihar,Madhubani,Speech And Language Disability,15,35,19,13,32
Bihar,Madhubani,Speech And Language Disability,35,60,7,2,9
Bihar,Madhepura,Speech And Language Disability,0,6,1,1,2
Bihar,Madhepura,Speech And Language Disability,6,15,11,8,19
Bihar,Madhepura,Speech And Language Disability,15,35,22,23,45
Bihar,Madhepura,Speech And Language Disability,35,60,14,3,17
Bihar,Madhepura,Speech And Language Disability,60,80,1,0,1
Mizoram,Lunglei,Speech And Language Disability,15,35,1,2,3
Mizoram,Lunglei,Speech And Language Disability,35,60,2,0,2
Punjab,Ludhiana,Speech And Language Disability,0,6,1,3,4
Punjab,Ludhiana,Speech And Language Disability,6,15,20,22,42
Punjab,Ludhiana,Speech And Language Disability,15,35,70,39,109
Punjab,Ludhiana,Speech And Language Disability,35,60,34,20,54
Punjab,Ludhiana,Speech And Language Disability,60,80,8,5,13
Uttar Pradesh,Lucknow,Speech And Language Disability,0,6,1,3,4
Uttar Pradesh,Lucknow,Speech And Language Disability,6,15,12,4,16
Uttar Pradesh,Lucknow,Speech And Language Disability,15,35,29,15,44
Uttar Pradesh,Lucknow,Speech And Language Disability,35,60,17,6,23
Uttar Pradesh,Lucknow,Speech And Language Disability,60,80,1,0,1
Arunachal Pradesh,Lower Dibang Valley,Speech And Language Disability,15,35,2,2,4
Arunachal Pradesh,Lower Dibang Valley,Speech And Language Disability,35,60,4,4,8
Arunachal Pradesh,Lower Dibang Valley,Speech And Language Disability,60,80,0,1,1
Arunachal Pradesh,Longding,Speech And Language Disability,15,35,1,0,1
Jharkhand,Lohardaga,Speech And Language Disability,6,15,7,5,12
Jharkhand,Lohardaga,Speech And Language Disability,15,35,15,11,26
Jharkhand,Lohardaga,Speech And Language Disability,35,60,6,5,11
Jharkhand,Lohardaga,Speech And Language Disability,60,80,1,3,4
Jharkhand,Lohardaga,Speech And Language Disability,80,100,0,1,1
Ladakh,Leh Ladakh,Speech And Language Disability,6,15,4,0,4
Ladakh,Leh Ladakh,Speech And Language Disability,15,35,5,5,10
Ladakh,Leh Ladakh,Speech And Language Disability,35,60,5,2,7
Ladakh,Leh Ladakh,Speech And Language Disability,60,80,1,0,1
Maharashtra,Latur,Speech And Language Disability,0,6,0,1,1
Maharashtra,Latur,Speech And Language Disability,6,15,1,1,2
Maharashtra,Latur,Speech And Language Disability,15,35,8,1,9
Maharashtra,Latur,Speech And Language Disability,35,60,6,0,6
Maharashtra,Latur,Speech And Language Disability,60,80,1,1,2
Jharkhand,Latehar,Speech And Language Disability,15,35,3,2,5
Jharkhand,Latehar,Speech And Language Disability,35,60,0,3,3
Uttar Pradesh,Lalitpur,Speech And Language Disability,0,6,0,2,2
Uttar Pradesh,Lalitpur,Speech And Language Disability,6,15,5,8,13
Uttar Pradesh,Lalitpur,Speech And Language Disability,15,35,16,9,25
Uttar Pradesh,Lalitpur,Speech And Language Disability,35,60,8,5,13
Lakshadweep,Lakshadweep District,Speech And Language Disability,0,6,1,0,1
Lakshadweep,Lakshadweep District,Speech And Language Disability,15,35,3,0,3
Lakshadweep,Lakshadweep District,Speech And Language Disability,35,60,0,3,3
Bihar,Lakhisarai,Speech And Language Disability,6,15,4,5,9
Bihar,Lakhisarai,Speech And Language Disability,15,35,5,4,9
Bihar,Lakhisarai,Speech And Language Disability,35,60,7,3,10
Assam,Lakhimpur,Speech And Language Disability,0,6,6,1,7
Assam,Lakhimpur,Speech And Language Disability,6,15,9,2,11
Assam,Lakhimpur,Speech And Language Disability,15,35,12,11,23
Assam,Lakhimpur,Speech And Language Disability,35,60,5,6,11
Himachal Pradesh,Lahul And Spiti,Speech And Language Disability,6,15,0,1,1
Himachal Pradesh,Lahul And Spiti,Speech And Language Disability,15,35,1,0,1
Himachal Pradesh,Lahul And Spiti,Speech And Language Disability,35,60,0,1,1
Uttar Pradesh,Kushi Nagar,Speech And Language Disability,0,6,1,0,1
Uttar Pradesh,Kushi Nagar,Speech And Language Disability,6,15,11,13,24
Uttar Pradesh,Kushi Nagar,Speech And Language Disability,15,35,79,37,116
Uttar Pradesh,Kushi Nagar,Speech And Language Disability,35,60,34,20,54
Uttar Pradesh,Kushi Nagar,Speech And Language Disability,60,80,1,2,3
Haryana,Kurukshetra,Speech And Language Disability,15,35,2,1,3
Haryana,Kurukshetra,Speech And Language Disability,60,80,2,0,2
Andhra Pradesh,Kurnool,Speech And Language Disability,15,35,3,0,3
Jammu And Kashmir,Kupwara,Speech And Language Disability,0,6,1,2,3
Jammu And Kashmir,Kupwara,Speech And Language Disability,6,15,17,15,32
Jammu And Kashmir,Kupwara,Speech And Language Disability,15,35,22,16,38
Jammu And Kashmir,Kupwara,Speech And Language Disability,35,60,15,5,20
Jammu And Kashmir,Kupwara,Speech And Language Disability,60,80,2,1,3
Himachal Pradesh,Kullu,Speech And Language Disability,0,6,1,2,3
Himachal Pradesh,Kullu,Speech And Language Disability,6,15,7,4,11
Himachal Pradesh,Kullu,Speech And Language Disability,15,35,6,5,11
Himachal Pradesh,Kullu,Speech And Language Disability,35,60,2,2,4
Himachal Pradesh,Kullu,Speech And Language Disability,60,80,1,0,1
Jammu And Kashmir,Kulgam,Speech And Language Disability,0,6,1,0,1
Jammu And Kashmir,Kulgam,Speech And Language Disability,6,15,6,7,13
Jammu And Kashmir,Kulgam,Speech And Language Disability,15,35,15,10,25
Jammu And Kashmir,Kulgam,Speech And Language Disability,35,60,7,6,13
Jammu And Kashmir,Kulgam,Speech And Language Disability,60,80,1,0,1
Tamil Nadu,Krishnagiri,Speech And Language Disability,6,15,3,0,3
Tamil Nadu,Krishnagiri,Speech And Language Disability,15,35,6,3,9
Tamil Nadu,Krishnagiri,Speech And Language Disability,35,60,9,1,10
Tamil Nadu,Krishnagiri,Speech And Language Disability,60,80,2,0,2
Kerala,Kozhikode,Speech And Language Disability,0,6,1,0,1
Kerala,Kozhikode,Speech And Language Disability,6,15,7,1,8
Kerala,Kozhikode,Speech And Language Disability,15,35,11,8,19
Kerala,Kozhikode,Speech And Language Disability,35,60,19,11,30
Kerala,Kozhikode,Speech And Language Disability,60,80,3,3,6
Kerala,Kozhikode,Speech And Language Disability,80,100,2,0,2
Kerala,Kottayam,Speech And Language Disability,15,35,4,5,9
Kerala,Kottayam,Speech And Language Disability,35,60,3,5,8
Rajasthan,Kota,Speech And Language Disability,15,35,3,0,3
Rajasthan,Kota,Speech And Language Disability,35,60,2,0,2
Rajasthan,Kota,Speech And Language Disability,80,100,1,0,1
Chhattisgarh,Korea,Speech And Language Disability,0,6,1,0,1
Chhattisgarh,Korea,Speech And Language Disability,6,15,15,11,26
Chhattisgarh,Korea,Speech And Language Disability,15,35,39,21,60
Chhattisgarh,Korea,Speech And Language Disability,35,60,14,13,27
Chhattisgarh,Korea,Speech And Language Disability,60,80,1,3,4
Chhattisgarh,Korea,Speech And Language Disability,80,100,0,1,1
Chhattisgarh,Korba,Speech And Language Disability,6,15,8,4,12
Chhattisgarh,Korba,Speech And Language Disability,15,35,15,8,23
Chhattisgarh,Korba,Speech And Language Disability,35,60,6,2,8
Odisha,Koraput,Speech And Language Disability,0,6,8,2,10
Odisha,Koraput,Speech And Language Disability,6,15,31,28,59
Odisha,Koraput,Speech And Language Disability,15,35,29,28,57
Odisha,Koraput,Speech And Language Disability,35,60,15,13,28
Odisha,Koraput,Speech And Language Disability,60,80,3,3,6
Karnataka,Koppal,Speech And Language Disability,6,15,5,4,9
Karnataka,Koppal,Speech And Language Disability,15,35,13,14,27
Karnataka,Koppal,Speech And Language Disability,35,60,2,1,3
Karnataka,Koppal,Speech And Language Disability,60,80,1,0,1
Chhattisgarh,Kondagaon,Speech And Language Disability,6,15,37,37,74
Chhattisgarh,Kondagaon,Speech And Language Disability,15,35,63,53,116
Chhattisgarh,Kondagaon,Speech And Language Disability,35,60,18,10,28
Chhattisgarh,Kondagaon,Speech And Language Disability,60,80,3,4,7
Chhattisgarh,Kondagaon,Speech And Language Disability,80,100,0,1,1
Kerala,Kollam,Speech And Language Disability,0,6,1,2,3
Kerala,Kollam,Speech And Language Disability,6,15,5,0,5
Kerala,Kollam,Speech And Language Disability,15,35,13,11,24
Kerala,Kollam,Speech And Language Disability,35,60,13,16,29
Kerala,Kollam,Speech And Language Disability,60,80,6,3,9
Maharashtra,Kolhapur,Speech And Language Disability,6,15,2,1,3
Maharashtra,Kolhapur,Speech And Language Disability,15,35,4,0,4
Maharashtra,Kolhapur,Speech And Language Disability,35,60,2,3,5
Mizoram,Kolasib,Speech And Language Disability,6,15,1,0,1
Mizoram,Kolasib,Speech And Language Disability,35,60,1,1,2
Karnataka,Kolar,Speech And Language Disability,6,15,4,3,7
Karnataka,Kolar,Speech And Language Disability,15,35,9,9,18
Karnataka,Kolar,Speech And Language Disability,35,60,17,10,27
Karnataka,Kolar,Speech And Language Disability,60,80,5,3,8
Karnataka,Kolar,Speech And Language Disability,80,100,1,0,1
Assam,Kokrajhar,Speech And Language Disability,0,6,1,4,5
Assam,Kokrajhar,Speech And Language Disability,6,15,29,28,57
Assam,Kokrajhar,Speech And Language Disability,15,35,76,65,141
Assam,Kokrajhar,Speech And Language Disability,35,60,56,52,108
Assam,Kokrajhar,Speech And Language Disability,60,80,6,2,8
Nagaland,Kohima,Speech And Language Disability,6,15,10,3,13
Nagaland,Kohima,Speech And Language Disability,15,35,7,6,13
Nagaland,Kohima,Speech And Language Disability,35,60,2,1,3
Jharkhand,Koderma,Speech And Language Disability,6,15,2,4,6
Jharkhand,Koderma,Speech And Language Disability,15,35,10,14,24
Jharkhand,Koderma,Speech And Language Disability,35,60,3,2,5
Jharkhand,Koderma,Speech And Language Disability,60,80,1,0,1
Karnataka,Kodagu,Speech And Language Disability,0,6,0,1,1
Karnataka,Kodagu,Speech And Language Disability,6,15,0,2,2
Karnataka,Kodagu,Speech And Language Disability,15,35,9,5,14
Karnataka,Kodagu,Speech And Language Disability,35,60,10,3,13
Karnataka,Kodagu,Speech And Language Disability,60,80,3,1,4
Jammu And Kashmir,Kishtwar,Speech And Language Disability,0,6,1,2,3
Jammu And Kashmir,Kishtwar,Speech And Language Disability,6,15,15,12,27
Jammu And Kashmir,Kishtwar,Speech And Language Disability,15,35,31,25,56
Jammu And Kashmir,Kishtwar,Speech And Language Disability,35,60,21,12,33
Jammu And Kashmir,Kishtwar,Speech And Language Disability,60,80,3,1,4
Bihar,Kishanganj,Speech And Language Disability,6,15,14,6,20
Bihar,Kishanganj,Speech And Language Disability,15,35,24,24,48
Bihar,Kishanganj,Speech And Language Disability,35,60,14,7,21
Bihar,Kishanganj,Speech And Language Disability,60,80,1,1,2
Himachal Pradesh,Kinnaur,Speech And Language Disability,6,15,1,0,1
Jharkhand,Khunti,Speech And Language Disability,0,6,0,1,1
Jharkhand,Khunti,Speech And Language Disability,6,15,6,3,9
Jharkhand,Khunti,Speech And Language Disability,15,35,12,15,27
Jharkhand,Khunti,Speech And Language Disability,35,60,7,6,13
Jharkhand,Khunti,Speech And Language Disability,60,80,0,1,1
Tripura,Khowai,Speech And Language Disability,6,15,2,0,2
Tripura,Khowai,Speech And Language Disability,15,35,1,2,3
Odisha,Khordha,Speech And Language Disability,0,6,0,2,2
Odisha,Khordha,Speech And Language Disability,6,15,32,15,47
Odisha,Khordha,Speech And Language Disability,15,35,19,25,44
Odisha,Khordha,Speech And Language Disability,35,60,25,13,38
Odisha,Khordha,Speech And Language Disability,60,80,5,1,6
Uttar Pradesh,Kheri,Speech And Language Disability,6,15,0,3,3
Uttar Pradesh,Kheri,Speech And Language Disability,15,35,37,16,53
Uttar Pradesh,Kheri,Speech And Language Disability,35,60,23,9,32
Uttar Pradesh,Kheri,Speech And Language Disability,60,80,2,3,5
Gujarat,Kheda,Speech And Language Disability,15,35,2,1,3
Madhya Pradesh,Khargone,Speech And Language Disability,0,6,2,0,2
Madhya Pradesh,Khargone,Speech And Language Disability,6,15,10,4,14
Madhya Pradesh,Khargone,Speech And Language Disability,15,35,17,14,31
Madhya Pradesh,Khargone,Speech And Language Disability,35,60,6,9,15
Madhya Pradesh,Khargone,Speech And Language Disability,60,80,3,0,3
Madhya Pradesh,Khargone,Speech And Language Disability,80,100,1,0,1
Bihar,Khagaria,Speech And Language Disability,6,15,2,2,4
Bihar,Khagaria,Speech And Language Disability,15,35,9,5,14
Bihar,Khagaria,Speech And Language Disability,35,60,2,1,3
Bihar,Khagaria,Speech And Language Disability,60,80,1,0,1
Odisha,Kendujhar,Speech And Language Disability,0,6,7,3,10
Odisha,Kendujhar,Speech And Language Disability,6,15,29,21,50
Odisha,Kendujhar,Speech And Language Disability,15,35,42,22,64
Odisha,Kendujhar,Speech And Language Disability,35,60,17,11,28
Odisha,Kendujhar,Speech And Language Disability,60,80,1,1,2
Odisha,Kendrapara,Speech And Language Disability,0,6,0,1,1
Odisha,Kendrapara,Speech And Language Disability,6,15,19,7,26
Odisha,Kendrapara,Speech And Language Disability,15,35,18,10,28
Odisha,Kendrapara,Speech And Language Disability,35,60,19,6,25
Odisha,Kendrapara,Speech And Language Disability,60,80,5,5,10
Odisha,Kendrapara,Speech And Language Disability,80,100,0,2,2
Uttar Pradesh,Kaushambi,Speech And Language Disability,6,15,1,5,6
Uttar Pradesh,Kaushambi,Speech And Language Disability,15,35,15,10,25
Uttar Pradesh,Kaushambi,Speech And Language Disability,35,60,4,4,8
Uttar Pradesh,Kaushambi,Speech And Language Disability,80,100,1,0,1
Madhya Pradesh,Katni,Speech And Language Disability,6,15,0,1,1
Madhya Pradesh,Katni,Speech And Language Disability,15,35,3,3,6
Madhya Pradesh,Katni,Speech And Language Disability,35,60,1,2,3
Madhya Pradesh,Katni,Speech And Language Disability,60,80,1,1,2
Bihar,Katihar,Speech And Language Disability,0,6,0,2,2
Bihar,Katihar,Speech And Language Disability,6,15,22,17,39
Bihar,Katihar,Speech And Language Disability,15,35,23,14,37
Bihar,Katihar,Speech And Language Disability,35,60,17,7,24
Bihar,Katihar,Speech And Language Disability,60,80,0,1,1
Jammu And Kashmir,Kathua,Speech And Language Disability,0,6,3,2,5
Jammu And Kashmir,Kathua,Speech And Language Disability,6,15,5,11,16
Jammu And Kashmir,Kathua,Speech And Language Disability,15,35,22,24,46
Jammu And Kashmir,Kathua,Speech And Language Disability,35,60,28,25,53
Jammu And Kashmir,Kathua,Speech And Language Disability,60,80,3,1,4
Uttar Pradesh,Kasganj,Speech And Language Disability,0,6,1,0,1
Uttar Pradesh,Kasganj,Speech And Language Disability,6,15,2,2,4
Uttar Pradesh,Kasganj,Speech And Language Disability,15,35,18,7,25
Uttar Pradesh,Kasganj,Speech And Language Disability,35,60,4,5,9
Kerala,Kasaragod,Speech And Language Disability,0,6,1,1,2
Kerala,Kasaragod,Speech And Language Disability,6,15,5,2,7
Kerala,Kasaragod,Speech And Language Disability,15,35,0,5,5
Kerala,Kasaragod,Speech And Language Disability,35,60,3,7,10
Kerala,Kasaragod,Speech And Language Disability,60,80,3,2,5
Tamil Nadu,Karur,Speech And Language Disability,0,6,0,1,1
Tamil Nadu,Karur,Speech And Language Disability,35,60,3,2,5
Tamil Nadu,Karur,Speech And Language Disability,60,80,1,0,1
Haryana,Karnal,Speech And Language Disability,15,35,3,1,4
Haryana,Karnal,Speech And Language Disability,35,60,2,0,2
Haryana,Karnal,Speech And Language Disability,60,80,4,0,4
Assam,Karimganj,Speech And Language Disability,0,6,6,5,11
Assam,Karimganj,Speech And Language Disability,6,15,47,33,80
Assam,Karimganj,Speech And Language Disability,15,35,59,44,103
Assam,Karimganj,Speech And Language Disability,35,60,9,13,22
Assam,Karimganj,Speech And Language Disability,60,80,1,0,1
Ladakh,Kargil,Speech And Language Disability,0,6,2,0,2
Ladakh,Kargil,Speech And Language Disability,6,15,3,2,5
Ladakh,Kargil,Speech And Language Disability,15,35,12,3,15
Ladakh,Kargil,Speech And Language Disability,35,60,2,3,5
Ladakh,Kargil,Speech And Language Disability,80,100,1,0,1
Assam,Karbi Anglong,Speech And Language Disability,0,6,3,0,3
Assam,Karbi Anglong,Speech And Language Disability,6,15,18,9,27
Assam,Karbi Anglong,Speech And Language Disability,15,35,18,15,33
Assam,Karbi Anglong,Speech And Language Disability,35,60,10,12,22
Puducherry,Karaikal,Speech And Language Disability,15,35,3,1,4
Punjab,Kapurthala,Speech And Language Disability,15,35,7,1,8
Punjab,Kapurthala,Speech And Language Disability,35,60,7,1,8
Uttar Pradesh,Kanpur Nagar,Speech And Language Disability,6,15,2,0,2
Uttar Pradesh,Kanpur Nagar,Speech And Language Disability,15,35,8,4,12
Uttar Pradesh,Kanpur Nagar,Speech And Language Disability,35,60,3,1,4
Uttar Pradesh,Kanpur Dehat,Speech And Language Disability,6,15,12,7,19
Uttar Pradesh,Kanpur Dehat,Speech And Language Disability,15,35,22,9,31
Uttar Pradesh,Kanpur Dehat,Speech And Language Disability,35,60,10,9,19
Uttar Pradesh,Kanpur Dehat,Speech And Language Disability,60,80,0,1,1
Kerala,Kannur,Speech And Language Disability,0,6,2,1,3
Kerala,Kannur,Speech And Language Disability,6,15,3,4,7
Kerala,Kannur,Speech And Language Disability,15,35,5,3,8
Kerala,Kannur,Speech And Language Disability,35,60,8,5,13
Kerala,Kannur,Speech And Language Disability,60,80,1,1,2
Kerala,Kannur,Speech And Language Disability,80,100,1,0,1
Tamil Nadu,Kanniyakumari,Speech And Language Disability,15,35,0,3,3
Tamil Nadu,Kanniyakumari,Speech And Language Disability,35,60,1,1,2
Uttar Pradesh,Kannauj,Speech And Language Disability,6,15,12,13,25
Uttar Pradesh,Kannauj,Speech And Language Disability,15,35,22,9,31
Uttar Pradesh,Kannauj,Speech And Language Disability,35,60,31,4,35
Uttar Pradesh,Kannauj,Speech And Language Disability,60,80,5,0,5
Uttar Pradesh,Kannauj,Speech And Language Disability,80,100,1,0,1
Chhattisgarh,Kanker,Speech And Language Disability,0,6,2,1,3
Chhattisgarh,Kanker,Speech And Language Disability,6,15,20,30,50
Chhattisgarh,Kanker,Speech And Language Disability,15,35,45,49,94
Chhattisgarh,Kanker,Speech And Language Disability,35,60,22,8,30
Chhattisgarh,Kanker,Speech And Language Disability,60,80,3,0,3
Chhattisgarh,Kanker,Speech And Language Disability,80,100,1,0,1
Himachal Pradesh,Kangra,Speech And Language Disability,0,6,1,1,2
Himachal Pradesh,Kangra,Speech And Language Disability,6,15,8,4,12
Himachal Pradesh,Kangra,Speech And Language Disability,15,35,36,9,45
Himachal Pradesh,Kangra,Speech And Language Disability,35,60,22,16,38
Himachal Pradesh,Kangra,Speech And Language Disability,60,80,7,0,7
Manipur,Kangpokpi,Speech And Language Disability,35,60,1,0,1
Odisha,Kandhamal,Speech And Language Disability,0,6,0,1,1
Odisha,Kandhamal,Speech And Language Disability,6,15,7,7,14
Odisha,Kandhamal,Speech And Language Disability,15,35,19,18,37
Odisha,Kandhamal,Speech And Language Disability,35,60,16,5,21
Odisha,Kandhamal,Speech And Language Disability,60,80,1,2,3
Tamil Nadu,Kanchipuram,Speech And Language Disability,6,15,3,1,4
Tamil Nadu,Kanchipuram,Speech And Language Disability,15,35,5,2,7
Tamil Nadu,Kanchipuram,Speech And Language Disability,35,60,1,2,3
Assam,Kamrup Metro,Speech And Language Disability,6,15,0,1,1
Assam,Kamrup Metro,Speech And Language Disability,15,35,3,3,6
Assam,Kamrup Metro,Speech And Language Disability,35,60,3,1,4
Assam,Kamrup,Speech And Language Disability,0,6,0,1,1
Assam,Kamrup,Speech And Language Disability,6,15,1,1,2
Assam,Kamrup,Speech And Language Disability,15,35,10,5,15
Assam,Kamrup,Speech And Language Disability,35,60,2,0,2
Tamil Nadu,Kallakurichi,Speech And Language Disability,0,6,2,2,4
Tamil Nadu,Kallakurichi,Speech And Language Disability,6,15,12,7,19
Tamil Nadu,Kallakurichi,Speech And Language Disability,15,35,9,6,15
Tamil Nadu,Kallakurichi,Speech And Language Disability,35,60,15,6,21
Tamil Nadu,Kallakurichi,Speech And Language Disability,60,80,2,3,5
Odisha,Kalahandi,Speech And Language Disability,6,15,4,1,5
Odisha,Kalahandi,Speech And Language Disability,15,35,11,12,23
Odisha,Kalahandi,Speech And Language Disability,35,60,7,3,10
Odisha,Kalahandi,Speech And Language Disability,60,80,1,0,1
Karnataka,Kalaburagi,Speech And Language Disability,0,6,0,2,2
Karnataka,Kalaburagi,Speech And Language Disability,6,15,22,15,37
Karnataka,Kalaburagi,Speech And Language Disability,15,35,43,22,65
Karnataka,Kalaburagi,Speech And Language Disability,35,60,39,13,52
Karnataka,Kalaburagi,Speech And Language Disability,60,80,5,2,7
Manipur,Kakching,Speech And Language Disability,0,6,1,0,1
Manipur,Kakching,Speech And Language Disability,6,15,1,0,1
Haryana,Kaithal,Speech And Language Disability,6,15,4,1,5
Haryana,Kaithal,Speech And Language Disability,15,35,8,3,11
Haryana,Kaithal,Speech And Language Disability,35,60,3,1,4
Haryana,Kaithal,Speech And Language Disability,60,80,0,1,1
Bihar,Kaimur (Bhabua),Speech And Language Disability,0,6,1,0,1
Bihar,Kaimur (Bhabua),Speech And Language Disability,6,15,14,15,29
Bihar,Kaimur (Bhabua),Speech And Language Disability,15,35,44,28,72
Bihar,Kaimur (Bhabua),Speech And Language Disability,35,60,19,21,40
Bihar,Kaimur (Bhabua),Speech And Language Disability,60,80,2,1,3
Chhattisgarh,Kabirdham,Speech And Language Disability,15,35,8,6,14
Chhattisgarh,Kabirdham,Speech And Language Disability,35,60,2,2,4
Gujarat,Junagadh,Speech And Language Disability,6,15,1,0,1
Gujarat,Junagadh,Speech And Language Disability,15,35,1,1,2
Gujarat,Junagadh,Speech And Language Disability,35,60,1,0,1
Assam,Jorhat,Speech And Language Disability,6,15,2,3,5
Assam,Jorhat,Speech And Language Disability,15,35,6,3,9
Assam,Jorhat,Speech And Language Disability,35,60,1,2,3
Assam,Jorhat,Speech And Language Disability,60,80,1,0,1
Rajasthan,Jodhpur,Speech And Language Disability,6,15,6,3,9
Rajasthan,Jodhpur,Speech And Language Disability,15,35,12,3,15
Rajasthan,Jodhpur,Speech And Language Disability,35,60,6,1,7
Rajasthan,Jodhpur,Speech And Language Disability,80,100,0,1,1
Haryana,Jind,Speech And Language Disability,35,60,1,0,1
Rajasthan,Jhunjhunu,Speech And Language Disability,0,6,0,1,1
Rajasthan,Jhunjhunu,Speech And Language Disability,6,15,1,0,1
Rajasthan,Jhunjhunu,Speech And Language Disability,15,35,5,2,7
Rajasthan,Jhunjhunu,Speech And Language Disability,35,60,8,1,9
Rajasthan,Jhunjhunu,Speech And Language Disability,60,80,1,1,2
Odisha,Jharsuguda,Speech And Language Disability,6,15,6,7,13
Odisha,Jharsuguda,Speech And Language Disability,15,35,7,4,11
Odisha,Jharsuguda,Speech And Language Disability,35,60,6,7,13
Odisha,Jharsuguda,Speech And Language Disability,60,80,3,0,3
Uttar Pradesh,Jhansi,Speech And Language Disability,0,6,1,1,2
Uttar Pradesh,Jhansi,Speech And Language Disability,6,15,13,4,17
Uttar Pradesh,Jhansi,Speech And Language Disability,15,35,19,11,30
Uttar Pradesh,Jhansi,Speech And Language Disability,35,60,9,5,14
Uttar Pradesh,Jhansi,Speech And Language Disability,60,80,1,1,2
Rajasthan,Jhalawar,Speech And Language Disability,6,15,4,0,4
Rajasthan,Jhalawar,Speech And Language Disability,15,35,5,1,6
Rajasthan,Jhalawar,Speech And Language Disability,35,60,3,5,8
Rajasthan,Jhalawar,Speech And Language Disability,60,80,1,0,1
Haryana,Jhajjar,Speech And Language Disability,15,35,2,1,3
Haryana,Jhajjar,Speech And Language Disability,35,60,6,1,7
Madhya Pradesh,Jhabua,Speech And Language Disability,6,15,0,2,2
Madhya Pradesh,Jhabua,Speech And Language Disability,15,35,8,4,12
Madhya Pradesh,Jhabua,Speech And Language Disability,35,60,3,1,4
Bihar,Jehanabad,Speech And Language Disability,0,6,1,4,5
Bihar,Jehanabad,Speech And Language Disability,6,15,7,4,11
Bihar,Jehanabad,Speech And Language Disability,15,35,8,5,13
Bihar,Jehanabad,Speech And Language Disability,35,60,2,1,3
Uttar Pradesh,Jaunpur,Speech And Language Disability,0,6,1,3,4
Uttar Pradesh,Jaunpur,Speech And Language Disability,6,15,40,27,67
Uttar Pradesh,Jaunpur,Speech And Language Disability,15,35,99,57,156
Uttar Pradesh,Jaunpur,Speech And Language Disability,35,60,35,38,73
Uttar Pradesh,Jaunpur,Speech And Language Disability,60,80,5,1,6
Chhattisgarh,Jashpur,Speech And Language Disability,6,15,0,3,3
Chhattisgarh,Jashpur,Speech And Language Disability,15,35,6,7,13
Chhattisgarh,Jashpur,Speech And Language Disability,35,60,0,2,2
Chhattisgarh,Janjgir-Champa,Speech And Language Disability,0,6,0,1,1
Chhattisgarh,Janjgir-Champa,Speech And Language Disability,6,15,32,27,59
Chhattisgarh,Janjgir-Champa,Speech And Language Disability,15,35,84,76,160
Chhattisgarh,Janjgir-Champa,Speech And Language Disability,35,60,25,21,46
Chhattisgarh,Janjgir-Champa,Speech And Language Disability,60,80,2,1,3
Bihar,Jamui,Speech And Language Disability,6,15,9,11,20
Bihar,Jamui,Speech And Language Disability,15,35,15,16,31
Bihar,Jamui,Speech And Language Disability,35,60,11,4,15
Bihar,Jamui,Speech And Language Disability,60,80,0,1,1
Jharkhand,Jamtara,Speech And Language Disability,0,6,2,1,3
Jharkhand,Jamtara,Speech And Language Disability,6,15,34,29,63
Jharkhand,Jamtara,Speech And Language Disability,15,35,68,45,113
Jharkhand,Jamtara,Speech And Language Disability,35,60,29,13,42
Jharkhand,Jamtara,Speech And Language Disability,60,80,1,1,2
Gujarat,Jamnagar,Speech And Language Disability,35,60,2,0,2
Gujarat,Jamnagar,Speech And Language Disability,60,80,0,1,1
Jammu And Kashmir,Jammu,Speech And Language Disability,0,6,0,1,1
Jammu And Kashmir,Jammu,Speech And Language Disability,6,15,7,10,17
Jammu And Kashmir,Jammu,Speech And Language Disability,15,35,19,17,36
Jammu And Kashmir,Jammu,Speech And Language Disability,35,60,25,12,37
Jammu And Kashmir,Jammu,Speech And Language Disability,60,80,5,2,7
Rajasthan,Jalore,Speech And Language Disability,0,6,0,1,1
Rajasthan,Jalore,Speech And Language Disability,6,15,14,8,22
Rajasthan,Jalore,Speech And Language Disability,15,35,50,14,64
Rajasthan,Jalore,Speech And Language Disability,35,60,17,5,22
Rajasthan,Jalore,Speech And Language Disability,60,80,6,2,8
Rajasthan,Jalore,Speech And Language Disability,80,100,1,0,1
Maharashtra,Jalna,Speech And Language Disability,0,6,1,5,6
Maharashtra,Jalna,Speech And Language Disability,6,15,16,19,35
Maharashtra,Jalna,Speech And Language Disability,15,35,52,18,70
Maharashtra,Jalna,Speech And Language Disability,35,60,37,18,55
Maharashtra,Jalna,Speech And Language Disability,60,80,4,1,5
Maharashtra,Jalna,Speech And Language Disability,80,100,1,1,2
Maharashtra,Jalgaon,Speech And Language Disability,6,15,2,0,2
Maharashtra,Jalgaon,Speech And Language Disability,15,35,5,1,6
Maharashtra,Jalgaon,Speech And Language Disability,35,60,3,1,4
Uttar Pradesh,Jalaun,Speech And Language Disability,0,6,2,3,5
Uttar Pradesh,Jalaun,Speech And Language Disability,6,15,6,6,12
Uttar Pradesh,Jalaun,Speech And Language Disability,15,35,44,27,71
Uttar Pradesh,Jalaun,Speech And Language Disability,35,60,29,17,46
Uttar Pradesh,Jalaun,Speech And Language Disability,60,80,5,1,6
Punjab,Jalandhar,Speech And Language Disability,6,15,2,2,4
Punjab,Jalandhar,Speech And Language Disability,15,35,14,6,20
Punjab,Jalandhar,Speech And Language Disability,35,60,13,7,20
Punjab,Jalandhar,Speech And Language Disability,60,80,3,0,3
Odisha,Jajapur,Speech And Language Disability,0,6,6,7,13
Odisha,Jajapur,Speech And Language Disability,6,15,32,31,63
Odisha,Jajapur,Speech And Language Disability,15,35,46,33,79
Odisha,Jajapur,Speech And Language Disability,35,60,35,23,58
Odisha,Jajapur,Speech And Language Disability,60,80,4,1,5
Rajasthan,Jaisalmer,Speech And Language Disability,6,15,2,0,2
Rajasthan,Jaisalmer,Speech And Language Disability,15,35,4,1,5
Rajasthan,Jaipur,Speech And Language Disability,6,15,11,15,26
Rajasthan,Jaipur,Speech And Language Disability,15,35,30,13,43
Rajasthan,Jaipur,Speech And Language Disability,35,60,19,9,28
Rajasthan,Jaipur,Speech And Language Disability,60,80,5,1,6
Odisha,Jagatsinghapur,Speech And Language Disability,0,6,1,1,2
Odisha,Jagatsinghapur,Speech And Language Disability,6,15,8,6,14
Odisha,Jagatsinghapur,Speech And Language Disability,15,35,18,8,26
Odisha,Jagatsinghapur,Speech And Language Disability,35,60,23,4,27
Odisha,Jagatsinghapur,Speech And Language Disability,60,80,6,0,6
Madhya Pradesh,Jabalpur,Speech And Language Disability,0,6,1,1,2
Madhya Pradesh,Jabalpur,Speech And Language Disability,6,15,7,2,9
Madhya Pradesh,Jabalpur,Speech And Language Disability,15,35,10,9,19
Madhya Pradesh,Jabalpur,Speech And Language Disability,35,60,10,12,22
Madhya Pradesh,Jabalpur,Speech And Language Disability,60,80,1,1,2
Madhya Pradesh,Indore,Speech And Language Disability,6,15,2,2,4
Madhya Pradesh,Indore,Speech And Language Disability,15,35,8,5,13
Madhya Pradesh,Indore,Speech And Language Disability,35,60,4,2,6
Madhya Pradesh,Indore,Speech And Language Disability,60,80,1,0,1
Manipur,Imphal West,Speech And Language Disability,6,15,0,2,2
Manipur,Imphal West,Speech And Language Disability,15,35,1,0,1
Manipur,Imphal West,Speech And Language Disability,35,60,2,2,4
Manipur,Imphal East,Speech And Language Disability,0,6,0,1,1
Kerala,Idukki,Speech And Language Disability,6,15,3,1,4
Kerala,Idukki,Speech And Language Disability,15,35,19,8,27
Kerala,Idukki,Speech And Language Disability,35,60,9,13,22
Kerala,Idukki,Speech And Language Disability,60,80,0,5,5
West Bengal,Howrah,Speech And Language Disability,6,15,1,0,1
Punjab,Hoshiarpur,Speech And Language Disability,0,6,2,0,2
Punjab,Hoshiarpur,Speech And Language Disability,6,15,10,5,15
Punjab,Hoshiarpur,Speech And Language Disability,15,35,67,37,104
Punjab,Hoshiarpur,Speech And Language Disability,35,60,50,32,82
Punjab,Hoshiarpur,Speech And Language Disability,60,80,12,3,15
Punjab,Hoshiarpur,Speech And Language Disability,80,100,1,0,1
Assam,Hojai,Speech And Language Disability,0,6,0,2,2
Assam,Hojai,Speech And Language Disability,6,15,1,5,6
Assam,Hojai,Speech And Language Disability,15,35,8,3,11
Assam,Hojai,Speech And Language Disability,35,60,2,2,4
Mizoram,Hnahthial,Speech And Language Disability,15,35,0,3,3
Haryana,Hisar,Speech And Language Disability,0,6,2,1,3
Haryana,Hisar,Speech And Language Disability,6,15,7,3,10
Haryana,Hisar,Speech And Language Disability,15,35,38,11,49
Haryana,Hisar,Speech And Language Disability,35,60,22,7,29
Haryana,Hisar,Speech And Language Disability,60,80,4,0,4
Maharashtra,Hingoli,Speech And Language Disability,6,15,1,3,4
Maharashtra,Hingoli,Speech And Language Disability,15,35,5,3,8
Maharashtra,Hingoli,Speech And Language Disability,35,60,4,1,5
Maharashtra,Hingoli,Speech And Language Disability,60,80,1,0,1
Jharkhand,Hazaribagh,Speech And Language Disability,0,6,1,0,1
Jharkhand,Hazaribagh,Speech And Language Disability,6,15,8,4,12
Jharkhand,Hazaribagh,Speech And Language Disability,15,35,17,17,34
Jharkhand,Hazaribagh,Speech And Language Disability,35,60,9,5,14
Karnataka,Haveri,Speech And Language Disability,0,6,1,3,4
Karnataka,Haveri,Speech And Language Disability,6,15,27,16,43
Karnataka,Haveri,Speech And Language Disability,15,35,47,38,85
Karnataka,Haveri,Speech And Language Disability,35,60,37,21,58
Karnataka,Haveri,Speech And Language Disability,60,80,3,6,9
Karnataka,Haveri,Speech And Language Disability,80,100,0,1,1
Uttar Pradesh,Hathras,Speech And Language Disability,0,6,0,2,2
Uttar Pradesh,Hathras,Speech And Language Disability,6,15,3,3,6
Uttar Pradesh,Hathras,Speech And Language Disability,15,35,14,6,20
Uttar Pradesh,Hathras,Speech And Language Disability,35,60,5,7,12
Uttar Pradesh,Hathras,Speech And Language Disability,60,80,1,1,2
Karnataka,Hassan,Speech And Language Disability,0,6,0,2,2
Karnataka,Hassan,Speech And Language Disability,6,15,12,2,14
Karnataka,Hassan,Speech And Language Disability,15,35,22,23,45
Karnataka,Hassan,Speech And Language Disability,35,60,35,24,59
Karnataka,Hassan,Speech And Language Disability,60,80,22,2,24
Karnataka,Hassan,Speech And Language Disability,80,100,1,0,1
Uttarakhand,Haridwar,Speech And Language Disability,0,6,1,0,1
Uttarakhand,Haridwar,Speech And Language Disability,6,15,4,3,7
Uttarakhand,Haridwar,Speech And Language Disability,15,35,10,9,19
Uttarakhand,Haridwar,Speech And Language Disability,35,60,11,1,12
Uttarakhand,Haridwar,Speech And Language Disability,80,100,1,0,1
Uttar Pradesh,Hardoi,Speech And Language Disability,0,6,1,0,1
Uttar Pradesh,Hardoi,Speech And Language Disability,6,15,3,4,7
Uttar Pradesh,Hardoi,Speech And Language Disability,15,35,46,12,58
Uttar Pradesh,Hardoi,Speech And Language Disability,35,60,25,9,34
Uttar Pradesh,Hardoi,Speech And Language Disability,60,80,2,0,2
Madhya Pradesh,Harda,Speech And Language Disability,6,15,3,7,10
Madhya Pradesh,Harda,Speech And Language Disability,15,35,13,12,25
Madhya Pradesh,Harda,Speech And Language Disability,35,60,10,3,13
Madhya Pradesh,Harda,Speech And Language Disability,60,80,6,2,8
Madhya Pradesh,Harda,Speech And Language Disability,80,100,4,0,4
Uttar Pradesh,Hapur,Speech And Language Disability,0,6,1,0,1
Uttar Pradesh,Hapur,Speech And Language Disability,6,15,3,3,6
Uttar Pradesh,Hapur,Speech And Language Disability,15,35,9,3,12
Uttar Pradesh,Hapur,Speech And Language Disability,35,60,1,4,5
Rajasthan,Hanumangarh,Speech And Language Disability,6,15,2,5,7
Rajasthan,Hanumangarh,Speech And Language Disability,15,35,2,4,6
Rajasthan,Hanumangarh,Speech And Language Disability,35,60,2,1,3
Rajasthan,Hanumangarh,Speech And Language Disability,60,80,1,0,1
Himachal Pradesh,Hamirpur,Speech And Language Disability,0,6,0,1,1
Himachal Pradesh,Hamirpur,Speech And Language Disability,6,15,3,2,5
Himachal Pradesh,Hamirpur,Speech And Language Disability,15,35,8,5,13
Himachal Pradesh,Hamirpur,Speech And Language Disability,35,60,12,7,19
Himachal Pradesh,Hamirpur,Speech And Language Disability,60,80,5,0,5
Uttar Pradesh,Hamirpur,Speech And Language Disability,6,15,8,5,13
Uttar Pradesh,Hamirpur,Speech And Language Disability,15,35,23,8,31
Uttar Pradesh,Hamirpur,Speech And Language Disability,35,60,30,6,36
Uttar Pradesh,Hamirpur,Speech And Language Disability,60,80,5,0,5
Assam,Hailakandi,Speech And Language Disability,0,6,6,8,14
Assam,Hailakandi,Speech And Language Disability,6,15,40,29,69
Assam,Hailakandi,Speech And Language Disability,15,35,54,48,102
Assam,Hailakandi,Speech And Language Disability,35,60,22,18,40
Assam,Hailakandi,Speech And Language Disability,60,80,2,1,3
Sikkim,Gyalshing,Speech And Language Disability,6,15,1,3,4
Sikkim,Gyalshing,Speech And Language Disability,15,35,2,2,4
Sikkim,Gyalshing,Speech And Language Disability,35,60,1,1,2
Sikkim,Gyalshing,Speech And Language Disability,60,80,1,0,1
Madhya Pradesh,Gwalior,Speech And Language Disability,6,15,4,3,7
Madhya Pradesh,Gwalior,Speech And Language Disability,15,35,17,3,20
Madhya Pradesh,Gwalior,Speech And Language Disability,35,60,6,2,8
Haryana,Gurugram,Speech And Language Disability,15,35,1,0,1
Haryana,Gurugram,Speech And Language Disability,35,60,3,0,3
Haryana,Gurugram,Speech And Language Disability,60,80,1,0,1
Punjab,Gurdaspur,Speech And Language Disability,6,15,0,2,2
Punjab,Gurdaspur,Speech And Language Disability,15,35,12,6,18
Punjab,Gurdaspur,Speech And Language Disability,35,60,5,5,10
Punjab,Gurdaspur,Speech And Language Disability,60,80,2,1,3
Andhra Pradesh,Guntur,Speech And Language Disability,6,15,0,1,1
Andhra Pradesh,Guntur,Speech And Language Disability,15,35,1,0,1
Madhya Pradesh,Guna,Speech And Language Disability,0,6,1,0,1
Madhya Pradesh,Guna,Speech And Language Disability,6,15,2,0,2
Madhya Pradesh,Guna,Speech And Language Disability,15,35,7,6,13
Madhya Pradesh,Guna,Speech And Language Disability,35,60,9,2,11
Madhya Pradesh,Guna,Speech And Language Disability,60,80,3,0,3
Jharkhand,Gumla,Speech And Language Disability,0,6,1,1,2
Jharkhand,Gumla,Speech And Language Disability,6,15,20,15,35
Jharkhand,Gumla,Speech And Language Disability,15,35,28,26,54
Jharkhand,Gumla,Speech And Language Disability,35,60,24,16,40
Jharkhand,Gumla,Speech And Language Disability,60,80,4,2,6
Uttar Pradesh,Gorakhpur,Speech And Language Disability,0,6,4,2,6
Uttar Pradesh,Gorakhpur,Speech And Language Disability,6,15,20,15,35
Uttar Pradesh,Gorakhpur,Speech And Language Disability,15,35,51,38,89
Uttar Pradesh,Gorakhpur,Speech And Language Disability,35,60,29,15,44
Uttar Pradesh,Gorakhpur,Speech And Language Disability,60,80,2,0,2
Bihar,Gopalganj,Speech And Language Disability,0,6,8,8,16
Bihar,Gopalganj,Speech And Language Disability,6,15,28,26,54
Bihar,Gopalganj,Speech And Language Disability,15,35,31,10,41
Bihar,Gopalganj,Speech And Language Disability,35,60,11,3,14
Bihar,Gopalganj,Speech And Language Disability,60,80,1,0,1
Maharashtra,Gondia,Speech And Language Disability,0,6,0,1,1
Maharashtra,Gondia,Speech And Language Disability,15,35,3,1,4
Maharashtra,Gondia,Speech And Language Disability,35,60,6,0,6
Uttar Pradesh,Gonda,Speech And Language Disability,0,6,4,1,5
Uttar Pradesh,Gonda,Speech And Language Disability,6,15,6,2,8
Uttar Pradesh,Gonda,Speech And Language Disability,15,35,17,9,26
Uttar Pradesh,Gonda,Speech And Language Disability,35,60,7,6,13
Uttar Pradesh,Gonda,Speech And Language Disability,60,80,1,0,1
Tripura,Gomati,Speech And Language Disability,6,15,1,0,1
Tripura,Gomati,Speech And Language Disability,15,35,0,1,1
Tripura,Gomati,Speech And Language Disability,35,60,1,0,1
Assam,Golaghat,Speech And Language Disability,0,6,1,0,1
Assam,Golaghat,Speech And Language Disability,6,15,7,7,14
Assam,Golaghat,Speech And Language Disability,15,35,19,21,40
Assam,Golaghat,Speech And Language Disability,35,60,17,7,24
Assam,Golaghat,Speech And Language Disability,60,80,4,1,5
Jharkhand,Godda,Speech And Language Disability,6,15,3,5,8
Jharkhand,Godda,Speech And Language Disability,15,35,21,15,36
Jharkhand,Godda,Speech And Language Disability,35,60,14,12,26
Jharkhand,Godda,Speech And Language Disability,60,80,1,3,4
Jharkhand,Godda,Speech And Language Disability,80,100,1,1,2
Assam,Goalpara,Speech And Language Disability,6,15,1,1,2
Assam,Goalpara,Speech And Language Disability,15,35,7,6,13
Assam,Goalpara,Speech And Language Disability,35,60,5,0,5
Assam,Goalpara,Speech And Language Disability,60,80,1,0,1
Jharkhand,Giridih,Speech And Language Disability,0,6,1,2,3
Jharkhand,Giridih,Speech And Language Disability,6,15,31,43,74
Jharkhand,Giridih,Speech And Language Disability,15,35,81,46,127
Jharkhand,Giridih,Speech And Language Disability,35,60,44,20,64
Jharkhand,Giridih,Speech And Language Disability,60,80,5,3,8
Jharkhand,Giridih,Speech And Language Disability,80,100,1,0,1
Gujarat,Gir Somnath,Speech And Language Disability,0,6,1,0,1
Gujarat,Gir Somnath,Speech And Language Disability,15,35,0,1,1
Gujarat,Gir Somnath,Speech And Language Disability,35,60,1,1,2
Uttar Pradesh,Ghazipur,Speech And Language Disability,0,6,2,1,3
Uttar Pradesh,Ghazipur,Speech And Language Disability,6,15,13,9,22
Uttar Pradesh,Ghazipur,Speech And Language Disability,15,35,25,6,31
Uttar Pradesh,Ghazipur,Speech And Language Disability,35,60,8,2,10
Uttar Pradesh,Ghazipur,Speech And Language Disability,60,80,0,1,1
Uttar Pradesh,Ghaziabad,Speech And Language Disability,6,15,0,1,1
Uttar Pradesh,Ghaziabad,Speech And Language Disability,15,35,9,3,12
Uttar Pradesh,Ghaziabad,Speech And Language Disability,35,60,5,0,5
Uttar Pradesh,Ghaziabad,Speech And Language Disability,60,80,1,0,1
Uttar Pradesh,Ghaziabad,Speech And Language Disability,80,100,1,0,1
Bihar,Gaya,Speech And Language Disability,0,6,3,0,3
Bihar,Gaya,Speech And Language Disability,6,15,30,23,53
Bihar,Gaya,Speech And Language Disability,15,35,22,16,38
Bihar,Gaya,Speech And Language Disability,35,60,13,5,18
Bihar,Gaya,Speech And Language Disability,60,80,2,0,2
Uttar Pradesh,Gautam Buddha Nagar,Speech And Language Disability,0,6,2,1,3
Uttar Pradesh,Gautam Buddha Nagar,Speech And Language Disability,6,15,3,2,5
Uttar Pradesh,Gautam Buddha Nagar,Speech And Language Disability,15,35,6,1,7
Uttar Pradesh,Gautam Buddha Nagar,Speech And Language Disability,35,60,3,1,4
Chhattisgarh,Gaurella Pendra Marwahi,Speech And Language Disability,6,15,1,1,2
Chhattisgarh,Gaurella Pendra Marwahi,Speech And Language Disability,15,35,2,0,2
Chhattisgarh,Gariyaband,Speech And Language Disability,6,15,13,15,28
Chhattisgarh,Gariyaband,Speech And Language Disability,15,35,32,22,54
Chhattisgarh,Gariyaband,Speech And Language Disability,35,60,18,8,26
Chhattisgarh,Gariyaband,Speech And Language Disability,80,100,1,0,1
Jharkhand,Garhwa,Speech And Language Disability,0,6,1,3,4
Jharkhand,Garhwa,Speech And Language Disability,6,15,14,19,33
Jharkhand,Garhwa,Speech And Language Disability,15,35,23,22,45
Jharkhand,Garhwa,Speech And Language Disability,35,60,10,14,24
Jharkhand,Garhwa,Speech And Language Disability,60,80,1,0,1
Odisha,Ganjam,Speech And Language Disability,0,6,3,2,5
Odisha,Ganjam,Speech And Language Disability,6,15,47,29,76
Odisha,Ganjam,Speech And Language Disability,15,35,43,29,72
Odisha,Ganjam,Speech And Language Disability,35,60,52,10,62
Odisha,Ganjam,Speech And Language Disability,60,80,9,1,10
Sikkim,Gangtok,Speech And Language Disability,0,6,1,0,1
Sikkim,Gangtok,Speech And Language Disability,15,35,3,9,12
Sikkim,Gangtok,Speech And Language Disability,35,60,3,0,3
Rajasthan,Ganganagar,Speech And Language Disability,0,6,2,0,2
Rajasthan,Ganganagar,Speech And Language Disability,6,15,16,8,24
Rajasthan,Ganganagar,Speech And Language Disability,15,35,48,12,60
Rajasthan,Ganganagar,Speech And Language Disability,35,60,21,4,25
Rajasthan,Ganganagar,Speech And Language Disability,60,80,3,0,3
Gujarat,Gandhinagar,Speech And Language Disability,6,15,1,0,1
Gujarat,Gandhinagar,Speech And Language Disability,35,60,1,0,1
Jammu And Kashmir,Ganderbal,Speech And Language Disability,0,6,5,1,6
Jammu And Kashmir,Ganderbal,Speech And Language Disability,6,15,4,6,10
Jammu And Kashmir,Ganderbal,Speech And Language Disability,15,35,14,6,20
Jammu And Kashmir,Ganderbal,Speech And Language Disability,35,60,8,7,15
Jammu And Kashmir,Ganderbal,Speech And Language Disability,60,80,3,1,4
Jammu And Kashmir,Ganderbal,Speech And Language Disability,80,100,0,1,1
Odisha,Gajapati,Speech And Language Disability,15,35,0,1,1
Odisha,Gajapati,Speech And Language Disability,35,60,4,1,5
Maharashtra,Gadchiroli,Speech And Language Disability,0,6,1,0,1
Maharashtra,Gadchiroli,Speech And Language Disability,6,15,1,1,2
Maharashtra,Gadchiroli,Speech And Language Disability,35,60,1,2,3
Maharashtra,Gadchiroli,Speech And Language Disability,60,80,0,1,1
Karnataka,Gadag,Speech And Language Disability,0,6,3,2,5
Karnataka,Gadag,Speech And Language Disability,6,15,10,8,18
Karnataka,Gadag,Speech And Language Disability,15,35,6,15,21
Karnataka,Gadag,Speech And Language Disability,35,60,8,4,12
Uttar Pradesh,Firozabad,Speech And Language Disability,6,15,6,5,11
Uttar Pradesh,Firozabad,Speech And Language Disability,15,35,16,9,25
Uttar Pradesh,Firozabad,Speech And Language Disability,35,60,12,3,15
Uttar Pradesh,Firozabad,Speech And Language Disability,60,80,1,0,1
Punjab,Ferozepur,Speech And Language Disability,6,15,3,2,5
Punjab,Ferozepur,Speech And Language Disability,15,35,10,4,14
Punjab,Ferozepur,Speech And Language Disability,35,60,2,2,4
Punjab,Fazilka,Speech And Language Disability,0,6,1,0,1
Punjab,Fazilka,Speech And Language Disability,6,15,10,11,21
Punjab,Fazilka,Speech And Language Disability,15,35,12,7,19
Punjab,Fazilka,Speech And Language Disability,35,60,8,4,12
Punjab,Fazilka,Speech And Language Disability,60,80,3,0,3
Uttar Pradesh,Fatehpur,Speech And Language Disability,0,6,4,0,4
Uttar Pradesh,Fatehpur,Speech And Language Disability,6,15,16,9,25
Uttar Pradesh,Fatehpur,Speech And Language Disability,15,35,46,38,84
Uttar Pradesh,Fatehpur,Speech And Language Disability,35,60,34,13,47
Uttar Pradesh,Fatehpur,Speech And Language Disability,60,80,2,3,5
Uttar Pradesh,Fatehpur,Speech And Language Disability,80,100,0,1,1
Punjab,Fatehgarh Sahib,Speech And Language Disability,6,15,11,3,14
Punjab,Fatehgarh Sahib,Speech And Language Disability,15,35,15,15,30
Punjab,Fatehgarh Sahib,Speech And Language Disability,35,60,9,3,12
Punjab,Fatehgarh Sahib,Speech And Language Disability,60,80,4,1,5
Haryana,Fatehabad,Speech And Language Disability,6,15,9,6,15
Haryana,Fatehabad,Speech And Language Disability,15,35,22,12,34
Haryana,Fatehabad,Speech And Language Disability,35,60,4,2,6
Haryana,Fatehabad,Speech And Language Disability,60,80,0,1,1
Haryana,Fatehabad,Speech And Language Disability,80,100,1,0,1
Uttar Pradesh,Farrukhabad,Speech And Language Disability,0,6,0,2,2
Uttar Pradesh,Farrukhabad,Speech And Language Disability,6,15,6,4,10
Uttar Pradesh,Farrukhabad,Speech And Language Disability,15,35,51,15,66
Uttar Pradesh,Farrukhabad,Speech And Language Disability,35,60,34,7,41
Uttar Pradesh,Farrukhabad,Speech And Language Disability,60,80,3,0,3
Punjab,Faridkot,Speech And Language Disability,6,15,2,1,3
Punjab,Faridkot,Speech And Language Disability,15,35,8,5,13
Punjab,Faridkot,Speech And Language Disability,35,60,5,2,7
Haryana,Faridabad,Speech And Language Disability,15,35,8,1,9
Haryana,Faridabad,Speech And Language Disability,35,60,3,0,3
Uttar Pradesh,Etawah,Speech And Language Disability,6,15,2,4,6
Uttar Pradesh,Etawah,Speech And Language Disability,15,35,7,2,9
Uttar Pradesh,Etawah,Speech And Language Disability,35,60,3,2,5
Uttar Pradesh,Etah,Speech And Language Disability,0,6,1,0,1
Uttar Pradesh,Etah,Speech And Language Disability,6,15,12,7,19
Uttar Pradesh,Etah,Speech And Language Disability,15,35,62,22,84
Uttar Pradesh,Etah,Speech And Language Disability,35,60,27,9,36
Uttar Pradesh,Etah,Speech And Language Disability,60,80,2,1,3
Tamil Nadu,Erode,Speech And Language Disability,6,15,10,2,12
Tamil Nadu,Erode,Speech And Language Disability,15,35,9,4,13
Tamil Nadu,Erode,Speech And Language Disability,35,60,0,1,1
Tamil Nadu,Erode,Speech And Language Disability,60,80,1,0,1
Kerala,Ernakulam,Speech And Language Disability,6,15,1,1,2
Kerala,Ernakulam,Speech And Language Disability,15,35,3,3,6
Kerala,Ernakulam,Speech And Language Disability,35,60,15,9,24
Kerala,Ernakulam,Speech And Language Disability,60,80,4,2,6
Meghalaya,Eastern West Khasi Hills,Speech And Language Disability,15,35,2,0,2
Meghalaya,Eastern West Khasi Hills,Speech And Language Disability,35,60,1,2,3
Jharkhand,East Singhbum,Speech And Language Disability,6,15,2,5,7
Jharkhand,East Singhbum,Speech And Language Disability,15,35,63,60,123
Jharkhand,East Singhbum,Speech And Language Disability,35,60,45,38,83
Jharkhand,East Singhbum,Speech And Language Disability,60,80,19,4,23
Jharkhand,East Singhbum,Speech And Language Disability,80,100,1,3,4
Arunachal Pradesh,East Siang,Speech And Language Disability,15,35,3,3,6
Madhya Pradesh,East Nimar,Speech And Language Disability,6,15,3,5,8
Madhya Pradesh,East Nimar,Speech And Language Disability,15,35,21,7,28
Madhya Pradesh,East Nimar,Speech And Language Disability,35,60,5,2,7
Madhya Pradesh,East Nimar,Speech And Language Disability,60,80,1,0,1
Meghalaya,East Khasi Hills,Speech And Language Disability,6,15,0,3,3
Meghalaya,East Khasi Hills,Speech And Language Disability,15,35,21,17,38
Meghalaya,East Khasi Hills,Speech And Language Disability,35,60,3,4,7
Meghalaya,East Khasi Hills,Speech And Language Disability,60,80,1,0,1
Arunachal Pradesh,East Kameng,Speech And Language Disability,6,15,2,0,2
Arunachal Pradesh,East Kameng,Speech And Language Disability,15,35,6,3,9
Arunachal Pradesh,East Kameng,Speech And Language Disability,35,60,2,0,2
Meghalaya,East Jaintia Hills,Speech And Language Disability,15,35,5,3,8
Meghalaya,East Jaintia Hills,Speech And Language Disability,35,60,0,2,2
Meghalaya,East Jaintia Hills,Speech And Language Disability,60,80,0,1,1
Meghalaya,East Garo Hills,Speech And Language Disability,6,15,1,4,5
Meghalaya,East Garo Hills,Speech And Language Disability,15,35,19,9,28
Meghalaya,East Garo Hills,Speech And Language Disability,35,60,3,2,5
Delhi,East,Speech And Language Disability,0,6,0,1,1
Delhi,East,Speech And Language Disability,6,15,1,2,3
Delhi,East,Speech And Language Disability,15,35,1,1,2
Delhi,East,Speech And Language Disability,35,60,0,1,1
Chhattisgarh,Durg,Speech And Language Disability,0,6,0,2,2
Chhattisgarh,Durg,Speech And Language Disability,6,15,3,2,5
Chhattisgarh,Durg,Speech And Language Disability,15,35,14,12,26
Chhattisgarh,Durg,Speech And Language Disability,35,60,6,5,11
Chhattisgarh,Durg,Speech And Language Disability,60,80,2,0,2
Chhattisgarh,Durg,Speech And Language Disability,80,100,0,1,1
Rajasthan,Dungarpur,Speech And Language Disability,6,15,1,2,3
Rajasthan,Dungarpur,Speech And Language Disability,15,35,7,3,10
Rajasthan,Dungarpur,Speech And Language Disability,35,60,5,1,6
Rajasthan,Dungarpur,Speech And Language Disability,60,80,0,1,1
Jharkhand,Dumka,Speech And Language Disability,0,6,2,1,3
Jharkhand,Dumka,Speech And Language Disability,6,15,43,28,71
Jharkhand,Dumka,Speech And Language Disability,15,35,51,32,83
Jharkhand,Dumka,Speech And Language Disability,35,60,25,8,33
Jharkhand,Dumka,Speech And Language Disability,60,80,3,1,4
Gujarat,Dohad,Speech And Language Disability,6,15,4,2,6
Gujarat,Dohad,Speech And Language Disability,15,35,16,2,18
Gujarat,Dohad,Speech And Language Disability,35,60,4,2,6
Jammu And Kashmir,Doda,Speech And Language Disability,0,6,4,1,5
Jammu And Kashmir,Doda,Speech And Language Disability,6,15,12,13,25
Jammu And Kashmir,Doda,Speech And Language Disability,15,35,46,33,79
Jammu And Kashmir,Doda,Speech And Language Disability,35,60,17,16,33
Jammu And Kashmir,Doda,Speech And Language Disability,60,80,5,0,5
Dadra Nagar Haveli And Daman And Diu,Diu,Speech And Language Disability,6,15,1,0,1
Madhya Pradesh,Dindori,Speech And Language Disability,6,15,3,4,7
Madhya Pradesh,Dindori,Speech And Language Disability,15,35,18,8,26
Madhya Pradesh,Dindori,Speech And Language Disability,35,60,7,6,13
Madhya Pradesh,Dindori,Speech And Language Disability,60,80,0,1,1
Tamil Nadu,Dindigul,Speech And Language Disability,6,15,2,3,5
Tamil Nadu,Dindigul,Speech And Language Disability,15,35,2,0,2
Tamil Nadu,Dindigul,Speech And Language Disability,35,60,5,1,6
Tamil Nadu,Dindigul,Speech And Language Disability,60,80,3,0,3
Nagaland,Dimapur,Speech And Language Disability,15,35,0,2,2
Nagaland,Dimapur,Speech And Language Disability,35,60,1,0,1
Assam,Dima Hasao,Speech And Language Disability,15,35,1,1,2
Assam,Dibrugarh,Speech And Language Disability,6,15,0,3,3
Assam,Dibrugarh,Speech And Language Disability,15,35,2,2,4
Assam,Dibrugarh,Speech And Language Disability,35,60,1,1,2
Maharashtra,Dhule,Speech And Language Disability,15,35,0,1,1
Maharashtra,Dhule,Speech And Language Disability,35,60,1,1,2
Maharashtra,Dhule,Speech And Language Disability,60,80,1,0,1
Maharashtra,Dhule,Speech And Language Disability,80,100,0,1,1
Assam,Dhubri,Speech And Language Disability,6,15,1,0,1
Assam,Dhubri,Speech And Language Disability,15,35,1,3,4
Assam,Dhubri,Speech And Language Disability,35,60,1,0,1
Odisha,Dhenkanal,Speech And Language Disability,0,6,2,1,3
Odisha,Dhenkanal,Speech And Language Disability,6,15,35,23,58
Odisha,Dhenkanal,Speech And Language Disability,15,35,24,27,51
Odisha,Dhenkanal,Speech And Language Disability,35,60,29,15,44
Odisha,Dhenkanal,Speech And Language Disability,60,80,7,3,10
Odisha,Dhenkanal,Speech And Language Disability,80,100,1,0,1
Assam,Dhemaji,Speech And Language Disability,0,6,1,2,3
Assam,Dhemaji,Speech And Language Disability,6,15,2,1,3
Assam,Dhemaji,Speech And Language Disability,15,35,7,7,14
Assam,Dhemaji,Speech And Language Disability,35,60,4,8,12
Assam,Dhemaji,Speech And Language Disability,60,80,0,1,1
Karnataka,Dharwad,Speech And Language Disability,0,6,1,0,1
Karnataka,Dharwad,Speech And Language Disability,6,15,3,5,8
Karnataka,Dharwad,Speech And Language Disability,15,35,18,12,30
Karnataka,Dharwad,Speech And Language Disability,35,60,6,4,10
Karnataka,Dharwad,Speech And Language Disability,60,80,1,0,1
Tamil Nadu,Dharmapuri,Speech And Language Disability,15,35,1,3,4
Tamil Nadu,Dharmapuri,Speech And Language Disability,60,80,1,0,1
Madhya Pradesh,Dhar,Speech And Language Disability,6,15,9,6,15
Madhya Pradesh,Dhar,Speech And Language Disability,15,35,35,28,63
Madhya Pradesh,Dhar,Speech And Language Disability,35,60,22,4,26
Madhya Pradesh,Dhar,Speech And Language Disability,60,80,1,2,3
Madhya Pradesh,Dhar,Speech And Language Disability,80,100,1,0,1
Jharkhand,Dhanbad,Speech And Language Disability,6,15,3,2,5
Jharkhand,Dhanbad,Speech And Language Disability,15,35,14,12,26
Jharkhand,Dhanbad,Speech And Language Disability,35,60,8,6,14
Jharkhand,Dhanbad,Speech And Language Disability,60,80,1,0,1
Chhattisgarh,Dhamtari,Speech And Language Disability,6,15,1,1,2
Chhattisgarh,Dhamtari,Speech And Language Disability,15,35,12,8,20
Chhattisgarh,Dhamtari,Speech And Language Disability,35,60,10,3,13
Tripura,Dhalai,Speech And Language Disability,15,35,1,1,2
Tripura,Dhalai,Speech And Language Disability,35,60,1,1,2
Tripura,Dhalai,Speech And Language Disability,60,80,0,1,1
Madhya Pradesh,Dewas,Speech And Language Disability,6,15,2,1,3
Madhya Pradesh,Dewas,Speech And Language Disability,15,35,30,21,51
Madhya Pradesh,Dewas,Speech And Language Disability,35,60,16,6,22
Madhya Pradesh,Dewas,Speech And Language Disability,60,80,2,1,3
Gujarat,Devbhumi Dwarka,Speech And Language Disability,15,35,0,1,1
Gujarat,Devbhumi Dwarka,Speech And Language Disability,35,60,1,0,1
Uttar Pradesh,Deoria,Speech And Language Disability,0,6,4,0,4
Uttar Pradesh,Deoria,Speech And Language Disability,6,15,30,24,54
Uttar Pradesh,Deoria,Speech And Language Disability,15,35,68,51,119
Uttar Pradesh,Deoria,Speech And Language Disability,35,60,29,15,44
Uttar Pradesh,Deoria,Speech And Language Disability,60,80,5,3,8
Jharkhand,Deoghar,Speech And Language Disability,6,15,8,9,17
Jharkhand,Deoghar,Speech And Language Disability,15,35,21,8,29
Jharkhand,Deoghar,Speech And Language Disability,35,60,10,9,19
Jharkhand,Deoghar,Speech And Language Disability,60,80,2,0,2
Odisha,Deogarh,Speech And Language Disability,6,15,1,1,2
Uttarakhand,Dehradun,Speech And Language Disability,0,6,1,0,1
Uttarakhand,Dehradun,Speech And Language Disability,6,15,2,5,7
Uttarakhand,Dehradun,Speech And Language Disability,15,35,8,4,12
Uttarakhand,Dehradun,Speech And Language Disability,35,60,11,1,12
Karnataka,Davangere,Speech And Language Disability,0,6,2,0,2
Karnataka,Davangere,Speech And Language Disability,6,15,7,8,15
Karnataka,Davangere,Speech And Language Disability,15,35,19,19,38
Karnataka,Davangere,Speech And Language Disability,35,60,20,17,37
Karnataka,Davangere,Speech And Language Disability,60,80,5,1,6
Karnataka,Davangere,Speech And Language Disability,80,100,1,1,2
Rajasthan,Dausa,Speech And Language Disability,0,6,1,1,2
Rajasthan,Dausa,Speech And Language Disability,6,15,12,9,21
Rajasthan,Dausa,Speech And Language Disability,15,35,32,9,41
Rajasthan,Dausa,Speech And Language Disability,35,60,16,4,20
Rajasthan,Dausa,Speech And Language Disability,60,80,4,0,4
Madhya Pradesh,Datia,Speech And Language Disability,6,15,0,3,3
Madhya Pradesh,Datia,Speech And Language Disability,15,35,4,6,10
Madhya Pradesh,Datia,Speech And Language Disability,35,60,5,5,10
Madhya Pradesh,Datia,Speech And Language Disability,60,80,2,1,3
Assam,Darrang,Speech And Language Disability,6,15,6,5,11
Assam,Darrang,Speech And Language Disability,15,35,5,12,17
Assam,Darrang,Speech And Language Disability,35,60,9,8,17
Assam,Darrang,Speech And Language Disability,60,80,0,1,1
Bihar,Darbhanga,Speech And Language Disability,0,6,1,1,2
Bihar,Darbhanga,Speech And Language Disability,6,15,19,22,41
Bihar,Darbhanga,Speech And Language Disability,15,35,40,36,76
Bihar,Darbhanga,Speech And Language Disability,35,60,18,10,28
Bihar,Darbhanga,Speech And Language Disability,60,80,0,1,1
Chhattisgarh,Dantewada,Speech And Language Disability,6,15,6,0,6
Chhattisgarh,Dantewada,Speech And Language Disability,15,35,8,7,15
Chhattisgarh,Dantewada,Speech And Language Disability,35,60,2,1,3
Gujarat,Dang,Speech And Language Disability,6,15,1,0,1
Gujarat,Dang,Speech And Language Disability,15,35,3,1,4
Gujarat,Dang,Speech And Language Disability,35,60,2,0,2
Madhya Pradesh,Damoh,Speech And Language Disability,6,15,9,4,13
Madhya Pradesh,Damoh,Speech And Language Disability,15,35,23,10,33
Madhya Pradesh,Damoh,Speech And Language Disability,35,60,15,6,21
Madhya Pradesh,Damoh,Speech And Language Disability,60,80,3,0,3
Dadra Nagar Haveli And Daman And Diu,Daman,Speech And Language Disability,6,15,0,1,1
Dadra Nagar Haveli And Daman And Diu,Daman,Speech And Language Disability,15,35,2,1,3
Dadra Nagar Haveli And Daman And Diu,Daman,Speech And Language Disability,35,60,1,0,1
Dadra Nagar Haveli And Daman And Diu,Daman,Speech And Language Disability,60,80,1,0,1
Karnataka,Dakshina Kannada,Speech And Language Disability,0,6,1,1,2
Karnataka,Dakshina Kannada,Speech And Language Disability,6,15,15,9,24
Karnataka,Dakshina Kannada,Speech And Language Disability,15,35,37,29,66
Karnataka,Dakshina Kannada,Speech And Language Disability,35,60,25,23,48
Karnataka,Dakshina Kannada,Speech And Language Disability,60,80,6,1,7
Dadra Nagar Haveli And Daman And Diu,Dadra And Nagar Haveli,Speech And Language Disability,35,60,1,0,1
Odisha,Cuttack,Speech And Language Disability,0,6,7,4,11
Odisha,Cuttack,Speech And Language Disability,6,15,56,30,86
Odisha,Cuttack,Speech And Language Disability,15,35,42,30,72
Odisha,Cuttack,Speech And Language Disability,35,60,30,12,42
Odisha,Cuttack,Speech And Language Disability,60,80,4,0,4
Tamil Nadu,Cuddalore,Speech And Language Disability,0,6,0,2,2
Tamil Nadu,Cuddalore,Speech And Language Disability,6,15,2,1,3
Tamil Nadu,Cuddalore,Speech And Language Disability,15,35,2,1,3
Tamil Nadu,Cuddalore,Speech And Language Disability,35,60,3,4,7
Tamil Nadu,Coimbatore,Speech And Language Disability,6,15,5,2,7
Tamil Nadu,Coimbatore,Speech And Language Disability,15,35,9,3,12
Tamil Nadu,Coimbatore,Speech And Language Disability,35,60,2,3,5
Tamil Nadu,Coimbatore,Speech And Language Disability,60,80,0,1,1
Rajasthan,Churu,Speech And Language Disability,6,15,0,1,1
Rajasthan,Churu,Speech And Language Disability,15,35,1,2,3
Rajasthan,Churu,Speech And Language Disability,35,60,2,0,2
Manipur,Churachandpur,Speech And Language Disability,0,6,1,0,1
Manipur,Churachandpur,Speech And Language Disability,6,15,1,1,2
Manipur,Churachandpur,Speech And Language Disability,15,35,3,3,6
Manipur,Churachandpur,Speech And Language Disability,35,60,0,3,3
Rajasthan,Chittorgarh,Speech And Language Disability,0,6,0,1,1
Rajasthan,Chittorgarh,Speech And Language Disability,6,15,9,7,16
Rajasthan,Chittorgarh,Speech And Language Disability,15,35,25,6,31
Rajasthan,Chittorgarh,Speech And Language Disability,35,60,11,2,13
Rajasthan,Chittorgarh,Speech And Language Disability,60,80,3,0,3
Uttar Pradesh,Chitrakoot,Speech And Language Disability,0,6,10,3,13
Uttar Pradesh,Chitrakoot,Speech And Language Disability,6,15,36,26,62
Uttar Pradesh,Chitrakoot,Speech And Language Disability,15,35,39,19,58
Uttar Pradesh,Chitrakoot,Speech And Language Disability,35,60,16,14,30
Uttar Pradesh,Chitrakoot,Speech And Language Disability,60,80,3,1,4
Karnataka,Chitradurga,Speech And Language Disability,0,6,7,6,13
Karnataka,Chitradurga,Speech And Language Disability,6,15,40,36,76
Karnataka,Chitradurga,Speech And Language Disability,15,35,111,59,170
Karnataka,Chitradurga,Speech And Language Disability,35,60,79,42,121
Karnataka,Chitradurga,Speech And Language Disability,60,80,9,3,12
Karnataka,Chitradurga,Speech And Language Disability,80,100,1,1,2
Assam,Chirang,Speech And Language Disability,0,6,0,1,1
Assam,Chirang,Speech And Language Disability,6,15,16,5,21
Assam,Chirang,Speech And Language Disability,15,35,16,15,31
Assam,Chirang,Speech And Language Disability,35,60,10,10,20
Karnataka,Chikkamagaluru,Speech And Language Disability,6,15,8,11,19
Karnataka,Chikkamagaluru,Speech And Language Disability,15,35,26,18,44
Karnataka,Chikkamagaluru,Speech And Language Disability,35,60,31,20,51
Karnataka,Chikkamagaluru,Speech And Language Disability,60,80,7,4,11
Karnataka,Chikkaballapura,Speech And Language Disability,0,6,0,1,1
Karnataka,Chikkaballapura,Speech And Language Disability,6,15,15,14,29
Karnataka,Chikkaballapura,Speech And Language Disability,15,35,32,19,51
Karnataka,Chikkaballapura,Speech And Language Disability,35,60,33,27,60
Karnataka,Chikkaballapura,Speech And Language Disability,60,80,10,3,13
Karnataka,Chikkaballapura,Speech And Language Disability,80,100,1,0,1
Gujarat,Chhotaudepur,Speech And Language Disability,6,15,1,0,1
Gujarat,Chhotaudepur,Speech And Language Disability,15,35,1,7,8
Gujarat,Chhotaudepur,Speech And Language Disability,35,60,5,0,5
Madhya Pradesh,Chhindwara,Speech And Language Disability,0,6,3,3,6
Madhya Pradesh,Chhindwara,Speech And Language Disability,6,15,12,10,22
Madhya Pradesh,Chhindwara,Speech And Language Disability,15,35,46,31,77
Madhya Pradesh,Chhindwara,Speech And Language Disability,35,60,24,16,40
Madhya Pradesh,Chhindwara,Speech And Language Disability,60,80,6,4,10
Madhya Pradesh,Chhatarpur,Speech And Language Disability,6,15,10,12,22
Madhya Pradesh,Chhatarpur,Speech And Language Disability,15,35,46,20,66
Madhya Pradesh,Chhatarpur,Speech And Language Disability,35,60,25,12,37
Madhya Pradesh,Chhatarpur,Speech And Language Disability,60,80,2,3,5
Madhya Pradesh,Chhatarpur,Speech And Language Disability,80,100,1,0,1
Tamil Nadu,Chennai,Speech And Language Disability,6,15,7,2,9
Tamil Nadu,Chennai,Speech And Language Disability,15,35,11,6,17
Tamil Nadu,Chennai,Speech And Language Disability,35,60,11,3,14
Tamil Nadu,Chennai,Speech And Language Disability,60,80,4,0,4
Tamil Nadu,Chengalpattu,Speech And Language Disability,0,6,1,0,1
Tamil Nadu,Chengalpattu,Speech And Language Disability,6,15,3,0,3
Tamil Nadu,Chengalpattu,Speech And Language Disability,15,35,2,1,3
Tamil Nadu,Chengalpattu,Speech And Language Disability,35,60,3,0,3
Tamil Nadu,Chengalpattu,Speech And Language Disability,60,80,1,0,1
Jharkhand,Chatra,Speech And Language Disability,0,6,1,0,1
Jharkhand,Chatra,Speech And Language Disability,6,15,11,7,18
Jharkhand,Chatra,Speech And Language Disability,15,35,3,6,9
Jharkhand,Chatra,Speech And Language Disability,35,60,4,1,5
Haryana,Charki Dadri,Speech And Language Disability,6,15,0,1,1
Haryana,Charki Dadri,Speech And Language Disability,15,35,1,0,1
Haryana,Charki Dadri,Speech And Language Disability,35,60,1,0,1
Assam,Charaideo,Speech And Language Disability,0,6,2,1,3
Assam,Charaideo,Speech And Language Disability,6,15,1,1,2
Assam,Charaideo,Speech And Language Disability,15,35,4,6,10
Assam,Charaideo,Speech And Language Disability,35,60,1,3,4
Chandigarh,Chandigarh,Speech And Language Disability,6,15,3,4,7
Chandigarh,Chandigarh,Speech And Language Disability,15,35,5,0,5
Chandigarh,Chandigarh,Speech And Language Disability,35,60,7,0,7
Uttar Pradesh,Chandauli,Speech And Language Disability,0,6,1,0,1
Uttar Pradesh,Chandauli,Speech And Language Disability,6,15,9,6,15
Uttar Pradesh,Chandauli,Speech And Language Disability,15,35,53,33,86
Uttar Pradesh,Chandauli,Speech And Language Disability,35,60,28,12,40
Uttar Pradesh,Chandauli,Speech And Language Disability,60,80,1,2,3
Mizoram,Champhai,Speech And Language Disability,6,15,0,1,1
Uttarakhand,Champawat,Speech And Language Disability,15,35,5,6,11
Uttarakhand,Champawat,Speech And Language Disability,35,60,9,3,12
Uttarakhand,Champawat,Speech And Language Disability,60,80,2,1,3
Uttarakhand,Chamoli,Speech And Language Disability,0,6,1,0,1
Uttarakhand,Chamoli,Speech And Language Disability,6,15,7,3,10
Uttarakhand,Chamoli,Speech And Language Disability,15,35,12,14,26
Uttarakhand,Chamoli,Speech And Language Disability,35,60,24,14,38
Uttarakhand,Chamoli,Speech And Language Disability,60,80,7,5,12
Himachal Pradesh,Chamba,Speech And Language Disability,0,6,2,2,4
Himachal Pradesh,Chamba,Speech And Language Disability,6,15,2,2,4
Himachal Pradesh,Chamba,Speech And Language Disability,15,35,1,0,1
Himachal Pradesh,Chamba,Speech And Language Disability,35,60,2,2,4
Himachal Pradesh,Chamba,Speech And Language Disability,60,80,3,0,3
Karnataka,Chamarajanagara,Speech And Language Disability,0,6,0,1,1
Karnataka,Chamarajanagara,Speech And Language Disability,6,15,5,8,13
Karnataka,Chamarajanagara,Speech And Language Disability,15,35,11,13,24
Karnataka,Chamarajanagara,Speech And Language Disability,35,60,21,13,34
Karnataka,Chamarajanagara,Speech And Language Disability,60,80,2,2,4
Delhi,Central,Speech And Language Disability,6,15,2,0,2
Delhi,Central,Speech And Language Disability,15,35,1,1,2
Delhi,Central,Speech And Language Disability,60,80,1,0,1
Assam,Cachar,Speech And Language Disability,0,6,7,3,10
Assam,Cachar,Speech And Language Disability,6,15,23,16,39
Assam,Cachar,Speech And Language Disability,15,35,39,38,77
Assam,Cachar,Speech And Language Disability,35,60,19,8,27
Assam,Cachar,Speech And Language Disability,60,80,3,0,3
Bihar,Buxar,Speech And Language Disability,6,15,4,3,7
Bihar,Buxar,Speech And Language Disability,15,35,8,8,16
Bihar,Buxar,Speech And Language Disability,35,60,7,3,10
Bihar,Buxar,Speech And Language Disability,60,80,2,0,2
Madhya Pradesh,Burhanpur,Speech And Language Disability,6,15,8,7,15
Madhya Pradesh,Burhanpur,Speech And Language Disability,15,35,12,7,19
Madhya Pradesh,Burhanpur,Speech And Language Disability,35,60,5,2,7
Madhya Pradesh,Burhanpur,Speech And Language Disability,60,80,0,1,1
Rajasthan,Bundi,Speech And Language Disability,6,15,5,1,6
Rajasthan,Bundi,Speech And Language Disability,15,35,23,8,31
Rajasthan,Bundi,Speech And Language Disability,35,60,12,2,14
Rajasthan,Bundi,Speech And Language Disability,60,80,0,2,2
Maharashtra,Buldhana,Speech And Language Disability,0,6,3,3,6
Maharashtra,Buldhana,Speech And Language Disability,6,15,44,25,69
Maharashtra,Buldhana,Speech And Language Disability,15,35,132,48,180
Maharashtra,Buldhana,Speech And Language Disability,35,60,96,36,132
Maharashtra,Buldhana,Speech And Language Disability,60,80,15,3,18
Maharashtra,Buldhana,Speech And Language Disability,80,100,2,0,2
Uttar Pradesh,Bulandshahr,Speech And Language Disability,0,6,1,0,1
Uttar Pradesh,Bulandshahr,Speech And Language Disability,6,15,0,4,4
Uttar Pradesh,Bulandshahr,Speech And Language Disability,15,35,17,2,19
Uttar Pradesh,Bulandshahr,Speech And Language Disability,35,60,12,2,14
Uttar Pradesh,Bulandshahr,Speech And Language Disability,60,80,1,1,2
Jammu And Kashmir,Budgam,Speech And Language Disability,0,6,0,2,2
Jammu And Kashmir,Budgam,Speech And Language Disability,6,15,4,7,11
Jammu And Kashmir,Budgam,Speech And Language Disability,15,35,16,8,24
Jammu And Kashmir,Budgam,Speech And Language Disability,35,60,5,11,16
Uttar Pradesh,Budaun,Speech And Language Disability,0,6,6,3,9
Uttar Pradesh,Budaun,Speech And Language Disability,6,15,108,87,195
Uttar Pradesh,Budaun,Speech And Language Disability,15,35,84,51,135
Uttar Pradesh,Budaun,Speech And Language Disability,35,60,32,20,52
Uttar Pradesh,Budaun,Speech And Language Disability,60,80,7,4,11
Odisha,Boudh,Speech And Language Disability,0,6,2,3,5
Odisha,Boudh,Speech And Language Disability,6,15,22,18,40
Odisha,Boudh,Speech And Language Disability,15,35,10,11,21
Odisha,Boudh,Speech And Language Disability,35,60,9,2,11
Odisha,Boudh,Speech And Language Disability,60,80,1,1,2
Gujarat,Botad,Speech And Language Disability,0,6,2,0,2
Gujarat,Botad,Speech And Language Disability,6,15,7,5,12
Gujarat,Botad,Speech And Language Disability,15,35,10,2,12
Gujarat,Botad,Speech And Language Disability,35,60,2,0,2
Gujarat,Botad,Speech And Language Disability,60,80,2,0,2
Assam,Bongaigaon,Speech And Language Disability,0,6,5,2,7
Assam,Bongaigaon,Speech And Language Disability,6,15,13,5,18
Assam,Bongaigaon,Speech And Language Disability,15,35,9,9,18
Assam,Bongaigaon,Speech And Language Disability,35,60,5,8,13
Assam,Bongaigaon,Speech And Language Disability,60,80,1,0,1
Jharkhand,Bokaro,Speech And Language Disability,0,6,1,1,2
Jharkhand,Bokaro,Speech And Language Disability,6,15,23,16,39
Jharkhand,Bokaro,Speech And Language Disability,15,35,192,147,339
Jharkhand,Bokaro,Speech And Language Disability,35,60,115,59,174
Jharkhand,Bokaro,Speech And Language Disability,60,80,6,4,10
Assam,Biswanath,Speech And Language Disability,0,6,1,0,1
Assam,Biswanath,Speech And Language Disability,15,35,0,1,1
Assam,Biswanath,Speech And Language Disability,35,60,3,0,3
Assam,Biswanath,Speech And Language Disability,60,80,1,0,1
Manipur,Bishnupur,Speech And Language Disability,6,15,1,1,2
Manipur,Bishnupur,Speech And Language Disability,15,35,2,0,2
Manipur,Bishnupur,Speech And Language Disability,35,60,1,0,1
Chhattisgarh,Bilaspur,Speech And Language Disability,6,15,4,2,6
Chhattisgarh,Bilaspur,Speech And Language Disability,15,35,3,3,6
Chhattisgarh,Bilaspur,Speech And Language Disability,35,60,1,1,2
Himachal Pradesh,Bilaspur,Speech And Language Disability,0,6,1,0,1
Himachal Pradesh,Bilaspur,Speech And Language Disability,6,15,1,2,3
Himachal Pradesh,Bilaspur,Speech And Language Disability,15,35,4,2,6
Himachal Pradesh,Bilaspur,Speech And Language Disability,35,60,4,1,5
Himachal Pradesh,Bilaspur,Speech And Language Disability,60,80,1,0,1
Rajasthan,Bikaner,Speech And Language Disability,6,15,4,2,6
Rajasthan,Bikaner,Speech And Language Disability,15,35,10,2,12
Rajasthan,Bikaner,Speech And Language Disability,35,60,6,0,6
Rajasthan,Bikaner,Speech And Language Disability,60,80,1,0,1
Uttar Pradesh,Bijnor,Speech And Language Disability,0,6,17,4,21
Uttar Pradesh,Bijnor,Speech And Language Disability,6,15,34,25,59
Uttar Pradesh,Bijnor,Speech And Language Disability,15,35,99,52,151
Uttar Pradesh,Bijnor,Speech And Language Disability,35,60,35,19,54
Uttar Pradesh,Bijnor,Speech And Language Disability,60,80,5,2,7
Uttar Pradesh,Bijnor,Speech And Language Disability,80,100,1,0,1
Chhattisgarh,Bijapur,Speech And Language Disability,0,6,1,3,4
Chhattisgarh,Bijapur,Speech And Language Disability,6,15,15,14,29
Chhattisgarh,Bijapur,Speech And Language Disability,15,35,23,19,42
Chhattisgarh,Bijapur,Speech And Language Disability,35,60,4,7,11
Chhattisgarh,Bijapur,Speech And Language Disability,60,80,1,1,2
Karnataka,Bidar,Speech And Language Disability,0,6,6,4,10
Karnataka,Bidar,Speech And Language Disability,6,15,35,36,71
Karnataka,Bidar,Speech And Language Disability,15,35,67,57,124
Karnataka,Bidar,Speech And Language Disability,35,60,40,24,64
Karnataka,Bidar,Speech And Language Disability,60,80,9,2,11
Madhya Pradesh,Bhopal,Speech And Language Disability,0,6,1,0,1
Madhya Pradesh,Bhopal,Speech And Language Disability,6,15,13,7,20
Madhya Pradesh,Bhopal,Speech And Language Disability,15,35,34,18,52
Madhya Pradesh,Bhopal,Speech And Language Disability,35,60,26,14,40
Madhya Pradesh,Bhopal,Speech And Language Disability,60,80,4,3,7
Bihar,Bhojpur,Speech And Language Disability,0,6,2,1,3
Bihar,Bhojpur,Speech And Language Disability,6,15,17,10,27
Bihar,Bhojpur,Speech And Language Disability,15,35,27,20,47
Bihar,Bhojpur,Speech And Language Disability,35,60,14,5,19
Bihar,Bhojpur,Speech And Language Disability,60,80,0,1,1
Haryana,Bhiwani,Speech And Language Disability,6,15,1,0,1
Haryana,Bhiwani,Speech And Language Disability,15,35,6,4,10
Haryana,Bhiwani,Speech And Language Disability,35,60,9,4,13
Madhya Pradesh,Bhind,Speech And Language Disability,6,15,1,0,1
Madhya Pradesh,Bhind,Speech And Language Disability,15,35,15,5,20
Madhya Pradesh,Bhind,Speech And Language Disability,35,60,2,0,2
Rajasthan,Bhilwara,Speech And Language Disability,6,15,17,14,31
Rajasthan,Bhilwara,Speech And Language Disability,15,35,49,27,76
Rajasthan,Bhilwara,Speech And Language Disability,35,60,25,11,36
Rajasthan,Bhilwara,Speech And Language Disability,60,80,8,1,9
Rajasthan,Bhilwara,Speech And Language Disability,80,100,0,1,1
Gujarat,Bhavnagar,Speech And Language Disability,60,80,1,0,1
Gujarat,Bharuch,Speech And Language Disability,6,15,2,1,3
Gujarat,Bharuch,Speech And Language Disability,15,35,4,0,4
Gujarat,Bharuch,Speech And Language Disability,35,60,2,1,3
Rajasthan,Bharatpur,Speech And Language Disability,6,15,3,1,4
Rajasthan,Bharatpur,Speech And Language Disability,15,35,9,1,10
Rajasthan,Bharatpur,Speech And Language Disability,35,60,7,0,7
Rajasthan,Bharatpur,Speech And Language Disability,60,80,2,0,2
Maharashtra,Bhandara,Speech And Language Disability,6,15,1,0,1
Maharashtra,Bhandara,Speech And Language Disability,15,35,2,2,4
Maharashtra,Bhandara,Speech And Language Disability,35,60,1,1,2
Bihar,Bhagalpur,Speech And Language Disability,0,6,3,0,3
Bihar,Bhagalpur,Speech And Language Disability,6,15,15,13,28
Bihar,Bhagalpur,Speech And Language Disability,15,35,24,11,35
Bihar,Bhagalpur,Speech And Language Disability,35,60,10,2,12
Bihar,Bhagalpur,Speech And Language Disability,60,80,2,0,2
Odisha,Bhadrak,Speech And Language Disability,0,6,8,1,9
Odisha,Bhadrak,Speech And Language Disability,6,15,39,18,57
Odisha,Bhadrak,Speech And Language Disability,15,35,24,17,41
Odisha,Bhadrak,Speech And Language Disability,35,60,16,9,25
Odisha,Bhadrak,Speech And Language Disability,60,80,2,0,2
Madhya Pradesh,Betul,Speech And Language Disability,0,6,1,1,2
Madhya Pradesh,Betul,Speech And Language Disability,6,15,9,8,17
Madhya Pradesh,Betul,Speech And Language Disability,15,35,18,9,27
Madhya Pradesh,Betul,Speech And Language Disability,35,60,10,5,15
Madhya Pradesh,Betul,Speech And Language Disability,60,80,1,0,1
Karnataka,Bengaluru Urban,Speech And Language Disability,0,6,2,1,3
Karnataka,Bengaluru Urban,Speech And Language Disability,6,15,7,3,10
Karnataka,Bengaluru Urban,Speech And Language Disability,15,35,15,9,24
Karnataka,Bengaluru Urban,Speech And Language Disability,35,60,12,2,14
Karnataka,Bengaluru Urban,Speech And Language Disability,60,80,7,2,9
Karnataka,Bengaluru Rural,Speech And Language Disability,0,6,1,0,1
Karnataka,Bengaluru Rural,Speech And Language Disability,6,15,7,8,15
Karnataka,Bengaluru Rural,Speech And Language Disability,15,35,7,3,10
Karnataka,Bengaluru Rural,Speech And Language Disability,35,60,10,4,14
Karnataka,Bengaluru Rural,Speech And Language Disability,60,80,0,1,1
Chhattisgarh,Bemetara,Speech And Language Disability,15,35,1,2,3
Chhattisgarh,Bemetara,Speech And Language Disability,35,60,1,0,1
Karnataka,Belagavi,Speech And Language Disability,0,6,10,5,15
Karnataka,Belagavi,Speech And Language Disability,6,15,108,72,180
Karnataka,Belagavi,Speech And Language Disability,15,35,137,102,239
Karnataka,Belagavi,Speech And Language Disability,35,60,110,50,160
Karnataka,Belagavi,Speech And Language Disability,60,80,10,4,14
Bihar,Begusarai,Speech And Language Disability,0,6,6,9,15
Bihar,Begusarai,Speech And Language Disability,6,15,67,39,106
Bihar,Begusarai,Speech And Language Disability,15,35,58,34,92
Bihar,Begusarai,Speech And Language Disability,35,60,13,9,22
Bihar,Begusarai,Speech And Language Disability,60,80,2,0,2
Maharashtra,Beed,Speech And Language Disability,0,6,1,3,4
Maharashtra,Beed,Speech And Language Disability,6,15,16,5,21
Maharashtra,Beed,Speech And Language Disability,15,35,35,14,49
Maharashtra,Beed,Speech And Language Disability,35,60,17,4,21
Maharashtra,Beed,Speech And Language Disability,60,80,5,2,7
Punjab,Bathinda,Speech And Language Disability,6,15,3,2,5
Punjab,Bathinda,Speech And Language Disability,15,35,17,3,20
Punjab,Bathinda,Speech And Language Disability,35,60,10,7,17
Punjab,Bathinda,Speech And Language Disability,60,80,2,1,3
Uttar Pradesh,Basti,Speech And Language Disability,0,6,1,1,2
Uttar Pradesh,Basti,Speech And Language Disability,6,15,4,2,6
Uttar Pradesh,Basti,Speech And Language Disability,15,35,9,10,19
Uttar Pradesh,Basti,Speech And Language Disability,35,60,3,1,4
Chhattisgarh,Bastar,Speech And Language Disability,6,15,11,6,17
Chhattisgarh,Bastar,Speech And Language Disability,15,35,16,6,22
Chhattisgarh,Bastar,Speech And Language Disability,35,60,3,0,3
Madhya Pradesh,Barwani,Speech And Language Disability,6,15,1,3,4
Madhya Pradesh,Barwani,Speech And Language Disability,15,35,18,10,28
Madhya Pradesh,Barwani,Speech And Language Disability,35,60,5,3,8
Madhya Pradesh,Barwani,Speech And Language Disability,60,80,2,0,2
Assam,Barpeta,Speech And Language Disability,0,6,2,2,4
Assam,Barpeta,Speech And Language Disability,6,15,14,15,29
Assam,Barpeta,Speech And Language Disability,15,35,38,33,71
Assam,Barpeta,Speech And Language Disability,35,60,32,14,46
Assam,Barpeta,Speech And Language Disability,60,80,5,2,7
Assam,Barpeta,Speech And Language Disability,80,100,0,1,1
Punjab,Barnala,Speech And Language Disability,0,6,0,3,3
Punjab,Barnala,Speech And Language Disability,6,15,6,8,14
Punjab,Barnala,Speech And Language Disability,15,35,18,17,35
Punjab,Barnala,Speech And Language Disability,35,60,10,12,22
Punjab,Barnala,Speech And Language Disability,60,80,1,1,2
Rajasthan,Barmer,Speech And Language Disability,0,6,1,0,1
Rajasthan,Barmer,Speech And Language Disability,6,15,20,3,23
Rajasthan,Barmer,Speech And Language Disability,15,35,39,14,53
Rajasthan,Barmer,Speech And Language Disability,35,60,17,3,20
Rajasthan,Barmer,Speech And Language Disability,60,80,1,0,1
Odisha,Bargarh,Speech And Language Disability,0,6,0,2,2
Odisha,Bargarh,Speech And Language Disability,6,15,9,8,17
Odisha,Bargarh,Speech And Language Disability,15,35,18,11,29
Odisha,Bargarh,Speech And Language Disability,35,60,5,7,12
Odisha,Bargarh,Speech And Language Disability,60,80,1,1,2
Uttar Pradesh,Bareilly,Speech And Language Disability,0,6,0,1,1
Uttar Pradesh,Bareilly,Speech And Language Disability,6,15,19,10,29
Uttar Pradesh,Bareilly,Speech And Language Disability,15,35,50,37,87
Uttar Pradesh,Bareilly,Speech And Language Disability,35,60,24,14,38
Uttar Pradesh,Bareilly,Speech And Language Disability,60,80,1,1,2
Uttar Pradesh,Bareilly,Speech And Language Disability,80,100,1,0,1
Rajasthan,Baran,Speech And Language Disability,6,15,2,1,3
Rajasthan,Baran,Speech And Language Disability,15,35,4,0,4
Rajasthan,Baran,Speech And Language Disability,35,60,2,0,2
Jammu And Kashmir,Baramulla,Speech And Language Disability,0,6,4,4,8
Jammu And Kashmir,Baramulla,Speech And Language Disability,6,15,20,9,29
Jammu And Kashmir,Baramulla,Speech And Language Disability,15,35,44,20,64
Jammu And Kashmir,Baramulla,Speech And Language Disability,35,60,22,16,38
Jammu And Kashmir,Baramulla,Speech And Language Disability,60,80,3,1,4
Jammu And Kashmir,Baramulla,Speech And Language Disability,80,100,1,0,1
Uttar Pradesh,Barabanki,Speech And Language Disability,0,6,1,2,3
Uttar Pradesh,Barabanki,Speech And Language Disability,6,15,21,31,52
Uttar Pradesh,Barabanki,Speech And Language Disability,15,35,58,37,95
Uttar Pradesh,Barabanki,Speech And Language Disability,35,60,23,12,35
Uttar Pradesh,Barabanki,Speech And Language Disability,60,80,2,0,2
Rajasthan,Banswara,Speech And Language Disability,0,6,0,1,1
Rajasthan,Banswara,Speech And Language Disability,6,15,8,4,12
Rajasthan,Banswara,Speech And Language Disability,15,35,10,2,12
Rajasthan,Banswara,Speech And Language Disability,35,60,7,1,8
Bihar,Banka,Speech And Language Disability,0,6,1,0,1
Bihar,Banka,Speech And Language Disability,6,15,23,12,35
Bihar,Banka,Speech And Language Disability,15,35,36,21,57
Bihar,Banka,Speech And Language Disability,35,60,18,10,28
Bihar,Banka,Speech And Language Disability,60,80,4,1,5
Jammu And Kashmir,Bandipora,Speech And Language Disability,0,6,3,2,5
Jammu And Kashmir,Bandipora,Speech And Language Disability,6,15,12,15,27
Jammu And Kashmir,Bandipora,Speech And Language Disability,15,35,42,30,72
Jammu And Kashmir,Bandipora,Speech And Language Disability,35,60,19,11,30
Jammu And Kashmir,Bandipora,Speech And Language Disability,60,80,7,2,9
Uttar Pradesh,Banda,Speech And Language Disability,6,15,4,3,7
Uttar Pradesh,Banda,Speech And Language Disability,15,35,36,18,54
Uttar Pradesh,Banda,Speech And Language Disability,35,60,31,9,40
Uttar Pradesh,Banda,Speech And Language Disability,60,80,3,1,4
Uttar Pradesh,Banda,Speech And Language Disability,80,100,1,0,1
Gujarat,Banas Kantha,Speech And Language Disability,15,35,3,1,4
Gujarat,Banas Kantha,Speech And Language Disability,35,60,1,0,1
Gujarat,Banas Kantha,Speech And Language Disability,60,80,1,0,1
Chhattisgarh,Balrampur,Speech And Language Disability,6,15,5,10,15
Chhattisgarh,Balrampur,Speech And Language Disability,15,35,24,18,42
Chhattisgarh,Balrampur,Speech And Language Disability,35,60,4,5,9
Chhattisgarh,Balrampur,Speech And Language Disability,60,80,1,0,1
Chhattisgarh,Balrampur,Speech And Language Disability,80,100,0,1,1
Uttar Pradesh,Balrampur,Speech And Language Disability,6,15,3,2,5
Uttar Pradesh,Balrampur,Speech And Language Disability,15,35,6,5,11
Uttar Pradesh,Balrampur,Speech And Language Disability,35,60,3,0,3
Uttar Pradesh,Balrampur,Speech And Language Disability,60,80,1,0,1
Chhattisgarh,Baloda Bazar,Speech And Language Disability,0,6,6,6,12
Chhattisgarh,Baloda Bazar,Speech And Language Disability,6,15,38,25,63
Chhattisgarh,Baloda Bazar,Speech And Language Disability,15,35,61,61,122
Chhattisgarh,Baloda Bazar,Speech And Language Disability,35,60,30,20,50
Chhattisgarh,Baloda Bazar,Speech And Language Disability,60,80,1,2,3
Chhattisgarh,Balod,Speech And Language Disability,15,35,1,0,1
Uttar Pradesh,Ballia,Speech And Language Disability,6,15,3,4,7
Uttar Pradesh,Ballia,Speech And Language Disability,15,35,52,30,82
Uttar Pradesh,Ballia,Speech And Language Disability,35,60,32,10,42
Uttar Pradesh,Ballia,Speech And Language Disability,60,80,1,3,4
Karnataka,Ballari,Speech And Language Disability,0,6,2,1,3
Karnataka,Ballari,Speech And Language Disability,6,15,25,20,45
Karnataka,Ballari,Speech And Language Disability,15,35,62,44,106
Karnataka,Ballari,Speech And Language Disability,35,60,40,18,58
Karnataka,Ballari,Speech And Language Disability,60,80,2,6,8
Odisha,Baleshwar,Speech And Language Disability,0,6,15,21,36
Odisha,Baleshwar,Speech And Language Disability,6,15,84,72,156
Odisha,Baleshwar,Speech And Language Disability,15,35,135,67,202
Odisha,Baleshwar,Speech And Language Disability,35,60,86,34,120
Odisha,Baleshwar,Speech And Language Disability,60,80,16,7,23
Odisha,Baleshwar,Speech And Language Disability,80,100,1,0,1
Odisha,Balangir,Speech And Language Disability,0,6,20,12,32
Odisha,Balangir,Speech And Language Disability,6,15,55,42,97
Odisha,Balangir,Speech And Language Disability,15,35,53,48,101
Odisha,Balangir,Speech And Language Disability,35,60,42,22,64
Odisha,Balangir,Speech And Language Disability,60,80,4,3,7
Madhya Pradesh,Balaghat,Speech And Language Disability,6,15,4,2,6
Madhya Pradesh,Balaghat,Speech And Language Disability,15,35,6,4,10
Madhya Pradesh,Balaghat,Speech And Language Disability,35,60,2,2,4
Assam,Baksa,Speech And Language Disability,0,6,10,3,13
Assam,Baksa,Speech And Language Disability,6,15,45,27,72
Assam,Baksa,Speech And Language Disability,15,35,59,47,106
Assam,Baksa,Speech And Language Disability,35,60,35,26,61
Assam,Baksa,Speech And Language Disability,60,80,2,1,3
Assam,Bajali,Speech And Language Disability,0,6,1,0,1
Assam,Bajali,Speech And Language Disability,6,15,1,0,1
Assam,Bajali,Speech And Language Disability,15,35,1,0,1
Assam,Bajali,Speech And Language Disability,35,60,5,0,5
Uttar Pradesh,Bahraich,Speech And Language Disability,6,15,6,3,9
Uttar Pradesh,Bahraich,Speech And Language Disability,15,35,12,4,16
Uttar Pradesh,Bahraich,Speech And Language Disability,35,60,6,1,7
Uttar Pradesh,Bahraich,Speech And Language Disability,60,80,0,2,2
Uttar Pradesh,Baghpat,Speech And Language Disability,6,15,2,0,2
Uttar Pradesh,Baghpat,Speech And Language Disability,15,35,8,3,11
Uttar Pradesh,Baghpat,Speech And Language Disability,35,60,10,2,12
Uttar Pradesh,Baghpat,Speech And Language Disability,60,80,1,0,1
Uttarakhand,Bageshwar,Speech And Language Disability,6,15,1,1,2
Uttarakhand,Bageshwar,Speech And Language Disability,15,35,7,4,11
Uttarakhand,Bageshwar,Speech And Language Disability,35,60,6,2,8
Uttarakhand,Bageshwar,Speech And Language Disability,60,80,1,1,2
Karnataka,Bagalkote,Speech And Language Disability,0,6,0,1,1
Karnataka,Bagalkote,Speech And Language Disability,6,15,19,14,33
Karnataka,Bagalkote,Speech And Language Disability,15,35,22,22,44
Karnataka,Bagalkote,Speech And Language Disability,35,60,23,6,29
Karnataka,Bagalkote,Speech And Language Disability,60,80,3,1,4
Uttar Pradesh,Azamgarh,Speech And Language Disability,0,6,2,0,2
Uttar Pradesh,Azamgarh,Speech And Language Disability,6,15,2,3,5
Uttar Pradesh,Azamgarh,Speech And Language Disability,15,35,4,5,9
Uttar Pradesh,Azamgarh,Speech And Language Disability,35,60,5,3,8
Uttar Pradesh,Ayodhya,Speech And Language Disability,0,6,2,2,4
Uttar Pradesh,Ayodhya,Speech And Language Disability,6,15,7,5,12
Uttar Pradesh,Ayodhya,Speech And Language Disability,15,35,24,13,37
Uttar Pradesh,Ayodhya,Speech And Language Disability,35,60,14,10,24
Uttar Pradesh,Ayodhya,Speech And Language Disability,60,80,2,3,5
Bihar,Aurangabad,Speech And Language Disability,6,15,2,3,5
Bihar,Aurangabad,Speech And Language Disability,15,35,12,8,20
Bihar,Aurangabad,Speech And Language Disability,35,60,2,4,6
Maharashtra,Aurangabad,Speech And Language Disability,6,15,1,1,2
Maharashtra,Aurangabad,Speech And Language Disability,15,35,1,0,1
Maharashtra,Aurangabad,Speech And Language Disability,35,60,2,1,3
Uttar Pradesh,Auraiya,Speech And Language Disability,0,6,1,0,1
Uttar Pradesh,Auraiya,Speech And Language Disability,6,15,7,8,15
Uttar Pradesh,Auraiya,Speech And Language Disability,15,35,22,7,29
Uttar Pradesh,Auraiya,Speech And Language Disability,35,60,6,4,10
Uttar Pradesh,Auraiya,Speech And Language Disability,60,80,0,1,1
Madhya Pradesh,Ashoknagar,Speech And Language Disability,15,35,0,1,1
Madhya Pradesh,Ashoknagar,Speech And Language Disability,35,60,2,0,2
Bihar,Arwal,Speech And Language Disability,6,15,0,1,1
Bihar,Arwal,Speech And Language Disability,15,35,2,0,2
Bihar,Arwal,Speech And Language Disability,35,60,1,0,1
Gujarat,Arvalli,Speech And Language Disability,15,35,1,0,1
Gujarat,Arvalli,Speech And Language Disability,35,60,0,1,1
Tamil Nadu,Ariyalur,Speech And Language Disability,6,15,4,2,6
Tamil Nadu,Ariyalur,Speech And Language Disability,15,35,3,1,4
Tamil Nadu,Ariyalur,Speech And Language Disability,35,60,3,1,4
Tamil Nadu,Ariyalur,Speech And Language Disability,60,80,0,1,1
Bihar,Araria,Speech And Language Disability,0,6,0,3,3
Bihar,Araria,Speech And Language Disability,6,15,21,14,35
Bihar,Araria,Speech And Language Disability,15,35,8,6,14
Bihar,Araria,Speech And Language Disability,35,60,3,1,4
Bihar,Araria,Speech And Language Disability,60,80,2,0,2
Madhya Pradesh,Anuppur,Speech And Language Disability,6,15,11,9,20
Madhya Pradesh,Anuppur,Speech And Language Disability,15,35,37,24,61
Madhya Pradesh,Anuppur,Speech And Language Disability,35,60,15,9,24
Madhya Pradesh,Anuppur,Speech And Language Disability,60,80,3,1,4
Odisha,Anugul,Speech And Language Disability,0,6,1,0,1
Odisha,Anugul,Speech And Language Disability,6,15,5,5,10
Odisha,Anugul,Speech And Language Disability,15,35,9,4,13
Odisha,Anugul,Speech And Language Disability,35,60,7,4,11
Odisha,Anugul,Speech And Language Disability,60,80,0,1,1
Arunachal Pradesh,Anjaw,Speech And Language Disability,15,35,1,0,1
Jammu And Kashmir,Anantnag,Speech And Language Disability,0,6,4,4,8
Jammu And Kashmir,Anantnag,Speech And Language Disability,6,15,25,16,41
Jammu And Kashmir,Anantnag,Speech And Language Disability,15,35,22,17,39
Jammu And Kashmir,Anantnag,Speech And Language Disability,35,60,14,15,29
Jammu And Kashmir,Anantnag,Speech And Language Disability,60,80,5,3,8
Jammu And Kashmir,Anantnag,Speech And Language Disability,80,100,1,0,1
Andhra Pradesh,Anantapur,Speech And Language Disability,6,15,1,0,1
Gujarat,Anand,Speech And Language Disability,15,35,1,0,1
Gujarat,Anand,Speech And Language Disability,35,60,1,0,1
Gujarat,Anand,Speech And Language Disability,60,80,2,0,2
Uttar Pradesh,Amroha,Speech And Language Disability,6,15,2,0,2
Uttar Pradesh,Amroha,Speech And Language Disability,15,35,10,4,14
Uttar Pradesh,Amroha,Speech And Language Disability,35,60,13,1,14
Uttar Pradesh,Amroha,Speech And Language Disability,60,80,0,1,1
Punjab,Amritsar,Speech And Language Disability,6,15,3,4,7
Punjab,Amritsar,Speech And Language Disability,15,35,15,1,16
Punjab,Amritsar,Speech And Language Disability,35,60,8,2,10
Punjab,Amritsar,Speech And Language Disability,60,80,1,0,1
Gujarat,Amreli,Speech And Language Disability,0,6,2,0,2
Gujarat,Amreli,Speech And Language Disability,6,15,59,17,76
Gujarat,Amreli,Speech And Language Disability,15,35,58,17,75
Gujarat,Amreli,Speech And Language Disability,35,60,2,1,3
Gujarat,Amreli,Speech And Language Disability,60,80,3,1,4
Maharashtra,Amravati,Speech And Language Disability,6,15,1,1,2
Maharashtra,Amravati,Speech And Language Disability,15,35,2,3,5
Maharashtra,Amravati,Speech And Language Disability,35,60,3,3,6
Maharashtra,Amravati,Speech And Language Disability,60,80,1,0,1
Uttar Pradesh,Amethi,Speech And Language Disability,6,15,1,0,1
Uttar Pradesh,Amethi,Speech And Language Disability,15,35,3,8,11
Uttar Pradesh,Amethi,Speech And Language Disability,35,60,5,2,7
Uttar Pradesh,Amethi,Speech And Language Disability,60,80,0,1,1
Uttar Pradesh,Ambedkar Nagar,Speech And Language Disability,6,15,3,0,3
Uttar Pradesh,Ambedkar Nagar,Speech And Language Disability,15,35,19,18,37
Uttar Pradesh,Ambedkar Nagar,Speech And Language Disability,35,60,7,8,15
Uttar Pradesh,Ambedkar Nagar,Speech And Language Disability,60,80,1,0,1
Haryana,Ambala,Speech And Language Disability,0,6,1,0,1
Haryana,Ambala,Speech And Language Disability,6,15,0,1,1
Haryana,Ambala,Speech And Language Disability,15,35,10,0,10
Haryana,Ambala,Speech And Language Disability,35,60,9,4,13
Haryana,Ambala,Speech And Language Disability,60,80,1,0,1
Rajasthan,Alwar,Speech And Language Disability,6,15,13,8,21
Rajasthan,Alwar,Speech And Language Disability,15,35,26,11,37
Rajasthan,Alwar,Speech And Language Disability,35,60,15,12,27
Rajasthan,Alwar,Speech And Language Disability,60,80,5,5,10
Uttarakhand,Almora,Speech And Language Disability,6,15,1,0,1
Uttarakhand,Almora,Speech And Language Disability,15,35,5,8,13
Uttarakhand,Almora,Speech And Language Disability,35,60,15,3,18
Uttarakhand,Almora,Speech And Language Disability,60,80,1,1,2
Madhya Pradesh,Alirajpur,Speech And Language Disability,6,15,6,6,12
Madhya Pradesh,Alirajpur,Speech And Language Disability,15,35,9,6,15
Madhya Pradesh,Alirajpur,Speech And Language Disability,35,60,5,0,5
Madhya Pradesh,Alirajpur,Speech And Language Disability,60,80,4,0,4
Uttar Pradesh,Aligarh,Speech And Language Disability,0,6,1,1,2
Uttar Pradesh,Aligarh,Speech And Language Disability,6,15,9,3,12
Uttar Pradesh,Aligarh,Speech And Language Disability,15,35,17,9,26
Uttar Pradesh,Aligarh,Speech And Language Disability,35,60,8,4,12
Uttar Pradesh,Aligarh,Speech And Language Disability,60,80,3,1,4
Uttar Pradesh,Aligarh,Speech And Language Disability,80,100,0,1,1
Kerala,Alappuzha,Speech And Language Disability,6,15,1,0,1
Kerala,Alappuzha,Speech And Language Disability,15,35,9,7,16
Kerala,Alappuzha,Speech And Language Disability,35,60,4,7,11
Kerala,Alappuzha,Speech And Language Disability,60,80,4,2,6
Maharashtra,Akola,Speech And Language Disability,0,6,2,4,6
Maharashtra,Akola,Speech And Language Disability,6,15,22,13,35
Maharashtra,Akola,Speech And Language Disability,15,35,35,10,45
Maharashtra,Akola,Speech And Language Disability,35,60,37,9,46
Maharashtra,Akola,Speech And Language Disability,60,80,1,0,1
Rajasthan,Ajmer,Speech And Language Disability,6,15,2,1,3
Rajasthan,Ajmer,Speech And Language Disability,15,35,4,3,7
Rajasthan,Ajmer,Speech And Language Disability,35,60,3,2,5
Rajasthan,Ajmer,Speech And Language Disability,60,80,2,1,3
Mizoram,Aizawl,Speech And Language Disability,6,15,4,1,5
Mizoram,Aizawl,Speech And Language Disability,15,35,0,3,3
Mizoram,Aizawl,Speech And Language Disability,35,60,2,0,2
Mizoram,Aizawl,Speech And Language Disability,80,100,1,0,1
Maharashtra,Ahmednagar,Speech And Language Disability,6,15,3,1,4
Maharashtra,Ahmednagar,Speech And Language Disability,15,35,12,1,13
Maharashtra,Ahmednagar,Speech And Language Disability,35,60,1,0,1
Gujarat,Ahmadabad,Speech And Language Disability,6,15,5,1,6
Gujarat,Ahmadabad,Speech And Language Disability,15,35,2,2,4
Gujarat,Ahmadabad,Speech And Language Disability,35,60,3,1,4
Uttar Pradesh,Agra,Speech And Language Disability,0,6,2,0,2
Uttar Pradesh,Agra,Speech And Language Disability,6,15,5,4,9
Uttar Pradesh,Agra,Speech And Language Disability,15,35,18,5,23
Uttar Pradesh,Agra,Speech And Language Disability,35,60,11,1,12
Uttar Pradesh,Agra,Speech And Language Disability,60,80,7,0,7
Madhya Pradesh,Agar Malwa,Speech And Language Disability,6,15,0,1,1
Madhya Pradesh,Agar Malwa,Speech And Language Disability,15,35,2,2,4
Madhya Pradesh,Agar Malwa,Speech And Language Disability,35,60,2,0,2
Madhya Pradesh,Agar Malwa,Speech And Language Disability,60,80,1,0,1
West Bengal,24 Paraganas South,Speech And Language Disability,15,35,2,0,2
Maharashtra,Yavatmal,Thalassemia,0,6,7,0,7
Maharashtra,Yavatmal,Thalassemia,6,15,26,13,39
Maharashtra,Yavatmal,Thalassemia,15,35,12,6,18
Maharashtra,Yavatmal,Thalassemia,35,60,2,1,3
Haryana,Yamunanagar,Thalassemia,0,6,3,3,6
Haryana,Yamunanagar,Thalassemia,6,15,8,3,11
Haryana,Yamunanagar,Thalassemia,15,35,11,7,18
Haryana,Yamunanagar,Thalassemia,35,60,2,2,4
Haryana,Yamunanagar,Thalassemia,60,80,1,0,1
Karnataka,Yadgir,Thalassemia,0,6,5,3,8
Karnataka,Yadgir,Thalassemia,6,15,5,5,10
Karnataka,Yadgir,Thalassemia,15,35,1,0,1
Tripura,West Tripura,Thalassemia,0,6,0,1,1
Tripura,West Tripura,Thalassemia,6,15,4,2,6
Tripura,West Tripura,Thalassemia,15,35,11,14,25
Tripura,West Tripura,Thalassemia,35,60,1,1,2
Jharkhand,West Singhbhum,Thalassemia,0,6,1,0,1
Jharkhand,West Singhbhum,Thalassemia,6,15,0,1,1
Jharkhand,West Singhbhum,Thalassemia,15,35,2,2,4
Meghalaya,West Garo Hills,Thalassemia,6,15,2,0,2
Meghalaya,West Garo Hills,Thalassemia,35,60,1,0,1
Delhi,West,Thalassemia,0,6,7,3,10
Delhi,West,Thalassemia,6,15,28,22,50
Delhi,West,Thalassemia,15,35,60,46,106
Delhi,West,Thalassemia,35,60,4,1,5
Kerala,Wayanad,Thalassemia,6,15,1,2,3
Kerala,Wayanad,Thalassemia,15,35,3,1,4
Maharashtra,Washim,Thalassemia,0,6,6,1,7
Maharashtra,Washim,Thalassemia,6,15,12,5,17
Maharashtra,Washim,Thalassemia,15,35,7,1,8
Maharashtra,Wardha,Thalassemia,0,6,3,0,3
Maharashtra,Wardha,Thalassemia,6,15,4,4,8
Maharashtra,Wardha,Thalassemia,15,35,11,5,16
Tamil Nadu,Virudhunagar,Thalassemia,6,15,3,0,3
Tamil Nadu,Virudhunagar,Thalassemia,15,35,2,2,4
Tamil Nadu,Virudhunagar,Thalassemia,35,60,0,1,1
Tamil Nadu,Villupuram,Thalassemia,35,60,0,1,1
Karnataka,Vijayapura,Thalassemia,0,6,9,3,12
Karnataka,Vijayapura,Thalassemia,6,15,9,9,18
Karnataka,Vijayapura,Thalassemia,15,35,10,2,12
Karnataka,Vijayapura,Thalassemia,35,60,3,2,5
Madhya Pradesh,Vidisha,Thalassemia,0,6,2,1,3
Madhya Pradesh,Vidisha,Thalassemia,6,15,8,6,14
Madhya Pradesh,Vidisha,Thalassemia,15,35,12,2,14
Madhya Pradesh,Vidisha,Thalassemia,35,60,5,0,5
Madhya Pradesh,Vidisha,Thalassemia,60,80,2,0,2
Tamil Nadu,Vellore,Thalassemia,0,6,0,1,1
Tamil Nadu,Vellore,Thalassemia,15,35,3,2,5
Tamil Nadu,Vellore,Thalassemia,35,60,7,3,10
Uttar Pradesh,Varanasi,Thalassemia,6,15,1,1,2
Uttar Pradesh,Varanasi,Thalassemia,15,35,3,3,6
Gujarat,Valsad,Thalassemia,6,15,0,1,1
Gujarat,Valsad,Thalassemia,15,35,1,1,2
Bihar,Vaishali,Thalassemia,6,15,4,3,7
Bihar,Vaishali,Thalassemia,15,35,2,0,2
Bihar,Vaishali,Thalassemia,80,100,1,0,1
Gujarat,Vadodara,Thalassemia,0,6,0,1,1
Gujarat,Vadodara,Thalassemia,6,15,16,9,25
Gujarat,Vadodara,Thalassemia,15,35,34,13,47
Karnataka,Uttara Kannada,Thalassemia,0,6,2,2,4
Karnataka,Uttara Kannada,Thalassemia,6,15,10,9,19
Karnataka,Uttara Kannada,Thalassemia,15,35,4,4,8
Karnataka,Uttara Kannada,Thalassemia,60,80,0,1,1
Uttar Pradesh,Unnao,Thalassemia,0,6,2,0,2
Uttar Pradesh,Unnao,Thalassemia,6,15,1,0,1
Uttar Pradesh,Unnao,Thalassemia,15,35,2,1,3
Uttar Pradesh,Unnao,Thalassemia,35,60,0,1,1
Tripura,Unakoti,Thalassemia,6,15,2,2,4
Tripura,Unakoti,Thalassemia,15,35,7,1,8
Madhya Pradesh,Umaria,Thalassemia,0,6,1,1,2
Madhya Pradesh,Umaria,Thalassemia,6,15,1,1,2
Madhya Pradesh,Umaria,Thalassemia,15,35,1,0,1
Madhya Pradesh,Ujjain,Thalassemia,0,6,6,5,11
Madhya Pradesh,Ujjain,Thalassemia,6,15,28,22,50
Madhya Pradesh,Ujjain,Thalassemia,15,35,19,5,24
Madhya Pradesh,Ujjain,Thalassemia,35,60,1,0,1
Karnataka,Udupi,Thalassemia,0,6,5,2,7
Karnataka,Udupi,Thalassemia,6,15,4,5,9
Karnataka,Udupi,Thalassemia,15,35,7,3,10
Jammu And Kashmir,Udhampur,Thalassemia,6,15,6,1,7
Jammu And Kashmir,Udhampur,Thalassemia,15,35,4,7,11
Uttarakhand,Udam Singh Nagar,Thalassemia,0,6,1,0,1
Uttarakhand,Udam Singh Nagar,Thalassemia,6,15,3,6,9
Uttarakhand,Udam Singh Nagar,Thalassemia,15,35,8,3,11
Uttarakhand,Udam Singh Nagar,Thalassemia,35,60,2,0,2
Assam,Udalguri,Thalassemia,15,35,1,2,3
Assam,Udalguri,Thalassemia,35,60,1,0,1
Rajasthan,Udaipur,Thalassemia,0,6,3,3,6
Rajasthan,Udaipur,Thalassemia,6,15,8,13,21
Rajasthan,Udaipur,Thalassemia,15,35,10,8,18
Rajasthan,Udaipur,Thalassemia,35,60,2,0,2
Karnataka,Tumakuru,Thalassemia,0,6,6,4,10
Karnataka,Tumakuru,Thalassemia,6,15,9,11,20
Karnataka,Tumakuru,Thalassemia,15,35,6,2,8
Karnataka,Tumakuru,Thalassemia,35,60,1,0,1
Rajasthan,Tonk,Thalassemia,0,6,2,6,8
Rajasthan,Tonk,Thalassemia,6,15,10,3,13
Rajasthan,Tonk,Thalassemia,15,35,4,1,5
Tamil Nadu,Tiruvannamalai,Thalassemia,0,6,1,0,1
Tamil Nadu,Tiruvannamalai,Thalassemia,6,15,2,4,6
Tamil Nadu,Tiruvannamalai,Thalassemia,15,35,0,3,3
Tamil Nadu,Tiruvannamalai,Thalassemia,35,60,1,0,1
Tamil Nadu,Tiruppur,Thalassemia,0,6,2,2,4
Tamil Nadu,Tiruppur,Thalassemia,6,15,3,4,7
Tamil Nadu,Tiruppur,Thalassemia,15,35,2,3,5
Tamil Nadu,Tirupathur,Thalassemia,0,6,2,2,4
Tamil Nadu,Tirupathur,Thalassemia,6,15,2,2,4
Tamil Nadu,Tirupathur,Thalassemia,15,35,1,1,2
Tamil Nadu,Tiruchirappalli,Thalassemia,0,6,0,5,5
Tamil Nadu,Tiruchirappalli,Thalassemia,6,15,5,7,12
Tamil Nadu,Tiruchirappalli,Thalassemia,15,35,0,2,2
Assam,Tinsukia,Thalassemia,15,35,0,1,1
Kerala,Thrissur,Thalassemia,15,35,0,2,2
Kerala,Thrissur,Thalassemia,35,60,0,1,1
Tamil Nadu,Thiruvarur,Thalassemia,6,15,0,1,1
Kerala,Thiruvananthapuram,Thalassemia,15,35,1,2,3
Tamil Nadu,Thiruvallur,Thalassemia,6,15,0,3,3
Tamil Nadu,Thiruvallur,Thalassemia,15,35,3,2,5
Tamil Nadu,Thiruvallur,Thalassemia,35,60,0,2,2
Tamil Nadu,Theni,Thalassemia,0,6,1,1,2
Tamil Nadu,Theni,Thalassemia,6,15,9,3,12
Tamil Nadu,Theni,Thalassemia,15,35,2,1,3
Tamil Nadu,The Nilgiris,Thalassemia,15,35,1,3,4
Tamil Nadu,Thanjavur,Thalassemia,0,6,1,0,1
Tamil Nadu,Thanjavur,Thalassemia,6,15,1,2,3
Tamil Nadu,Thanjavur,Thalassemia,15,35,1,0,1
Maharashtra,Thane,Thalassemia,0,6,8,1,9
Maharashtra,Thane,Thalassemia,6,15,40,34,74
Maharashtra,Thane,Thalassemia,15,35,91,63,154
Maharashtra,Thane,Thalassemia,35,60,4,4,8
Maharashtra,Thane,Thalassemia,60,80,1,0,1
Tamil Nadu,Tenkasi,Thalassemia,6,15,0,1,1
Punjab,Tarn Taran,Thalassemia,6,15,4,3,7
Punjab,Tarn Taran,Thalassemia,15,35,9,3,12
Punjab,Tarn Taran,Thalassemia,35,60,0,1,1
Gujarat,Tapi,Thalassemia,6,15,1,1,2
Gujarat,Tapi,Thalassemia,15,35,0,1,1
Chhattisgarh,Surguja,Thalassemia,0,6,4,4,8
Chhattisgarh,Surguja,Thalassemia,6,15,4,4,8
Chhattisgarh,Surguja,Thalassemia,15,35,0,1,1
Gujarat,Surendranagar,Thalassemia,0,6,3,3,6
Gujarat,Surendranagar,Thalassemia,6,15,13,9,22
Gujarat,Surendranagar,Thalassemia,15,35,10,3,13
Gujarat,Surat,Thalassemia,0,6,2,4,6
Gujarat,Surat,Thalassemia,6,15,19,12,31
Gujarat,Surat,Thalassemia,15,35,63,19,82
Chhattisgarh,Surajpur,Thalassemia,0,6,0,1,1
Chhattisgarh,Surajpur,Thalassemia,6,15,0,1,1
Chhattisgarh,Surajpur,Thalassemia,15,35,1,1,2
Chhattisgarh,Surajpur,Thalassemia,35,60,1,0,1
Bihar,Supaul,Thalassemia,0,6,1,0,1
Bihar,Supaul,Thalassemia,6,15,1,0,1
Bihar,Supaul,Thalassemia,15,35,2,0,2
Odisha,Sundargarh,Thalassemia,0,6,10,16,26
Odisha,Sundargarh,Thalassemia,6,15,49,42,91
Odisha,Sundargarh,Thalassemia,15,35,28,18,46
Odisha,Sundargarh,Thalassemia,35,60,2,3,5
Odisha,Sundargarh,Thalassemia,60,80,1,1,2
Uttar Pradesh,Sultanpur,Thalassemia,6,15,2,0,2
Uttar Pradesh,Sultanpur,Thalassemia,15,35,6,0,6
Uttar Pradesh,Sultanpur,Thalassemia,35,60,4,1,5
Uttar Pradesh,Sultanpur,Thalassemia,60,80,1,0,1
Jammu And Kashmir,Srinagar,Thalassemia,15,35,0,1,1
Jammu And Kashmir,Srinagar,Thalassemia,35,60,0,1,1
Punjab,Sri Muktsar Sahib,Thalassemia,0,6,1,1,2
Punjab,Sri Muktsar Sahib,Thalassemia,6,15,5,1,6
Punjab,Sri Muktsar Sahib,Thalassemia,15,35,4,1,5
Punjab,Sri Muktsar Sahib,Thalassemia,35,60,1,0,1
Delhi,South West,Thalassemia,0,6,3,0,3
Delhi,South West,Thalassemia,6,15,9,9,18
Delhi,South West,Thalassemia,15,35,21,11,32
Tripura,South Tripura,Thalassemia,6,15,2,1,3
Tripura,South Tripura,Thalassemia,15,35,3,2,5
Goa,South Goa,Thalassemia,0,6,0,1,1
Goa,South Goa,Thalassemia,15,35,0,4,4
Delhi,South East,Thalassemia,6,15,6,1,7
Delhi,South East,Thalassemia,15,35,4,6,10
Andaman And Nicobar Islands,South Andamans,Thalassemia,0,6,1,0,1
Andaman And Nicobar Islands,South Andamans,Thalassemia,6,15,1,0,1
Andaman And Nicobar Islands,South Andamans,Thalassemia,15,35,2,2,4
Andaman And Nicobar Islands,South Andamans,Thalassemia,35,60,1,2,3
Delhi,South,Thalassemia,0,6,2,0,2
Delhi,South,Thalassemia,6,15,11,6,17
Delhi,South,Thalassemia,15,35,24,20,44
Delhi,South,Thalassemia,35,60,2,1,3
Assam,Sonitpur,Thalassemia,0,6,1,0,1
Assam,Sonitpur,Thalassemia,6,15,2,6,8
Assam,Sonitpur,Thalassemia,15,35,5,1,6
Haryana,Sonipat,Thalassemia,0,6,2,0,2
Haryana,Sonipat,Thalassemia,6,15,6,3,9
Haryana,Sonipat,Thalassemia,15,35,19,7,26
Haryana,Sonipat,Thalassemia,35,60,1,2,3
Odisha,Sonepur,Thalassemia,0,6,3,3,6
Odisha,Sonepur,Thalassemia,6,15,11,7,18
Odisha,Sonepur,Thalassemia,15,35,4,2,6
Uttar Pradesh,Sonbhadra,Thalassemia,0,6,3,3,6
Uttar Pradesh,Sonbhadra,Thalassemia,6,15,7,1,8
Uttar Pradesh,Sonbhadra,Thalassemia,15,35,4,1,5
Uttar Pradesh,Sonbhadra,Thalassemia,35,60,1,4,5
Maharashtra,Solapur,Thalassemia,0,6,6,0,6
Maharashtra,Solapur,Thalassemia,6,15,10,10,20
Maharashtra,Solapur,Thalassemia,15,35,12,4,16
Maharashtra,Solapur,Thalassemia,35,60,1,0,1
Himachal Pradesh,Solan,Thalassemia,6,15,0,1,1
Himachal Pradesh,Solan,Thalassemia,15,35,1,0,1
Himachal Pradesh,Solan,Thalassemia,35,60,1,0,1
Himachal Pradesh,Solan,Thalassemia,60,80,0,1,1
Bihar,Siwan,Thalassemia,0,6,0,1,1
Assam,Sivasagar,Thalassemia,6,15,1,2,3
Assam,Sivasagar,Thalassemia,15,35,1,2,3
Assam,Sivasagar,Thalassemia,35,60,0,1,1
Tamil Nadu,Sivaganga,Thalassemia,6,15,2,1,3
Tamil Nadu,Sivaganga,Thalassemia,15,35,0,1,1
Uttar Pradesh,Sitapur,Thalassemia,0,6,1,0,1
Uttar Pradesh,Sitapur,Thalassemia,6,15,1,0,1
Uttar Pradesh,Sitapur,Thalassemia,15,35,1,2,3
Uttar Pradesh,Sitapur,Thalassemia,35,60,1,0,1
Bihar,Sitamarhi,Thalassemia,0,6,1,0,1
Bihar,Sitamarhi,Thalassemia,15,35,3,0,3
Haryana,Sirsa,Thalassemia,0,6,2,1,3
Haryana,Sirsa,Thalassemia,6,15,5,2,7
Haryana,Sirsa,Thalassemia,15,35,10,2,12
Rajasthan,Sirohi,Thalassemia,6,15,3,1,4
Rajasthan,Sirohi,Thalassemia,15,35,4,2,6
Himachal Pradesh,Sirmaur,Thalassemia,6,15,3,0,3
Himachal Pradesh,Sirmaur,Thalassemia,15,35,3,1,4
Madhya Pradesh,Singrauli,Thalassemia,0,6,1,1,2
Madhya Pradesh,Singrauli,Thalassemia,6,15,0,1,1
Madhya Pradesh,Singrauli,Thalassemia,15,35,1,1,2
Maharashtra,Sindhudurg,Thalassemia,6,15,0,2,2
Maharashtra,Sindhudurg,Thalassemia,15,35,1,1,2
Maharashtra,Sindhudurg,Thalassemia,35,60,1,0,1
Jharkhand,Simdega,Thalassemia,6,15,1,1,2
Jharkhand,Simdega,Thalassemia,15,35,1,0,1
Rajasthan,Sikar,Thalassemia,0,6,0,1,1
Rajasthan,Sikar,Thalassemia,6,15,8,6,14
Rajasthan,Sikar,Thalassemia,15,35,3,0,3
Madhya Pradesh,Sidhi,Thalassemia,0,6,3,0,3
Madhya Pradesh,Sidhi,Thalassemia,6,15,3,4,7
Madhya Pradesh,Sidhi,Thalassemia,15,35,4,3,7
Madhya Pradesh,Sidhi,Thalassemia,35,60,4,0,4
Madhya Pradesh,Sidhi,Thalassemia,60,80,0,1,1
Uttar Pradesh,Siddharth Nagar,Thalassemia,0,6,3,0,3
Uttar Pradesh,Siddharth Nagar,Thalassemia,6,15,2,4,6
Uttar Pradesh,Siddharth Nagar,Thalassemia,15,35,5,0,5
Uttar Pradesh,Siddharth Nagar,Thalassemia,35,60,1,0,1
Uttar Pradesh,Siddharth Nagar,Thalassemia,60,80,2,0,2
Uttar Pradesh,Shravasti,Thalassemia,0,6,4,0,4
Uttar Pradesh,Shravasti,Thalassemia,6,15,1,0,1
Uttar Pradesh,Shravasti,Thalassemia,15,35,1,0,1
Uttar Pradesh,Shravasti,Thalassemia,35,60,1,1,2
Madhya Pradesh,Shivpuri,Thalassemia,0,6,3,2,5
Madhya Pradesh,Shivpuri,Thalassemia,6,15,6,2,8
Madhya Pradesh,Shivpuri,Thalassemia,15,35,2,2,4
Madhya Pradesh,Shivpuri,Thalassemia,35,60,1,0,1
Karnataka,Shivamogga,Thalassemia,0,6,5,5,10
Karnataka,Shivamogga,Thalassemia,6,15,12,6,18
Karnataka,Shivamogga,Thalassemia,15,35,3,5,8
Karnataka,Shivamogga,Thalassemia,35,60,0,2,2
Himachal Pradesh,Shimla,Thalassemia,6,15,1,0,1
Himachal Pradesh,Shimla,Thalassemia,15,35,5,3,8
Himachal Pradesh,Shimla,Thalassemia,35,60,2,0,2
Madhya Pradesh,Sheopur,Thalassemia,0,6,1,1,2
Madhya Pradesh,Sheopur,Thalassemia,6,15,2,1,3
Madhya Pradesh,Sheopur,Thalassemia,15,35,0,1,1
Bihar,Sheohar,Thalassemia,0,6,1,0,1
Bihar,Sheohar,Thalassemia,6,15,0,1,1
Bihar,Sheikhpura,Thalassemia,6,15,1,0,1
Uttar Pradesh,Shamli,Thalassemia,6,15,4,2,6
Uttar Pradesh,Shamli,Thalassemia,15,35,1,1,2
Uttar Pradesh,Shamli,Thalassemia,60,80,1,0,1
Madhya Pradesh,Shajapur,Thalassemia,0,6,1,1,2
Madhya Pradesh,Shajapur,Thalassemia,6,15,8,4,12
Madhya Pradesh,Shajapur,Thalassemia,15,35,4,2,6
Uttar Pradesh,Shahjahanpur,Thalassemia,6,15,5,3,8
Uttar Pradesh,Shahjahanpur,Thalassemia,15,35,7,4,11
Uttar Pradesh,Shahjahanpur,Thalassemia,35,60,3,1,4
Uttar Pradesh,Shahjahanpur,Thalassemia,60,80,1,0,1
Punjab,Shahid Bhagat Singh Nagar,Thalassemia,0,6,1,1,2
Punjab,Shahid Bhagat Singh Nagar,Thalassemia,6,15,2,0,2
Punjab,Shahid Bhagat Singh Nagar,Thalassemia,15,35,2,1,3
Punjab,Shahid Bhagat Singh Nagar,Thalassemia,35,60,2,0,2
Punjab,Shahid Bhagat Singh Nagar,Thalassemia,60,80,1,0,1
Madhya Pradesh,Shahdol,Thalassemia,0,6,5,2,7
Madhya Pradesh,Shahdol,Thalassemia,6,15,4,9,13
Madhya Pradesh,Shahdol,Thalassemia,15,35,1,2,3
Madhya Pradesh,Shahdol,Thalassemia,35,60,3,0,3
Delhi,Shahdara,Thalassemia,6,15,5,1,6
Delhi,Shahdara,Thalassemia,15,35,4,2,6
Tripura,Sepahijala,Thalassemia,6,15,3,0,3
Tripura,Sepahijala,Thalassemia,15,35,6,3,9
Tripura,Sepahijala,Thalassemia,35,60,0,1,1
Madhya Pradesh,Seoni,Thalassemia,0,6,1,0,1
Madhya Pradesh,Seoni,Thalassemia,6,15,3,3,6
Madhya Pradesh,Seoni,Thalassemia,15,35,1,1,2
Madhya Pradesh,Seoni,Thalassemia,35,60,5,0,5
Madhya Pradesh,Sehore,Thalassemia,0,6,2,1,3
Madhya Pradesh,Sehore,Thalassemia,6,15,9,7,16
Madhya Pradesh,Sehore,Thalassemia,15,35,7,2,9
Madhya Pradesh,Sehore,Thalassemia,35,60,1,0,1
Rajasthan,Sawai Madhopur,Thalassemia,0,6,0,2,2
Rajasthan,Sawai Madhopur,Thalassemia,6,15,6,2,8
Rajasthan,Sawai Madhopur,Thalassemia,15,35,3,1,4
Madhya Pradesh,Satna,Thalassemia,6,15,6,4,10
Madhya Pradesh,Satna,Thalassemia,15,35,2,1,3
Maharashtra,Satara,Thalassemia,0,6,5,0,5
Maharashtra,Satara,Thalassemia,6,15,10,15,25
Maharashtra,Satara,Thalassemia,15,35,8,7,15
Maharashtra,Satara,Thalassemia,35,60,1,0,1
Bihar,Saran,Thalassemia,15,35,1,0,1
Bihar,Saran,Thalassemia,35,60,1,0,1
Bihar,Saran,Thalassemia,60,80,1,0,1
Jharkhand,Saraikela Kharsawan,Thalassemia,0,6,1,0,1
Jharkhand,Saraikela Kharsawan,Thalassemia,6,15,0,2,2
Jharkhand,Saraikela Kharsawan,Thalassemia,15,35,3,1,4
Jharkhand,Saraikela Kharsawan,Thalassemia,35,60,4,0,4
Uttar Pradesh,Sant Kabeer Nagar,Thalassemia,0,6,1,0,1
Uttar Pradesh,Sant Kabeer Nagar,Thalassemia,35,60,1,0,1
Punjab,Sangrur,Thalassemia,0,6,0,2,2
Punjab,Sangrur,Thalassemia,6,15,11,6,17
Punjab,Sangrur,Thalassemia,15,35,15,7,22
Punjab,Sangrur,Thalassemia,35,60,4,2,6
Punjab,Sangrur,Thalassemia,60,80,3,0,3
Maharashtra,Sangli,Thalassemia,0,6,2,3,5
Maharashtra,Sangli,Thalassemia,6,15,16,15,31
Maharashtra,Sangli,Thalassemia,15,35,16,9,25
Maharashtra,Sangli,Thalassemia,35,60,0,1,1
Uttar Pradesh,Sambhal,Thalassemia,0,6,2,0,2
Uttar Pradesh,Sambhal,Thalassemia,6,15,3,0,3
Uttar Pradesh,Sambhal,Thalassemia,15,35,2,0,2
Odisha,Sambalpur,Thalassemia,0,6,3,1,4
Odisha,Sambalpur,Thalassemia,6,15,7,1,8
Odisha,Sambalpur,Thalassemia,15,35,12,6,18
Jammu And Kashmir,Samba,Thalassemia,0,6,1,0,1
Jammu And Kashmir,Samba,Thalassemia,6,15,2,1,3
Jammu And Kashmir,Samba,Thalassemia,15,35,1,2,3
Jammu And Kashmir,Samba,Thalassemia,60,80,1,0,1
Bihar,Samastipur,Thalassemia,6,15,6,3,9
Bihar,Samastipur,Thalassemia,15,35,8,4,12
Bihar,Samastipur,Thalassemia,35,60,18,6,24
Bihar,Samastipur,Thalassemia,60,80,5,2,7
Tamil Nadu,Salem,Thalassemia,0,6,1,1,2
Tamil Nadu,Salem,Thalassemia,6,15,11,4,15
Tamil Nadu,Salem,Thalassemia,15,35,5,3,8
Tamil Nadu,Salem,Thalassemia,35,60,1,0,1
Jharkhand,Sahebganj,Thalassemia,6,15,1,0,1
Bihar,Saharsa,Thalassemia,6,15,1,0,1
Bihar,Saharsa,Thalassemia,35,60,1,1,2
Uttar Pradesh,Saharanpur,Thalassemia,0,6,15,6,21
Uttar Pradesh,Saharanpur,Thalassemia,6,15,15,6,21
Uttar Pradesh,Saharanpur,Thalassemia,15,35,21,11,32
Uttar Pradesh,Saharanpur,Thalassemia,35,60,18,4,22
Madhya Pradesh,Sagar,Thalassemia,0,6,1,0,1
Madhya Pradesh,Sagar,Thalassemia,6,15,11,2,13
Madhya Pradesh,Sagar,Thalassemia,15,35,5,6,11
Madhya Pradesh,Sagar,Thalassemia,35,60,1,1,2
Gujarat,Sabar Kantha,Thalassemia,0,6,3,1,4
Gujarat,Sabar Kantha,Thalassemia,6,15,11,9,20
Gujarat,Sabar Kantha,Thalassemia,15,35,5,1,6
Punjab,S.A.S Nagar,Thalassemia,0,6,3,2,5
Punjab,S.A.S Nagar,Thalassemia,6,15,7,4,11
Punjab,S.A.S Nagar,Thalassemia,15,35,18,8,26
Punjab,S.A.S Nagar,Thalassemia,35,60,3,1,4
Punjab,Rupnagar,Thalassemia,0,6,1,1,2
Punjab,Rupnagar,Thalassemia,6,15,3,0,3
Punjab,Rupnagar,Thalassemia,15,35,1,3,4
Uttarakhand,Rudra Prayag,Thalassemia,0,6,0,1,1
Uttarakhand,Rudra Prayag,Thalassemia,35,60,4,1,5
Bihar,Rohtas,Thalassemia,15,35,0,1,1
Bihar,Rohtas,Thalassemia,35,60,2,0,2
Haryana,Rohtak,Thalassemia,0,6,1,1,2
Haryana,Rohtak,Thalassemia,6,15,13,2,15
Haryana,Rohtak,Thalassemia,15,35,18,7,25
Haryana,Rohtak,Thalassemia,35,60,2,0,2
Haryana,Rewari,Thalassemia,0,6,1,1,2
Haryana,Rewari,Thalassemia,6,15,1,1,2
Haryana,Rewari,Thalassemia,15,35,2,1,3
Haryana,Rewari,Thalassemia,35,60,1,0,1
Madhya Pradesh,Rewa,Thalassemia,0,6,2,1,3
Madhya Pradesh,Rewa,Thalassemia,6,15,4,1,5
Madhya Pradesh,Rewa,Thalassemia,15,35,2,1,3
Jammu And Kashmir,Reasi,Thalassemia,6,15,0,1,1
Jammu And Kashmir,Reasi,Thalassemia,15,35,1,1,2
Odisha,Rayagada,Thalassemia,0,6,2,0,2
Odisha,Rayagada,Thalassemia,6,15,2,2,4
Odisha,Rayagada,Thalassemia,15,35,3,1,4
Maharashtra,Ratnagiri,Thalassemia,0,6,1,0,1
Maharashtra,Ratnagiri,Thalassemia,6,15,4,6,10
Maharashtra,Ratnagiri,Thalassemia,15,35,5,6,11
Maharashtra,Ratnagiri,Thalassemia,35,60,0,1,1
Madhya Pradesh,Ratlam,Thalassemia,0,6,3,4,7
Madhya Pradesh,Ratlam,Thalassemia,6,15,15,19,34
Madhya Pradesh,Ratlam,Thalassemia,15,35,9,5,14
Madhya Pradesh,Ratlam,Thalassemia,35,60,0,2,2
Tamil Nadu,Ranipet,Thalassemia,0,6,1,0,1
Tamil Nadu,Ranipet,Thalassemia,6,15,1,0,1
Tamil Nadu,Ranipet,Thalassemia,35,60,1,0,1
Jharkhand,Ranchi,Thalassemia,0,6,6,7,13
Jharkhand,Ranchi,Thalassemia,6,15,31,16,47
Jharkhand,Ranchi,Thalassemia,15,35,5,9,14
Jharkhand,Ranchi,Thalassemia,35,60,1,0,1
Uttar Pradesh,Rampur,Thalassemia,0,6,0,1,1
Uttar Pradesh,Rampur,Thalassemia,6,15,2,2,4
Uttar Pradesh,Rampur,Thalassemia,15,35,5,0,5
Uttar Pradesh,Rampur,Thalassemia,35,60,1,0,1
Jharkhand,Ramgarh,Thalassemia,6,15,13,4,17
Jharkhand,Ramgarh,Thalassemia,15,35,6,6,12
Jharkhand,Ramgarh,Thalassemia,35,60,2,0,2
Jharkhand,Ramgarh,Thalassemia,60,80,2,0,2
Tamil Nadu,Ramanathapuram,Thalassemia,6,15,0,1,1
Karnataka,Ramanagara,Thalassemia,0,6,0,1,1
Karnataka,Ramanagara,Thalassemia,6,15,6,3,9
Karnataka,Ramanagara,Thalassemia,15,35,4,6,10
Karnataka,Ramanagara,Thalassemia,35,60,3,1,4
Rajasthan,Rajsamand,Thalassemia,0,6,0,1,1
Rajasthan,Rajsamand,Thalassemia,6,15,3,2,5
Rajasthan,Rajsamand,Thalassemia,15,35,4,2,6
Jammu And Kashmir,Rajouri,Thalassemia,0,6,2,4,6
Jammu And Kashmir,Rajouri,Thalassemia,6,15,10,4,14
Jammu And Kashmir,Rajouri,Thalassemia,15,35,2,1,3
Chhattisgarh,Rajnandgaon,Thalassemia,0,6,3,3,6
Chhattisgarh,Rajnandgaon,Thalassemia,6,15,5,11,16
Chhattisgarh,Rajnandgaon,Thalassemia,15,35,4,7,11
Chhattisgarh,Rajnandgaon,Thalassemia,35,60,1,1,2
Chhattisgarh,Rajnandgaon,Thalassemia,60,80,1,0,1
Gujarat,Rajkot,Thalassemia,0,6,1,0,1
Gujarat,Rajkot,Thalassemia,6,15,45,46,91
Gujarat,Rajkot,Thalassemia,15,35,82,51,133
Gujarat,Rajkot,Thalassemia,35,60,5,1,6
Gujarat,Rajkot,Thalassemia,80,100,0,1,1
Madhya Pradesh,Rajgarh,Thalassemia,0,6,6,2,8
Madhya Pradesh,Rajgarh,Thalassemia,6,15,15,6,21
Madhya Pradesh,Rajgarh,Thalassemia,15,35,4,3,7
Madhya Pradesh,Rajgarh,Thalassemia,35,60,0,1,1
Madhya Pradesh,Rajgarh,Thalassemia,60,80,2,0,2
Madhya Pradesh,Raisen,Thalassemia,0,6,3,1,4
Madhya Pradesh,Raisen,Thalassemia,6,15,1,3,4
Madhya Pradesh,Raisen,Thalassemia,15,35,4,1,5
Madhya Pradesh,Raisen,Thalassemia,35,60,2,0,2
Chhattisgarh,Raipur,Thalassemia,0,6,3,3,6
Chhattisgarh,Raipur,Thalassemia,6,15,22,9,31
Chhattisgarh,Raipur,Thalassemia,15,35,19,13,32
Chhattisgarh,Raipur,Thalassemia,35,60,1,2,3
Chhattisgarh,Raigarh,Thalassemia,0,6,0,1,1
Chhattisgarh,Raigarh,Thalassemia,6,15,1,0,1
Chhattisgarh,Raigarh,Thalassemia,15,35,0,1,1
Maharashtra,Raigad,Thalassemia,0,6,1,1,2
Maharashtra,Raigad,Thalassemia,6,15,12,7,19
Maharashtra,Raigad,Thalassemia,15,35,13,9,22
Maharashtra,Raigad,Thalassemia,35,60,1,2,3
Karnataka,Raichur,Thalassemia,0,6,11,9,20
Karnataka,Raichur,Thalassemia,6,15,17,11,28
Karnataka,Raichur,Thalassemia,15,35,1,1,2
Uttar Pradesh,Rae Bareli,Thalassemia,6,15,3,1,4
Uttar Pradesh,Rae Bareli,Thalassemia,15,35,2,1,3
Bihar,Purnia,Thalassemia,0,6,4,0,4
Bihar,Purnia,Thalassemia,6,15,8,4,12
Bihar,Purnia,Thalassemia,15,35,5,4,9
Bihar,Purnia,Thalassemia,35,60,1,1,2
Odisha,Puri,Thalassemia,0,6,7,11,18
Odisha,Puri,Thalassemia,6,15,68,39,107
Odisha,Puri,Thalassemia,15,35,31,31,62
Odisha,Puri,Thalassemia,35,60,9,2,11
Odisha,Puri,Thalassemia,60,80,1,1,2
Bihar,Purbi Champaran,Thalassemia,0,6,1,0,1
Bihar,Purbi Champaran,Thalassemia,6,15,0,2,2
Bihar,Purbi Champaran,Thalassemia,15,35,3,1,4
Bihar,Purbi Champaran,Thalassemia,35,60,1,1,2
Bihar,Purbi Champaran,Thalassemia,60,80,0,1,1
Maharashtra,Pune,Thalassemia,0,6,8,13,21
Maharashtra,Pune,Thalassemia,6,15,62,46,108
Maharashtra,Pune,Thalassemia,15,35,54,50,104
Maharashtra,Pune,Thalassemia,35,60,5,3,8
Jammu And Kashmir,Pulwama,Thalassemia,6,15,1,0,1
Tamil Nadu,Pudukkottai,Thalassemia,6,15,2,0,2
Tamil Nadu,Pudukkottai,Thalassemia,15,35,0,2,2
Uttar Pradesh,Prayagraj,Thalassemia,0,6,2,0,2
Uttar Pradesh,Prayagraj,Thalassemia,6,15,5,2,7
Uttar Pradesh,Prayagraj,Thalassemia,35,60,2,1,3
Uttar Pradesh,Prayagraj,Thalassemia,60,80,1,0,1
Rajasthan,Pratapgarh,Thalassemia,0,6,0,2,2
Rajasthan,Pratapgarh,Thalassemia,6,15,5,1,6
Rajasthan,Pratapgarh,Thalassemia,15,35,0,1,1
Uttar Pradesh,Pratapgarh,Thalassemia,6,15,2,0,2
Uttar Pradesh,Pratapgarh,Thalassemia,15,35,3,1,4
Uttar Pradesh,Pratapgarh,Thalassemia,35,60,2,1,3
Uttar Pradesh,Pratapgarh,Thalassemia,60,80,2,0,2
Gujarat,Porbandar,Thalassemia,0,6,2,5,7
Gujarat,Porbandar,Thalassemia,6,15,27,7,34
Gujarat,Porbandar,Thalassemia,15,35,35,20,55
Jammu And Kashmir,Poonch,Thalassemia,0,6,4,2,6
Jammu And Kashmir,Poonch,Thalassemia,6,15,5,4,9
Jammu And Kashmir,Poonch,Thalassemia,15,35,7,6,13
Jammu And Kashmir,Poonch,Thalassemia,35,60,2,5,7
Jammu And Kashmir,Poonch,Thalassemia,60,80,1,0,1
Uttarakhand,Pithoragarh,Thalassemia,6,15,1,0,1
Uttar Pradesh,Pilibhit,Thalassemia,6,15,5,4,9
Uttar Pradesh,Pilibhit,Thalassemia,15,35,10,2,12
Uttar Pradesh,Pilibhit,Thalassemia,35,60,6,6,12
Uttar Pradesh,Pilibhit,Thalassemia,60,80,2,1,3
Uttar Pradesh,Pilibhit,Thalassemia,80,100,1,0,1
Tamil Nadu,Perambalur,Thalassemia,0,6,0,2,2
Tamil Nadu,Perambalur,Thalassemia,6,15,1,0,1
Bihar,Patna,Thalassemia,6,15,1,0,1
Bihar,Patna,Thalassemia,15,35,6,5,11
Bihar,Patna,Thalassemia,35,60,3,1,4
Punjab,Patiala,Thalassemia,0,6,6,5,11
Punjab,Patiala,Thalassemia,6,15,44,19,63
Punjab,Patiala,Thalassemia,15,35,54,29,83
Punjab,Patiala,Thalassemia,35,60,2,1,3
Punjab,Pathankot,Thalassemia,0,6,1,1,2
Punjab,Pathankot,Thalassemia,6,15,3,2,5
Punjab,Pathankot,Thalassemia,15,35,4,2,6
Punjab,Pathankot,Thalassemia,35,60,1,0,1
Punjab,Pathankot,Thalassemia,60,80,1,0,1
Gujarat,Patan,Thalassemia,0,6,2,0,2
Gujarat,Patan,Thalassemia,6,15,3,2,5
Bihar,Pashchim Champaran,Thalassemia,0,6,2,1,3
Bihar,Pashchim Champaran,Thalassemia,6,15,1,1,2
Bihar,Pashchim Champaran,Thalassemia,15,35,1,0,1
Bihar,Pashchim Champaran,Thalassemia,35,60,1,3,4
Bihar,Pashchim Champaran,Thalassemia,60,80,1,0,1
Maharashtra,Parbhani,Thalassemia,0,6,17,8,25
Maharashtra,Parbhani,Thalassemia,6,15,28,22,50
Maharashtra,Parbhani,Thalassemia,15,35,5,3,8
Maharashtra,Parbhani,Thalassemia,60,80,0,1,1
Madhya Pradesh,Panna,Thalassemia,6,15,2,1,3
Madhya Pradesh,Panna,Thalassemia,15,35,1,1,2
Haryana,Panipat,Thalassemia,0,6,4,1,5
Haryana,Panipat,Thalassemia,6,15,13,9,22
Haryana,Panipat,Thalassemia,15,35,15,7,22
Haryana,Panipat,Thalassemia,35,60,1,0,1
Haryana,Panchkula,Thalassemia,0,6,1,1,2
Haryana,Panchkula,Thalassemia,6,15,1,0,1
Haryana,Panchkula,Thalassemia,15,35,4,5,9
Haryana,Panchkula,Thalassemia,35,60,1,1,2
Gujarat,Panch Mahals,Thalassemia,0,6,0,5,5
Gujarat,Panch Mahals,Thalassemia,6,15,7,7,14
Gujarat,Panch Mahals,Thalassemia,15,35,10,5,15
Haryana,Palwal,Thalassemia,0,6,1,0,1
Haryana,Palwal,Thalassemia,6,15,4,2,6
Haryana,Palwal,Thalassemia,15,35,1,4,5
Rajasthan,Pali,Thalassemia,0,6,2,3,5
Rajasthan,Pali,Thalassemia,6,15,13,6,19
Rajasthan,Pali,Thalassemia,15,35,9,5,14
Maharashtra,Palghar,Thalassemia,0,6,3,2,5
Maharashtra,Palghar,Thalassemia,6,15,17,11,28
Maharashtra,Palghar,Thalassemia,15,35,10,15,25
Jharkhand,Palamu,Thalassemia,0,6,2,0,2
Jharkhand,Palamu,Thalassemia,6,15,3,0,3
Jharkhand,Palamu,Thalassemia,15,35,1,2,3
Kerala,Palakkad,Thalassemia,0,6,0,1,1
Kerala,Palakkad,Thalassemia,6,15,2,2,4
Kerala,Palakkad,Thalassemia,15,35,3,2,5
Jharkhand,Pakur,Thalassemia,15,35,1,0,1
Jharkhand,Pakur,Thalassemia,35,60,1,0,1
Maharashtra,Osmanabad,Thalassemia,0,6,2,1,3
Maharashtra,Osmanabad,Thalassemia,6,15,4,4,8
Maharashtra,Osmanabad,Thalassemia,15,35,2,6,8
Haryana,Nuh,Thalassemia,0,6,1,2,3
Haryana,Nuh,Thalassemia,6,15,2,2,4
Odisha,Nuapada,Thalassemia,0,6,1,0,1
Odisha,Nuapada,Thalassemia,6,15,4,3,7
Odisha,Nuapada,Thalassemia,15,35,0,1,1
Delhi,North West,Thalassemia,0,6,7,1,8
Delhi,North West,Thalassemia,6,15,24,23,47
Delhi,North West,Thalassemia,15,35,35,42,77
Delhi,North West,Thalassemia,35,60,3,2,5
Tripura,North Tripura,Thalassemia,6,15,1,0,1
Tripura,North Tripura,Thalassemia,15,35,5,0,5
Goa,North Goa,Thalassemia,6,15,1,3,4
Goa,North Goa,Thalassemia,15,35,1,0,1
Delhi,North East,Thalassemia,0,6,0,1,1
Delhi,North East,Thalassemia,6,15,16,13,29
Delhi,North East,Thalassemia,15,35,20,9,29
Andaman And Nicobar Islands,North And Middle Andaman,Thalassemia,0,6,1,0,1
Andaman And Nicobar Islands,North And Middle Andaman,Thalassemia,15,35,2,0,2
Delhi,North,Thalassemia,0,6,1,1,2
Delhi,North,Thalassemia,6,15,5,6,11
Delhi,North,Thalassemia,15,35,10,12,22
Madhya Pradesh,Niwari,Thalassemia,35,60,1,0,1
Madhya Pradesh,Niwari,Thalassemia,60,80,1,0,1
Delhi,New Delhi,Thalassemia,15,35,1,0,1
Madhya Pradesh,Neemuch,Thalassemia,0,6,2,0,2
Madhya Pradesh,Neemuch,Thalassemia,6,15,10,3,13
Madhya Pradesh,Neemuch,Thalassemia,15,35,4,1,5
Odisha,Nayagarh,Thalassemia,0,6,13,7,20
Odisha,Nayagarh,Thalassemia,6,15,42,21,63
Odisha,Nayagarh,Thalassemia,15,35,30,18,48
Odisha,Nayagarh,Thalassemia,35,60,7,4,11
Odisha,Nayagarh,Thalassemia,60,80,1,0,1
Bihar,Nawada,Thalassemia,0,6,1,0,1
Bihar,Nawada,Thalassemia,6,15,0,1,1
Bihar,Nawada,Thalassemia,15,35,0,2,2
Bihar,Nawada,Thalassemia,35,60,3,0,3
Gujarat,Navsari,Thalassemia,0,6,0,1,1
Gujarat,Navsari,Thalassemia,6,15,2,2,4
Gujarat,Navsari,Thalassemia,15,35,3,4,7
Gujarat,Navsari,Thalassemia,35,60,0,1,1
Maharashtra,Nashik,Thalassemia,0,6,4,5,9
Maharashtra,Nashik,Thalassemia,6,15,24,19,43
Maharashtra,Nashik,Thalassemia,15,35,13,11,24
Maharashtra,Nashik,Thalassemia,35,60,1,0,1
Madhya Pradesh,Narsinghpur,Thalassemia,0,6,2,0,2
Madhya Pradesh,Narsinghpur,Thalassemia,6,15,8,3,11
Madhya Pradesh,Narsinghpur,Thalassemia,15,35,6,2,8
Madhya Pradesh,Narsinghpur,Thalassemia,35,60,12,1,13
Madhya Pradesh,Narmadapuram,Thalassemia,15,35,5,0,5
Madhya Pradesh,Narmadapuram,Thalassemia,35,60,1,0,1
Gujarat,Narmada,Thalassemia,6,15,1,1,2
Maharashtra,Nandurbar,Thalassemia,0,6,4,0,4
Maharashtra,Nandurbar,Thalassemia,6,15,7,4,11
Maharashtra,Nandurbar,Thalassemia,15,35,1,1,2
Maharashtra,Nanded,Thalassemia,0,6,7,3,10
Maharashtra,Nanded,Thalassemia,6,15,26,13,39
Maharashtra,Nanded,Thalassemia,15,35,8,10,18
Maharashtra,Nanded,Thalassemia,35,60,2,1,3
Sikkim,Namchi,Thalassemia,6,15,0,1,1
Tamil Nadu,Namakkal,Thalassemia,0,6,1,1,2
Tamil Nadu,Namakkal,Thalassemia,6,15,5,1,6
Tamil Nadu,Namakkal,Thalassemia,35,60,1,0,1
Assam,Nalbari,Thalassemia,0,6,1,0,1
Assam,Nalbari,Thalassemia,6,15,8,1,9
Assam,Nalbari,Thalassemia,15,35,5,1,6
Assam,Nalbari,Thalassemia,35,60,0,1,1
Bihar,Nalanda,Thalassemia,0,6,1,0,1
Bihar,Nalanda,Thalassemia,6,15,2,0,2
Bihar,Nalanda,Thalassemia,15,35,1,0,1
Bihar,Nalanda,Thalassemia,35,60,1,0,1
Uttarakhand,Nainital,Thalassemia,0,6,3,2,5
Uttarakhand,Nainital,Thalassemia,6,15,3,2,5
Uttarakhand,Nainital,Thalassemia,15,35,3,1,4
Maharashtra,Nagpur,Thalassemia,0,6,11,13,24
Maharashtra,Nagpur,Thalassemia,6,15,33,24,57
Maharashtra,Nagpur,Thalassemia,15,35,30,22,52
Maharashtra,Nagpur,Thalassemia,35,60,3,1,4
Rajasthan,Nagaur,Thalassemia,0,6,0,2,2
Rajasthan,Nagaur,Thalassemia,6,15,12,4,16
Rajasthan,Nagaur,Thalassemia,15,35,4,0,4
Tamil Nadu,Nagapattinam,Thalassemia,6,15,1,0,1
Tamil Nadu,Nagapattinam,Thalassemia,15,35,0,2,2
Assam,Nagaon,Thalassemia,0,6,0,1,1
Assam,Nagaon,Thalassemia,6,15,2,1,3
Assam,Nagaon,Thalassemia,15,35,1,0,1
Assam,Nagaon,Thalassemia,35,60,1,0,1
Odisha,Nabarangpur,Thalassemia,0,6,1,1,2
Odisha,Nabarangpur,Thalassemia,6,15,1,0,1
Odisha,Nabarangpur,Thalassemia,35,60,1,0,1
Karnataka,Mysuru,Thalassemia,0,6,6,2,8
Karnataka,Mysuru,Thalassemia,6,15,20,11,31
Karnataka,Mysuru,Thalassemia,15,35,11,9,20
Karnataka,Mysuru,Thalassemia,35,60,3,0,3
Karnataka,Mysuru,Thalassemia,60,80,2,0,2
Bihar,Muzaffarpur,Thalassemia,0,6,0,1,1
Bihar,Muzaffarpur,Thalassemia,6,15,2,0,2
Bihar,Muzaffarpur,Thalassemia,15,35,2,0,2
Bihar,Muzaffarpur,Thalassemia,35,60,2,0,2
Bihar,Muzaffarpur,Thalassemia,60,80,1,0,1
Uttar Pradesh,Muzaffarnagar,Thalassemia,0,6,1,1,2
Uttar Pradesh,Muzaffarnagar,Thalassemia,6,15,9,6,15
Uttar Pradesh,Muzaffarnagar,Thalassemia,15,35,21,8,29
Uttar Pradesh,Muzaffarnagar,Thalassemia,35,60,18,8,26
Uttar Pradesh,Muzaffarnagar,Thalassemia,60,80,1,1,2
Uttar Pradesh,Muzaffarnagar,Thalassemia,80,100,1,0,1
Bihar,Munger,Thalassemia,0,6,1,1,2
Bihar,Munger,Thalassemia,6,15,1,0,1
Bihar,Munger,Thalassemia,15,35,1,0,1
Bihar,Munger,Thalassemia,35,60,0,1,1
Maharashtra,Mumbai Suburban,Thalassemia,0,6,5,1,6
Maharashtra,Mumbai Suburban,Thalassemia,6,15,12,11,23
Maharashtra,Mumbai Suburban,Thalassemia,15,35,39,28,67
Maharashtra,Mumbai Suburban,Thalassemia,35,60,1,0,1
Maharashtra,Mumbai,Thalassemia,0,6,0,1,1
Maharashtra,Mumbai,Thalassemia,6,15,6,3,9
Maharashtra,Mumbai,Thalassemia,15,35,10,5,15
Maharashtra,Mumbai,Thalassemia,35,60,3,1,4
Madhya Pradesh,Morena,Thalassemia,6,15,2,0,2
Madhya Pradesh,Morena,Thalassemia,15,35,2,0,2
Madhya Pradesh,Morena,Thalassemia,35,60,2,0,2
Madhya Pradesh,Morena,Thalassemia,60,80,1,0,1
Gujarat,Morbi,Thalassemia,0,6,1,0,1
Gujarat,Morbi,Thalassemia,6,15,10,2,12
Gujarat,Morbi,Thalassemia,15,35,14,2,16
Uttar Pradesh,Moradabad,Thalassemia,0,6,2,0,2
Uttar Pradesh,Moradabad,Thalassemia,6,15,9,1,10
Uttar Pradesh,Moradabad,Thalassemia,15,35,2,3,5
Punjab,Moga,Thalassemia,0,6,1,1,2
Punjab,Moga,Thalassemia,6,15,6,1,7
Punjab,Moga,Thalassemia,15,35,4,2,6
Uttar Pradesh,Mirzapur,Thalassemia,15,35,3,1,4
Uttar Pradesh,Mirzapur,Thalassemia,35,60,1,0,1
Uttar Pradesh,Mirzapur,Thalassemia,60,80,0,1,1
Uttar Pradesh,Meerut,Thalassemia,6,15,4,1,5
Uttar Pradesh,Meerut,Thalassemia,15,35,4,3,7
Uttar Pradesh,Meerut,Thalassemia,80,100,0,1,1
Odisha,Mayurbhanj,Thalassemia,0,6,19,14,33
Odisha,Mayurbhanj,Thalassemia,6,15,62,33,95
Odisha,Mayurbhanj,Thalassemia,15,35,33,20,53
Odisha,Mayurbhanj,Thalassemia,35,60,1,2,3
Uttar Pradesh,Mau,Thalassemia,0,6,0,2,2
Uttar Pradesh,Mau,Thalassemia,6,15,2,4,6
Uttar Pradesh,Mau,Thalassemia,15,35,5,2,7
Uttar Pradesh,Mathura,Thalassemia,0,6,0,1,1
Uttar Pradesh,Mathura,Thalassemia,6,15,2,1,3
Uttar Pradesh,Mathura,Thalassemia,15,35,3,1,4
Uttar Pradesh,Mathura,Thalassemia,60,80,1,0,1
Assam,Marigaon,Thalassemia,6,15,0,2,2
Assam,Marigaon,Thalassemia,15,35,2,1,3
Punjab,Mansa,Thalassemia,0,6,2,1,3
Punjab,Mansa,Thalassemia,6,15,8,2,10
Punjab,Mansa,Thalassemia,15,35,6,0,6
Punjab,Mansa,Thalassemia,35,60,1,0,1
Karnataka,Mandya,Thalassemia,0,6,5,2,7
Karnataka,Mandya,Thalassemia,6,15,2,2,4
Karnataka,Mandya,Thalassemia,15,35,5,2,7
Karnataka,Mandya,Thalassemia,35,60,2,0,2
Madhya Pradesh,Mandsaur,Thalassemia,0,6,5,2,7
Madhya Pradesh,Mandsaur,Thalassemia,6,15,8,8,16
Madhya Pradesh,Mandsaur,Thalassemia,15,35,5,2,7
Madhya Pradesh,Mandla,Thalassemia,0,6,1,0,1
Madhya Pradesh,Mandla,Thalassemia,6,15,2,1,3
Madhya Pradesh,Mandla,Thalassemia,15,35,2,2,4
Madhya Pradesh,Mandla,Thalassemia,35,60,0,1,1
Himachal Pradesh,Mandi,Thalassemia,0,6,1,1,2
Himachal Pradesh,Mandi,Thalassemia,6,15,2,2,4
Himachal Pradesh,Mandi,Thalassemia,15,35,8,3,11
Himachal Pradesh,Mandi,Thalassemia,35,60,2,1,3
Odisha,Malkangiri,Thalassemia,6,15,0,1,1
Odisha,Malkangiri,Thalassemia,15,35,0,1,1
Odisha,Malkangiri,Thalassemia,35,60,2,1,3
Odisha,Malkangiri,Thalassemia,60,80,1,0,1
Punjab,Malerkotla,Thalassemia,0,6,1,0,1
Punjab,Malerkotla,Thalassemia,6,15,2,0,2
Kerala,Malappuram,Thalassemia,0,6,0,1,1
Kerala,Malappuram,Thalassemia,6,15,1,1,2
Kerala,Malappuram,Thalassemia,15,35,0,1,1
Kerala,Malappuram,Thalassemia,35,60,2,0,2
Uttar Pradesh,Mainpuri,Thalassemia,0,6,3,0,3
Uttar Pradesh,Mainpuri,Thalassemia,6,15,4,3,7
Uttar Pradesh,Mainpuri,Thalassemia,15,35,2,1,3
Uttar Pradesh,Mainpuri,Thalassemia,35,60,1,0,1
Uttar Pradesh,Mahoba,Thalassemia,6,15,1,1,2
Uttar Pradesh,Mahoba,Thalassemia,15,35,3,0,3
Uttar Pradesh,Mahoba,Thalassemia,35,60,3,0,3
Uttar Pradesh,Mahoba,Thalassemia,60,80,2,1,3
Gujarat,Mahisagar,Thalassemia,0,6,3,1,4
Gujarat,Mahisagar,Thalassemia,6,15,12,4,16
Gujarat,Mahisagar,Thalassemia,15,35,4,1,5
Gujarat,Mahesana,Thalassemia,6,15,4,5,9
Gujarat,Mahesana,Thalassemia,15,35,3,3,6
Haryana,Mahendragarh,Thalassemia,0,6,1,0,1
Haryana,Mahendragarh,Thalassemia,6,15,0,1,1
Haryana,Mahendragarh,Thalassemia,15,35,3,0,3
Chhattisgarh,Mahasamund,Thalassemia,6,15,2,0,2
Chhattisgarh,Mahasamund,Thalassemia,15,35,4,1,5
Chhattisgarh,Mahasamund,Thalassemia,35,60,1,0,1
Uttar Pradesh,Maharajganj,Thalassemia,6,15,2,1,3
Uttar Pradesh,Maharajganj,Thalassemia,15,35,3,3,6
Uttar Pradesh,Maharajganj,Thalassemia,60,80,1,0,1
Telangana,Mahabubabad,Thalassemia,6,15,1,0,1
Telangana,Mahabubabad,Thalassemia,35,60,0,1,1
Tamil Nadu,Madurai,Thalassemia,0,6,0,3,3
Tamil Nadu,Madurai,Thalassemia,6,15,2,1,3
Tamil Nadu,Madurai,Thalassemia,15,35,2,0,2
Bihar,Madhubani,Thalassemia,6,15,1,0,1
Bihar,Madhubani,Thalassemia,15,35,3,1,4
Bihar,Madhubani,Thalassemia,35,60,1,0,1
Bihar,Madhepura,Thalassemia,6,15,1,0,1
Bihar,Madhepura,Thalassemia,15,35,0,1,1
Bihar,Madhepura,Thalassemia,35,60,2,0,2
Punjab,Ludhiana,Thalassemia,0,6,5,4,9
Punjab,Ludhiana,Thalassemia,6,15,26,9,35
Punjab,Ludhiana,Thalassemia,15,35,38,24,62
Punjab,Ludhiana,Thalassemia,35,60,7,3,10
Punjab,Ludhiana,Thalassemia,60,80,1,0,1
Uttar Pradesh,Lucknow,Thalassemia,6,15,3,1,4
Uttar Pradesh,Lucknow,Thalassemia,15,35,19,7,26
Uttar Pradesh,Lucknow,Thalassemia,35,60,15,6,21
Uttar Pradesh,Lucknow,Thalassemia,60,80,5,1,6
Jharkhand,Lohardaga,Thalassemia,6,15,2,0,2
Jharkhand,Lohardaga,Thalassemia,15,35,0,1,1
Jharkhand,Lohardaga,Thalassemia,35,60,0,1,1
Maharashtra,Latur,Thalassemia,0,6,8,5,13
Maharashtra,Latur,Thalassemia,6,15,30,30,60
Maharashtra,Latur,Thalassemia,15,35,18,6,24
Maharashtra,Latur,Thalassemia,35,60,1,1,2
Jharkhand,Latehar,Thalassemia,0,6,0,1,1
Jharkhand,Latehar,Thalassemia,15,35,0,2,2
Uttar Pradesh,Lalitpur,Thalassemia,15,35,1,1,2
Uttar Pradesh,Lalitpur,Thalassemia,35,60,2,0,2
Uttar Pradesh,Lalitpur,Thalassemia,60,80,1,0,1
Bihar,Lakhisarai,Thalassemia,15,35,1,0,1
Assam,Lakhimpur,Thalassemia,0,6,1,1,2
Assam,Lakhimpur,Thalassemia,6,15,1,0,1
Assam,Lakhimpur,Thalassemia,15,35,1,0,1
Assam,Lakhimpur,Thalassemia,35,60,1,0,1
Uttar Pradesh,Kushi Nagar,Thalassemia,0,6,1,1,2
Uttar Pradesh,Kushi Nagar,Thalassemia,6,15,3,3,6
Uttar Pradesh,Kushi Nagar,Thalassemia,15,35,5,4,9
Uttar Pradesh,Kushi Nagar,Thalassemia,35,60,4,1,5
Haryana,Kurukshetra,Thalassemia,0,6,2,0,2
Haryana,Kurukshetra,Thalassemia,6,15,5,5,10
Haryana,Kurukshetra,Thalassemia,15,35,12,4,16
Jammu And Kashmir,Kupwara,Thalassemia,0,6,0,3,3
Jammu And Kashmir,Kupwara,Thalassemia,6,15,1,0,1
Himachal Pradesh,Kullu,Thalassemia,15,35,1,0,1
Jammu And Kashmir,Kulgam,Thalassemia,6,15,0,1,1
Tamil Nadu,Krishnagiri,Thalassemia,0,6,1,1,2
Tamil Nadu,Krishnagiri,Thalassemia,6,15,2,5,7
Tamil Nadu,Krishnagiri,Thalassemia,15,35,0,3,3
Tamil Nadu,Krishnagiri,Thalassemia,35,60,0,1,1
Kerala,Kozhikode,Thalassemia,0,6,0,1,1
Kerala,Kozhikode,Thalassemia,6,15,3,2,5
Kerala,Kozhikode,Thalassemia,15,35,5,9,14
Rajasthan,Kota,Thalassemia,0,6,14,12,26
Rajasthan,Kota,Thalassemia,6,15,34,36,70
Rajasthan,Kota,Thalassemia,15,35,39,26,65
Rajasthan,Kota,Thalassemia,35,60,2,1,3
Chhattisgarh,Korea,Thalassemia,6,15,2,0,2
Chhattisgarh,Korea,Thalassemia,15,35,0,2,2
Chhattisgarh,Korba,Thalassemia,0,6,2,0,2
Chhattisgarh,Korba,Thalassemia,6,15,1,1,2
Chhattisgarh,Korba,Thalassemia,15,35,1,0,1
Odisha,Koraput,Thalassemia,6,15,2,0,2
Odisha,Koraput,Thalassemia,15,35,1,1,2
Karnataka,Koppal,Thalassemia,0,6,5,3,8
Karnataka,Koppal,Thalassemia,6,15,10,2,12
Karnataka,Koppal,Thalassemia,15,35,4,2,6
Karnataka,Koppal,Thalassemia,35,60,1,0,1
Chhattisgarh,Kondagaon,Thalassemia,6,15,2,0,2
Chhattisgarh,Kondagaon,Thalassemia,15,35,1,1,2
Chhattisgarh,Kondagaon,Thalassemia,60,80,1,0,1
Kerala,Kollam,Thalassemia,35,60,1,0,1
Maharashtra,Kolhapur,Thalassemia,0,6,4,2,6
Maharashtra,Kolhapur,Thalassemia,6,15,7,11,18
Maharashtra,Kolhapur,Thalassemia,15,35,13,6,19
Maharashtra,Kolhapur,Thalassemia,35,60,2,2,4
Karnataka,Kolar,Thalassemia,6,15,3,0,3
Karnataka,Kolar,Thalassemia,35,60,1,0,1
Assam,Kokrajhar,Thalassemia,15,35,0,1,1
Karnataka,Kodagu,Thalassemia,0,6,0,2,2
Karnataka,Kodagu,Thalassemia,6,15,4,4,8
Karnataka,Kodagu,Thalassemia,15,35,4,5,9
Bihar,Kishanganj,Thalassemia,6,15,5,1,6
Bihar,Kishanganj,Thalassemia,15,35,1,1,2
Jharkhand,Khunti,Thalassemia,6,15,0,1,1
Jharkhand,Khunti,Thalassemia,15,35,1,0,1
Tripura,Khowai,Thalassemia,6,15,0,1,1
Tripura,Khowai,Thalassemia,15,35,1,0,1
Odisha,Khordha,Thalassemia,0,6,23,9,32
Odisha,Khordha,Thalassemia,6,15,78,53,131
Odisha,Khordha,Thalassemia,15,35,68,30,98
Odisha,Khordha,Thalassemia,35,60,4,6,10
Uttar Pradesh,Kheri,Thalassemia,0,6,1,0,1
Uttar Pradesh,Kheri,Thalassemia,6,15,5,1,6
Uttar Pradesh,Kheri,Thalassemia,15,35,6,1,7
Uttar Pradesh,Kheri,Thalassemia,35,60,1,0,1
Gujarat,Kheda,Thalassemia,0,6,4,1,5
Gujarat,Kheda,Thalassemia,6,15,14,6,20
Gujarat,Kheda,Thalassemia,15,35,15,8,23
Madhya Pradesh,Khargone,Thalassemia,0,6,9,4,13
Madhya Pradesh,Khargone,Thalassemia,6,15,8,6,14
Madhya Pradesh,Khargone,Thalassemia,15,35,4,2,6
Madhya Pradesh,Khargone,Thalassemia,60,80,0,1,1
Bihar,Khagaria,Thalassemia,6,15,3,0,3
Odisha,Kendujhar,Thalassemia,0,6,1,9,10
Odisha,Kendujhar,Thalassemia,6,15,24,16,40
Odisha,Kendujhar,Thalassemia,15,35,14,15,29
Odisha,Kendujhar,Thalassemia,35,60,1,2,3
Odisha,Kendrapara,Thalassemia,0,6,27,18,45
Odisha,Kendrapara,Thalassemia,6,15,72,43,115
Odisha,Kendrapara,Thalassemia,15,35,35,18,53
Odisha,Kendrapara,Thalassemia,35,60,1,1,2
Uttar Pradesh,Kaushambi,Thalassemia,15,35,2,0,2
Uttar Pradesh,Kaushambi,Thalassemia,35,60,0,1,1
Madhya Pradesh,Katni,Thalassemia,0,6,5,4,9
Madhya Pradesh,Katni,Thalassemia,6,15,10,3,13
Madhya Pradesh,Katni,Thalassemia,15,35,5,5,10
Bihar,Katihar,Thalassemia,15,35,0,1,1
Bihar,Katihar,Thalassemia,60,80,1,0,1
Jammu And Kashmir,Kathua,Thalassemia,0,6,1,1,2
Jammu And Kashmir,Kathua,Thalassemia,6,15,5,4,9
Jammu And Kashmir,Kathua,Thalassemia,15,35,1,2,3
Jammu And Kashmir,Kathua,Thalassemia,35,60,1,1,2
Jammu And Kashmir,Kathua,Thalassemia,60,80,2,0,2
Uttar Pradesh,Kasganj,Thalassemia,0,6,0,1,1
Uttar Pradesh,Kasganj,Thalassemia,6,15,1,1,2
Uttar Pradesh,Kasganj,Thalassemia,15,35,2,1,3
Kerala,Kasaragod,Thalassemia,0,6,1,2,3
Kerala,Kasaragod,Thalassemia,6,15,2,5,7
Kerala,Kasaragod,Thalassemia,15,35,3,1,4
Kerala,Kasaragod,Thalassemia,35,60,1,0,1
Kerala,Kasaragod,Thalassemia,60,80,0,1,1
Tamil Nadu,Karur,Thalassemia,0,6,0,1,1
Tamil Nadu,Karur,Thalassemia,6,15,0,1,1
Haryana,Karnal,Thalassemia,0,6,2,4,6
Haryana,Karnal,Thalassemia,6,15,13,12,25
Haryana,Karnal,Thalassemia,15,35,14,4,18
Haryana,Karnal,Thalassemia,60,80,0,1,1
Assam,Karimganj,Thalassemia,6,15,3,2,5
Assam,Karimganj,Thalassemia,15,35,1,0,1
Rajasthan,Karauli,Thalassemia,0,6,1,0,1
Rajasthan,Karauli,Thalassemia,6,15,6,2,8
Rajasthan,Karauli,Thalassemia,15,35,2,0,2
Punjab,Kapurthala,Thalassemia,6,15,8,7,15
Punjab,Kapurthala,Thalassemia,15,35,9,5,14
Punjab,Kapurthala,Thalassemia,60,80,1,0,1
Uttar Pradesh,Kanpur Nagar,Thalassemia,0,6,1,1,2
Uttar Pradesh,Kanpur Nagar,Thalassemia,6,15,6,1,7
Uttar Pradesh,Kanpur Nagar,Thalassemia,15,35,10,8,18
Uttar Pradesh,Kanpur Nagar,Thalassemia,35,60,1,0,1
Uttar Pradesh,Kanpur Nagar,Thalassemia,60,80,1,0,1
Uttar Pradesh,Kanpur Dehat,Thalassemia,0,6,1,0,1
Uttar Pradesh,Kanpur Dehat,Thalassemia,6,15,2,0,2
Uttar Pradesh,Kanpur Dehat,Thalassemia,15,35,1,0,1
Kerala,Kannur,Thalassemia,0,6,1,1,2
Kerala,Kannur,Thalassemia,6,15,3,1,4
Kerala,Kannur,Thalassemia,15,35,4,2,6
Uttar Pradesh,Kannauj,Thalassemia,0,6,1,0,1
Uttar Pradesh,Kannauj,Thalassemia,6,15,3,2,5
Chhattisgarh,Kanker,Thalassemia,0,6,1,0,1
Chhattisgarh,Kanker,Thalassemia,6,15,5,0,5
Chhattisgarh,Kanker,Thalassemia,15,35,3,1,4
Chhattisgarh,Kanker,Thalassemia,35,60,1,1,2
Chhattisgarh,Kanker,Thalassemia,60,80,1,0,1
Himachal Pradesh,Kangra,Thalassemia,0,6,1,2,3
Himachal Pradesh,Kangra,Thalassemia,6,15,5,6,11
Himachal Pradesh,Kangra,Thalassemia,15,35,18,6,24
Himachal Pradesh,Kangra,Thalassemia,35,60,5,0,5
Odisha,Kandhamal,Thalassemia,0,6,3,5,8
Odisha,Kandhamal,Thalassemia,6,15,6,3,9
Odisha,Kandhamal,Thalassemia,15,35,4,0,4
Odisha,Kandhamal,Thalassemia,60,80,0,1,1
Tamil Nadu,Kanchipuram,Thalassemia,6,15,1,0,1
Assam,Kamrup Metro,Thalassemia,6,15,4,0,4
Assam,Kamrup Metro,Thalassemia,15,35,10,7,17
Assam,Kamrup,Thalassemia,6,15,6,5,11
Assam,Kamrup,Thalassemia,15,35,5,8,13
Assam,Kamrup,Thalassemia,35,60,0,1,1
Tamil Nadu,Kallakurichi,Thalassemia,6,15,1,0,1
Odisha,Kalahandi,Thalassemia,0,6,2,5,7
Odisha,Kalahandi,Thalassemia,6,15,9,6,15
Odisha,Kalahandi,Thalassemia,15,35,3,4,7
Odisha,Kalahandi,Thalassemia,35,60,1,3,4
Karnataka,Kalaburagi,Thalassemia,0,6,3,2,5
Karnataka,Kalaburagi,Thalassemia,6,15,0,2,2
Karnataka,Kalaburagi,Thalassemia,15,35,5,3,8
Karnataka,Kalaburagi,Thalassemia,35,60,0,1,1
Haryana,Kaithal,Thalassemia,6,15,1,1,2
Haryana,Kaithal,Thalassemia,15,35,3,1,4
Bihar,Kaimur (Bhabua),Thalassemia,6,15,0,1,1
Bihar,Kaimur (Bhabua),Thalassemia,15,35,1,0,1
Bihar,Kaimur (Bhabua),Thalassemia,35,60,2,0,2
Bihar,Kaimur (Bhabua),Thalassemia,60,80,1,0,1
Gujarat,Kachchh,Thalassemia,0,6,10,13,23
Gujarat,Kachchh,Thalassemia,6,15,61,38,99
Gujarat,Kachchh,Thalassemia,15,35,24,16,40
Gujarat,Kachchh,Thalassemia,35,60,1,2,3
Chhattisgarh,Kabirdham,Thalassemia,15,35,0,1,1
Gujarat,Junagadh,Thalassemia,0,6,4,3,7
Gujarat,Junagadh,Thalassemia,6,15,25,26,51
Gujarat,Junagadh,Thalassemia,15,35,18,13,31
Assam,Jorhat,Thalassemia,0,6,6,6,12
Assam,Jorhat,Thalassemia,6,15,11,7,18
Assam,Jorhat,Thalassemia,15,35,1,1,2
Assam,Jorhat,Thalassemia,35,60,1,0,1
Rajasthan,Jodhpur,Thalassemia,0,6,4,5,9
Rajasthan,Jodhpur,Thalassemia,6,15,17,9,26
Rajasthan,Jodhpur,Thalassemia,15,35,21,10,31
Haryana,Jind,Thalassemia,0,6,1,0,1
Haryana,Jind,Thalassemia,6,15,0,3,3
Haryana,Jind,Thalassemia,15,35,5,0,5
Rajasthan,Jhunjhunu,Thalassemia,6,15,3,1,4
Rajasthan,Jhunjhunu,Thalassemia,15,35,2,0,2
Rajasthan,Jhunjhunu,Thalassemia,35,60,2,0,2
Odisha,Jharsuguda,Thalassemia,6,15,5,3,8
Odisha,Jharsuguda,Thalassemia,15,35,2,0,2
Uttar Pradesh,Jhansi,Thalassemia,6,15,1,0,1
Uttar Pradesh,Jhansi,Thalassemia,15,35,3,0,3
Uttar Pradesh,Jhansi,Thalassemia,35,60,1,0,1
Rajasthan,Jhalawar,Thalassemia,0,6,4,2,6
Rajasthan,Jhalawar,Thalassemia,6,15,10,3,13
Rajasthan,Jhalawar,Thalassemia,15,35,8,2,10
Haryana,Jhajjar,Thalassemia,0,6,1,0,1
Haryana,Jhajjar,Thalassemia,6,15,1,0,1
Haryana,Jhajjar,Thalassemia,15,35,2,1,3
Madhya Pradesh,Jhabua,Thalassemia,6,15,2,1,3
Madhya Pradesh,Jhabua,Thalassemia,35,60,1,0,1
Madhya Pradesh,Jhabua,Thalassemia,60,80,0,1,1
Uttar Pradesh,Jaunpur,Thalassemia,6,15,6,1,7
Uttar Pradesh,Jaunpur,Thalassemia,15,35,6,1,7
Uttar Pradesh,Jaunpur,Thalassemia,35,60,3,1,4
Uttar Pradesh,Jaunpur,Thalassemia,60,80,1,0,1
Chhattisgarh,Jashpur,Thalassemia,0,6,3,4,7
Chhattisgarh,Jashpur,Thalassemia,6,15,7,5,12
Chhattisgarh,Jashpur,Thalassemia,15,35,2,2,4
Chhattisgarh,Janjgir-Champa,Thalassemia,6,15,1,0,1
Chhattisgarh,Janjgir-Champa,Thalassemia,15,35,2,1,3
Chhattisgarh,Janjgir-Champa,Thalassemia,35,60,1,0,1
Bihar,Jamui,Thalassemia,0,6,1,0,1
Bihar,Jamui,Thalassemia,6,15,1,0,1
Bihar,Jamui,Thalassemia,35,60,2,0,2
Jharkhand,Jamtara,Thalassemia,0,6,5,1,6
Jharkhand,Jamtara,Thalassemia,6,15,8,3,11
Jharkhand,Jamtara,Thalassemia,15,35,2,1,3
Gujarat,Jamnagar,Thalassemia,0,6,3,0,3
Gujarat,Jamnagar,Thalassemia,6,15,47,35,82
Gujarat,Jamnagar,Thalassemia,15,35,58,48,106
Gujarat,Jamnagar,Thalassemia,35,60,3,1,4
Jammu And Kashmir,Jammu,Thalassemia,6,15,3,6,9
Jammu And Kashmir,Jammu,Thalassemia,15,35,17,4,21
Jammu And Kashmir,Jammu,Thalassemia,35,60,1,4,5
Rajasthan,Jalore,Thalassemia,0,6,0,1,1
Rajasthan,Jalore,Thalassemia,6,15,2,3,5
Rajasthan,Jalore,Thalassemia,15,35,3,0,3
Rajasthan,Jalore,Thalassemia,35,60,0,1,1
Maharashtra,Jalna,Thalassemia,0,6,6,0,6
Maharashtra,Jalna,Thalassemia,6,15,20,13,33
Maharashtra,Jalna,Thalassemia,15,35,8,2,10
Maharashtra,Jalna,Thalassemia,35,60,1,1,2
Maharashtra,Jalgaon,Thalassemia,0,6,10,5,15
Maharashtra,Jalgaon,Thalassemia,6,15,31,16,47
Maharashtra,Jalgaon,Thalassemia,15,35,16,4,20
Maharashtra,Jalgaon,Thalassemia,35,60,1,2,3
Uttar Pradesh,Jalaun,Thalassemia,0,6,0,1,1
Uttar Pradesh,Jalaun,Thalassemia,6,15,2,0,2
Uttar Pradesh,Jalaun,Thalassemia,15,35,3,1,4
Uttar Pradesh,Jalaun,Thalassemia,35,60,1,0,1
Punjab,Jalandhar,Thalassemia,0,6,5,5,10
Punjab,Jalandhar,Thalassemia,6,15,33,23,56
Punjab,Jalandhar,Thalassemia,15,35,28,18,46
Punjab,Jalandhar,Thalassemia,35,60,1,0,1
Punjab,Jalandhar,Thalassemia,60,80,1,0,1
Odisha,Jajapur,Thalassemia,0,6,17,16,33
Odisha,Jajapur,Thalassemia,6,15,56,35,91
Odisha,Jajapur,Thalassemia,15,35,48,28,76
Odisha,Jajapur,Thalassemia,35,60,8,3,11
Odisha,Jajapur,Thalassemia,60,80,0,1,1
Rajasthan,Jaisalmer,Thalassemia,6,15,3,3,6
Rajasthan,Jaisalmer,Thalassemia,15,35,1,1,2
Rajasthan,Jaisalmer,Thalassemia,35,60,2,1,3
Rajasthan,Jaipur,Thalassemia,0,6,4,7,11
Rajasthan,Jaipur,Thalassemia,6,15,18,14,32
Rajasthan,Jaipur,Thalassemia,15,35,22,11,33
Rajasthan,Jaipur,Thalassemia,35,60,2,1,3
Odisha,Jagatsinghapur,Thalassemia,0,6,11,10,21
Odisha,Jagatsinghapur,Thalassemia,6,15,45,27,72
Odisha,Jagatsinghapur,Thalassemia,15,35,30,16,46
Odisha,Jagatsinghapur,Thalassemia,35,60,3,1,4
Madhya Pradesh,Jabalpur,Thalassemia,0,6,5,10,15
Madhya Pradesh,Jabalpur,Thalassemia,6,15,19,12,31
Madhya Pradesh,Jabalpur,Thalassemia,15,35,11,7,18
Madhya Pradesh,Jabalpur,Thalassemia,35,60,3,1,4
Madhya Pradesh,Indore,Thalassemia,0,6,1,2,3
Madhya Pradesh,Indore,Thalassemia,6,15,23,14,37
Madhya Pradesh,Indore,Thalassemia,15,35,19,16,35
Madhya Pradesh,Indore,Thalassemia,35,60,2,1,3
Manipur,Imphal West,Thalassemia,6,15,0,1,1
Punjab,Hoshiarpur,Thalassemia,0,6,1,2,3
Punjab,Hoshiarpur,Thalassemia,6,15,7,9,16
Punjab,Hoshiarpur,Thalassemia,15,35,7,6,13
Punjab,Hoshiarpur,Thalassemia,35,60,2,1,3
Punjab,Hoshiarpur,Thalassemia,60,80,1,0,1
Assam,Hojai,Thalassemia,6,15,1,0,1
Haryana,Hisar,Thalassemia,0,6,4,0,4
Haryana,Hisar,Thalassemia,6,15,7,3,10
Haryana,Hisar,Thalassemia,15,35,11,12,23
Haryana,Hisar,Thalassemia,35,60,1,0,1
Maharashtra,Hingoli,Thalassemia,0,6,2,3,5
Maharashtra,Hingoli,Thalassemia,6,15,8,6,14
Maharashtra,Hingoli,Thalassemia,15,35,2,3,5
Jharkhand,Hazaribagh,Thalassemia,0,6,1,0,1
Jharkhand,Hazaribagh,Thalassemia,6,15,5,3,8
Jharkhand,Hazaribagh,Thalassemia,15,35,0,1,1
Jharkhand,Hazaribagh,Thalassemia,35,60,3,0,3
Karnataka,Haveri,Thalassemia,0,6,8,2,10
Karnataka,Haveri,Thalassemia,6,15,14,10,24
Karnataka,Haveri,Thalassemia,15,35,1,1,2
Karnataka,Haveri,Thalassemia,35,60,1,0,1
Uttar Pradesh,Hathras,Thalassemia,6,15,4,1,5
Uttar Pradesh,Hathras,Thalassemia,15,35,4,0,4
Uttar Pradesh,Hathras,Thalassemia,60,80,1,0,1
Karnataka,Hassan,Thalassemia,0,6,2,3,5
Karnataka,Hassan,Thalassemia,6,15,8,7,15
Karnataka,Hassan,Thalassemia,15,35,4,5,9
Karnataka,Hassan,Thalassemia,35,60,2,1,3
Karnataka,Hassan,Thalassemia,60,80,1,1,2
Uttarakhand,Haridwar,Thalassemia,6,15,3,1,4
Uttarakhand,Haridwar,Thalassemia,15,35,4,2,6
Uttarakhand,Haridwar,Thalassemia,35,60,1,1,2
Uttar Pradesh,Hardoi,Thalassemia,15,35,3,0,3
Madhya Pradesh,Harda,Thalassemia,0,6,2,0,2
Madhya Pradesh,Harda,Thalassemia,6,15,0,2,2
Madhya Pradesh,Harda,Thalassemia,15,35,1,0,1
Madhya Pradesh,Harda,Thalassemia,35,60,1,0,1
Uttar Pradesh,Hapur,Thalassemia,6,15,2,1,3
Uttar Pradesh,Hapur,Thalassemia,15,35,2,2,4
Rajasthan,Hanumangarh,Thalassemia,0,6,1,1,2
Rajasthan,Hanumangarh,Thalassemia,6,15,12,7,19
Rajasthan,Hanumangarh,Thalassemia,15,35,15,3,18
Himachal Pradesh,Hamirpur,Thalassemia,0,6,1,1,2
Himachal Pradesh,Hamirpur,Thalassemia,6,15,3,3,6
Himachal Pradesh,Hamirpur,Thalassemia,15,35,7,0,7
Himachal Pradesh,Hamirpur,Thalassemia,60,80,1,0,1
Uttar Pradesh,Hamirpur,Thalassemia,15,35,4,1,5
Uttar Pradesh,Hamirpur,Thalassemia,35,60,7,0,7
Uttar Pradesh,Hamirpur,Thalassemia,60,80,3,1,4
Assam,Hailakandi,Thalassemia,15,35,0,1,1
Madhya Pradesh,Gwalior,Thalassemia,6,15,4,2,6
Madhya Pradesh,Gwalior,Thalassemia,15,35,6,5,11
Haryana,Gurugram,Thalassemia,0,6,2,1,3
Haryana,Gurugram,Thalassemia,6,15,6,3,9
Haryana,Gurugram,Thalassemia,15,35,16,11,27
Haryana,Gurugram,Thalassemia,35,60,1,2,3
Punjab,Gurdaspur,Thalassemia,0,6,2,1,3
Punjab,Gurdaspur,Thalassemia,6,15,9,6,15
Punjab,Gurdaspur,Thalassemia,15,35,7,5,12
Punjab,Gurdaspur,Thalassemia,35,60,1,0,1
Punjab,Gurdaspur,Thalassemia,60,80,1,0,1
Madhya Pradesh,Guna,Thalassemia,0,6,6,2,8
Madhya Pradesh,Guna,Thalassemia,6,15,9,3,12
Madhya Pradesh,Guna,Thalassemia,15,35,2,0,2
Jharkhand,Gumla,Thalassemia,0,6,1,2,3
Jharkhand,Gumla,Thalassemia,6,15,2,4,6
Jharkhand,Gumla,Thalassemia,15,35,25,15,40
Jharkhand,Gumla,Thalassemia,35,60,19,15,34
Jharkhand,Gumla,Thalassemia,60,80,13,3,16
Uttar Pradesh,Gorakhpur,Thalassemia,0,6,1,0,1
Uttar Pradesh,Gorakhpur,Thalassemia,6,15,2,0,2
Uttar Pradesh,Gorakhpur,Thalassemia,15,35,5,5,10
Uttar Pradesh,Gorakhpur,Thalassemia,35,60,4,0,4
Uttar Pradesh,Gorakhpur,Thalassemia,60,80,2,0,2
Bihar,Gopalganj,Thalassemia,0,6,3,0,3
Bihar,Gopalganj,Thalassemia,6,15,3,2,5
Bihar,Gopalganj,Thalassemia,15,35,1,1,2
Maharashtra,Gondia,Thalassemia,0,6,2,1,3
Maharashtra,Gondia,Thalassemia,6,15,5,5,10
Maharashtra,Gondia,Thalassemia,15,35,3,1,4
Uttar Pradesh,Gonda,Thalassemia,0,6,1,0,1
Uttar Pradesh,Gonda,Thalassemia,6,15,1,0,1
Uttar Pradesh,Gonda,Thalassemia,15,35,2,0,2
Uttar Pradesh,Gonda,Thalassemia,35,60,5,1,6
Uttar Pradesh,Gonda,Thalassemia,60,80,2,1,3
Tripura,Gomati,Thalassemia,0,6,1,0,1
Tripura,Gomati,Thalassemia,6,15,3,3,6
Tripura,Gomati,Thalassemia,15,35,5,2,7
Tripura,Gomati,Thalassemia,35,60,1,0,1
Assam,Golaghat,Thalassemia,0,6,3,2,5
Assam,Golaghat,Thalassemia,6,15,4,6,10
Assam,Golaghat,Thalassemia,15,35,4,5,9
Jharkhand,Godda,Thalassemia,6,15,0,1,1
Jharkhand,Godda,Thalassemia,15,35,0,1,1
Jharkhand,Godda,Thalassemia,35,60,2,1,3
Jharkhand,Godda,Thalassemia,60,80,0,1,1
Assam,Goalpara,Thalassemia,0,6,1,0,1
Assam,Goalpara,Thalassemia,6,15,1,5,6
Assam,Goalpara,Thalassemia,15,35,4,4,8
Assam,Goalpara,Thalassemia,35,60,1,0,1
Jharkhand,Giridih,Thalassemia,0,6,4,1,5
Jharkhand,Giridih,Thalassemia,6,15,14,4,18
Jharkhand,Giridih,Thalassemia,15,35,6,3,9
Jharkhand,Giridih,Thalassemia,35,60,1,0,1
Gujarat,Gir Somnath,Thalassemia,6,15,24,13,37
Gujarat,Gir Somnath,Thalassemia,15,35,18,9,27
Uttar Pradesh,Ghazipur,Thalassemia,0,6,2,0,2
Uttar Pradesh,Ghazipur,Thalassemia,6,15,3,1,4
Uttar Pradesh,Ghazipur,Thalassemia,15,35,2,0,2
Uttar Pradesh,Ghaziabad,Thalassemia,0,6,1,0,1
Uttar Pradesh,Ghaziabad,Thalassemia,6,15,6,3,9
Uttar Pradesh,Ghaziabad,Thalassemia,15,35,12,7,19
Bihar,Gaya,Thalassemia,6,15,0,1,1
Bihar,Gaya,Thalassemia,15,35,1,0,1
Bihar,Gaya,Thalassemia,35,60,1,1,2
Uttar Pradesh,Gautam Buddha Nagar,Thalassemia,0,6,2,0,2
Uttar Pradesh,Gautam Buddha Nagar,Thalassemia,6,15,2,0,2
Uttar Pradesh,Gautam Buddha Nagar,Thalassemia,15,35,6,1,7
Uttar Pradesh,Gautam Buddha Nagar,Thalassemia,35,60,1,0,1
Chhattisgarh,Gaurella Pendra Marwahi,Thalassemia,15,35,0,2,2
Chhattisgarh,Gariyaband,Thalassemia,0,6,1,1,2
Chhattisgarh,Gariyaband,Thalassemia,6,15,1,1,2
Chhattisgarh,Gariyaband,Thalassemia,15,35,4,1,5
Jharkhand,Garhwa,Thalassemia,0,6,2,5,7
Jharkhand,Garhwa,Thalassemia,6,15,14,4,18
Jharkhand,Garhwa,Thalassemia,15,35,5,1,6
Jharkhand,Garhwa,Thalassemia,35,60,2,1,3
Jharkhand,Garhwa,Thalassemia,60,80,1,0,1
Odisha,Ganjam,Thalassemia,0,6,12,12,24
Odisha,Ganjam,Thalassemia,6,15,37,30,67
Odisha,Ganjam,Thalassemia,15,35,16,9,25
Rajasthan,Ganganagar,Thalassemia,0,6,3,5,8
Rajasthan,Ganganagar,Thalassemia,6,15,12,12,24
Rajasthan,Ganganagar,Thalassemia,15,35,12,7,19
Gujarat,Gandhinagar,Thalassemia,0,6,2,0,2
Gujarat,Gandhinagar,Thalassemia,6,15,6,3,9
Gujarat,Gandhinagar,Thalassemia,15,35,7,8,15
Jammu And Kashmir,Ganderbal,Thalassemia,6,15,0,1,1
Jammu And Kashmir,Ganderbal,Thalassemia,15,35,1,1,2
Jammu And Kashmir,Ganderbal,Thalassemia,35,60,1,0,1
Jammu And Kashmir,Ganderbal,Thalassemia,60,80,2,0,2
Odisha,Gajapati,Thalassemia,0,6,4,5,9
Odisha,Gajapati,Thalassemia,6,15,9,5,14
Odisha,Gajapati,Thalassemia,15,35,1,2,3
Maharashtra,Gadchiroli,Thalassemia,0,6,2,1,3
Maharashtra,Gadchiroli,Thalassemia,6,15,4,4,8
Maharashtra,Gadchiroli,Thalassemia,15,35,7,3,10
Maharashtra,Gadchiroli,Thalassemia,35,60,5,3,8
Maharashtra,Gadchiroli,Thalassemia,60,80,0,1,1
Karnataka,Gadag,Thalassemia,0,6,7,0,7
Karnataka,Gadag,Thalassemia,6,15,8,2,10
Karnataka,Gadag,Thalassemia,15,35,2,0,2
Uttar Pradesh,Firozabad,Thalassemia,0,6,1,0,1
Uttar Pradesh,Firozabad,Thalassemia,6,15,3,1,4
Uttar Pradesh,Firozabad,Thalassemia,15,35,1,1,2
Uttar Pradesh,Firozabad,Thalassemia,35,60,2,1,3
Punjab,Ferozepur,Thalassemia,0,6,2,1,3
Punjab,Ferozepur,Thalassemia,6,15,8,8,16
Punjab,Ferozepur,Thalassemia,15,35,4,4,8
Punjab,Fazilka,Thalassemia,0,6,2,6,8
Punjab,Fazilka,Thalassemia,6,15,7,7,14
Punjab,Fazilka,Thalassemia,15,35,6,2,8
Uttar Pradesh,Fatehpur,Thalassemia,0,6,0,1,1
Uttar Pradesh,Fatehpur,Thalassemia,6,15,2,1,3
Uttar Pradesh,Fatehpur,Thalassemia,15,35,4,0,4
Uttar Pradesh,Fatehpur,Thalassemia,35,60,4,0,4
Uttar Pradesh,Fatehpur,Thalassemia,60,80,1,0,1
Punjab,Fatehgarh Sahib,Thalassemia,0,6,0,1,1
Punjab,Fatehgarh Sahib,Thalassemia,6,15,6,8,14
Punjab,Fatehgarh Sahib,Thalassemia,15,35,12,1,13
Punjab,Fatehgarh Sahib,Thalassemia,35,60,1,0,1
Haryana,Fatehabad,Thalassemia,0,6,3,2,5
Haryana,Fatehabad,Thalassemia,6,15,9,11,20
Haryana,Fatehabad,Thalassemia,15,35,7,6,13
Haryana,Fatehabad,Thalassemia,35,60,1,0,1
Uttar Pradesh,Farrukhabad,Thalassemia,0,6,1,0,1
Uttar Pradesh,Farrukhabad,Thalassemia,6,15,2,3,5
Uttar Pradesh,Farrukhabad,Thalassemia,15,35,10,2,12
Uttar Pradesh,Farrukhabad,Thalassemia,35,60,5,4,9
Uttar Pradesh,Farrukhabad,Thalassemia,60,80,6,1,7
Uttar Pradesh,Farrukhabad,Thalassemia,80,100,1,0,1
Punjab,Faridkot,Thalassemia,0,6,2,0,2
Punjab,Faridkot,Thalassemia,6,15,3,6,9
Punjab,Faridkot,Thalassemia,15,35,7,3,10
Haryana,Faridabad,Thalassemia,0,6,3,1,4
Haryana,Faridabad,Thalassemia,6,15,20,3,23
Haryana,Faridabad,Thalassemia,15,35,21,16,37
Haryana,Faridabad,Thalassemia,35,60,3,1,4
Uttar Pradesh,Etawah,Thalassemia,15,35,4,0,4
Uttar Pradesh,Etawah,Thalassemia,35,60,1,0,1
Uttar Pradesh,Etawah,Thalassemia,60,80,1,0,1
Uttar Pradesh,Etah,Thalassemia,6,15,1,0,1
Uttar Pradesh,Etah,Thalassemia,15,35,5,0,5
Uttar Pradesh,Etah,Thalassemia,35,60,3,0,3
Tamil Nadu,Erode,Thalassemia,0,6,3,0,3
Tamil Nadu,Erode,Thalassemia,6,15,7,5,12
Tamil Nadu,Erode,Thalassemia,15,35,3,2,5
Kerala,Ernakulam,Thalassemia,0,6,1,0,1
Kerala,Ernakulam,Thalassemia,6,15,1,1,2
Kerala,Ernakulam,Thalassemia,15,35,0,3,3
Jharkhand,East Singhbum,Thalassemia,0,6,1,0,1
Jharkhand,East Singhbum,Thalassemia,6,15,2,4,6
Jharkhand,East Singhbum,Thalassemia,15,35,13,8,21
Jharkhand,East Singhbum,Thalassemia,35,60,4,1,5
Jharkhand,East Singhbum,Thalassemia,60,80,1,0,1
Madhya Pradesh,East Nimar,Thalassemia,0,6,4,3,7
Madhya Pradesh,East Nimar,Thalassemia,6,15,5,5,10
Madhya Pradesh,East Nimar,Thalassemia,15,35,8,3,11
Meghalaya,East Khasi Hills,Thalassemia,15,35,1,1,2
Andhra Pradesh,East Godavari,Thalassemia,60,80,1,0,1
Delhi,East,Thalassemia,0,6,7,2,9
Delhi,East,Thalassemia,6,15,13,12,25
Delhi,East,Thalassemia,15,35,29,20,49
Delhi,East,Thalassemia,35,60,2,1,3
Chhattisgarh,Durg,Thalassemia,0,6,0,1,1
Chhattisgarh,Durg,Thalassemia,6,15,6,8,14
Chhattisgarh,Durg,Thalassemia,15,35,12,8,20
Chhattisgarh,Durg,Thalassemia,35,60,2,1,3
Chhattisgarh,Durg,Thalassemia,60,80,1,0,1
Rajasthan,Dungarpur,Thalassemia,6,15,3,2,5
Rajasthan,Dungarpur,Thalassemia,15,35,2,1,3
Jharkhand,Dumka,Thalassemia,6,15,1,0,1
Jharkhand,Dumka,Thalassemia,15,35,0,1,1
Jharkhand,Dumka,Thalassemia,35,60,1,0,1
Gujarat,Dohad,Thalassemia,0,6,0,1,1
Gujarat,Dohad,Thalassemia,6,15,5,2,7
Gujarat,Dohad,Thalassemia,15,35,4,1,5
Jammu And Kashmir,Doda,Thalassemia,60,80,1,0,1
Dadra Nagar Haveli And Daman And Diu,Diu,Thalassemia,6,15,0,1,1
Tamil Nadu,Dindigul,Thalassemia,0,6,0,1,1
Tamil Nadu,Dindigul,Thalassemia,6,15,1,3,4
Tamil Nadu,Dindigul,Thalassemia,15,35,4,1,5
Tamil Nadu,Dindigul,Thalassemia,35,60,1,0,1
Assam,Dibrugarh,Thalassemia,6,15,2,3,5
Assam,Dibrugarh,Thalassemia,15,35,2,2,4
Maharashtra,Dhule,Thalassemia,0,6,3,1,4
Maharashtra,Dhule,Thalassemia,6,15,6,7,13
Maharashtra,Dhule,Thalassemia,15,35,9,0,9
Maharashtra,Dhule,Thalassemia,35,60,2,1,3
Maharashtra,Dhule,Thalassemia,60,80,1,0,1
Assam,Dhubri,Thalassemia,35,60,0,2,2
Rajasthan,Dholpur,Thalassemia,0,6,0,1,1
Rajasthan,Dholpur,Thalassemia,6,15,3,0,3
Rajasthan,Dholpur,Thalassemia,15,35,5,1,6
Odisha,Dhenkanal,Thalassemia,0,6,7,2,9
Odisha,Dhenkanal,Thalassemia,6,15,30,20,50
Odisha,Dhenkanal,Thalassemia,15,35,17,8,25
Odisha,Dhenkanal,Thalassemia,35,60,3,3,6
Assam,Dhemaji,Thalassemia,6,15,0,2,2
Assam,Dhemaji,Thalassemia,15,35,1,0,1
Karnataka,Dharwad,Thalassemia,0,6,1,3,4
Karnataka,Dharwad,Thalassemia,6,15,9,1,10
Karnataka,Dharwad,Thalassemia,15,35,1,4,5
Karnataka,Dharwad,Thalassemia,35,60,1,1,2
Tamil Nadu,Dharmapuri,Thalassemia,0,6,1,3,4
Tamil Nadu,Dharmapuri,Thalassemia,6,15,7,7,14
Tamil Nadu,Dharmapuri,Thalassemia,15,35,12,3,15
Tamil Nadu,Dharmapuri,Thalassemia,35,60,2,0,2
Madhya Pradesh,Dhar,Thalassemia,0,6,1,0,1
Madhya Pradesh,Dhar,Thalassemia,6,15,3,8,11
Madhya Pradesh,Dhar,Thalassemia,15,35,3,0,3
Madhya Pradesh,Dhar,Thalassemia,35,60,0,1,1
Jharkhand,Dhanbad,Thalassemia,0,6,1,0,1
Jharkhand,Dhanbad,Thalassemia,6,15,1,0,1
Jharkhand,Dhanbad,Thalassemia,15,35,1,1,2
Jharkhand,Dhanbad,Thalassemia,35,60,1,2,3
Chhattisgarh,Dhamtari,Thalassemia,6,15,0,1,1
Tripura,Dhalai,Thalassemia,6,15,2,2,4
Tripura,Dhalai,Thalassemia,15,35,3,1,4
Tripura,Dhalai,Thalassemia,35,60,0,1,1
Madhya Pradesh,Dewas,Thalassemia,0,6,1,1,2
Madhya Pradesh,Dewas,Thalassemia,6,15,2,2,4
Madhya Pradesh,Dewas,Thalassemia,15,35,7,2,9
Madhya Pradesh,Dewas,Thalassemia,35,60,1,0,1
Gujarat,Devbhumi Dwarka,Thalassemia,0,6,3,1,4
Gujarat,Devbhumi Dwarka,Thalassemia,6,15,16,9,25
Gujarat,Devbhumi Dwarka,Thalassemia,15,35,8,7,15
Uttar Pradesh,Deoria,Thalassemia,0,6,1,0,1
Uttar Pradesh,Deoria,Thalassemia,6,15,9,4,13
Uttar Pradesh,Deoria,Thalassemia,15,35,4,1,5
Uttar Pradesh,Deoria,Thalassemia,35,60,3,0,3
Jharkhand,Deoghar,Thalassemia,0,6,0,1,1
Jharkhand,Deoghar,Thalassemia,6,15,6,3,9
Jharkhand,Deoghar,Thalassemia,15,35,7,5,12
Jharkhand,Deoghar,Thalassemia,35,60,5,3,8
Jharkhand,Deoghar,Thalassemia,60,80,0,1,1
Odisha,Deogarh,Thalassemia,0,6,1,0,1
Odisha,Deogarh,Thalassemia,6,15,3,0,3
Odisha,Deogarh,Thalassemia,15,35,1,0,1
Uttarakhand,Dehradun,Thalassemia,6,15,5,1,6
Uttarakhand,Dehradun,Thalassemia,15,35,4,3,7
Karnataka,Davangere,Thalassemia,0,6,6,4,10
Karnataka,Davangere,Thalassemia,6,15,10,10,20
Karnataka,Davangere,Thalassemia,15,35,10,1,11
Karnataka,Davangere,Thalassemia,35,60,1,0,1
Karnataka,Davangere,Thalassemia,60,80,1,0,1
Rajasthan,Dausa,Thalassemia,6,15,3,0,3
Rajasthan,Dausa,Thalassemia,15,35,8,1,9
Madhya Pradesh,Datia,Thalassemia,0,6,0,1,1
Madhya Pradesh,Datia,Thalassemia,6,15,4,1,5
Madhya Pradesh,Datia,Thalassemia,15,35,4,4,8
Assam,Darrang,Thalassemia,6,15,1,0,1
Assam,Darrang,Thalassemia,35,60,1,0,1
Bihar,Darbhanga,Thalassemia,15,35,1,2,3
Bihar,Darbhanga,Thalassemia,35,60,4,0,4
Chhattisgarh,Dantewada,Thalassemia,0,6,1,0,1
Chhattisgarh,Dantewada,Thalassemia,6,15,0,1,1
Gujarat,Dang,Thalassemia,6,15,1,0,1
Madhya Pradesh,Damoh,Thalassemia,6,15,4,0,4
Madhya Pradesh,Damoh,Thalassemia,15,35,2,3,5
Madhya Pradesh,Damoh,Thalassemia,35,60,0,1,1
Dadra Nagar Haveli And Daman And Diu,Daman,Thalassemia,6,15,1,0,1
Dadra Nagar Haveli And Daman And Diu,Daman,Thalassemia,15,35,1,0,1
Dadra Nagar Haveli And Daman And Diu,Daman,Thalassemia,60,80,0,1,1
Karnataka,Dakshina Kannada,Thalassemia,0,6,1,5,6
Karnataka,Dakshina Kannada,Thalassemia,6,15,9,10,19
Karnataka,Dakshina Kannada,Thalassemia,15,35,6,11,17
Dadra Nagar Haveli And Daman And Diu,Dadra And Nagar Haveli,Thalassemia,0,6,1,0,1
Dadra Nagar Haveli And Daman And Diu,Dadra And Nagar Haveli,Thalassemia,6,15,2,2,4
Dadra Nagar Haveli And Daman And Diu,Dadra And Nagar Haveli,Thalassemia,15,35,1,0,1
Odisha,Cuttack,Thalassemia,0,6,18,11,29
Odisha,Cuttack,Thalassemia,6,15,82,37,119
Odisha,Cuttack,Thalassemia,15,35,53,31,84
Odisha,Cuttack,Thalassemia,35,60,4,1,5
Odisha,Cuttack,Thalassemia,60,80,2,0,2
Tamil Nadu,Cuddalore,Thalassemia,6,15,2,0,2
Tamil Nadu,Coimbatore,Thalassemia,0,6,1,0,1
Tamil Nadu,Coimbatore,Thalassemia,6,15,6,6,12
Tamil Nadu,Coimbatore,Thalassemia,15,35,5,4,9
Tamil Nadu,Coimbatore,Thalassemia,35,60,1,0,1
Rajasthan,Churu,Thalassemia,0,6,1,0,1
Rajasthan,Churu,Thalassemia,6,15,0,4,4
Rajasthan,Churu,Thalassemia,15,35,4,1,5
Rajasthan,Chittorgarh,Thalassemia,0,6,1,1,2
Rajasthan,Chittorgarh,Thalassemia,6,15,14,3,17
Rajasthan,Chittorgarh,Thalassemia,15,35,8,2,10
Rajasthan,Chittorgarh,Thalassemia,35,60,1,1,2
Uttar Pradesh,Chitrakoot,Thalassemia,35,60,1,0,1
Karnataka,Chitradurga,Thalassemia,0,6,3,6,9
Karnataka,Chitradurga,Thalassemia,6,15,7,9,16
Karnataka,Chitradurga,Thalassemia,15,35,2,2,4
Karnataka,Chitradurga,Thalassemia,35,60,2,2,4
Assam,Chirang,Thalassemia,0,6,1,0,1
Assam,Chirang,Thalassemia,15,35,3,0,3
Karnataka,Chikkamagaluru,Thalassemia,0,6,1,2,3
Karnataka,Chikkamagaluru,Thalassemia,6,15,11,6,17
Karnataka,Chikkamagaluru,Thalassemia,15,35,5,5,10
Karnataka,Chikkamagaluru,Thalassemia,35,60,1,0,1
Karnataka,Chikkaballapura,Thalassemia,6,15,2,1,3
Karnataka,Chikkaballapura,Thalassemia,15,35,4,1,5
Karnataka,Chikkaballapura,Thalassemia,35,60,0,3,3
Gujarat,Chhotaudepur,Thalassemia,15,35,1,2,3
Madhya Pradesh,Chhindwara,Thalassemia,0,6,0,1,1
Madhya Pradesh,Chhindwara,Thalassemia,6,15,3,2,5
Madhya Pradesh,Chhindwara,Thalassemia,15,35,5,3,8
Madhya Pradesh,Chhindwara,Thalassemia,35,60,0,2,2
Madhya Pradesh,Chhindwara,Thalassemia,60,80,1,0,1
Madhya Pradesh,Chhatarpur,Thalassemia,0,6,1,0,1
Madhya Pradesh,Chhatarpur,Thalassemia,6,15,6,2,8
Madhya Pradesh,Chhatarpur,Thalassemia,15,35,3,1,4
Tamil Nadu,Chennai,Thalassemia,6,15,5,3,8
Tamil Nadu,Chennai,Thalassemia,15,35,6,12,18
Tamil Nadu,Chennai,Thalassemia,35,60,0,1,1
Tamil Nadu,Chengalpattu,Thalassemia,6,15,1,0,1
Tamil Nadu,Chengalpattu,Thalassemia,15,35,0,1,1
Jharkhand,Chatra,Thalassemia,6,15,2,2,4
Haryana,Charki Dadri,Thalassemia,6,15,3,1,4
Haryana,Charki Dadri,Thalassemia,15,35,3,1,4
Maharashtra,Chandrapur,Thalassemia,0,6,2,4,6
Maharashtra,Chandrapur,Thalassemia,6,15,26,15,41
Maharashtra,Chandrapur,Thalassemia,15,35,7,2,9
Chandigarh,Chandigarh,Thalassemia,0,6,0,1,1
Chandigarh,Chandigarh,Thalassemia,6,15,5,4,9
Chandigarh,Chandigarh,Thalassemia,15,35,11,7,18
Chandigarh,Chandigarh,Thalassemia,35,60,2,4,6
Uttar Pradesh,Chandauli,Thalassemia,6,15,1,0,1
Uttarakhand,Champawat,Thalassemia,35,60,3,1,4
Uttarakhand,Chamoli,Thalassemia,15,35,1,2,3
Uttarakhand,Chamoli,Thalassemia,35,60,9,1,10
Uttarakhand,Chamoli,Thalassemia,60,80,2,0,2
Himachal Pradesh,Chamba,Thalassemia,6,15,2,0,2
Himachal Pradesh,Chamba,Thalassemia,15,35,1,1,2
Himachal Pradesh,Chamba,Thalassemia,60,80,1,0,1
Karnataka,Chamarajanagara,Thalassemia,6,15,4,2,6
Karnataka,Chamarajanagara,Thalassemia,15,35,3,0,3
Delhi,Central,Thalassemia,6,15,9,3,12
Delhi,Central,Thalassemia,15,35,6,11,17
Delhi,Central,Thalassemia,35,60,2,2,4
Assam,Cachar,Thalassemia,6,15,3,2,5
Assam,Cachar,Thalassemia,15,35,3,3,6
Madhya Pradesh,Burhanpur,Thalassemia,0,6,0,1,1
Madhya Pradesh,Burhanpur,Thalassemia,6,15,1,6,7
Madhya Pradesh,Burhanpur,Thalassemia,15,35,0,2,2
Madhya Pradesh,Burhanpur,Thalassemia,35,60,0,1,1
Rajasthan,Bundi,Thalassemia,0,6,7,4,11
Rajasthan,Bundi,Thalassemia,6,15,18,6,24
Rajasthan,Bundi,Thalassemia,15,35,9,3,12
Rajasthan,Bundi,Thalassemia,35,60,1,2,3
Maharashtra,Buldhana,Thalassemia,0,6,18,15,33
Maharashtra,Buldhana,Thalassemia,6,15,41,27,68
Maharashtra,Buldhana,Thalassemia,15,35,12,5,17
Maharashtra,Buldhana,Thalassemia,35,60,3,1,4
Uttar Pradesh,Bulandshahr,Thalassemia,0,6,6,4,10
Uttar Pradesh,Bulandshahr,Thalassemia,6,15,8,2,10
Uttar Pradesh,Bulandshahr,Thalassemia,15,35,8,2,10
Uttar Pradesh,Bulandshahr,Thalassemia,35,60,2,1,3
Jammu And Kashmir,Budgam,Thalassemia,60,80,1,0,1
Uttar Pradesh,Budaun,Thalassemia,0,6,1,2,3
Uttar Pradesh,Budaun,Thalassemia,6,15,3,1,4
Uttar Pradesh,Budaun,Thalassemia,15,35,3,2,5
Odisha,Boudh,Thalassemia,0,6,1,0,1
Odisha,Boudh,Thalassemia,6,15,3,3,6
Odisha,Boudh,Thalassemia,15,35,2,1,3
Odisha,Boudh,Thalassemia,35,60,1,0,1
Gujarat,Botad,Thalassemia,0,6,1,0,1
Gujarat,Botad,Thalassemia,6,15,6,6,12
Gujarat,Botad,Thalassemia,15,35,16,2,18
Assam,Bongaigaon,Thalassemia,0,6,1,0,1
Assam,Bongaigaon,Thalassemia,6,15,2,1,3
Assam,Bongaigaon,Thalassemia,15,35,4,1,5
Assam,Bongaigaon,Thalassemia,35,60,1,0,1
Jharkhand,Bokaro,Thalassemia,0,6,2,4,6
Jharkhand,Bokaro,Thalassemia,6,15,16,9,25
Jharkhand,Bokaro,Thalassemia,15,35,10,12,22
Jharkhand,Bokaro,Thalassemia,35,60,9,5,14
Jharkhand,Bokaro,Thalassemia,60,80,1,0,1
Assam,Biswanath,Thalassemia,6,15,0,1,1
Assam,Biswanath,Thalassemia,15,35,1,0,1
Chhattisgarh,Bilaspur,Thalassemia,6,15,15,3,18
Chhattisgarh,Bilaspur,Thalassemia,15,35,5,5,10
Chhattisgarh,Bilaspur,Thalassemia,35,60,1,0,1
Himachal Pradesh,Bilaspur,Thalassemia,15,35,2,2,4
Rajasthan,Bikaner,Thalassemia,0,6,3,5,8
Rajasthan,Bikaner,Thalassemia,6,15,17,12,29
Rajasthan,Bikaner,Thalassemia,15,35,6,7,13
Uttar Pradesh,Bijnor,Thalassemia,0,6,2,0,2
Uttar Pradesh,Bijnor,Thalassemia,6,15,5,4,9
Uttar Pradesh,Bijnor,Thalassemia,15,35,7,2,9
Uttar Pradesh,Bijnor,Thalassemia,35,60,4,2,6
Chhattisgarh,Bijapur,Thalassemia,15,35,0,1,1
Chhattisgarh,Bijapur,Thalassemia,35,60,1,0,1
Karnataka,Bidar,Thalassemia,0,6,1,0,1
Karnataka,Bidar,Thalassemia,6,15,1,2,3
Karnataka,Bidar,Thalassemia,15,35,4,0,4
Karnataka,Bidar,Thalassemia,35,60,2,1,3
Madhya Pradesh,Bhopal,Thalassemia,0,6,1,2,3
Madhya Pradesh,Bhopal,Thalassemia,6,15,13,11,24
Madhya Pradesh,Bhopal,Thalassemia,15,35,11,4,15
Madhya Pradesh,Bhopal,Thalassemia,35,60,7,0,7
Bihar,Bhojpur,Thalassemia,15,35,1,1,2
Bihar,Bhojpur,Thalassemia,35,60,1,1,2
Bihar,Bhojpur,Thalassemia,60,80,2,0,2
Haryana,Bhiwani,Thalassemia,0,6,2,1,3
Haryana,Bhiwani,Thalassemia,6,15,3,4,7
Haryana,Bhiwani,Thalassemia,15,35,2,5,7
Haryana,Bhiwani,Thalassemia,35,60,2,0,2
Madhya Pradesh,Bhind,Thalassemia,0,6,0,1,1
Madhya Pradesh,Bhind,Thalassemia,6,15,3,2,5
Madhya Pradesh,Bhind,Thalassemia,60,80,1,0,1
Rajasthan,Bhilwara,Thalassemia,0,6,9,6,15
Rajasthan,Bhilwara,Thalassemia,6,15,16,11,27
Rajasthan,Bhilwara,Thalassemia,15,35,6,5,11
Rajasthan,Bhilwara,Thalassemia,35,60,1,1,2
Gujarat,Bhavnagar,Thalassemia,0,6,1,3,4
Gujarat,Bhavnagar,Thalassemia,6,15,17,12,29
Gujarat,Bhavnagar,Thalassemia,15,35,19,10,29
Gujarat,Bhavnagar,Thalassemia,35,60,1,1,2
Gujarat,Bharuch,Thalassemia,0,6,2,0,2
Gujarat,Bharuch,Thalassemia,6,15,10,9,19
Gujarat,Bharuch,Thalassemia,15,35,9,5,14
Gujarat,Bharuch,Thalassemia,35,60,1,1,2
Rajasthan,Bharatpur,Thalassemia,0,6,4,0,4
Rajasthan,Bharatpur,Thalassemia,6,15,6,8,14
Maharashtra,Bhandara,Thalassemia,0,6,3,7,10
Maharashtra,Bhandara,Thalassemia,6,15,17,11,28
Maharashtra,Bhandara,Thalassemia,15,35,11,8,19
Maharashtra,Bhandara,Thalassemia,35,60,1,0,1
Bihar,Bhagalpur,Thalassemia,0,6,0,1,1
Bihar,Bhagalpur,Thalassemia,6,15,3,0,3
Bihar,Bhagalpur,Thalassemia,15,35,2,2,4
Bihar,Bhagalpur,Thalassemia,35,60,1,0,1
Bihar,Bhagalpur,Thalassemia,60,80,1,0,1
Odisha,Bhadrak,Thalassemia,0,6,24,14,38
Odisha,Bhadrak,Thalassemia,6,15,63,45,108
Odisha,Bhadrak,Thalassemia,15,35,24,12,36
Odisha,Bhadrak,Thalassemia,35,60,5,0,5
Uttar Pradesh,Bhadohi,Thalassemia,6,15,2,0,2
Uttar Pradesh,Bhadohi,Thalassemia,15,35,2,0,2
Madhya Pradesh,Betul,Thalassemia,0,6,1,2,3
Madhya Pradesh,Betul,Thalassemia,6,15,3,4,7
Madhya Pradesh,Betul,Thalassemia,15,35,1,1,2
Madhya Pradesh,Betul,Thalassemia,35,60,2,1,3
Karnataka,Bengaluru Urban,Thalassemia,0,6,1,1,2
Karnataka,Bengaluru Urban,Thalassemia,6,15,8,1,9
Karnataka,Bengaluru Urban,Thalassemia,15,35,12,12,24
Karnataka,Bengaluru Urban,Thalassemia,35,60,1,0,1
Karnataka,Bengaluru Urban,Thalassemia,60,80,1,0,1
Karnataka,Bengaluru Rural,Thalassemia,15,35,1,1,2
Karnataka,Bengaluru Rural,Thalassemia,35,60,0,1,1
Chhattisgarh,Bemetara,Thalassemia,6,15,0,1,1
Chhattisgarh,Bemetara,Thalassemia,15,35,2,2,4
Karnataka,Belagavi,Thalassemia,0,6,8,3,11
Karnataka,Belagavi,Thalassemia,6,15,13,14,27
Karnataka,Belagavi,Thalassemia,15,35,17,4,21
Karnataka,Belagavi,Thalassemia,35,60,4,0,4
Bihar,Begusarai,Thalassemia,0,6,2,1,3
Bihar,Begusarai,Thalassemia,6,15,5,0,5
Bihar,Begusarai,Thalassemia,35,60,1,0,1
Maharashtra,Beed,Thalassemia,0,6,6,2,8
Maharashtra,Beed,Thalassemia,6,15,28,24,52
Maharashtra,Beed,Thalassemia,15,35,18,5,23
Maharashtra,Beed,Thalassemia,35,60,1,0,1
Maharashtra,Beed,Thalassemia,60,80,1,0,1
Punjab,Bathinda,Thalassemia,0,6,4,4,8
Punjab,Bathinda,Thalassemia,6,15,16,7,23
Punjab,Bathinda,Thalassemia,15,35,6,6,12
Punjab,Bathinda,Thalassemia,35,60,1,2,3
Uttar Pradesh,Basti,Thalassemia,6,15,1,1,2
Uttar Pradesh,Basti,Thalassemia,15,35,3,0,3
Uttar Pradesh,Basti,Thalassemia,35,60,4,0,4
Uttar Pradesh,Basti,Thalassemia,60,80,1,1,2
Chhattisgarh,Bastar,Thalassemia,0,6,0,1,1
Chhattisgarh,Bastar,Thalassemia,6,15,1,2,3
Chhattisgarh,Bastar,Thalassemia,15,35,1,1,2
Madhya Pradesh,Barwani,Thalassemia,0,6,0,2,2
Madhya Pradesh,Barwani,Thalassemia,6,15,2,4,6
Madhya Pradesh,Barwani,Thalassemia,15,35,1,0,1
Madhya Pradesh,Barwani,Thalassemia,35,60,0,1,1
Assam,Barpeta,Thalassemia,0,6,11,8,19
Assam,Barpeta,Thalassemia,6,15,17,11,28
Assam,Barpeta,Thalassemia,15,35,10,7,17
Assam,Barpeta,Thalassemia,35,60,3,2,5
Assam,Barpeta,Thalassemia,60,80,0,1,1
Assam,Barpeta,Thalassemia,80,100,1,0,1
Punjab,Barnala,Thalassemia,0,6,1,1,2
Punjab,Barnala,Thalassemia,6,15,5,2,7
Punjab,Barnala,Thalassemia,15,35,5,1,6
Rajasthan,Barmer,Thalassemia,0,6,3,0,3
Rajasthan,Barmer,Thalassemia,6,15,8,7,15
Rajasthan,Barmer,Thalassemia,15,35,2,0,2
Odisha,Bargarh,Thalassemia,0,6,0,1,1
Odisha,Bargarh,Thalassemia,6,15,5,2,7
Odisha,Bargarh,Thalassemia,15,35,7,0,7
Odisha,Bargarh,Thalassemia,35,60,1,0,1
Uttar Pradesh,Bareilly,Thalassemia,0,6,1,0,1
Uttar Pradesh,Bareilly,Thalassemia,6,15,8,3,11
Uttar Pradesh,Bareilly,Thalassemia,15,35,9,9,18
Uttar Pradesh,Bareilly,Thalassemia,35,60,4,0,4
Rajasthan,Baran,Thalassemia,0,6,2,1,3
Rajasthan,Baran,Thalassemia,6,15,9,7,16
Rajasthan,Baran,Thalassemia,15,35,5,5,10
Rajasthan,Baran,Thalassemia,35,60,0,1,1
Jammu And Kashmir,Baramulla,Thalassemia,6,15,1,1,2
Jammu And Kashmir,Baramulla,Thalassemia,15,35,1,0,1
Uttar Pradesh,Barabanki,Thalassemia,0,6,2,0,2
Uttar Pradesh,Barabanki,Thalassemia,6,15,1,1,2
Uttar Pradesh,Barabanki,Thalassemia,15,35,4,1,5
Uttar Pradesh,Barabanki,Thalassemia,35,60,2,0,2
Uttar Pradesh,Barabanki,Thalassemia,60,80,0,1,1
Rajasthan,Banswara,Thalassemia,0,6,2,1,3
Rajasthan,Banswara,Thalassemia,6,15,7,9,16
Rajasthan,Banswara,Thalassemia,15,35,5,1,6
Bihar,Banka,Thalassemia,6,15,1,2,3
Bihar,Banka,Thalassemia,15,35,1,0,1
Bihar,Banka,Thalassemia,35,60,2,2,4
Jammu And Kashmir,Bandipora,Thalassemia,6,15,0,1,1
Jammu And Kashmir,Bandipora,Thalassemia,15,35,1,1,2
Jammu And Kashmir,Bandipora,Thalassemia,35,60,2,1,3
Jammu And Kashmir,Bandipora,Thalassemia,60,80,1,1,2
Uttar Pradesh,Banda,Thalassemia,15,35,1,0,1
Uttar Pradesh,Banda,Thalassemia,35,60,1,0,1
Gujarat,Banas Kantha,Thalassemia,0,6,1,0,1
Gujarat,Banas Kantha,Thalassemia,6,15,3,5,8
Gujarat,Banas Kantha,Thalassemia,15,35,2,1,3
Chhattisgarh,Balrampur,Thalassemia,0,6,6,3,9
Chhattisgarh,Balrampur,Thalassemia,6,15,7,2,9
Chhattisgarh,Balrampur,Thalassemia,15,35,1,1,2
Chhattisgarh,Balrampur,Thalassemia,35,60,1,0,1
Uttar Pradesh,Balrampur,Thalassemia,0,6,1,0,1
Uttar Pradesh,Balrampur,Thalassemia,6,15,1,0,1
Uttar Pradesh,Balrampur,Thalassemia,35,60,2,0,2
Chhattisgarh,Baloda Bazar,Thalassemia,0,6,0,1,1
Chhattisgarh,Baloda Bazar,Thalassemia,15,35,3,1,4
Chhattisgarh,Baloda Bazar,Thalassemia,35,60,1,0,1
Chhattisgarh,Balod,Thalassemia,0,6,1,1,2
Chhattisgarh,Balod,Thalassemia,6,15,1,0,1
Uttar Pradesh,Ballia,Thalassemia,0,6,1,0,1
Uttar Pradesh,Ballia,Thalassemia,6,15,1,3,4
Uttar Pradesh,Ballia,Thalassemia,15,35,3,2,5
Uttar Pradesh,Ballia,Thalassemia,35,60,2,1,3
Uttar Pradesh,Ballia,Thalassemia,60,80,2,0,2
Karnataka,Ballari,Thalassemia,0,6,18,11,29
Karnataka,Ballari,Thalassemia,6,15,22,14,36
Karnataka,Ballari,Thalassemia,15,35,2,6,8
Karnataka,Ballari,Thalassemia,35,60,6,2,8
Odisha,Baleshwar,Thalassemia,0,6,34,28,62
Odisha,Baleshwar,Thalassemia,6,15,132,118,250
Odisha,Baleshwar,Thalassemia,15,35,81,73,154
Odisha,Baleshwar,Thalassemia,35,60,12,7,19
Odisha,Baleshwar,Thalassemia,60,80,4,1,5
Odisha,Balangir,Thalassemia,0,6,6,5,11
Odisha,Balangir,Thalassemia,6,15,11,5,16
Odisha,Balangir,Thalassemia,15,35,3,7,10
Odisha,Balangir,Thalassemia,60,80,2,1,3
Madhya Pradesh,Balaghat,Thalassemia,0,6,0,2,2
Madhya Pradesh,Balaghat,Thalassemia,6,15,7,2,9
Madhya Pradesh,Balaghat,Thalassemia,15,35,2,2,4
Madhya Pradesh,Balaghat,Thalassemia,35,60,2,0,2
Assam,Baksa,Thalassemia,6,15,0,2,2
Assam,Baksa,Thalassemia,15,35,0,2,2
Assam,Bajali,Thalassemia,6,15,0,1,1
Assam,Bajali,Thalassemia,15,35,2,1,3
Uttar Pradesh,Bahraich,Thalassemia,0,6,2,0,2
Uttar Pradesh,Bahraich,Thalassemia,6,15,11,2,13
Uttar Pradesh,Bahraich,Thalassemia,15,35,3,1,4
Uttar Pradesh,Bahraich,Thalassemia,35,60,1,1,2
Uttar Pradesh,Baghpat,Thalassemia,15,35,2,0,2
Uttar Pradesh,Baghpat,Thalassemia,35,60,2,0,2
Uttarakhand,Bageshwar,Thalassemia,15,35,1,0,1
Uttarakhand,Bageshwar,Thalassemia,35,60,1,0,1
Karnataka,Bagalkote,Thalassemia,0,6,8,8,16
Karnataka,Bagalkote,Thalassemia,6,15,10,12,22
Karnataka,Bagalkote,Thalassemia,15,35,9,4,13
Karnataka,Bagalkote,Thalassemia,35,60,2,1,3
Uttar Pradesh,Azamgarh,Thalassemia,15,35,1,0,1
Uttar Pradesh,Ayodhya,Thalassemia,0,6,3,0,3
Uttar Pradesh,Ayodhya,Thalassemia,6,15,3,2,5
Uttar Pradesh,Ayodhya,Thalassemia,15,35,3,1,4
Uttar Pradesh,Ayodhya,Thalassemia,35,60,2,0,2
Bihar,Aurangabad,Thalassemia,35,60,1,0,1
Maharashtra,Aurangabad,Thalassemia,0,6,7,4,11
Maharashtra,Aurangabad,Thalassemia,6,15,46,20,66
Maharashtra,Aurangabad,Thalassemia,15,35,17,20,37
Maharashtra,Aurangabad,Thalassemia,35,60,3,1,4
Maharashtra,Aurangabad,Thalassemia,60,80,1,1,2
Uttar Pradesh,Auraiya,Thalassemia,0,6,2,0,2
Uttar Pradesh,Auraiya,Thalassemia,6,15,1,0,1
Uttar Pradesh,Auraiya,Thalassemia,35,60,2,0,2
Madhya Pradesh,Ashoknagar,Thalassemia,6,15,2,1,3
Madhya Pradesh,Ashoknagar,Thalassemia,15,35,1,1,2
Bihar,Arwal,Thalassemia,15,35,1,0,1
Gujarat,Arvalli,Thalassemia,0,6,1,1,2
Gujarat,Arvalli,Thalassemia,6,15,11,4,15
Gujarat,Arvalli,Thalassemia,15,35,3,2,5
Gujarat,Arvalli,Thalassemia,35,60,0,1,1
Bihar,Araria,Thalassemia,6,15,2,0,2
Madhya Pradesh,Anuppur,Thalassemia,0,6,0,1,1
Madhya Pradesh,Anuppur,Thalassemia,6,15,4,0,4
Madhya Pradesh,Anuppur,Thalassemia,15,35,2,0,2
Odisha,Anugul,Thalassemia,0,6,1,3,4
Odisha,Anugul,Thalassemia,6,15,10,9,19
Odisha,Anugul,Thalassemia,15,35,3,1,4
Odisha,Anugul,Thalassemia,35,60,1,1,2
Odisha,Anugul,Thalassemia,60,80,0,1,1
Gujarat,Anand,Thalassemia,0,6,0,3,3
Gujarat,Anand,Thalassemia,6,15,7,3,10
Gujarat,Anand,Thalassemia,15,35,11,0,11
Uttar Pradesh,Amroha,Thalassemia,0,6,2,1,3
Uttar Pradesh,Amroha,Thalassemia,6,15,2,2,4
Uttar Pradesh,Amroha,Thalassemia,15,35,5,2,7
Uttar Pradesh,Amroha,Thalassemia,35,60,1,1,2
Uttar Pradesh,Amroha,Thalassemia,60,80,1,0,1
Punjab,Amritsar,Thalassemia,0,6,3,1,4
Punjab,Amritsar,Thalassemia,6,15,18,14,32
Punjab,Amritsar,Thalassemia,15,35,27,12,39
Punjab,Amritsar,Thalassemia,35,60,0,1,1
Gujarat,Amreli,Thalassemia,6,15,19,2,21
Gujarat,Amreli,Thalassemia,15,35,21,11,32
Maharashtra,Amravati,Thalassemia,0,6,12,16,28
Maharashtra,Amravati,Thalassemia,6,15,37,49,86
Maharashtra,Amravati,Thalassemia,15,35,42,33,75
Maharashtra,Amravati,Thalassemia,35,60,4,0,4
Uttar Pradesh,Amethi,Thalassemia,0,6,0,1,1
Uttar Pradesh,Amethi,Thalassemia,6,15,1,1,2
Uttar Pradesh,Amethi,Thalassemia,15,35,1,1,2
Uttar Pradesh,Ambedkar Nagar,Thalassemia,0,6,1,0,1
Uttar Pradesh,Ambedkar Nagar,Thalassemia,6,15,2,0,2
Uttar Pradesh,Ambedkar Nagar,Thalassemia,15,35,0,1,1
Uttar Pradesh,Ambedkar Nagar,Thalassemia,35,60,2,1,3
Uttar Pradesh,Ambedkar Nagar,Thalassemia,60,80,2,0,2
Haryana,Ambala,Thalassemia,0,6,3,2,5
Haryana,Ambala,Thalassemia,6,15,9,4,13
Haryana,Ambala,Thalassemia,15,35,7,4,11
Haryana,Ambala,Thalassemia,35,60,1,1,2
Haryana,Ambala,Thalassemia,60,80,1,0,1
Rajasthan,Alwar,Thalassemia,0,6,3,1,4
Rajasthan,Alwar,Thalassemia,6,15,11,3,14
Rajasthan,Alwar,Thalassemia,15,35,8,3,11
Rajasthan,Alwar,Thalassemia,35,60,0,1,1
Uttarakhand,Almora,Thalassemia,0,6,1,0,1
Uttarakhand,Almora,Thalassemia,6,15,1,1,2
Uttarakhand,Almora,Thalassemia,15,35,1,1,2
Uttar Pradesh,Aligarh,Thalassemia,0,6,2,0,2
Uttar Pradesh,Aligarh,Thalassemia,6,15,13,3,16
Uttar Pradesh,Aligarh,Thalassemia,15,35,7,5,12
Uttar Pradesh,Aligarh,Thalassemia,35,60,4,0,4
Maharashtra,Akola,Thalassemia,0,6,10,9,19
Maharashtra,Akola,Thalassemia,6,15,16,24,40
Maharashtra,Akola,Thalassemia,15,35,15,15,30
Maharashtra,Akola,Thalassemia,35,60,2,0,2
Rajasthan,Ajmer,Thalassemia,0,6,5,4,9
Rajasthan,Ajmer,Thalassemia,6,15,16,9,25
Rajasthan,Ajmer,Thalassemia,15,35,14,19,33
Rajasthan,Ajmer,Thalassemia,35,60,1,0,1
Mizoram,Aizawl,Thalassemia,15,35,1,0,1
Maharashtra,Ahmednagar,Thalassemia,0,6,6,0,6
Maharashtra,Ahmednagar,Thalassemia,6,15,14,16,30
Maharashtra,Ahmednagar,Thalassemia,15,35,17,14,31
Maharashtra,Ahmednagar,Thalassemia,35,60,1,1,2
Gujarat,Ahmadabad,Thalassemia,0,6,5,10,15
Gujarat,Ahmadabad,Thalassemia,6,15,37,37,74
Gujarat,Ahmadabad,Thalassemia,15,35,91,43,134
Gujarat,Ahmadabad,Thalassemia,35,60,5,1,6
Gujarat,Ahmadabad,Thalassemia,60,80,1,0,1
Uttar Pradesh,Agra,Thalassemia,0,6,1,2,3
Uttar Pradesh,Agra,Thalassemia,6,15,2,0,2
Uttar Pradesh,Agra,Thalassemia,15,35,5,4,9
Madhya Pradesh,Agar Malwa,Thalassemia,0,6,1,0,1
Madhya Pradesh,Agar Malwa,Thalassemia,6,15,1,0,1
Madhya Pradesh,Agar Malwa,Thalassemia,15,35,4,0,4
